Watch,strike,open_interest.yt,open_interest.td,OI_Dollar.yt,OI_Dollar.td,Date.td,expiry,stkClose,diff_oi,diff_oi_d,totalOI,totalOIdiff,OI_pct,cum_sep_OI,pct
424.71,400,41658,47618,84315792,117664078,2023-11-02,2023-11-17,422.66,5960,33348286,436972766,114712146,26.9270964131435,26.9270964131435,0.283419430694897
427.87,400,13575,13589,32905800,37872543,2023-11-02,2023-12-15,422.66,14,4966743,661780848,102231664,5.72282245919574,5.72282245919574,0.131143636169348
426.19,415,32384,32111,27299712,35932209,2023-11-02,2023-11-17,422.66,-273,8632497,436972766,114712146,8.22298591487049,35.150082328014,0.240243982773227
425.3,410,22796,22572,27583160,34535160,2023-11-02,2023-11-17,422.66,-224,6952000,436972766,114712146,7.90327514369626,43.0533574717103,0.201302093286958
426.67,385,7439,7440,27628446,31002480,2023-11-02,2023-12-15,422.66,1,3374034,661780848,102231664,4.68470492817888,10.4075273873746,0.108831099963616
432.04,420,24903,24977,23931783,30072308,2023-11-02,2023-12-15,422.66,74,6140525,661780848,102231664,4.54414903224881,14.9516764196234,0.204192009472635
429.74,425,43494,51238,13918080,24286812,2023-11-02,2023-11-17,422.66,7744,10368732,436972766,114712146,5.55796925797431,48.6113267296846,0.426928491067498
429.72,410,12283,12156,20094988,23971632,2023-11-02,2023-12-15,422.66,-127,3876644,661780848,102231664,3.62229158979832,18.5739680094218,0.16171798399041
430.65,415,14555,14687,18572180,22985155,2023-11-02,2023-12-15,422.66,132,4412975,661780848,102231664,3.47322759029134,22.0471955997131,0.191992396831781
422.76,355,3323,3322,20798657,22509872,2023-11-02,2023-12-15,422.66,-1,1711215,661780848,102231664,3.40140879991136,25.4486043996245,0.0760206455194416
436.24,430,35924,35806,17099824,22342944,2023-11-02,2023-12-15,422.66,-118,5243120,661780848,102231664,3.37618473963453,28.824789139259,0.234665583908728
427.71,420,30893,27332,16898471,21072972,2023-11-02,2023-11-17,422.66,-3561,4174501,436972766,114712146,4.82249092841635,53.4338176581009,0.198097401733367
426.07,414,16773,16685,16185945,20138795,2023-11-02,2023-11-17,422.66,-88,3952850,436972766,114712146,4.60870712478223,58.0425247828832,0.196280363348452
432.57,430,65931,72646,10680822,18670022,2023-11-02,2023-11-17,422.66,6715,7989200,436972766,114712146,4.27258251604632,62.3151072989295,0.427915939252776
424.73,380,3938,3925,16657740,17556525,2023-11-02,2023-12-15,422.66,-13,898785,661780848,102231664,2.65292128852904,31.477710427788,0.0511937869253739
422.85,370,3273,3275,15628575,17308375,2023-11-02,2023-12-15,422.66,2,1679800,661780848,102231664,2.61542398096114,34.0931344087492,0.0970512829771715
426.96,390,4657,4631,15358786,17116176,2023-11-02,2023-12-15,422.66,-26,1757390,661780848,102231664,2.58638128494163,36.6795156936908,0.10267421882084
428.94,405,6988,6966,14192628,16676604,2023-11-02,2023-12-15,422.66,-22,2483976,661780848,102231664,2.51995869182361,39.1994743855144,0.14894975020094
426,400,5567,6052,11879978,15735200,2023-11-02,2023-11-24,422.66,485,3855222,67048283,15185362,23.4684607807183,23.4684607807183,0.245006228074635
427.41,395,4350,4339,12575850,14062699,2023-11-02,2023-12-15,422.66,-11,1486849,661780848,102231664,2.12497823750862,41.324452623023,0.105729988247633
433.92,425,13828,15063,9693428,13436196,2023-11-02,2023-12-15,422.66,1235,3742768,661780848,102231664,2.03030898228714,43.3547616053102,0.278558603938198
429.18,409,6479,6475,11331771,13066550,2023-11-02,2023-12-15,422.66,-4,1734779,661780848,102231664,1.97445272698493,45.3292143322951,0.132764884380345
432.86,422,8653,10627,7588681,11540922,2023-11-02,2023-12-15,422.66,1974,3952241,661780848,102231664,1.74391900806413,47.0731333403592,0.342454528329712
442.61,440,42426,43392,7763958,11325312,2023-11-02,2023-12-15,422.66,966,3561354,661780848,102231664,1.71133873611283,48.7844720764721,0.314459681110772
418.65,320,1114,1114,10989610,10989610,2023-11-02,2023-12-15,422.66,0,0,661780848,102231664,1.66061167125223,50.4450837477243,0
439.21,435,27859,26014,8580572,10951894,2023-11-02,2023-12-15,422.66,-1845,2371322,661780848,102231664,1.6549125036027,52.099996251327,0.216521635435843
430.94,416,7219,7185,9110378,10734390,2023-11-02,2023-12-15,422.66,-34,1624012,661780848,102231664,1.62204603418804,53.722042285515,0.151290571704587
412.23,300,936,936,10504728,10504728,2023-11-02,2023-12-15,422.66,0,0,661780848,102231664,1.58734240069758,55.3093846862126,0
433.05,423,6327,9822,5099562,9871110,2023-11-02,2023-12-15,422.66,3495,4771548,661780848,102231664,1.49159801614567,56.8009827023583,0.483385151213997
433.47,424,7260,10373,5445000,9823231,2023-11-02,2023-12-15,422.66,3113,4378231,661780848,102231664,1.48436314373365,58.2853458460919,0.445701724819461
431.55,418,6996,6979,7758564,9456545,2023-11-02,2023-12-15,422.66,-17,1697981,661780848,102231664,1.42895416641009,59.714300012502,0.179556169827353
421.9,330,1022,1022,9198000,9392180,2023-11-02,2023-12-15,422.66,0,194180,661780848,102231664,1.41922813698592,61.1335281494879,0.0206746463547334
425.82,412,6731,6707,7235825,9269074,2023-11-02,2023-11-17,422.66,-24,2033249,436972766,114712146,2.12120175928767,64.4363090582172,0.219358373878556
430.45,410,4614,4448,8097570,9096160,2023-11-02,2023-12-29,422.66,-166,998590,119134666,22518358,7.63519159066598,7.63519159066598,0.109781490211254
422.2,350,1252,1258,8666344,9082760,2023-11-02,2023-12-15,422.66,6,416416,661780848,102231664,1.3724724774749,62.5060006269628,0.0458468571227248
419.17,365,1635,1635,8856795,8856795,2023-11-02,2023-12-15,422.66,0,0,661780848,102231664,1.33832748813547,63.8443281150983,0
414.76,250,531,531,8748756,8748756,2023-11-02,2023-12-15,422.66,0,0,661780848,102231664,1.32200199302232,65.1663301081206,0
431.88,419,6571,6748,6984973,8691424,2023-11-02,2023-12-15,422.66,177,1706451,661780848,102231664,1.31333870211971,66.4796688102403,0.196337332064343
426.02,375,1670,1657,7102510,8454014,2023-11-02,2023-12-15,422.66,-13,1351504,661780848,102231664,1.27746428829865,67.757133098539,0.159865360998929
430.32,414,5064,5048,6841464,8238336,2023-11-02,2023-12-15,422.66,-16,1396872,661780848,102231664,1.24487374104244,69.0020068395814,0.169557541717162
427.13,418,9690,8896,6395400,8122048,2023-11-02,2023-11-17,422.66,-794,1726648,436972766,114712146,1.85870805504616,66.2950171132633,0.212587761116408
431.2,417,5278,5481,6185816,7783020,2023-11-02,2023-12-15,422.66,203,1597204,661780848,102231664,1.17607211262179,70.1780789522032,0.205216484089724
437.38,430,9600,10380,5558400,7660440,2023-11-02,2023-12-29,422.66,780,2102040,119134666,22518358,6.43006797030849,14.0652595609745,0.274401992574839
423.18,415,10007,9358,4943458,7654844,2023-11-02,2023-11-03,422.66,-649,2711386,86263600,31048392,8.87378222100631,8.87378222100631,0.354205258787769
428.38,422,11653,11550,5372033,7368900,2023-11-02,2023-11-17,422.66,-103,1996867,436972766,114712146,1.68635223367673,67.98136934694,0.270985764496736
424.81,415,7866,7372,5388210,7231932,2023-11-02,2023-11-10,422.66,-494,1843722,68344835,21359059,10.5815340691071,10.5815340691071,0.254941832970775
422.79,408,4862,4863,6806800,7192377,2023-11-02,2023-11-17,422.66,1,385576.999999999,436972766,114712146,1.64595543695737,69.6273247838974,0.053609119766664
438.03,433,13961,14297,5151609,7191391,2023-11-02,2023-12-15,422.66,336,2039782,661780848,102231664,1.08667257774737,71.2647515299506,0.283642204964241
427.41,403,2943,2942,6183243,7181422,2023-11-02,2023-12-15,422.66,-1,998178.999999999,661780848,102231664,1.08516618782537,72.349917717776,0.138994616943552
435.82,429,10673,10417,5774093,7104394,2023-11-02,2023-12-15,422.66,-256,1330301,661780848,102231664,1.07352668507566,73.4234444028516,0.187250453733281
423.53,414,7166,7299,4048790,6955947,2023-11-02,2023-11-03,422.66,133,2907157,86263600,31048392,8.06359461000932,16.9373768310156,0.417938348293913
429.45,405,2791,2791,5916920,6823995,2023-11-02,2023-12-29,422.66,0,907075,119134666,22518358,5.72796754220976,19.7932271031842,0.132924335378323
429.12,408,3176,3174,5716800,6703488,2023-11-02,2023-12-15,422.66,-2,986688,661780848,102231664,1.01294681166113,74.4363912145128,0.147190238872659
423.48,360,1054,1051,6209114,6671748,2023-11-02,2023-12-15,422.66,-3,462634,661780848,102231664,1.00815066198471,75.4445418764975,0.0693422473390782
427,402,2662,2662,5813808,6655000,2023-11-02,2023-12-15,422.66,0,841192,661780848,102231664,1.00561991482715,76.4501617913246,0.1264
426.68,416,6101,6216,4819790,6638688,2023-11-02,2023-11-17,422.66,115,1818898,436972766,114712146,1.51924525200273,71.1465700359001,0.273984558394671
429.87,415,4424,4445,5322072,6609715,2023-11-02,2023-12-08,422.66,21,1287643,58295535,11187777,11.338286885951,11.338286885951,0.194810668841244
423.08,400,3368,2770,6315000,6393160,2023-11-02,2023-11-03,422.66,-598,78160,86263600,31048392,7.41119081512944,24.3485676461451,0.0122255660737413
429.28,424,12481,12026,4780223,6349728,2023-11-02,2023-11-17,422.66,-455,1569505,436972766,114712146,1.45311756110677,72.5996875970069,0.247176729459908
427.07,407,3013,3017,5206464,6055119,2023-11-02,2023-12-15,422.66,4,848654.999999999,661780848,102231664,0.91497344147983,77.3651352328044,0.140154966401156
426.71,417,6311,6231,4531298,6050301,2023-11-02,2023-11-17,422.66,-80,1519003,436972766,114712146,1.3845945264241,73.984282123431,0.251062385160672
425.15,409,3727,3722,4971818,6011030,2023-11-02,2023-11-17,422.66,-5,1039212,436972766,114712146,1.37560746749146,75.3598895909225,0.172884181246808
431.72,415,3510,3595,4970160,6010840,2023-11-02,2023-12-29,422.66,85,1040680,119134666,22518358,5.0454164197682,24.8386435229524,0.173133871472207
424.05,420,14944,14459,3272736,5855895,2023-11-02,2023-11-03,422.66,-485,2583159,86263600,31048392,6.78837307972308,31.1369407258682,0.441121126659546
435,425,5358,5742,4361412,5742000,2023-11-02,2023-12-29,422.66,384,1380588,119134666,22518358,4.81975582153393,29.6583993444864,0.240436781609195
421.38,150,208,207,5595408,5617566,2023-11-02,2023-12-15,422.66,-1,22158,661780848,102231664,0.848855934253329,78.2139911670578,0.0039444129361364
428.37,412.5,3539,3539,4989990,5616393,2023-11-02,2023-12-08,422.66,0,626403,58295535,11187777,9.63434506605008,20.9726319520011,0.111531190926276
425.91,413,4521,4347,4611420,5611977,2023-11-02,2023-11-17,422.66,-174,1000557,436972766,114712146,1.28428530028803,76.6441748912105,0.178289576026416
428.2,425,14701,17534,2837293,5610880,2023-11-02,2023-11-10,422.66,2833,2773587,68344835,21359059,8.20966207614665,18.7911961452537,0.494322993897571
441.19,438,16459,17467,3917242,5571973,2023-11-02,2023-12-15,422.66,1008,1654731,661780848,102231664,0.841966493415355,79.0559576604731,0.296973980311821
437.47,432,10266,10183,4137198,5570101,2023-11-02,2023-12-15,422.66,-83,1432903,661780848,102231664,0.841683620315346,79.8976412807885,0.257249015771886
425.5,411,3816,3813,4388400,5528850,2023-11-02,2023-11-17,422.66,-3,1140450,436972766,114712146,1.26526191794754,77.909436809158,0.206272552158225
435.43,428,7263,7301,4089069,5424643,2023-11-02,2023-12-15,422.66,38,1335574,661780848,102231664,0.819703836457957,80.7173451172464,0.246204957635
430.86,427,13728,14045,3377088,5421370,2023-11-02,2023-11-17,422.66,317,2044282,436972766,114712146,1.24066541940968,79.1501022285677,0.377078487540972
427.3,419,5643,6447,3391443,5351010,2023-11-02,2023-11-17,422.66,804,1959567,436972766,114712146,1.22456372944762,80.3746659580153,0.366205071565929
430.13,420,4356,5239,3345408,5307107,2023-11-02,2023-12-01,422.66,883,1961699,49322029,10894195,10.7601149174135,10.7601149174135,0.369636225536813
436.84,431,8806,8921,3839416,5209864,2023-11-02,2023-12-15,422.66,115,1370448,661780848,102231664,0.787249134777016,81.5045942520234,0.263048709140968
434.35,426,6227,6203,4240587,5179505,2023-11-02,2023-12-15,422.66,-24,938918,661780848,102231664,0.782661664454817,82.2872559164783,0.181275623828918
423.53,405,2997,2777,5130864,5145781,2023-11-02,2023-11-24,422.66,-220,14917.0000000009,67048283,15185362,7.67473941129857,31.1432001920169,0.00289887968415308
420.71,391,1702,1702,5056642,5056642,2023-11-02,2023-12-15,422.66,0,0,661780848,102231664,0.764096152870232,83.0513520693485,0
428.77,423,10173,8721,4293006,5032017,2023-11-02,2023-11-17,422.66,-1452,739011,436972766,114712146,1.15156307017998,81.5262290281953,0.146861785244366
428.6,415,3623,3606,3934578,4904160,2023-11-02,2023-12-01,422.66,-17,969582,49322029,10894195,9.94314325552179,20.7032581729353,0.197706029167074
423.85,405,2586,2589,3941064,4880265,2023-11-02,2023-11-10,422.66,3,939201,68344835,21359059,7.14064932631705,25.9318454715708,0.192448770712246
446.5,445,32996,32485,3398588,4872750,2023-11-02,2023-12-15,422.66,-511,1474162,661780848,102231664,0.736308706232006,83.7876607755805,0.302531835205993
426.03,420,9233,7976,3693200,4809528,2023-11-02,2023-11-10,422.66,-1257,1116328,68344835,21359059,7.0371491861821,32.9689946577529,0.232107599747834
424.35,350,611,640,4292275,4758400,2023-11-02,2023-12-29,422.66,29,466125,119134666,22518358,3.99413551048189,33.6525348549682,0.0979583473436449
431.46,428,13193,13722,2889267,4747812,2023-11-02,2023-11-17,422.66,529,1858545,436972766,114712146,1.08652354778558,82.6127525759809,0.391452947168085
430.22,426,11046,11122,3092880,4693484,2023-11-02,2023-11-17,422.66,76,1600604,436972766,114712146,1.07409073635495,83.6868433123359,0.341026836354401
436.17,435,40959,39765,2826171,4652505,2023-11-02,2023-11-17,422.66,-1194,1826334,436972766,114712146,1.06471280638116,84.751556118717,0.392548530307866
424.8,405,2341,2340,3893083,4633200,2023-11-02,2023-11-17,422.66,-1,740117.000000001,436972766,114712146,1.060294910919,85.811851029636,0.159742078908746
420.26,394,1762,1762,4627012,4627012,2023-11-02,2023-12-15,422.66,0,0,661780848,102231664,0.699175869773735,84.4868366453542,0
423.28,416,6706,6345,2883580,4619160,2023-11-02,2023-11-03,422.66,-361,1735580,86263600,31048392,5.35470349023226,36.4916442161004,0.375734982117961
438.51,434,8694,9720,3077676,4383720,2023-11-02,2023-12-15,422.66,1026,1306044,661780848,102231664,0.662412642077548,85.1492492874318,0.297930524759793
423.24,413,4393,4230,2771983,4331520,2023-11-02,2023-11-03,422.66,-163,1559537,86263600,31048392,5.02126041574894,41.5129046318494,0.360043818336288
426.93,411,2721,2713,4380810,4321809,2023-11-02,2023-12-15,422.66,-8,-59001.0000000009,661780848,102231664,0.653057430274863,85.8023067177066,-0.0136519221464903
424.3,410,3011,3019,3312100,4317170,2023-11-02,2023-11-10,422.66,8,1005070,68344835,21359059,6.31674653980802,39.2857411975609,0.232807603128902
423.78,419,7716,8964,2037024,4284792,2023-11-02,2023-11-03,422.66,1248,2247768,86263600,31048392,4.96709156585165,46.479996197701,0.524592092218246
440.19,435,7880,8185,3073200,4248015,2023-11-02,2023-12-29,422.66,305,1174815,119134666,22518358,3.56572536158367,37.2182602165519,0.276556226849481
428.44,400,1476,1479,3681144,4206276,2023-11-02,2023-12-29,422.66,3,525132,119134666,22518358,3.53069021908367,40.7489504356356,0.124844874658724
427.2,410,2398,2399,3712104,4126280,2023-11-02,2023-12-08,422.66,1,414176,58295535,11187777,7.0782093345571,28.0508412865582,0.100375156315131
416.55,200,190,190,4114450,4114450,2023-11-02,2023-12-15,422.66,0,0,661780848,102231664,0.621723945689042,86.4240306633957,0
428.04,421,5397,5792,2676912,4077568,2023-11-02,2023-11-17,422.66,395,1400656,436972766,114712146,0.933140075827975,86.744991105464,0.3435027938222
428.75,420,5389,4639,3578296,4059125,2023-11-02,2023-11-24,422.66,-750,480829,67048283,15185362,6.05403273339602,37.1972329254129,0.118456317556124
430.19,413,2326,2318,3405264,3984642,2023-11-02,2023-12-15,422.66,-8,579378.000000001,661780848,102231664,0.602108993036317,87.026139656432,0.145402773950583
444.09,442,18573,18825,2730231,3934425,2023-11-02,2023-12-15,422.66,252,1204194,661780848,102231664,0.594520831464135,87.6206604878961,0.306066070645647
423.25,412,3611,3434,2751582,3863250,2023-11-02,2023-11-03,422.66,-177,1111668,86263600,31048392,4.47842427165108,50.9584204693521,0.287754610755193
424.4,421,9244,11357,1654676,3861380,2023-11-02,2023-11-03,422.66,2113,2206704,86263600,31048392,4.47625649752619,55.4346769668783,0.571480662353873
440.44,440,85846,86565,2317842,3808860,2023-11-02,2023-11-17,422.66,719,1491018,436972766,114712146,0.871646998705636,87.6166381041696,0.391460436981144
424.87,414,3463,3495,2742696,3799065,2023-11-02,2023-11-10,422.66,32,1056369,68344835,21359059,5.55867169772229,44.8444128952832,0.278060259563866
450.83,450,45341,45456,2629778,3772848,2023-11-02,2023-12-15,422.66,115,1143070,661780848,102231664,0.570105347019653,88.1907658349158,0.30297271451169
429.06,413,2346,2343,2934846,3762858,2023-11-02,2023-12-08,422.66,-3,828012,58295535,11187777,6.45479623782508,34.5056375243833,0.220048697027632
423.57,418,8622,6741,2724552,3754737,2023-11-02,2023-11-03,422.66,-1881,1030185,86263600,31048392,4.35263193281987,59.7873088996981,0.27436941655301
422.84,410,3083,2918,2682210,3746712,2023-11-02,2023-11-03,422.66,-165,1064502,86263600,31048392,4.34332905188283,64.130637951581,0.284116313183399
423.33,411,2964,3033,2374164,3739689,2023-11-02,2023-11-03,422.66,69,1365525,86263600,31048392,4.33518772692074,68.4658256785017,0.365143999942241
419.04,335,444,444,3731376,3731376,2023-11-02,2023-12-15,422.66,0,0,661780848,102231664,0.563838619881003,88.7546044547968,0
439.76,436,10141,9891,2880044,3719016,2023-11-02,2023-12-15,422.66,-250,838972,661780848,102231664,0.561970932105306,89.3165753869021,0.225589779662147
433.32,420,2711,2784,2963123,3708288,2023-11-02,2023-12-29,422.66,73,745165,119134666,22518358,3.11268594147064,43.8616363771062,0.20094582729281
424.78,422,11014,12956,1586016,3601768,2023-11-02,2023-11-03,422.66,1942,2015752,86263600,31048392,4.17530453169123,72.641130210193,0.55965625770455
432.61,421,2968,3024,2789920,3510864,2023-11-02,2023-12-15,422.66,56,720944,661780848,102231664,0.530517619331287,89.8470930062334,0.205346604140747
434.8,427,4418,4419,2783340,3446820,2023-11-02,2023-12-15,422.66,1,663480,661780848,102231664,0.520840095390612,90.367933101624,0.192490469476213
422.9,406,1999,1998,2832583,3376620,2023-11-02,2023-11-17,422.66,-1,544037,436972766,114712146,0.772730079018242,88.3893681831879,0.161118811118811
427.41,415,2696,2640,2669040,3276240,2023-11-02,2023-11-24,422.66,-56,607200,67048283,15185362,4.8863891115601,42.083622036973,0.185334407735697
429.6,417,2586,2597,2759262,3272220,2023-11-02,2023-12-08,422.66,11,512958,58295535,11187777,5.6131571654673,40.1187946898506,0.156761464693694
433.19,431,13294,14935,1874454,3270765,2023-11-02,2023-11-17,422.66,1641,1396311,436972766,114712146,0.748505457202795,89.1378736403907,0.426906549385236
423.42,392,1033,1033,3245686,3245686,2023-11-02,2023-12-15,422.66,0,0,661780848,102231664,0.490447254526773,90.8583803561508,0
425.22,423,12848,13972,1464672,3101784,2023-11-02,2023-11-03,422.66,1124,1637112,86263600,31048392,3.59570432952022,76.2368345397132,0.527796906554422
422.04,399,1339,1340,2878850,3087360,2023-11-02,2023-11-17,422.66,1,208510,436972766,114712146,0.706533733958148,89.8444073743488,0.0675366656301824
434.51,430,6847,6773,2184193,3054623,2023-11-02,2023-12-01,422.66,-74,870430,49322029,10894195,6.1932225051001,26.8964806780354,0.284954968256312
417.33,350,452,452,3043316,3043316,2023-11-02,2023-11-17,422.66,0,0,436972766,114712146,0.696454387274103,90.5408617616229,0
431.1,413,1657,1653,2502070,2991930,2023-11-02,2023-12-29,422.66,-4,489860.000000001,119134666,22518358,2.5113848894326,46.3730212665388,0.163727092545614
422.92,280,208,208,2810080,2972736,2023-11-02,2023-12-15,422.66,0,162656,661780848,102231664,0.449202482813465,91.3075828389642,0.0547159249930029
423.38,417,4723,4595,1752233,2931610,2023-11-02,2023-11-03,422.66,-128,1179377,86263600,31048392,3.39843224720508,79.6352667869182,0.402296690214592
431.61,414,1657,1654,2445732,2912694,2023-11-02,2023-12-29,422.66,-3,466962,119134666,22518358,2.44487528088592,48.8178965474248,0.160319621628637
436.6,428,3386,3375,2339726,2902500,2023-11-02,2023-12-29,422.66,-11,562774,119134666,22518358,2.43631857749952,51.2542151249243,0.193892850990525
421.65,310,259,259,2683758,2891735,2023-11-02,2023-12-15,422.66,0,207977,661780848,102231664,0.436962630263365,91.7445454692276,0.0719211822660099
431.91,425,4691,4150,2406483,2867650,2023-11-02,2023-12-01,422.66,-541,461167,49322029,10894195,5.81413631624928,32.7106169942847,0.160817045315851
436.03,427,3124,3152,2268024,2846256,2023-11-02,2023-12-29,422.66,28,578232,119134666,22518358,2.38910813750886,53.6433232624331,0.203155302966423
426.49,410,1579,1722,2084280,2839578,2023-11-02,2023-11-24,422.66,143,755298,67048283,15185362,4.23512411197763,46.3187461489506,0.265989523795437
425.2,416,3158,3085,1957960,2838200,2023-11-02,2023-11-10,422.66,-73,880239.999999999,68344835,21359059,4.15276443347913,48.9971773287623,0.310140229723064
440.46,437,8131,8143,2040881,2817478,2023-11-02,2023-12-15,422.66,12,776597,661780848,102231664,0.425741846188937,92.1702873154165,0.275635515166401
428.93,411,1529,1527,2313377,2737911,2023-11-02,2023-12-08,422.66,-2,424534,58295535,11187777,4.69660498012412,44.8153996699747,0.155057633356234
438.52,435,3251,7702,835507,2711104,2023-11-02,2023-12-08,422.66,4451,1875597,58295535,11187777,4.65062032623939,49.4660199962141,0.691820380184604
435.4,434,18102,19283,1520568,2699620,2023-11-02,2023-11-17,422.66,1181,1179052,436972766,114712146,0.617800515284287,91.1586622769072,0.436747394077685
447.08,445,12619,12949,1880231,2693392,2023-11-02,2023-12-29,422.66,330,813161,119134666,22518358,2.26079619848013,55.9041194609133,0.301909636621776
423.04,407,1686,1674,2233950,2685096,2023-11-02,2023-11-17,422.66,-12,451146,436972766,114712146,0.614476738351241,91.7731390152585,0.168018573637591
427.33,406,1254,1252,2455332,2670516,2023-11-02,2023-12-15,422.66,-2,215184,661780848,102231664,0.403534796764019,92.5738221121806,0.0805776861101001
430.26,412,1450,1449,2189500,2645874,2023-11-02,2023-12-15,422.66,-1,456374,661780848,102231664,0.399811207591792,92.9736333197724,0.172485159913133
428.84,416,2087,2059,2166306,2643756,2023-11-02,2023-12-01,422.66,-28,477450,49322029,10894195,5.36019310965492,38.0708101039396,0.180595334819098
433.96,432,13194,13024,1583280,2552704,2023-11-02,2023-11-17,422.66,-170,969424,436972766,114712146,0.584179198023522,92.357318213282,0.379763576192148
429.16,412,1457,1453,2108279,2493348,2023-11-02,2023-12-08,422.66,-4,385069,58295535,11187777,4.27708228426071,53.7431022804748,0.154438530040732
443.38,440,7261,7340,1844294,2480920,2023-11-02,2023-12-29,422.66,79,636626,119134666,22518358,2.08245012413096,57.9865695850442,0.256608838656627
437.98,431,2890,3545,1615510,2474410,2023-11-02,2023-12-29,422.66,655,858900,119134666,22518358,2.0769857196729,60.0635553047171,0.347113049171318
431.92,429,6657,8439,1258173,2464188,2023-11-02,2023-11-17,422.66,1782,1206015,436972766,114712146,0.563922558047931,92.9212407713299,0.489416797744328
424.3,225,123,123,2451390,2451390,2023-11-02,2023-12-15,422.66,0,0,661780848,102231664,0.370423231105654,93.344056550878,0
423.89,370,448,448,2216256,2414272,2023-11-02,2023-11-17,422.66,0,198016,436972766,114712146,0.552499420524528,93.4737401918544,0.082018927444795
424.13,390,672,671,1980384,2290123,2023-11-02,2023-11-17,422.66,-1,309739.000000001,436972766,114712146,0.524088267780057,93.9978284596345,0.135249940723708
441.85,439,7765,7919,1584060,2256915,2023-11-02,2023-12-15,422.66,154,672855,661780848,102231664,0.341036614586344,93.6850931654643,0.298130412532151
424.54,413,1833,1945,1541553,2244530,2023-11-02,2023-11-10,422.66,112,702977,68344835,21359059,3.28412527442637,52.2813026031887,0.31319563561191
413.04,340,306,306,2235024,2235024,2023-11-02,2023-12-15,422.66,0,0,661780848,102231664,0.337728721940892,94.0228218874053,0
426.9,404,974,975,2049296,2232750,2023-11-02,2023-12-15,422.66,1,183454,661780848,102231664,0.337385103655946,94.3602069910612,0.0821650431082746
424.49,411,1793,1633,1755347,2202917,2023-11-02,2023-11-10,422.66,-160,447570,68344835,21359059,3.2232384495478,55.5045410527365,0.203171522122713
424.63,412,1743,1698,1633191,2144574,2023-11-02,2023-11-10,422.66,-45,511383,68344835,21359059,3.13787281804104,58.6424138707775,0.23845435037448
434.61,433,10743,13045,1063557,2100245,2023-11-02,2023-11-17,422.66,2302,1036688,436972766,114712146,0.480635216520565,94.478463676155,0.493603365321665
430.99,425,3207,3485,1318077,2087515,2023-11-02,2023-11-24,422.66,278,769438,67048283,15185362,3.11345034741606,49.4321964963667,0.368590405338405
419.9,325,217,217,2059330,2059330,2023-11-02,2023-12-15,422.66,0,0,661780848,102231664,0.311180053974605,94.6713870450358,0
428.79,417.5,1815,1811,1865820,2044619,2023-11-02,2023-12-08,422.66,-4,178799,58295535,11187777,3.50733379494673,57.2504360754216,0.0874485662120914
439.1,433,3348,3351,1543428,2044110,2023-11-02,2023-12-29,422.66,3,500682,119134666,22518358,1.71579781824377,61.7793531229609,0.244938873152619
430.8,419,1726,1730,1682850,2041400,2023-11-02,2023-12-08,422.66,4,358550,58295535,11187777,3.50181193122252,60.7522480066441,0.175639267169589
444.88,443,10515,10847,1451070,2039236,2023-11-02,2023-12-15,422.66,332,588166,661780848,102231664,0.308143701372271,94.9795307464081,0.288424684538719
427.7,414,1484,1484,1892100,2033080,2023-11-02,2023-12-08,422.66,0,140980,58295535,11187777,3.48753982616336,64.2397878328074,0.0693430656934307
426.35,425,15168,14720,985920,1987200,2023-11-02,2023-11-03,422.66,-448,1001280,86263600,31048392,2.30363675988482,81.9389035468031,0.503864734299517
427.06,413,1419,1404,1606308,1974024,2023-11-02,2023-11-24,422.66,-15,367716,67048283,15185362,2.94418277646275,52.3763792728294,0.186277370487897
424.64,395,675,662,1646325,1962168,2023-11-02,2023-11-17,422.66,-13,315843,436972766,114712146,0.449036679782465,94.9275003559375,0.160966339273701
429.08,417,1656,1590,1583136,1920720,2023-11-02,2023-12-01,422.66,-66,337584,49322029,10894195,3.89424368571698,41.9650537896565,0.175759090341122
427.05,422.5,4129,4147,1267603,1886885,2023-11-02,2023-11-10,422.66,18,619282,68344835,21359059,2.76083042705422,61.4032442978317,0.328203361625112
427.56,410,1004,1073,1485920,1884188,2023-11-02,2023-12-01,422.66,69,398268,49322029,10894195,3.82017536220986,45.7852291518664,0.21137381195507
429.57,418,2008,1581,1787120,1829217,2023-11-02,2023-12-01,422.66,-427,42097.0000000002,49322029,10894195,3.70872212090058,49.493951272767,0.0230136719700288
420.58,408,1457,1449,1593958,1822842,2023-11-02,2023-11-03,422.66,-8,228884,86263600,31048392,2.11310680286935,84.0520103496724,0.125564365973573
430.07,407,790,789,1548400,1820223,2023-11-02,2023-12-29,422.66,-1,271823,119134666,22518358,1.52787014990246,63.3072232728633,0.149334999063301
413.6,300,159,159,1806240,1806240,2023-11-02,2023-12-29,422.66,0,0,119134666,22518358,1.51613301203195,64.8233562848953,0
429,409,900,900,1647900,1800000,2023-11-02,2023-12-29,422.66,0,152100,119134666,22518358,1.51089524186017,66.3342515267554,0.0845
443.36,441,7046,7592,1169636,1791712,2023-11-02,2023-12-15,422.66,546,622076,661780848,102231664,0.27074098705256,95.2502717334606,0.347196424425354
424.2,403,820,820,1738400,1738400,2023-11-02,2023-12-29,422.66,0,0,119134666,22518358,1.45918904913873,67.7934405758942,0
426.79,422,2592,3590,806112,1719610,2023-11-02,2023-11-10,422.66,998,913498,68344835,21359059,2.51607893998135,63.9193232378131,0.531223940312048
451.26,450,13866,13630,1247940,1717380,2023-11-02,2023-12-29,422.66,-236,469440,119134666,22518358,1.44154515025878,69.234985726153,0.273346609370087
431.34,430,9190,12809,689250,1716406,2023-11-02,2023-11-10,422.66,3619,1027156,68344835,21359059,2.51139094856254,66.4307141863756,0.598434170004067
433.47,430,4550,4946,1051050,1716262,2023-11-02,2023-11-24,422.66,396,665212,67048283,15185362,2.55974041870692,54.9361196915363,0.387593502623725
427.25,414,1325,1266,1424375,1677450,2023-11-02,2023-11-24,422.66,-59,253075,67048283,15185362,2.50185377603182,57.4379734675681,0.15086887835703
425.76,424,9184,9495,799008,1671120,2023-11-02,2023-11-03,422.66,311,872112,86263600,31048392,1.93722497090314,85.9892353205756,0.521872755995979
430.45,418,1329,1336,1354251,1663320,2023-11-02,2023-12-08,422.66,7,309069,58295535,11187777,2.85325454170718,67.0930423745146,0.185814515547219
433.96,422,1319,1382,1304491,1652872,2023-11-02,2023-12-29,422.66,63,348381,119134666,22518358,1.3873980223355,70.6223837484885,0.2107731270177
424.74,380,371,369,1483629,1650906,2023-11-02,2023-12-29,422.66,-2,167277,119134666,22518358,1.38574778897689,72.0081315374654,0.101324363713016
425.23,260,99,99,1635777,1635777,2023-11-02,2023-12-15,422.66,0,0,661780848,102231664,0.247178050701159,95.4974497841618,0
423.21,409,1127,1139,1127000,1618519,2023-11-02,2023-11-03,422.66,12,491519,86263600,31048392,1.87624791916869,87.8654832397442,0.303684417668251
440.81,436,3183,3299,1196808,1586819,2023-11-02,2023-12-29,422.66,116,390011,119134666,22518358,1.33195404266295,73.3400855801283,0.245781654996569
430.33,416,1129,1103,1264480,1580599,2023-11-02,2023-12-08,422.66,-26,316119,58295535,11187777,2.71135516639482,69.8043975409094,0.19999949386277
419.87,395,651,635,1452381,1579245,2023-11-02,2023-11-03,422.66,-16,126864,86263600,31048392,1.83072002559596,89.6962032653402,0.0803320574071788
420.97,290,119,119,1558543,1558543,2023-11-02,2023-12-15,422.66,0,0,661780848,102231664,0.235507419821856,95.7329572039836,0
426.37,421,1741,2861,658098,1536357,2023-11-02,2023-11-10,422.66,1120,878259,68344835,21359059,2.24794894888546,68.6786631352611,0.571650339081346
428.36,413,1025,998,1296625,1532928,2023-11-02,2023-12-01,422.66,-27,236303,49322029,10894195,3.10799865917925,52.6019499319462,0.154151401761857
427.82,412,934,932,1222606,1474424,2023-11-02,2023-12-01,422.66,-2,251818,49322029,10894195,2.98938229001082,55.5913322219571,0.170790763036955
437.26,429,1181,1767,753478,1459542,2023-11-02,2023-12-29,422.66,586,706064,119134666,22518358,1.22511947949726,74.5652050596256,0.483757233433502
431.99,416,1278,907,1750860,1450293,2023-11-02,2023-12-29,422.66,-371,-300567,119134666,22518358,1.21735599611284,75.7825610557384,-0.207245708281016
436.97,436,14729,14802,854282,1435794,2023-11-02,2023-11-17,422.66,73,581512,436972766,114712146,0.328577456472425,95.2560778124099,0.405010746667001
427.25,423,2844,3357,759348,1426725,2023-11-02,2023-11-10,422.66,513,667377,68344835,21359059,2.08753887546879,70.7662020107299,0.467768490774326
430.4,421,1753,1510,1262160,1419400,2023-11-02,2023-12-01,422.66,-243,157240,49322029,10894195,2.8778215916462,58.4691538136033,0.110779202479921
423.49,407,859,859,1416491,1416491,2023-11-02,2023-12-08,422.66,0,0,58295535,11187777,2.42984475569184,72.2342422966013,0
427.01,426,6791,13891,319177,1402991,2023-11-02,2023-11-03,422.66,7100,1083814,86263600,31048392,1.62639977928118,91.3226030446214,0.772502460814075
415.8,170,57,57,1401060,1401060,2023-11-02,2023-12-15,422.66,0,0,661780848,102231664,0.211710569176218,95.9446677731598,0
429.62,422,1801,1828,981545,1392936,2023-11-02,2023-11-24,422.66,27,411391,67048283,15185362,2.07751181338976,59.5154852809579,0.295340920185852
438.66,438,20678,20617,806442,1360722,2023-11-02,2023-11-17,422.66,-61,554280,436972766,114712146,0.31139743843899,95.5674752508489,0.407342572546045
424.82,240,73,73,1328600,1349186,2023-11-02,2023-12-15,422.66,0,20585.9999999998,661780848,102231664,0.203872022600449,96.1485397957603,0.015258088951412
427.92,416,1129,1126,1016100,1342192,2023-11-02,2023-11-24,422.66,-3,326092,67048283,15185362,2.0018290401262,61.5173143210841,0.242954808253961
449.07,448,13691,12073,999443,1291811,2023-11-02,2023-12-15,422.66,-1618,292368,661780848,102231664,0.195202234078554,96.3437420298389,0.226324129458566
426.77,412,784,868,948640,1282036,2023-11-02,2023-11-24,422.66,84,333396,67048283,15185362,1.91210862178231,63.4294229428664,0.260051979819599
427.72,424,3478,3445,786028,1281540,2023-11-02,2023-11-10,422.66,-33,495512,68344835,21359059,1.87510877742261,72.6413107881525,0.386653557438707
424.5,407,732,722,974292,1263500,2023-11-02,2023-11-10,422.66,-10,289208,68344835,21359059,1.84871322024554,74.490024008398,0.228894341115948
428.54,419,1456,1311,1043952,1250694,2023-11-02,2023-11-24,422.66,-145,206742,67048283,15185362,1.86536320400628,65.2947861468727,0.165301824427078
427.89,397,396,396,908424,1223244,2023-11-02,2023-12-29,422.66,0,314820,119134666,22518358,1.02677418846333,76.8093352442017,0.257364842991259
448.21,447,10703,10058,877646,1217018,2023-11-02,2023-12-15,422.66,-645,339372,661780848,102231664,0.183900456424209,96.5276424862631,0.278855366149063
423.16,405,754,670,1035996,1216720,2023-11-02,2023-11-03,422.66,-84,180724,86263600,31048392,1.41046745092948,92.7330704955508,0.148533762903544
427.99,417,1153,1107,965061,1216593,2023-11-02,2023-11-24,422.66,-46,251532,67048283,15185362,1.81450284118387,67.1092889880566,0.206751148494197
425.36,417,1471,1433,823760,1197988,2023-11-02,2023-11-10,422.66,-38,374228,68344835,21359059,1.75285813478078,76.2428821431788,0.312380424511765
428.4,414,831,816,959805,1175040,2023-11-02,2023-12-01,422.66,-15,215235,49322029,10894195,2.38238374175564,60.8515375553589,0.183172487745098
445.66,444,7127,7058,848113,1171628,2023-11-02,2023-12-15,422.66,-69,323515,661780848,102231664,0.177041690393555,96.7046841766566,0.27612433297941
418.64,210,56,56,1168384,1168384,2023-11-02,2023-11-17,422.66,0,0,436972766,114712146,0.267381423033581,95.8348566738825,0
431.79,422,1189,1190,953578,1165010,2023-11-02,2023-12-08,422.66,1,211432,58295535,11187777,1.99845494170351,74.2326972383048,0.181485137466631
431.13,420,1050,1046,952350,1164198,2023-11-02,2023-12-08,422.66,-4,211848,58295535,11187777,1.99706203914245,76.2297592774472,0.181969046502399
429.43,421,1335,1335,839715,1125405,2023-11-02,2023-11-24,422.66,0,285690,67048283,15185362,1.67849935843995,68.7877883464965,0.253855278766311
417.2,315,110,110,1124200,1124200,2023-11-02,2023-12-15,422.66,0,0,661780848,102231664,0.169874967430306,96.8745591440869,0
428.27,418,1098,1083,852048,1112241,2023-11-02,2023-11-24,422.66,-15,260193,67048283,15185362,1.65886574604752,70.446654092544,0.233935810674126
432.89,427,1882,1887,856310,1111443,2023-11-02,2023-12-01,422.66,5,255133,49322029,10894195,2.253441357816,63.1049789131749,0.22955113307655
426.16,412.5,814,813,911680,1110558,2023-11-02,2023-11-24,422.66,-1,198878,67048283,15185362,1.65635561465459,72.1030097071986,0.179079345698289
423.94,400,447,461,886848,1103634,2023-11-02,2023-11-10,422.66,14,216786,68344835,21359059,1.61480234753658,77.8576844907154,0.196429251001691
416.65,370,236,236,1100940,1100940,2023-11-02,2023-12-29,422.66,0,0,119134666,22518358,0.924113893096406,77.7334491372981,0
437.82,437,13311,13397,652239,1098554,2023-11-02,2023-11-17,422.66,86,446315,436972766,114712146,0.251401022094819,96.0862576959773,0.406274976013924
428.75,426,3006,3973,492984,1092575,2023-11-02,2023-11-10,422.66,967,599591,68344835,21359059,1.59862116866622,79.4563056593816,0.548787039791319
429.79,419,1338,1010,1107864,1089790,2023-11-02,2023-12-01,422.66,-328,-18074,49322029,10894195,2.20954008197838,65.3145189951533,-0.0165848466218262
415.57,325,120,120,1086840,1086840,2023-11-02,2023-11-03,422.66,0,0,86263600,31048392,1.259905684437,93.9929761799879,0
425.78,419,1736,1600,775992,1084800,2023-11-02,2023-11-10,422.66,-136,308808,68344835,21359059,1.58724503468331,81.0435506940649,0.28466814159292
437.51,432,1764,1955,908460,1077205,2023-11-02,2023-12-29,422.66,191,168745,119134666,22518358,0.904191060559988,78.6376401978581,0.156650776778793
424.93,412.5,884,860,764660,1068980,2023-11-02,2023-11-10,422.66,-24,304320,68344835,21359059,1.56409771126084,82.6076484053257,0.284682594622912
447.36,446,7865,7754,755040,1054544,2023-11-02,2023-12-15,422.66,-111,299504,661780848,102231664,0.159349428619306,97.0339085727062,0.284012805534904
422.48,409,780,775,896220,1044700,2023-11-02,2023-11-10,422.66,-5,148480,68344835,21359059,1.52857198353028,84.136220388856,0.142126926390351
420.55,395,147,399,327957,1019445,2023-11-02,2023-11-10,422.66,252,691488,68344835,21359059,1.49161966665074,85.6278400555068,0.67829848594088
427.72,427,11017,14119,363561,1016568,2023-11-02,2023-11-03,422.66,3102,653007,86263600,31048392,1.17844374684108,95.1714199268289,0.642364308142692
425.51,418,3014,1339,1519056,1005589,2023-11-02,2023-11-10,422.66,-1675,-513467,68344835,21359059,1.47134600588325,87.09918606139,-0.510613182920657
433.83,426,1281,1264,767319,989712,2023-11-02,2023-12-08,422.66,-17,222393,58295535,11187777,1.69774923585486,77.9275085133021,0.224704762597604
439.59,434,1822,1760,777994,983840,2023-11-02,2023-12-29,422.66,-62,205846,119134666,22518358,0.825821763750947,79.4634619616091,0.209227110099203
433.56,427.5,1372,1620,585844,981720,2023-11-02,2023-12-01,422.66,248,395876,49322029,10894195,1.9904290636543,67.3049480588076,0.403247361773214
418.47,380,255,255,980985,980985,2023-11-02,2023-11-17,422.66,0,0,436972766,114712146,0.224495684017068,96.3107533799944,0
422.21,402,484,484,906048,978164,2023-11-02,2023-11-17,422.66,0,72116.0000000001,436972766,114712146,0.223850106026974,96.5346034860214,0.0737258782780803
423.65,407.5,595,595,960925,960925,2023-11-02,2023-12-08,422.66,0,0,58295535,11187777,1.64836809542961,79.5758766087317,0
431.22,426,1486,1825,558736,952650,2023-11-02,2023-11-24,422.66,339,393914,67048283,15185362,1.42084175369562,73.5238514608942,0.413492888259067
420,383,257,257,950900,950900,2023-11-02,2023-12-15,422.66,0,0,661780848,102231664,0.143688050639991,97.1775966233462,0
419.41,384,266,266,941906,941906,2023-11-02,2023-12-15,422.66,0,0,661780848,102231664,0.142328990457578,97.3199256138038,0
434.18,423,784,821,721280,917878,2023-11-02,2023-12-29,422.66,37,196598,119134666,22518358,0.770454168226736,80.2339161298358,0.214187506400633
429.97,428,4324,4639,492936,913883,2023-11-02,2023-11-10,422.66,315,420947,68344835,21359059,1.33716468845085,88.4363507498409,0.460613667176214
445.59,443,3417,3515,652647,910385,2023-11-02,2023-12-29,422.66,98,257738,119134666,22518358,0.76416464708937,80.9980807769252,0.283108794630843
430.51,424,1400,1397,648200,909447,2023-11-02,2023-11-24,422.66,-3,261247,67048283,15185362,1.35640609916886,74.8802575600631,0.287259180578967
429.34,427,3009,3875,415242,906750,2023-11-02,2023-11-10,422.66,866,491508,68344835,21359059,1.32672790855373,89.7630786583946,0.54205459057072
417.38,235,49,49,893662,893662,2023-11-02,2023-12-15,422.66,0,0,661780848,102231664,0.135038963835351,97.4549645776391,0
429.95,408,407,405,724053,888975,2023-11-02,2023-12-29,422.66,-2,164922,119134666,22518358,0.746193387573689,81.7442741644989,0.185519277819961
455.47,455,18639,18641,633726,876127,2023-11-02,2023-12-15,422.66,2,242401,661780848,102231664,0.13238929513415,97.5873538727733,0.276673358999323
433.96,429,1480,1756,519480,870976,2023-11-02,2023-12-01,422.66,276,351496,49322029,10894195,1.7658965327643,69.0708445915719,0.403565655081196
428.33,417.5,795,794,641565,859902,2023-11-02,2023-11-24,422.66,-1,218337,67048283,15185362,1.28251158944667,76.1627691495098,0.25390916639338
442.01,440,3927,4235,569415,851235,2023-11-02,2023-12-08,422.66,308,281820,58295535,11187777,1.4602061718792,81.0360827806109,0.331071913161465
431.57,421,790,803,663600,848771,2023-11-02,2023-12-08,422.66,13,185171,58295535,11187777,1.45597943307322,82.4920622136841,0.218163674300842
422.05,395,312,312,843960,843960,2023-11-02,2023-12-29,422.66,0,0,119134666,22518358,0.708408415733503,82.4526825802324,0
426.3,411,348,549,429084,839970,2023-11-02,2023-11-24,422.66,201,410886,67048283,15185362,1.25278375883242,77.4155529083422,0.489167470266795
415.35,320,88,88,839080,839080,2023-11-02,2023-11-17,422.66,0,0,436972766,114712146,0.19202112014459,96.726624606166,0
449.95,449,8748,8785,577368,834575,2023-11-02,2023-12-15,422.66,37,257207,661780848,102231664,0.126110479401483,97.7134643521748,0.308189198094839
425.27,402,358,358,686286,833066,2023-11-02,2023-11-24,422.66,0,146780,67048283,15185362,1.24248670171017,78.6580396100524,0.176192522561238
432.38,426,1431,1296,671139,826848,2023-11-02,2023-12-01,422.66,-135,155709,49322029,10894195,1.6764273829854,70.7472719745573,0.188316353187043
417.68,377,203,203,825804,825804,2023-11-02,2023-12-15,422.66,0,0,661780848,102231664,0.124785116174894,97.8382494683497,0
416.61,360,145,145,820845,820845,2023-11-02,2023-11-17,422.66,0,0,436972766,114712146,0.18784809120118,96.9144726973671,0
444.06,441,2676,2671,636888,817326,2023-11-02,2023-12-29,422.66,-5,180438,119134666,22518358,0.686052202471445,83.1387347827038,0.220766254835892
455.72,455,11155,11184,580060,805248,2023-11-02,2023-12-29,422.66,29,225188,119134666,22518358,0.675914095398564,83.8146488781024,0.279650492767446
431.79,427,1526,1652,527996,791308,2023-11-02,2023-11-24,422.66,126,263312,67048283,15185362,1.18020621050057,79.8382458205529,0.332755387282828
422.62,348,105,106,0,790972,2023-11-02,2023-12-29,422.66,1,790972,119134666,22518358,0.663931017358121,84.4785798954605,1
435.44,430,1267,1452,506800,789888,2023-11-02,2023-12-08,422.66,185,283088,58295535,11187777,1.35497169723204,83.8470339109162,0.35839005023497
417.78,300,67,67,789126,789126,2023-11-02,2023-11-17,422.66,0,0,436972766,114712146,0.180589286427063,97.0950619837942,0
427.55,397,260,255,683540,779025,2023-11-02,2023-12-15,422.66,-5,95485,661780848,102231664,0.117716461930612,97.9559659302803,0.122569879015436
435.11,429,1246,1269,549486,775359,2023-11-02,2023-12-08,422.66,23,225873,58295535,11187777,1.33004869069304,85.1770826016092,0.291314088054695
425.1,409,480,480,668640,772800,2023-11-02,2023-11-24,422.66,0,104160,67048283,15185362,1.15260222249092,80.9908480430439,0.134782608695652
421.5,362,126,126,749700,749700,2023-11-02,2023-12-15,422.66,0,0,661780848,102231664,0.113285236686088,98.0692511669664,0
436.78,435,3938,4197,460746,747066,2023-11-02,2023-11-24,422.66,259,286320,67048283,15185362,1.11422092643297,82.1050689694768,0.383259310422372
433.53,428,1229,1343,511264,742679,2023-11-02,2023-12-01,422.66,114,231415,49322029,10894195,1.50577544163887,72.2530474161961,0.311594915165233
422.06,395,270,271,652050,733326,2023-11-02,2023-11-24,422.66,1,81275.9999999999,67048283,15185362,1.09372823163868,83.1987972011155,0.110832017411083
434.42,427.5,1009,1057,526698,731444,2023-11-02,2023-12-08,422.66,48,204746,58295535,11187777,1.25471702078041,86.4317996223896,0.279920267306862
429.88,423,996,1056,506964,726528,2023-11-02,2023-11-24,422.66,60,219564,67048283,15185362,1.08358926954177,84.2823864706573,0.302209963002114
441.4,440,4991,5184,459172,725760,2023-11-02,2023-12-01,422.66,193,266588,49322029,10894195,1.47147231108436,73.7245197272805,0.367322530864198
425.61,390,202,201,633674,715761,2023-11-02,2023-12-29,422.66,-1,82087,119134666,22518358,0.600799938449485,85.07937983391,0.114684929746102
432.44,417,500,462,634500,713328,2023-11-02,2023-12-29,422.66,-38,78828,119134666,22518358,0.598757711714238,85.6781375456242,0.110507368279389
419.41,379,176,176,711216,711216,2023-11-02,2023-12-29,422.66,0,0,119134666,22518358,0.596984927963789,86.275122473588,0
431.08,423,1088,875,664768,707000,2023-11-02,2023-12-01,422.66,-213,42232,49322029,10894195,1.43343656847532,75.1579562957558,0.0597340876944837
416.24,376,174,174,700176,700176,2023-11-02,2023-12-15,422.66,0,0,661780848,102231664,0.105801792559582,98.175052959526,0
449.55,448,4517,4516,510421,699980,2023-11-02,2023-12-29,422.66,-1,189559,119134666,22518358,0.587553584109599,86.8626760576976,0.270806308751679
435.63,426,443,711,348198,684693,2023-11-02,2023-12-29,422.66,268,336495,119134666,22518358,0.574721886574979,87.4373979442726,0.491453834054094
435.97,431,1141,1339,440426,665483,2023-11-02,2023-12-08,422.66,198,225057,58295535,11187777,1.14156770325549,87.5733673256451,0.338185949152721
423.85,250,39,38,638430,660630,2023-11-02,2023-11-17,422.66,-1,22200.0000000001,436972766,114712146,0.151183334844259,97.2462453186385,0.0336042868171293
421.08,403,365,365,659920,659920,2023-11-02,2023-11-17,422.66,0,0,436972766,114712146,0.15102085332247,97.3972661719609,0
427.72,409,352,352,540672,658944,2023-11-02,2023-12-01,422.66,0,118272,49322029,10894195,1.3360034316512,76.493959727407,0.17948717948718
418.38,385,197,197,657586,657586,2023-11-02,2023-11-17,422.66,0,0,436972766,114712146,0.150486723925491,97.5477528958864,0
434.04,431,1923,2161,424983,656944,2023-11-02,2023-11-24,422.66,238,231961,67048283,15185362,0.979807342717486,85.2621938133748,0.353090978835335
419.42,300,5,55,57430,656810,2023-11-02,2023-11-10,422.66,50,599380,68344835,21359059,0.961023609172515,90.7241022675671,0.912562232609126
424.2,408,402,402,512550,651240,2023-11-02,2023-11-10,422.66,0,138690,68344835,21359059,0.95287376141884,91.676976028986,0.212962962962963
437.66,435,1746,2440,333486,649040,2023-11-02,2023-12-01,422.66,694,315554,49322029,10894195,1.31592315474288,77.8098828821499,0.486185751263405
423.22,394,221,220,544986,642840,2023-11-02,2023-11-17,422.66,-1,97854,436972766,114712146,0.147112142910984,97.6948650387974,0.152221392570469
430.99,411,325,321,549250,641679,2023-11-02,2023-12-29,422.66,-4,92429,119134666,22518358,0.538616526611994,87.9760144708846,0.144042426197522
448.69,447,3746,3795,486980,641355,2023-11-02,2023-12-29,422.66,49,154375,119134666,22518358,0.538344565468459,88.514359036353,0.240701327657849
431.98,422.5,633,670,493107,635160,2023-11-02,2023-12-08,422.66,37,142053,58295535,11187777,1.08955171266547,88.6629190383106,0.223649159266956
433.16,425,1080,775,671760,632400,2023-11-02,2023-12-08,422.66,-305,-39360,58295535,11187777,1.08481721627565,89.7477362545862,-0.0622390891840607
446.36,444,2679,2659,463467,627524,2023-11-02,2023-12-29,422.66,-20,164057,119134666,22518358,0.526735014307255,89.0410940506603,0.26143541920309
430.9,422,661,705,441548,627450,2023-11-02,2023-12-01,422.66,44,185902,49322029,10894195,1.27214961087671,79.0820324930266,0.296281775440274
435.2,431,920,1489,276000,625380,2023-11-02,2023-12-01,422.66,569,349380,49322029,10894195,1.26795270324341,80.34998519627,0.55866832965557
428.61,408,299,301,472121,620361,2023-11-02,2023-12-08,422.66,2,148240,58295535,11187777,1.06416554887094,90.8119018034572,0.238957639181057
415.47,398,355,355,620185,620185,2023-11-02,2023-11-17,422.66,0,0,436972766,114712146,0.141927609282634,97.83679264808,0
442.29,442,21558,21281,431160,617149,2023-11-02,2023-11-17,422.66,-277,185989,436972766,114712146,0.141232829141576,97.9780254772216,0.301368065086389
434.75,428,911,906,455500,611550,2023-11-02,2023-12-08,422.66,-5,156050,58295535,11187777,1.04905118376562,91.8609529872228,0.255171286076363
432.2,423,695,657,522640,604440,2023-11-02,2023-12-08,422.66,-38,81800.0000000001,58295535,11187777,1.03685470937011,92.8978076965929,0.135331877440275
457.37,457,16132,16276,435564,602212,2023-11-02,2023-12-15,422.66,144,166648,661780848,102231664,0.0909987047555054,98.2660516642815,0.276726468419759
416.2,300,51,51,592620,592620,2023-11-02,2023-12-01,422.66,0,0,49322029,10894195,1.2015320780903,81.5515172743603,0
460.42,460,15492,14098,464760,592116,2023-11-02,2023-12-29,422.66,-1394,127356,119134666,22518358,0.497014026127374,89.5381080767877,0.215086233102973
422.97,398,237,237,591789,591789,2023-11-02,2023-12-15,422.66,0,0,661780848,102231664,0.0894237120624561,98.3554753763439,0
433.68,421,440,466,465080,590888,2023-11-02,2023-12-29,422.66,26,125808,119134666,22518358,0.495983259817927,90.0340913366056,0.212913445526056
429.59,427.5,3003,2820,384384,589380,2023-11-02,2023-11-10,422.66,-183,204996,68344835,21359059,0.862362166797242,92.5393381957832,0.347816349384098
436.11,434,2680,2783,372520,587213,2023-11-02,2023-11-24,422.66,103,214693,67048283,15185362,0.875806170905226,86.13799998428,0.365613499701131
460.28,460,20768,20805,415360,582540,2023-11-02,2023-12-15,422.66,37,167180,661780848,102231664,0.0880261194866129,98.4435014958305,0.286984584749545
420.99,392,200,200,579800,579800,2023-11-02,2023-11-17,422.66,0,0,436972766,114712146,0.132685614553837,98.1107110917755,0
432.32,428,1385,1337,409960,577584,2023-11-02,2023-11-24,422.66,-48,167624,67048283,15185362,0.86144487846169,86.9994448627417,0.290215795451397
422.84,401,260,260,567840,567840,2023-11-02,2023-12-15,422.66,0,0,661780848,102231664,0.0858048403359053,98.5293063361664,0
441.38,437,1288,1293,446936,566334,2023-11-02,2023-12-29,422.66,5,119398,119134666,22518358,0.475372969946464,90.5094643065521,0.210826120275314
424.12,375,117,115,499473,564880,2023-11-02,2023-11-17,422.66,-2,65407,436972766,114712146,0.129271214124131,98.2399823058996,0.115789194165132
434.68,424,373,526,323764,561768,2023-11-02,2023-12-29,422.66,153,238004,119134666,22518358,0.471540332349612,90.9810046389017,0.423669557539767
425.46,417.5,1615,703,867255,559588,2023-11-02,2023-11-10,422.66,-912,-307667,68344835,21359059,0.818771455077769,93.3581096508609,-0.549809860111368
431.68,424,590,723,346330,555264,2023-11-02,2023-12-01,422.66,133,208934,49322029,10894195,1.12579310149629,82.6773103758566,0.376278671046565
453.88,453,6328,6267,411320,551496,2023-11-02,2023-12-29,422.66,-61,140176,119134666,22518358,0.462918156836063,91.4439227957377,0.25417410099076
452.66,452,8782,8341,412754,550506,2023-11-02,2023-12-15,422.66,-441,137752,661780848,102231664,0.0831855442271729,98.6124918803936,0.250227972083865
422.65,404,296,295,467680,550175,2023-11-02,2023-11-17,422.66,-1,82495,436972766,114712146,0.12590601584539,98.365888321745,0.149943199890944
427.5,342,64,64,547200,547200,2023-11-02,2023-12-29,422.66,0,0,119134666,22518358,0.45931215352549,91.9032349492632,0
453.6,453,8928,9095,357120,545700,2023-11-02,2023-12-15,422.66,167,188580,661780848,102231664,0.0824593219415742,98.6949512023352,0.345574491478835
444.83,442,1946,1920,420336,543360,2023-11-02,2023-12-29,422.66,-26,123024,119134666,22518358,0.456088910342855,92.3593238596061,0.226413427561837
427.38,385,121,127,415998,538226,2023-11-02,2023-12-29,422.66,6,122228,119134666,22518358,0.451779501358572,92.8111033609646,0.227094194631995
433.93,427,745,772,398575,534996,2023-11-02,2023-12-08,422.66,27,136421,58295535,11187777,0.917730663248909,93.8155383598418,0.254994429864896
435.76,432,1384,1412,372296,530912,2023-11-02,2023-12-01,422.66,28,158616,49322029,10894195,1.0764196258025,83.7537300016591,0.298761376649991
430.2,430,20089,26222,220979,524440,2023-11-02,2023-11-03,422.66,6133,303461,86263600,31048392,0.607950514469603,95.7793704412985,0.578638166425139
427.26,375,100,100,522600,522600,2023-11-02,2023-12-29,422.66,0,0,119134666,22518358,0.438663251886735,93.2497666128514,0
419.32,365,96,96,521472,521472,2023-11-02,2023-11-17,422.66,0,0,436972766,114712146,0.119337414268055,98.485225736013,0
429.67,422.5,680,725,372640,519825,2023-11-02,2023-11-24,422.66,45,147185,67048283,15185362,0.775299495738019,87.7747443584797,0.283143365555716
430.62,429,1701,3201,161595,518562,2023-11-02,2023-11-10,422.66,1500,356967,68344835,21359059,0.7587435100253,94.1168531608863,0.688378631677601
424.59,408,304,311,425600,515949,2023-11-02,2023-11-24,422.66,7,90349,67048283,15185362,0.769518587075526,88.5442629455552,0.175112268848278
470.11,470,46819,46787,374552,514657,2023-11-02,2023-12-15,422.66,-32,140105,661780848,102231664,0.0777684941405255,98.7727196964757,0.27222985405814
439.83,437,2094,1792,439740,507136,2023-11-02,2023-12-08,422.66,-302,67396,58295535,11187777,0.869939696067632,94.6854780559094,0.132895318021201
420.59,406,386,347,503730,506273,2023-11-02,2023-11-03,422.66,-39,2542.99999999994,86263600,31048392,0.586890646808155,96.3662610881067,0.00502298167194368
454.52,454,9786,9726,371868,505752,2023-11-02,2023-12-15,422.66,-60,133884,661780848,102231664,0.0764228825189574,98.8491425789947,0.264722630854648
422.73,406,299,299,391092,500227,2023-11-02,2023-11-10,422.66,0,109135,68344835,21359059,0.73191631818264,94.8487694790689,0.218170950388524
416.69,340,65,65,498485,498485,2023-11-02,2023-11-17,422.66,0,0,436972766,114712146,0.114076903364728,98.5993026393778,0
434.69,432,2021,1829,357717,492001,2023-11-02,2023-11-24,422.66,-192,134284,67048283,15185362,0.733801043048336,89.2780639886036,0.272934404604869
465.16,465,30403,30613,364836,489808,2023-11-02,2023-12-15,422.66,210,124972,661780848,102231664,0.0740136257312783,98.9231562047259,0.255144873093131
450.43,449,3414,3409,365298,487487,2023-11-02,2023-12-29,422.66,-5,122189,119134666,22518358,0.40918988264927,93.6589564955007,0.250650786585078
436,432.5,1183,1390,299299,486500,2023-11-02,2023-12-01,422.66,207,187201,49322029,10894195,0.986374668406281,84.7401046700654,0.384791366906475
442.06,438,1128,1195,357576,485170,2023-11-02,2023-12-29,422.66,67,127594,119134666,22518358,0.407245024718498,94.0662015202191,0.262988230929365
426.71,394,148,147,422984,480837,2023-11-02,2023-12-29,422.66,-1,57853,119134666,22518358,0.403607964116842,94.469809484336,0.1203172800762
451.75,451,6479,6292,349866,471900,2023-11-02,2023-12-15,422.66,-187,122034,661780848,102231664,0.0713075939604707,98.9944637986864,0.258601398601398
452.99,452,4840,4753,382360,470547,2023-11-02,2023-12-29,422.66,-87,88186.9999999999,119134666,22518358,0.394970679650875,94.8647801639869,0.187413797133974
439.54,439,9445,8608,302240,464832,2023-11-02,2023-11-17,422.66,-837,162592,436972766,114712146,0.106375508079147,98.7056781474569,0.349786589563541
435.17,432.5,1685,1697,284765,453099,2023-11-02,2023-11-24,422.66,12,168334,67048283,15185362,0.675780168747945,89.9538441573515,0.371517041529555
423.35,407,281,277,339167,452895,2023-11-02,2023-11-03,422.66,-4,113728,86263600,31048392,0.525012867536249,96.891273955643,0.251113392728999
428.49,428,6161,9197,135542,450653,2023-11-02,2023-11-03,422.66,3036,315111,86263600,31048392,0.522413857061379,97.4136878127043,0.699232003337379
447.9,446,2243,2357,322992,447830,2023-11-02,2023-12-29,422.66,114,124838,119134666,22518358,0.375902342312354,95.2406825062992,0.278762030234687
419.39,368,87,87,447093,447093,2023-11-02,2023-12-15,422.66,0,0,661780848,102231664,0.0675590720630827,99.0620228707495,0
423.01,401,203,202,396256,444602,2023-11-02,2023-11-17,422.66,-1,48346.0000000001,436972766,114712146,0.101745928944231,98.8074240764011,0.108739951687127
440.82,440,5797,5312,295647,435584,2023-11-02,2023-11-24,422.66,-485,139937,67048283,15185362,0.64965720300399,90.6035013603555,0.321262948133999
435.45,433,2203,1773,345871,434385,2023-11-02,2023-11-24,422.66,-430,88514.0000000001,67048283,15185362,0.647868939462626,91.2513702998181,0.203768546335624
422.18,335,49,49,427182,427182,2023-11-02,2023-12-29,422.66,0,0,119134666,22518358,0.358570695115727,95.5992532014149,0
439.43,437.5,2073,2211,290220,426723,2023-11-02,2023-12-01,422.66,138,136503,49322029,10894195,0.865177302417952,85.6052819724833,0.319886671212941
432.56,424,456,486,318744,416016,2023-11-02,2023-12-08,422.66,30,97272,58295535,11187777,0.713632699313935,95.3991107552234,0.233817930079612
435.39,435,10205,10606,234715,413634,2023-11-02,2023-11-10,422.66,401,178919,68344835,21359059,0.60521618056434,95.4539856596332,0.432553900308002
436.36,433,1254,1212,304722,407232,2023-11-02,2023-12-01,422.66,-42,102510,49322029,10894195,0.825659463441782,86.4309414359251,0.251723833097596
452.13,451,3616,3599,296512,406687,2023-11-02,2023-12-29,422.66,-17,110175,119134666,22518358,0.341367474014658,95.9406206754296,0.270908585718255
424.16,405,211,211,375791,404276,2023-11-02,2023-12-01,422.66,0,28485,49322029,10894195,0.819666198241763,87.2506076341669,0.0704592901878915
432.23,427.5,862,849,284460,401577,2023-11-02,2023-11-24,422.66,-13,117117,67048283,15185362,0.598937037656878,91.850307337475,0.291642698660531
441.36,441,11089,10995,232869,395820,2023-11-02,2023-11-17,422.66,-94,162951,436972766,114712146,0.0905823041612621,98.8980063805624,0.411679551311202
426.05,411,279,262,393390,394310,2023-11-02,2023-12-01,422.66,-17,920.000000000058,49322029,10894195,0.799460216853609,88.0500678510205,0.00233318962237848
426.23,349,51,51,393873,393873,2023-11-02,2023-12-29,422.66,0,0,119134666,22518358,0.330611578665105,96.2712322540947,0
442.68,439,952,1068,275128,393024,2023-11-02,2023-12-29,422.66,116,117896,119134666,22518358,0.329898939742694,96.6011311938374,0.299971503012539
421.73,390,122,122,354654,387106,2023-11-02,2023-11-24,422.66,0,32452,67048283,15185362,0.577354083772734,92.4276614212477,0.0838323353293413
420.29,385,109,109,384661,384661,2023-11-02,2023-11-24,422.66,0,0,67048283,15185362,0.573707457952354,93.0013688792001,0
437.02,434,1970,1264,399910,381728,2023-11-02,2023-12-01,422.66,-706,-18181.9999999999,49322029,10894195,0.773950317412935,88.8240181684334,-0.0476307737446557
465.26,465,14650,14560,278350,378560,2023-11-02,2023-12-29,422.66,-90,100210,119134666,22518358,0.317758057088102,96.9188892509255,0.264713651732883
419,220,19,19,378100,378100,2023-11-02,2023-12-15,422.66,0,0,661780848,102231664,0.0571337174750032,99.1191565882245,0
433.17,419,240,265,275760,375505,2023-11-02,2023-12-29,422.66,25,99745,119134666,22518358,0.315193732108167,97.2340829830337,0.265628953009947
427.73,348,47,47,374731,374731,2023-11-02,2023-12-15,422.66,0,0,661780848,102231664,0.056624636559443,99.175781224784,0
439.86,438,1971,2007,238491,373302,2023-11-02,2023-12-01,422.66,36,134811,49322029,10894195,0.756866673104628,89.5808848415381,0.361131202083032
437.54,436,2477,2424,240269,373296,2023-11-02,2023-11-24,422.66,-53,133027,67048283,15185362,0.556756986603222,93.5581258658033,0.356357957224294
423.45,280,36,26,0,372970,2023-11-02,2023-11-17,422.66,-10,372970,436972766,114712146,0.0853531453262238,98.9833595258886,1
419.78,391,128,128,368384,368384,2023-11-02,2023-11-17,422.66,0,0,436972766,114712146,0.0843036520037956,99.0676631778924,0
420.99,404,228,215,354996,365285,2023-11-02,2023-11-10,422.66,-13,10288.9999999999,68344835,21359059,0.534473453626744,95.98845911326,0.028167047647727
426.6,404,154,155,331408,350300,2023-11-02,2023-12-29,422.66,1,18892,119134666,22518358,0.294037001790898,97.5281199848246,0.0539309163574079
456.43,456,8081,8078,250511,347354,2023-11-02,2023-12-15,422.66,-3,96843,661780848,102231664,0.0524877685792442,99.2282689933632,0.278802029053934
425.66,409,208,208,346528,346528,2023-11-02,2023-12-08,422.66,0,0,58295535,11187777,0.594433175714058,95.9935439309374,0
445.16,445,21755,21574,217550,345184,2023-11-02,2023-11-17,422.66,-181,127634,436972766,114712146,0.0789943966439318,99.1466575745364,0.369756419764531
426.5,408,183,184,292800,340400,2023-11-02,2023-12-01,422.66,1,47600,49322029,10894195,0.690158144142854,90.2710429856809,0.139835487661575
432.83,429,823,884,223033,338572,2023-11-02,2023-11-24,422.66,61,115539,67048283,15185362,0.504967442641298,94.0630933084446,0.341253854423874
420.57,380,83,83,336731,336731,2023-11-02,2023-12-01,422.66,0,0,49322029,10894195,0.682719277424698,90.9537622631056,0
424,403,160,160,305440,336000,2023-11-02,2023-11-24,422.66,0,30560,67048283,15185362,0.501131401083008,94.5642247095276,0.0909523809523809
417.49,365,64,64,335936,335936,2023-11-02,2023-11-24,422.66,0,0,67048283,15185362,0.501035947482801,95.0652606570104,0
462.22,462,15068,15072,256156,331584,2023-11-02,2023-12-15,422.66,4,75428,661780848,102231664,0.0501048044835531,99.2783737978468,0.227477803512835
440.55,438,980,1277,180320,325635,2023-11-02,2023-12-08,422.66,297,145315,58295535,11187777,0.558593381122585,96.55213731206,0.446251170789381
470.16,470,20169,20154,242028,322464,2023-11-02,2023-12-29,422.66,-15,80436,119134666,22518358,0.270671846261776,97.7987918310864,0.249441798154213
424.86,407,178,179,298328,319694,2023-11-02,2023-12-01,422.66,1,21366,49322029,10894195,0.64817690286018,91.6019391659658,0.0668326587299105
423.11,396,115,115,311765,311765,2023-11-02,2023-12-15,422.66,0,0,661780848,102231664,0.0471100064231536,99.3254838042699,0
445.68,445,4772,4519,219512,307292,2023-11-02,2023-12-01,422.66,-253,87780,49322029,10894195,0.623031951909359,92.2249711178751,0.285656639287713
418.1,380,79,79,300990,300990,2023-11-02,2023-11-24,422.66,0,0,67048283,15185362,0.448915298845162,95.5141759558556,0
443.96,443,2949,3112,185787,298752,2023-11-02,2023-12-01,422.66,163,112965,49322029,10894195,0.605717173557479,92.8306882914326,0.378122991645244
438.34,437,2313,2216,194292,296944,2023-11-02,2023-11-24,422.66,-97,102652,67048283,15185362,0.442880841557121,95.9570567974127,0.345694811142842
420.11,340,37,37,290080,296407,2023-11-02,2023-11-03,422.66,0,6327,86263600,31048392,0.34360610964532,97.7572939223496,0.021345649731619
471.11,471,26670,26670,240030,293370,2023-11-02,2023-12-15,422.66,0,53340,661780848,102231664,0.0443303853362647,99.3698141896062,0.181818181818182
459.3,459,9677,9753,212894,292590,2023-11-02,2023-12-15,422.66,76,79696,661780848,102231664,0.0442125215445945,99.4140267111508,0.272381147681055
439.11,437,980,1372,136220,289492,2023-11-02,2023-12-01,422.66,392,153272,49322029,10894195,0.586942601246189,93.4176308926788,0.529451591062966
432.04,431,1181,2738,80308,284752,2023-11-02,2023-11-10,422.66,1557,204444,68344835,21359059,0.416640116257505,96.4050992295175,0.717972130134292
480.05,480,56339,56340,281695,281700,2023-11-02,2023-12-15,422.66,1,5,661780848,102231664,0.0425669616839682,99.4565936728347,1.7749378771743e-05
450.07,450,39804,39877,199020,279139,2023-11-02,2023-11-17,422.66,73,80119.0000000001,436972766,114712146,0.0638801824093541,99.2105377569457,0.287021877989102
439.19,438,2416,2332,171536,277508,2023-11-02,2023-11-24,422.66,-84,105972,67048283,15185362,0.413892776344474,96.3709495737572,0.381870072214134
437.89,434,538,708,152792,275412,2023-11-02,2023-12-08,422.66,170,122620,58295535,11187777,0.472440985403085,97.0245782974631,0.445223882764731
432.87,432,2934,3107,143766,270309,2023-11-02,2023-11-10,422.66,173,126543,68344835,21359059,0.395507575663911,96.8006068051814,0.468142015249215
429.33,429,6168,8063,98688,266079,2023-11-02,2023-11-03,422.66,1895,167391,86263600,31048392,0.308448754747078,98.0657426770967,0.629102634931731
423.98,406,147,147,239169,264306,2023-11-02,2023-11-24,422.66,0,25137,67048283,15185362,0.394202488376921,96.7651520621341,0.0951056729699666
439.23,436,425,778,99450,251294,2023-11-02,2023-12-08,422.66,353,151844,58295535,11187777,0.431069034703944,97.455647332167,0.604248410228657
438.35,436,1207,1061,188292,249335,2023-11-02,2023-12-01,422.66,-146,61043,49322029,10894195,0.505524620651758,93.9231555133306,0.244823229791245
441.68,441,3596,3599,169012,244732,2023-11-02,2023-11-24,422.66,3,75720,67048283,15185362,0.365008601338829,97.1301606634729,0.30939966984293
461.25,461,9782,9769,176076,244225,2023-11-02,2023-12-15,422.66,-13,68149,661780848,102231664,0.036904210923916,99.4934978837586,0.27904186713072
458.34,458,7209,7181,180225,244154,2023-11-02,2023-12-15,422.66,-28,63929,661780848,102231664,0.0368934822967255,99.5303913660554,0.261838839421021
417.75,402,155,155,244125,244125,2023-11-02,2023-11-10,422.66,0,0,68344835,21359059,0.357195975379851,97.1578027805613,0
444.2,444,14325,11893,186225,237860,2023-11-02,2023-11-17,422.66,-2432,51635,436972766,114712146,0.054433598271431,99.2649713552171,0.217081476498781
431.05,422.5,595,277,399840,236835,2023-11-02,2023-12-01,422.66,-318,-163005,49322029,10894195,0.480180975523128,94.4033364888537,-0.688263981252771
434.53,434,3832,4207,111128,222971,2023-11-02,2023-11-10,422.66,375,111843,68344835,21359059,0.326244111936184,97.4840468924974,0.50160334752053
442.63,442,2278,3529,86564,222327,2023-11-02,2023-11-24,422.66,1251,135763,67048283,15185362,0.331592383954113,97.461753047427,0.610645580608743
414.75,355,37,37,221075,221075,2023-11-02,2023-11-17,422.66,0,0,436972766,114712146,0.0505923977880123,99.3155637530052,0
433.67,433,3315,3198,119340,214266,2023-11-02,2023-11-10,422.66,-117,94926,68344835,21359059,0.313507231380396,97.7975541238778,0.443028758645796
437.25,433,419,499,131985,212075,2023-11-02,2023-12-08,422.66,80,80090,58295535,11187777,0.363792870242978,97.81944020241,0.377649416480019
445.35,445,5193,6033,109053,211155,2023-11-02,2023-11-24,422.66,840,102102,67048283,15185362,0.314929764868103,97.7766828122951,0.483540527100945
416.5,386,69,69,210450,210450,2023-11-02,2023-12-15,422.66,0,0,661780848,102231664,0.0318005576371711,99.5621919236925,0
430.85,412,111,109,182595,205465,2023-11-02,2023-12-29,422.66,-2,22870,119134666,22518358,0.17246449492711,97.9712563260135,0.111308495364174
443.49,442.5,2073,2071,132672,205029,2023-11-02,2023-12-01,422.66,-2,72357,49322029,10894195,0.415694577366231,94.8190310662199,0.352911051607334
454.79,454,2488,2488,144304,196552,2023-11-02,2023-12-29,422.66,0,52248,119134666,22518358,0.164983045321166,98.1362393713346,0.265822784810127
421.04,403,106,106,171190,191224,2023-11-02,2023-11-10,422.66,0,20034,68344835,21359059,0.279792906076955,98.0773470299548,0.104767184035477
415.67,393,84,84,190428,190428,2023-11-02,2023-11-17,422.66,0,0,436972766,114712146,0.043578917227075,99.3591426702322,0
423.34,360,39,30,223275,190020,2023-11-02,2023-12-29,422.66,-9,-33255,119134666,22518358,0.159500174365705,98.2957395457003,-0.175007893905905
446.14,446,12997,12950,116973,181300,2023-11-02,2023-11-17,422.66,-47,64327,436972766,114712146,0.0414899998596251,99.4006326700919,0.354809707666851
426.76,406,86,86,150070,178536,2023-11-02,2023-12-01,422.66,0,28466,49322029,10894195,0.361980242134808,95.1810113083547,0.159441233140655
422.81,403,90,90,138870,178290,2023-11-02,2023-11-03,422.66,0,39420,86263600,31048392,0.206680453864666,98.2724231309614,0.221100454316002
440.57,439,1186,1127,125716,176939,2023-11-02,2023-12-01,422.66,-59,51223,49322029,10894195,0.358742338033174,95.5397536463879,0.289495249775346
436.3,436,5209,5888,88553,176640,2023-11-02,2023-11-10,422.66,679,88087,68344835,21359059,0.258454058744893,98.3358010886997,0.498680932971014
413.04,325,20,20,176080,176080,2023-11-02,2023-12-08,422.66,0,0,58295535,11187777,0.302047146492437,98.1214873489025,0
475.07,475,25163,25100,176141,175700,2023-11-02,2023-12-15,422.66,-63,-440.999999999971,661780848,102231664,0.0265495746108385,99.5887414983034,-0.00250996015936238
424.93,405,88,88,169752,175384,2023-11-02,2023-12-08,422.66,0,5632,58295535,11187777,0.300853230011527,98.422340578914,0.0321123933768189
440,439,1584,1697,95040,169700,2023-11-02,2023-11-24,422.66,113,74660,67048283,15185362,0.253101186796983,98.0297839990921,0.439952857984679
466.16,466,10598,10597,127176,169552,2023-11-02,2023-12-15,422.66,-1,42376,661780848,102231664,0.025620566160597,99.614362064464,0.24992922525243
450.15,450,11069,11132,110690,166980,2023-11-02,2023-11-24,422.66,63,56290,67048283,15185362,0.249044408788216,98.2788284078804,0.337106240268296
414.37,397,94,94,163278,163278,2023-11-02,2023-11-17,422.66,0,0,436972766,114712146,0.0373657153727516,99.4379983854646,0
457.6,457,2513,2707,103033,162420,2023-11-02,2023-12-29,422.66,194,59387,119134666,22518358,0.136333113990516,98.4320726596908,0.365638468168945
444.41,444,3901,3900,97525,159900,2023-11-02,2023-11-24,422.66,-1,62375,67048283,15185362,0.238484854265396,98.5173132621457,0.390087554721701
413.79,355,27,27,158733,158733,2023-11-02,2023-11-03,422.66,0,0,86263600,31048392,0.1840092460783,98.4564323770397,0
423.06,375,34,33,141270,158598,2023-11-02,2023-11-24,422.66,-1,17328,67048283,15185362,0.236542970086199,98.7538562322319,0.109257367684334
433.3,432.5,1975,1972,88875,157760,2023-11-02,2023-11-10,422.66,-3,68885,68344835,21359059,0.23082944014716,98.5666305288468,0.436644269776876
442.22,441,1278,1290,104796,157380,2023-11-02,2023-12-01,422.66,12,52584,49322029,10894195,0.319086629627504,95.8588402760154,0.33412123522684
443.24,443,6522,6549,91308,157176,2023-11-02,2023-11-17,422.66,27,65868,436972766,114712146,0.0359692896742219,99.4739676751388,0.419071613986868
464.18,464,8682,8731,121548,157158,2023-11-02,2023-12-15,422.66,49,35610,661780848,102231664,0.0237477407324426,99.6381098051964,0.226587256137136
444.79,444,2026,1988,109404,157052,2023-11-02,2023-12-01,422.66,-38,47648,49322029,10894195,0.318421612379329,96.1772618883947,0.303389960013244
419.59,389,51,51,156009,156009,2023-11-02,2023-12-15,422.66,0,0,661780848,102231664,0.0235741183008669,99.6616839234973,0
436.65,432,318,332,106848,154380,2023-11-02,2023-12-08,422.66,14,47532,58295535,11187777,0.264823026326116,98.6871636052401,0.307889623008162
448.1,448,15410,15420,107870,154200,2023-11-02,2023-11-17,422.66,10,46330,436972766,114712146,0.0352882403659911,99.5092559155048,0.300453955901427
455.03,455,50853,50832,152559,152496,2023-11-02,2023-11-17,422.66,-21,-63,436972766,114712146,0.0348982847136977,99.5441542002185,-0.000413125590179415
426.03,400,56,58,125328,150974,2023-11-02,2023-12-01,422.66,2,25646,49322029,10894195,0.306098518371983,96.4833604067667,0.169870308794892
426.8,356,21,21,148680,148680,2023-11-02,2023-12-29,422.66,0,0,119134666,22518358,0.12479994697765,98.5568726066685,0
432.63,418,116,101,140360,147763,2023-11-02,2023-12-29,422.66,-15,7403,119134666,22518358,0.124030229790546,98.6809028364591,0.0501004987716817
443.09,442,1229,1354,83572,147586,2023-11-02,2023-12-01,422.66,125,64014,49322029,10894195,0.29922937679632,96.782589783563,0.433740327673357
413.32,340,20,20,146640,146640,2023-11-02,2023-12-08,422.66,0,0,58295535,11187777,0.251545851667713,98.9387094569078,0
411.41,330,18,18,146538,146538,2023-11-02,2023-11-17,422.66,0,0,436972766,114712146,0.0335348130139534,99.5776890132325,0
422.62,388,42,42,145404,145404,2023-11-02,2023-12-15,422.66,0,0,661780848,102231664,0.0219716240564278,99.6836555475537,0
419.56,404,156,93,217308,144708,2023-11-02,2023-11-03,422.66,-63,-72600,86263600,31048392,0.167750940141613,98.6241833171813,-0.501699975122315
419.3,387,42,42,135660,135660,2023-11-02,2023-12-15,422.66,0,0,661780848,102231664,0.0204992333051016,99.7041547808588,0
429.43,398,43,43,135149,135149,2023-11-02,2023-12-29,422.66,0,0,119134666,22518358,0.113442211690089,98.7943450481491,0
450.32,450,4036,4216,88792,134912,2023-11-02,2023-12-01,422.66,180,46120,49322029,10894195,0.273532948127499,97.0561227316905,0.341852466793169
415.2,285,10,10,130200,130200,2023-11-02,2023-11-17,422.66,0,0,436972766,114712146,0.0297959072350976,99.6074849204676,0
475.11,475,11576,11619,104184,127809,2023-11-02,2023-12-29,422.66,43,23625,119134666,22518358,0.107281116648281,98.9016261647974,0.184846137595944
417.86,402,79,79,125294,125294,2023-11-02,2023-11-03,422.66,0,0,86263600,31048392,0.145245503317738,98.769428820499,0
423.53,406,71,71,124463,124463,2023-11-02,2023-12-08,422.66,0,0,58295535,11187777,0.21350348701663,99.1522129439245,0
428.51,406,55,55,113300,123805,2023-11-02,2023-12-29,422.66,0,10505,119134666,22518358,0.103920214121388,99.0055463789188,0.0848511772545536
418.21,350,18,18,122778,122778,2023-11-02,2023-11-03,422.66,0,0,86263600,31048392,0.142328861767884,98.9117576822669,0
426.4,407.5,63,63,103194,119070,2023-11-02,2023-12-01,422.66,0,15876,49322029,10894195,0.241413426037278,97.2975361577278,0.133333333333333
422,385,42,32,139524,118400,2023-11-02,2023-12-01,422.66,-10,-21124,49322029,10894195,0.240055006658384,97.5375911643862,-0.178412162162162
415.06,396,62,62,118172,118172,2023-11-02,2023-11-17,422.66,0,0,436972766,114712146,0.0270433329476648,99.6345282534152,0
469.13,469,9057,9060,81513,117780,2023-11-02,2023-12-15,422.66,3,36267,661780848,102231664,0.0177974325422001,99.721952213401,0.307921548650026
416.57,310,11,11,117227,117227,2023-11-02,2023-11-17,422.66,0,0,436972766,114712146,0.0268270723306358,99.6613553257459,0
422.9,340,17,14,0,116060,2023-11-02,2023-12-29,422.66,-3,116060,119134666,22518358,0.0974191676501616,99.102965546569,1
424.63,400,47,47,102366,115761,2023-11-02,2023-12-08,422.66,0,13395,58295535,11187777,0.198576100210762,99.3507890441352,0.115712545676005
425.75,390,23,32,67229,114400,2023-11-02,2023-12-01,422.66,9,47171,49322029,10894195,0.231945040217222,97.7695362046034,0.412333916083916
415.65,335,14,14,112910,112910,2023-11-02,2023-11-17,422.66,0,0,436972766,114712146,0.0258391389087163,99.6871944646546,0
431.13,431,6932,8610,48524,111930,2023-11-02,2023-11-03,422.66,1678,63406,86263600,31048392,0.129753453368512,99.0415111356354,0.566479049405879
415.34,375,27,27,108918,108918,2023-11-02,2023-11-03,422.66,0,0,86263600,31048392,0.126261830018687,99.1677729656541,0
463.2,463,5345,5384,80175,107680,2023-11-02,2023-12-15,422.66,39,27505,661780848,102231664,0.0162712475474963,99.7382234609485,0.255432763744428
426.91,404,48,47,92256,107677,2023-11-02,2023-12-01,422.66,-1,15421,49322029,10894195,0.21831421412124,97.9878504187247,0.143215357040036
415.23,345,15,15,105345,105345,2023-11-02,2023-11-17,422.66,0,0,436972766,114712146,0.0241079097364159,99.711302374391,0
440.1,440,10289,10466,61734,104660,2023-11-02,2023-11-10,422.66,177,42926,68344835,21359059,0.153135200341035,98.7197657291879,0.410147143130136
500.03,500,34609,34650,69218,103950,2023-11-02,2023-12-15,422.66,41,34732,661780848,102231664,0.0157076168514324,99.7539310778,0.334122174122174
472.09,472,11540,11541,115400,103869,2023-11-02,2023-12-15,422.66,1,-11531,661780848,102231664,0.0156953771499897,99.7696264549499,-0.11101483599534
417.17,386,33,33,102861,102861,2023-11-02,2023-11-17,422.66,0,0,436972766,114712146,0.0235394532573685,99.7348418276484,0
437.23,437,4459,4433,62426,101959,2023-11-02,2023-11-10,422.66,-26,39533,68344835,21359059,0.149183182606264,98.8689489117941,0.387734285349994
423.6,220,4,5,0,101800,2023-11-02,2023-11-17,422.66,1,101800,436972766,114712146,0.0232966463635402,99.7581384740119,1
447.11,447,9464,9225,75712,101475,2023-11-02,2023-11-17,422.66,-239,25763,436972766,114712146,0.0232222710190593,99.781360745031,0.253885193397389
467.14,467,7259,7248,79849,101472,2023-11-02,2023-12-15,422.66,-11,21623,661780848,102231664,0.0153331726517417,99.7849596276017,0.213093267108168
417,371,22,22,101200,101200,2023-11-02,2023-12-15,422.66,0,0,661780848,102231664,0.0152920714320823,99.8002516990338,0
446.31,446,3145,3242,56610,100502,2023-11-02,2023-11-24,422.66,97,43892,67048283,15185362,0.149894964498942,98.9037511967309,0.436727627310899
421.8,390,28,30,65828,95400,2023-11-02,2023-11-03,422.66,2,29572,86263600,31048392,0.11059125749447,99.2783642231486,0.309979035639413
443.52,443,1694,1751,50820,91052,2023-11-02,2023-11-24,422.66,57,40232,67048283,15185362,0.135800643843482,99.0395518405744,0.441857400166938
446.59,446,1509,1542,58851,90978,2023-11-02,2023-12-01,422.66,33,32127,49322029,10894195,0.184457131721,98.1723075504457,0.353129327969399
418.12,403,60,60,90720,90720,2023-11-02,2023-12-01,422.66,0,0,49322029,10894195,0.183934038885545,98.3562415893312,0
480.08,480,11286,11283,79002,90264,2023-11-02,2023-12-29,422.66,-3,11262,119134666,22518358,0.0757663600618144,99.1787319066308,0.124767349109279
422.94,399,37,37,88578,88578,2023-11-02,2023-12-15,422.66,0,0,661780848,102231664,0.0133847935109781,99.8136364925447,0
447.98,447.5,1841,1803,60753,86544,2023-11-02,2023-12-01,422.66,-38,25791,49322029,10894195,0.175467233920973,98.5317088232522,0.29801026067665
425.48,340,10,10,85480,85480,2023-11-02,2023-12-01,422.66,0,0,49322029,10894195,0.173309982847624,98.7050188060998,0
419.43,381,22,22,84546,84546,2023-11-02,2023-12-15,422.66,0,0,661780848,102231664,0.0127755283724983,99.8264120209172,0
452.05,452,16774,16784,67096,83920,2023-11-02,2023-11-17,422.66,10,16824,436972766,114712146,0.0192048581810245,99.800565603212,0.20047664442326
456.65,456,1291,1291,60677,83915,2023-11-02,2023-12-29,422.66,0,23238,119134666,22518358,0.0704370967892754,99.2491690034201,0.276923076923077
424.34,350,11,11,68134,81774,2023-11-02,2023-11-24,422.66,0,13640,67048283,15185362,0.121962854738577,99.1615146953129,0.166801183750336
425.6,345,10,10,80600,80600,2023-11-02,2023-12-01,422.66,0,0,49322029,10894195,0.163415823789407,98.8684346298892,0
423.65,225,5,4,94265,79460,2023-11-02,2023-11-17,422.66,-1,-14805,436972766,114712146,0.0181841996075334,99.8187498028195,-0.18632016108734
425.87,407,44,42,64988,79254,2023-11-02,2023-11-24,422.66,-2,14266,67048283,15185362,0.118204369230454,99.2797190645434,0.18000353294471
460.02,460,39171,39125,78342,78250,2023-11-02,2023-11-17,422.66,-46,-92,436972766,114712146,0.0179072944788509,99.8366570972984,-0.00117571884984026
420.53,390,25,25,65600,76325,2023-11-02,2023-11-10,422.66,0,10725,68344835,21359059,0.111676324919067,98.9806252367132,0.140517523747134
424.39,175,3,3,74817,74817,2023-11-02,2023-12-15,422.66,0,0,661780848,102231664,0.0113054042325504,99.8377174251498,0
424.42,392,23,23,74566,74566,2023-11-02,2023-12-29,422.66,0,0,119134666,22518358,0.0625896747803028,99.3117586782004,0
459.46,459,1609,1613,56315,74198,2023-11-02,2023-12-29,422.66,4,17883,119134666,22518358,0.062280780641967,99.3740394588423,0.241017278093749
458.5,458,1476,1463,54612,73150,2023-11-02,2023-12-29,422.66,-13,18538,119134666,22518358,0.0614011038567062,99.435440562699,0.253424470266576
415.54,401,50,50,72700,72700,2023-11-02,2023-11-10,422.66,0,0,68344835,21359059,0.106372339621568,99.0869975763348,0
418.34,404,49,49,70266,70266,2023-11-02,2023-11-24,422.66,0,0,67048283,15185362,0.104799104251484,99.3845181687949,0
454.05,454,13982,13958,41946,69790,2023-11-02,2023-11-17,422.66,-24,27844,436972766,114712146,0.0159712470502109,99.8526283443486,0.398968333572145
473.08,473,8603,8605,77427,68840,2023-11-02,2023-12-15,422.66,2,-8587,661780848,102231664,0.0104022351520212,99.8481196603018,-0.124738524113887
482.05,482,13653,13653,68265,68265,2023-11-02,2023-12-15,422.66,0,0,661780848,102231664,0.0103153483825207,99.8584350086843,0
416.8,380,18,18,66240,66240,2023-11-02,2023-11-03,422.66,0,0,86263600,31048392,0.0767878919961606,99.3551521151448,0
476.07,476,9246,9245,64722,64715,2023-11-02,2023-12-15,422.66,-1,-6.99999999999272,661780848,102231664,0.00977891702299611,99.8682139257073,-0.00010816657652774
449.09,449,6871,7002,34355,63018,2023-11-02,2023-11-17,422.66,131,28663,436972766,114712146,0.0144214937184438,99.867049838067,0.454838300168206
481.05,481,12559,12559,62795,62795,2023-11-02,2023-12-15,422.66,0,0,661780848,102231664,0.00948879076657716,99.8777027164739,0
439.13,439,4596,4563,41364,59319,2023-11-02,2023-11-10,422.66,-33,17955,68344835,21359059,0.0867936838240959,99.1737912601589,0.302685480200273
432.07,432,6581,8168,32905,57176,2023-11-02,2023-11-03,422.66,1587,24271,86263600,31048392,0.066280563296686,99.4214326784414,0.424496292150553
422.16,402,27,27,54432,54432,2023-11-02,2023-12-01,422.66,0,0,49322029,10894195,0.110360423331327,98.9787950532205,0
424.53,395,22,18,59004,53154,2023-11-02,2023-12-01,422.66,-4,-5850,49322029,10894195,0.107769289053376,99.0865643422739,-0.110057568574331
446.1,445,382,472,30178,51920,2023-11-02,2023-12-08,422.66,90,21742,58295535,11187777,0.0890634248403416,99.4398524689755,0.418759630200308
424.46,382,2,12,0,50952,2023-11-02,2023-11-17,422.66,10,50952,436972766,114712146,0.011660223236887,99.8787100613039,1
455.08,455,6423,6317,32115,50536,2023-11-02,2023-11-24,422.66,-106,18421,67048283,15185362,0.0753725490628895,99.4598907178578,0.364512426784866
447.49,447,1002,1029,35070,50421,2023-11-02,2023-12-01,422.66,27,15351,49322029,10894195,0.102228154482452,99.1887924967564,0.304456476468138
419.53,378,12,12,49836,49836,2023-11-02,2023-12-15,422.66,0,0,661780848,102231664,0.00753058964317444,99.8852333061171,0
490.03,490,16592,16592,33184,49776,2023-11-02,2023-12-15,422.66,0,16592,661780848,102231664,0.00752152319766135,99.8927548293148,0.333333333333333
423.95,370,12,9,52320,48555,2023-11-02,2023-12-01,422.66,-3,-3765.00000000001,49322029,10894195,0.0984448551376506,99.287237351894,-0.0775409329626199
419.2,395,20,20,48400,48400,2023-11-02,2023-12-08,422.66,0,0,58295535,11187777,0.0830252265460811,99.5228776955216,0
414.9,392,21,21,48090,48090,2023-11-02,2023-11-10,422.66,0,0,68344835,21359059,0.0703637663328911,99.2441550264918,0
438.17,438,2709,2792,24381,47464,2023-11-02,2023-11-10,422.66,83,23083,68344835,21359059,0.0694478229408265,99.3136028494326,0.486326479015675
474.08,474,5827,5826,40789,46608,2023-11-02,2023-12-15,422.66,-1,5818.99999999999,661780848,102231664,0.00704281487457008,99.8997976441893,0.124849811191212
423.41,393,15,15,45615,45615,2023-11-02,2023-12-15,422.66,0,0,661780848,102231664,0.0068927652013284,99.9066904093906,0
416.31,394,20,20,44620,44620,2023-11-02,2023-11-10,422.66,0,0,68344835,21359059,0.0652865721308714,99.3788894215635,0
425.3,398,12,16,24000,43680,2023-11-02,2023-11-24,422.66,4,19680,67048283,15185362,0.065147082140791,99.5250377999986,0.450549450549451
505.02,505,21624,21664,43248,43328,2023-11-02,2023-12-15,422.66,40,80,661780848,102231664,0.00654718251985437,99.9132375919105,0.00184638109305761
455.17,455,2526,2521,30312,42857,2023-11-02,2023-12-01,422.66,-5,12545,49322029,10894195,0.0868922079422159,99.3741295598362,0.292717642392141
422.7,384,11,11,42570,42570,2023-11-02,2023-11-17,422.66,0,0,436972766,114712146,0.00974202589092246,99.8884520871948,0
477.06,477,7049,7049,49343,42294,2023-11-02,2023-12-15,422.66,0,-7049.00000000001,661780848,102231664,0.00639093744217874,99.9196285293527,-0.166666666666667
465.02,465,20676,20785,20676,41570,2023-11-02,2023-11-17,422.66,109,20894,436972766,114712146,0.00951317867713523,99.897965265872,0.502622083233101
500.03,500,13633,13641,40899,40923,2023-11-02,2023-12-29,422.66,8,23.9999999999927,119134666,22518358,0.0343502033236909,99.4697907660227,0.000586467267795439
421.93,385,11,11,40623,40623,2023-11-02,2023-12-08,422.66,0,0,58295535,11187777,0.0696845821896994,99.5925622777113,0
448.45,448,850,901,23800,40545,2023-11-02,2023-12-01,422.66,51,16745,49322029,10894195,0.0822046473392244,99.4563342071755,0.412997903563941
478.09,478,4456,4500,31192,40500,2023-11-02,2023-12-29,422.66,44,9308,119134666,22518358,0.0339951429418537,99.5037859089646,0.229827160493827
447.72,447.5,1800,1801,30600,39622,2023-11-02,2023-11-24,422.66,1,9022,67048283,15185362,0.0590947273027111,99.5841325273013,0.227701781838373
447.25,447,1543,1548,26231,38700,2023-11-02,2023-11-24,422.66,5,12469,67048283,15185362,0.0577195988747393,99.641852126176,0.322196382428941
419.43,379,9,9,36387,36387,2023-11-02,2023-12-15,422.66,0,0,661780848,102231664,0.00549834588141481,99.9251268752341,0
427.38,391,10,10,0,36380,2023-11-02,2023-12-29,422.66,0,36380,119134666,22518358,0.0305368716104849,99.5343227805751,1
458.03,458,11958,11952,35874,35856,2023-11-02,2023-11-17,422.66,-6,-18,436972766,114712146,0.00820554569755498,99.9061708115695,-0.000502008032128514
460.09,460,4248,3817,29736,34353,2023-11-02,2023-12-01,422.66,-431,4617,49322029,10894195,0.0696504192883062,99.5259846264638,0.134398742467907
424.58,387,9,9,33822,33822,2023-11-02,2023-12-29,422.66,0,0,119134666,22518358,0.0283897215945525,99.5627125021696,0
416.98,305,3,3,33594,33594,2023-11-02,2023-11-24,422.66,0,0,67048283,15185362,0.0501041913332814,99.6919563175093,0
413.97,398,21,21,33537,33537,2023-11-02,2023-11-03,422.66,0,0,86263600,31048392,0.0388773480355561,99.460310026477,0
416.3,350,5,5,33150,33150,2023-11-02,2023-11-10,422.66,0,0,68344835,21359059,0.0485040310654053,99.4273934526289,0
414.66,360,6,6,32796,32796,2023-11-02,2023-11-03,422.66,0,0,86263600,31048392,0.0380183530480991,99.4983283795251,0
420.68,399,18,15,37314,32520,2023-11-02,2023-11-10,422.66,-3,-4794,68344835,21359059,0.0475822349999089,99.4749756876288,-0.147416974169742
462.35,462,913,913,23738,31955,2023-11-02,2023-12-29,422.66,0,8217,119134666,22518358,0.0268225874742453,99.5895350896438,0.257142857142857
452.24,452,1260,1326,21420,31824,2023-11-02,2023-12-01,422.66,66,10404,49322029,10894195,0.0645228930058818,99.5905075194697,0.326923076923077
475.02,475,15842,15845,15842,31690,2023-11-02,2023-11-17,422.66,3,15848,436972766,114712146,0.00725216820491738,99.9134229797744,0.500094667087409
425.52,320,3,3,31656,31656,2023-11-02,2023-11-24,422.66,0,0,67048283,15185362,0.0472137370020348,99.7391700545113,0
453.05,453,6314,6299,25256,31495,2023-11-02,2023-11-17,422.66,-15,6239,436972766,114712146,0.00720754299822887,99.9206305227727,0.19809493570408
490.05,490,6279,6281,25116,31405,2023-11-02,2023-12-29,422.66,2,6289,119134666,22518358,0.0263609250392325,99.6158960146831,0.200254736506926
414.59,310,3,3,31377,31377,2023-11-02,2023-11-24,422.66,0,0,67048283,15185362,0.0467976189636355,99.785967673475,0
414.42,386,11,11,31262,31262,2023-11-02,2023-11-24,422.66,0,0,67048283,15185362,0.0466261007757648,99.8325937742507,0
485.04,485,7618,7619,30472,30476,2023-11-02,2023-12-15,422.66,1,3.99999999999636,661780848,102231664,0.00460514989095,99.929732025125,0.000131250820317508
496.04,496,7515,7515,30060,30060,2023-11-02,2023-12-15,422.66,0,0,661780848,102231664,0.00454228920205923,99.9342743143271,0
417.43,375,7,7,29701,29701,2023-11-02,2023-12-01,422.66,0,0,49322029,10894195,0.0602185283172353,99.6507260477869,0
456.03,456,9946,9874,19892,29622,2023-11-02,2023-11-17,422.66,-72,9730,436972766,114712146,0.00677891216680538,99.9274094349395,0.328472081561002
417.2,375,7,7,29540,29540,2023-11-02,2023-11-10,422.66,0,0,68344835,21359059,0.0432219932932752,99.5181976809221,0
468.12,468,2435,2448,24350,29376,2023-11-02,2023-12-15,422.66,13,5026,661780848,102231664,0.00443893172320998,99.9387132460503,0.171092047930283
416.33,398,16,16,29328,29328,2023-11-02,2023-11-10,422.66,0,0,68344835,21359059,0.0429118016013939,99.5611094825234,0
422.19,404,16,16,29104,29104,2023-11-02,2023-12-08,422.66,0,0,58295535,11187777,0.0499249213511807,99.6424871990625,0
483.1,483,2906,2906,29060,29060,2023-11-02,2023-12-29,422.66,0,0,119134666,22518358,0.0243925642935869,99.6402885789767,0
457.03,457,9188,9220,18376,27660,2023-11-02,2023-11-17,422.66,32,9284,436972766,114712146,0.00632991393335483,99.9337393488728,0.335647143890094
435.02,435,13580,13340,27160,26680,2023-11-02,2023-11-03,422.66,-240,-480.000000000004,86263600,31048392,0.0309284564984536,99.5292568360235,-0.0179910044977513
451.05,451,5314,5280,21256,26400,2023-11-02,2023-11-17,422.66,-34,5144,436972766,114712146,0.00604156644398292,99.9397809153168,0.194848484848485
477.09,477,2838,2875,28380,25875,2023-11-02,2023-12-29,422.66,37,-2505,119134666,22518358,0.0217191191017399,99.6620076980784,-0.0968115942028986
422.9,359,4,4,23280,25560,2023-11-02,2023-12-29,422.66,0,2280,119134666,22518358,0.0214547124344143,99.6834624105128,0.0892018779342723
505.03,505,8509,8509,25527,25527,2023-11-02,2023-12-29,422.66,0,0,119134666,22518358,0.0214270126883136,99.7048894232011,0
464.27,464,928,927,22272,25029,2023-11-02,2023-12-29,422.66,-1,2757,119134666,22518358,0.0210089983380656,99.7258984215392,0.110152223420832
414.55,392,11,11,24805,24805,2023-11-02,2023-11-03,422.66,0,0,86263600,31048392,0.0287548861860623,99.5580117222096,0
443.6,442,0,154,0,24640,2023-11-02,2023-12-08,422.66,154,24640,58295535,11187777,0.0422673880598231,99.6847545871223,1
485.06,485,4003,4043,20015,24258,2023-11-02,2023-12-29,422.66,40,4243,119134666,22518358,0.0203618315428022,99.746260253082,0.174911369445132
422.7,375,2,5,8378,23850,2023-11-02,2023-12-08,422.66,3,15472,58295535,11187777,0.0409122242380999,99.7256668113604,0.648721174004193
466.23,466,1015,1034,19285,23782,2023-11-02,2023-12-29,422.66,19,4497,119134666,22518358,0.0199622836899547,99.766222536772,0.189092591035237
414.4,355,4,4,23760,23760,2023-11-02,2023-11-10,422.66,0,0,68344835,21359059,0.0347648801844353,99.5958743627079,0
454.19,454,1168,1239,16352,23541,2023-11-02,2023-12-01,422.66,71,7189,49322029,10894195,0.0477291799978464,99.6984552277847,0.305382099316087
450.57,450,374,412,14212,23484,2023-11-02,2023-12-08,422.66,38,9272,58295535,11187777,0.0402843888472762,99.7659512002077,0.394822006472492
417.13,396,11,11,23243,23243,2023-11-02,2023-11-03,422.66,0,0,86263600,31048392,0.0269441572111528,99.5849558794208,0
417.74,360,4,4,23096,23096,2023-11-02,2023-12-01,422.66,0,0,49322029,10894195,0.0468269462312672,99.745282174016,0
461.36,461,631,630,17668,22680,2023-11-02,2023-12-29,422.66,-1,5012,119134666,22518358,0.0190372800474381,99.7852598168194,0.220987654320988
493.03,493,7549,7549,22647,22647,2023-11-02,2023-12-15,422.66,0,0,661780848,102231664,0.00342212985891668,99.9421353759092,0
422.75,310,2,2,21542,22550,2023-11-02,2023-12-01,422.66,0,1008,49322029,10894195,0.0457199358120486,99.7910021098281,0.0447006651884701
424.77,350,1,3,0,22431,2023-11-02,2023-12-01,422.66,2,22431,49322029,10894195,0.0454786643104241,99.8364807741385,1
432.55,432.5,4068,4447,16272,22235,2023-11-02,2023-11-03,422.66,379,5963,86263600,31048392,0.0257756458112112,99.610731525232,0.268180796042276
456.02,456,10968,10965,10968,21930,2023-11-02,2023-11-10,422.66,-3,10962,68344835,21359059,0.032087282089422,99.6279616447973,0.499863201094391
421.1,390,7,7,21770,21770,2023-11-02,2023-12-08,422.66,0,0,58295535,11187777,0.0373441979733096,99.803295398181,0
495.04,495,5416,5417,16248,21668,2023-11-02,2023-12-29,422.66,1,5420,119134666,22518358,0.0181878211670145,99.8034476379864,0.250138453018276
462.02,462,10635,10637,21270,21274,2023-11-02,2023-11-17,422.66,2,4,436972766,114712146,0.00486849562610957,99.9446494109429,0.000188022938798533
420.25,401,12,11,21276,21175,2023-11-02,2023-11-03,422.66,-1,-101,86263600,31048392,0.0245468540612727,99.6352783792933,-0.00476977567886659
415.1,345,3,3,21030,21030,2023-11-02,2023-11-10,422.66,0,0,68344835,21359059,0.0307704305672843,99.6587320753646,0
415.08,396,11,11,20988,20988,2023-11-02,2023-11-24,422.66,0,0,67048283,15185362,0.0313028150176493,99.8638965892684,0
472.14,472,1487,1487,22305,20818,2023-11-02,2023-12-29,422.66,0,-1487,119134666,22518358,0.0174743428583583,99.8209219808448,-0.0714285714285714
479.05,479,4155,4155,20775,20775,2023-11-02,2023-12-15,422.66,0,0,661780848,102231664,0.0031392567589082,99.9452746326681,0
418.93,378,5,5,20465,20465,2023-11-02,2023-11-24,422.66,0,0,67048283,15185362,0.0305227801284635,99.8944193693968,0
441.07,441,2914,2882,17484,20174,2023-11-02,2023-11-10,422.66,-32,2690,68344835,21359059,0.0295179584528955,99.6882500338175,0.133339942500248
520.01,520,20119,20119,20119,20119,2023-11-02,2023-12-15,422.66,0,0,661780848,102231664,0.00304013028796506,99.9483147629561,0
419.81,370,4,4,19924,19924,2023-11-02,2023-12-08,422.66,0,0,58295535,11187777,0.0341775746633083,99.8374729728443,0
480.01,480,19776,19844,19776,19844,2023-11-02,2023-11-17,422.66,68,68,436972766,114712146,0.00454124411039383,99.9491906550533,0.00342672848216085
494.04,494,4882,4882,19528,19528,2023-11-02,2023-12-29,422.66,0,0,119134666,22518358,0.0163915346016918,99.8373135154465,0
426.35,394,4,6,11516,19410,2023-11-02,2023-12-08,422.66,2,7894,58295535,11187777,0.0332958604805668,99.8707688333249,0.406697578567749
550.01,550,19062,19062,19062,19062,2023-11-02,2023-12-15,422.66,0,0,661780848,102231664,0.00288040973950942,99.9511951726956,0
460.05,460,3743,3773,14972,18865,2023-11-02,2023-11-24,422.66,30,3893,67048283,15185362,0.0281364401233064,99.9225558095201,0.206360985952823
412.97,396,11,11,18667,18667,2023-11-02,2023-11-10,422.66,0,0,68344835,21359059,0.0273129637374938,99.715562997555,0
419.45,235,1,1,18445,18445,2023-11-02,2023-11-17,422.66,0,0,436972766,114712146,0.00422108685830549,99.9534117419116,0
413.53,230,1,1,18353,18353,2023-11-02,2023-11-17,422.66,0,0,436972766,114712146,0.00420003291463706,99.9576117748263,0
420.41,240,1,1,18041,18041,2023-11-02,2023-11-17,422.66,0,0,436972766,114712146,0.00412863258393545,99.9617404074102,0
414.75,385,6,6,17850,17850,2023-11-02,2023-11-03,422.66,0,0,86263600,31048392,0.0206923893739654,99.6559707686672,0
418.34,330,2,2,17668,17668,2023-11-02,2023-11-03,422.66,0,0,86263600,31048392,0.0204814081489759,99.6764521768162,0
540.01,540,17577,17577,17577,17577,2023-11-02,2023-12-15,422.66,0,0,661780848,102231664,0.00265601521306038,99.9538511879087,0
465.06,465,2857,2872,11428,17232,2023-11-02,2023-12-01,422.66,15,5804,49322029,10894195,0.0349377354285242,99.871418509567,0.336815227483751
470.01,470,17119,17105,17119,17105,2023-11-02,2023-11-17,422.66,-14,-14,436972766,114712146,0.0039144315918306,99.965654839002,-0.000818474130371236
493.04,493,4242,4242,16968,16968,2023-11-02,2023-12-29,422.66,0,0,119134666,22518358,0.0142427058132685,99.8515562212597,0
483.05,483,3364,3369,13456,16845,2023-11-02,2023-12-15,422.66,5,3389,661780848,102231664,0.00254540457780066,99.9563965924865,0.201187295933511
422.04,398,7,7,16828,16828,2023-11-02,2023-12-08,422.66,0,0,58295535,11187777,0.0288667047999474,99.8996355381248,0
464.02,464,8267,8318,8267,16636,2023-11-02,2023-11-17,422.66,51,8369,436972766,114712146,0.00380710224856439,99.9694619412506,0.503065640779033
510.01,510,16458,16458,32916,16458,2023-11-02,2023-12-15,422.66,0,-16458,661780848,102231664,0.00248692600424121,99.9588835184907,-1
501.03,501,5460,5460,16380,16380,2023-11-02,2023-12-15,422.66,0,0,661780848,102231664,0.00247513962507419,99.9613586581158,0
515.01,515,16278,16278,16278,16278,2023-11-02,2023-12-15,422.66,0,0,661780848,102231664,0.00245972666770193,99.9638183847835,0
487.04,487,4056,4056,16224,16224,2023-11-02,2023-12-15,422.66,0,0,661780848,102231664,0.00245156686674015,99.9662699516502,0
433.03,433,4680,5379,18720,16137,2023-11-02,2023-11-03,422.66,699,-2583,86263600,31048392,0.0187066155365647,99.6951587923527,-0.160066926938093
419.94,380,3,4,11070,15976,2023-11-02,2023-11-10,422.66,1,4906,68344835,21359059,0.0233755776863021,99.7389385752413,0.307085628442664
600.01,600,15520,15518,15520,15518,2023-11-02,2023-12-15,422.66,-2,-2.00000000000182,661780848,102231664,0.0023448850245361,99.9686148366747,-0.000128882587962484
416.36,397,8,8,15488,15488,2023-11-02,2023-11-03,422.66,0,0,86263600,31048392,0.0179542703991023,99.7131130627518,0
495.02,495,7678,7708,15356,15416,2023-11-02,2023-12-15,422.66,30,60,661780848,102231664,0.00232947206716384,99.9709443087419,0.00389206019719772
448.02,448,7604,7623,22812,15246,2023-11-02,2023-11-10,422.66,19,-7566,68344835,21359059,0.0223074647850126,99.7612460400263,-0.496261314443133
700.01,700,14944,14944,14944,14944,2023-11-02,2023-12-15,422.66,0,0,661780848,102231664,0.00225814936246085,99.9732024581044,0
445.03,445,5020,4981,15060,14943,2023-11-02,2023-11-10,422.66,-39,-117,68344835,21359059,0.0218641247725596,99.7831101647989,-0.00782975306163421
417.62,388,5,5,14810,14810,2023-11-02,2023-11-03,422.66,0,0,86263600,31048392,0.0171683073741416,99.730281370126,0
459.02,459,7112,7084,21336,14168,2023-11-02,2023-11-17,422.66,-28,-7168,436972766,114712146,0.0032423073249375,99.9727042485755,-0.505928853754941
478.07,478,2008,2008,10040,14056,2023-11-02,2023-12-15,422.66,0,4016,661780848,102231664,0.00212396596886708,99.9753264240733,0.285714285714286
468.02,468,6925,6927,13850,13854,2023-11-02,2023-11-17,422.66,2,4,436972766,114712146,0.00317044929980831,99.9758746978753,0.00028872527789808
411.01,365,3,3,13803,13803,2023-11-02,2023-11-03,422.66,0,0,86263600,31048392,0.0160009552117,99.7462823253377,0
489.04,489,3414,3414,10242,13656,2023-11-02,2023-12-15,422.66,0,3414,661780848,102231664,0.0020635229987798,99.977389947072,0.25
469.18,469,762,756,13716,13608,2023-11-02,2023-12-29,422.66,-6,-108.000000000002,119134666,22518358,0.0114223680284628,99.8629785892882,-0.00793650793650807
444.04,444,3838,3341,11514,13364,2023-11-02,2023-11-10,422.66,-497,1850,68344835,21359059,0.0195537819353869,99.8026639467342,0.138431607303203
414.08,370,3,3,13224,13224,2023-11-02,2023-11-03,422.66,0,0,86263600,31048392,0.0153297566992335,99.7616120820369,0
423.79,402,6,6,13074,13074,2023-11-02,2023-12-29,422.66,0,0,119134666,22518358,0.0109741357733777,99.8739527250616,0
450.02,450,6303,6520,12606,13040,2023-11-02,2023-11-10,422.66,217,434,68344835,21359059,0.0190797153874174,99.8217436621217,0.0332822085889571
442.06,442,2081,2170,10405,13020,2023-11-02,2023-11-10,422.66,89,2615,68344835,21359059,0.0190504520202587,99.8407941141419,0.20084485407066
491.03,491,4326,4326,12978,12978,2023-11-02,2023-12-15,422.66,0,0,661780848,102231664,0.00196107216448186,99.9793510192365,0
434.02,434,5999,6235,17997,12470,2023-11-02,2023-11-03,422.66,236,-5527,86263600,31048392,0.0144556916242772,99.7760677736612,-0.443223736968725
484.04,484,3149,3109,12596,12436,2023-11-02,2023-12-15,422.66,-40,-160,661780848,102231664,0.00187917194001359,99.9812301911765,-0.0128658732711483
505.01,505,12190,12190,12190,12190,2023-11-02,2023-11-10,422.66,0,0,68344835,21359059,0.0178360222831762,99.8586301364251,0
455.01,455,12132,12137,12132,12137,2023-11-02,2023-11-10,422.66,5,5,68344835,21359059,0.0177584743602059,99.8763886107853,0.000411963417648513
520.02,520,5860,5860,11720,11720,2023-11-02,2023-12-29,422.66,0,0,119134666,22518358,0.00983760679700063,99.8837903318586,0
440.01,440,11763,11708,23526,11708,2023-11-02,2023-11-03,422.66,-55,-11818,86263600,31048392,0.0135723526493214,99.7896401263105,-1.00939528527503
415.19,300,1,1,11519,11519,2023-11-02,2023-11-03,422.66,0,0,86263600,31048392,0.0133532567618323,99.8029933830724,0
545.01,545,11424,11424,11424,11424,2023-11-02,2023-12-15,422.66,0,0,661780848,102231664,0.00172625122569277,99.9829564424022,0
436.02,436,4964,5621,9928,11242,2023-11-02,2023-11-03,422.66,657,1314,86263600,31048392,0.0130321479743484,99.8160255310467,0.116883116883117
445.23,444,0,91,0,11193,2023-11-02,2023-12-08,422.66,91,11193,58295535,11187777,0.0192004413374026,99.9188359794622,1
468.2,468,558,559,9486,11180,2023-11-02,2023-12-29,422.66,1,1694,119134666,22518358,0.00938433822444258,99.893174670083,0.151520572450805
456.15,456,734,737,7340,11055,2023-11-02,2023-12-01,422.66,3,3715,49322029,10894195,0.0224139197517604,99.8938324293188,0.336047037539575
415.14,360,2,2,11028,11028,2023-11-02,2023-11-10,422.66,0,0,68344835,21359059,0.0161358206512606,99.8925244314366,0
535.01,535,10954,10954,10954,10954,2023-11-02,2023-12-15,422.66,0,0,661780848,102231664,0.00165523073584021,99.9846116731381,0
471.15,471,725,725,8700,10875,2023-11-02,2023-12-29,422.66,0,2175,119134666,22518358,0.00912832541957183,99.9023029955026,0.2
565.01,565,10671,10673,10671,10673,2023-11-02,2023-12-15,422.66,2,2,661780848,102231664,0.0016127695493539,99.9862244426874,0.00018738873793685
466.02,466,5311,5308,5311,10616,2023-11-02,2023-11-17,422.66,-3,5305,436972766,114712146,0.00242944202156525,99.9783041398969,0.499717407686511
494.03,494,3515,3516,10545,10548,2023-11-02,2023-12-15,422.66,1,2.99999999999818,661780848,102231664,0.00159388112120162,99.9878183238086,0.000284414106939532
423.67,398,3,4,5919,10268,2023-11-02,2023-12-01,422.66,1,4349,49322029,10894195,0.0208182838544619,99.9146507131732,0.423548889754577
472.02,472,5149,5122,10298,10244,2023-11-02,2023-11-17,422.66,-27,-54,436972766,114712146,0.0023443108580364,99.980648450755,-0.00527137836782507
452.11,452,885,927,7080,10197,2023-11-02,2023-11-24,422.66,42,3117,67048283,15185362,0.0152084431453673,99.9377642526655,0.305678140629597
486.04,486,2500,2500,10000,10000,2023-11-02,2023-12-15,422.66,0,0,661780848,102231664,0.00151107425218205,99.9893293980608,0
560.01,560,9923,9923,9923,9923,2023-11-02,2023-12-15,422.66,0,0,661780848,102231664,0.00149943898044024,99.9908288370412,0
437.02,437,4501,4823,9002,9646,2023-11-02,2023-11-03,422.66,322,644,86263600,31048392,0.0111820049244409,99.8272075359711,0.0667634252539913
499.03,499,3170,3170,9510,9510,2023-11-02,2023-12-15,422.66,0,0,661780848,102231664,0.00143703161382513,99.9922658686551,0
417.65,386,3,3,9495,9495,2023-11-02,2023-12-29,422.66,0,0,119134666,22518358,0.00796997240081237,99.9102729679034,0
446.01,446,9404,9403,9404,9403,2023-11-02,2023-11-03,422.66,-1,-1,86263600,31048392,0.010900310211955,99.8381078461831,-0.00010634903754121
530.01,530,9353,9353,9353,9353,2023-11-02,2023-12-15,422.66,0,0,661780848,102231664,0.00141330774806587,99.9936791764031,0
454.02,454,4644,4644,4644,9288,2023-11-02,2023-11-10,422.66,0,4644,68344835,21359059,0.0135899077084611,99.906114339145,0.5
412.8,320,1,1,9280,9280,2023-11-02,2023-11-03,422.66,0,0,86263600,31048392,0.0107577239994621,99.8488655701826,0
421.59,330,0,1,0,9159,2023-11-02,2023-12-08,422.66,1,9159,58295535,11187777,0.015711323345776,99.934547302808,1
500.01,500,9138,9138,9138,9138,2023-11-02,2023-11-17,422.66,0,0,436972766,114712146,0.00209120583958772,99.9827396565945,0
474.02,474,4510,4510,9020,9020,2023-11-02,2023-11-17,422.66,0,0,436972766,114712146,0.00206420186836083,99.9848038584629,0
485.01,485,8820,8947,8820,8947,2023-11-02,2023-11-17,422.66,127,127,436972766,114712146,0.00204749602175436,99.9868513544846,0.0141947021347938
497.03,497,2912,2912,8736,8736,2023-11-02,2023-12-15,422.66,0,0,661780848,102231664,0.00132007446670624,99.9949992508698,0
498.02,498,4320,4320,8640,8640,2023-11-02,2023-12-15,422.66,0,0,661780848,102231664,0.00130556815388529,99.9963048190237,0
496.03,496,2842,2842,8526,8526,2023-11-02,2023-12-29,422.66,0,0,119134666,22518358,0.00715660712894432,99.9174295750323,0
446.03,446,2809,2807,8427,8421,2023-11-02,2023-11-10,422.66,-2,-6,68344835,21359059,0.0123213407421351,99.9184356798872,-0.000712504453152832
481.07,481,1188,1187,9504,8309,2023-11-02,2023-12-29,422.66,-1,-1195,119134666,22518358,0.00697446031367562,99.924404035346,-0.143819954266458
452.01,452,8018,8029,16036,8029,2023-11-02,2023-11-10,422.66,11,-8007,68344835,21359059,0.0117477787458262,99.930183458633,-0.997259932743804
495.01,495,7850,7895,15700,7895,2023-11-02,2023-11-17,422.66,45,-7805,436972766,114712146,0.00180674875285019,99.9886581032375,-0.988600379987334
555.01,555,7791,7791,7791,7791,2023-11-02,2023-12-15,422.66,0,0,661780848,102231664,0.00117727794987503,99.9974820969736,0
443.05,443,1552,1551,6208,7755,2023-11-02,2023-11-10,422.66,-1,1547,68344835,21359059,0.0113468706157532,99.9415303292487,0.199484203739523
510.03,510,2585,2585,7755,7755,2023-11-02,2023-12-29,422.66,0,0,119134666,22518358,0.00650944033368088,99.9309134756797,0
417.53,392,3,3,7659,7659,2023-11-02,2023-12-01,422.66,0,0,49322029,10894195,0.0155285582432142,99.9301792714164,0
425.8,402,2,3,4100,7140,2023-11-02,2023-12-08,422.66,1,3040,58295535,11187777,0.0122479363127897,99.9467952391208,0.425770308123249
459.01,459,7015,7015,7015,7015,2023-11-02,2023-11-03,422.66,0,0,86263600,31048392,0.0081320510620934,99.8569976212447,0
460.01,460,6913,6911,6913,6911,2023-11-02,2023-11-03,422.66,-2,-2,86263600,31048392,0.00801149036209943,99.8650091116068,-0.000289393720156273
491.05,491,1371,1371,6855,6855,2023-11-02,2023-12-29,422.66,0,0,119134666,22518358,0.0057539927127508,99.9366674683925,0
416.21,382,2,2,6842,6842,2023-11-02,2023-11-24,422.66,0,0,67048283,15185362,0.0102045864470534,99.9479688391126,0
454.09,454,735,756,5145,6804,2023-11-02,2023-11-24,422.66,21,1659,67048283,15185362,0.0101479108719309,99.9581167499845,0.243827160493827
450.01,450,6813,6788,6813,6788,2023-11-02,2023-11-03,422.66,-25,-25,86263600,31048392,0.00786890414960656,99.8728780157564,-0.00368296994696523
473.11,473,617,617,6170,6787,2023-11-02,2023-12-29,422.66,0,617,119134666,22518358,0.0056969144480583,99.9423643828405,0.0909090909090909
474.11,474,609,614,5481,6754,2023-11-02,2023-12-29,422.66,5,1273,119134666,22518358,0.00566921470195753,99.9480335975425,0.188480900207285
482.08,482,802,844,6416,6752,2023-11-02,2023-12-29,422.66,42,336,119134666,22518358,0.00566753592946658,99.9537011334719,0.0497630331753555
421.65,388,2,2,5718,6730,2023-11-02,2023-11-24,422.66,0,1012,67048283,15185362,0.0100375426466924,99.9681542926312,0.15037147102526
458.13,458,520,515,4680,6695,2023-11-02,2023-12-01,422.66,-5,2015,49322029,10894195,0.0135740563308943,99.9437533277473,0.300970873786408
463.3,463,222,223,5772,6690,2023-11-02,2023-12-29,422.66,1,917.999999999999,119134666,22518358,0.00561549398224695,99.9593166274542,0.137219730941704
421.87,355,0,1,0,6687,2023-11-02,2023-12-08,422.66,1,6687,58295535,11187777,0.0114708613618522,99.9582661004827,1
448.2,448,263,318,3419,6360,2023-11-02,2023-11-24,422.66,55,2941,67048283,15185362,0.00948570152049979,99.9776399941517,0.462421383647799
447.02,447,3155,3158,9465,6316,2023-11-02,2023-11-10,422.66,3,-3149,68344835,21359059,0.0092413713486908,99.9507717005974,-0.498575047498417
488.03,488,2053,2053,6159,6159,2023-11-02,2023-12-15,422.66,0,0,661780848,102231664,0.000930670631918922,99.9984127676055,0
437.52,437.5,2919,3044,2919,6088,2023-11-02,2023-11-03,422.66,125,3169,86263600,31048392,0.00705743789964713,99.879935453656,0.520532194480946
414.76,385,2,2,5952,5952,2023-11-02,2023-11-10,422.66,0,0,68344835,21359059,0.00870877806640399,99.9594804786638,0
412.9,356,1,1,5690,5690,2023-11-02,2023-11-03,422.66,0,0,86263600,31048392,0.0065960613746702,99.8865315150307,0
455.31,455,174,183,3828,5673,2023-11-02,2023-12-08,422.66,9,1845,58295535,11187777,0.0097314485577669,99.9679975490404,0.325224748810153
421.41,365,1,1,5641,5641,2023-11-02,2023-12-01,422.66,0,0,49322029,10894195,0.0114370801736482,99.955190407921,0
520.01,520,5544,5544,5544,5544,2023-11-02,2023-11-17,422.66,0,0,436972766,114712146,0.00126872895323641,99.9899268321907,0
494.01,494,5543,5543,5543,5543,2023-11-02,2023-11-17,422.66,0,0,436972766,114712146,0.00126850010602263,99.9911953322968,0
446.96,446,0,57,0,5472,2023-11-02,2023-12-08,422.66,57,5472,58295535,11187777,0.00938665371198669,99.9773842027524,1
484.06,484,882,910,4410,5460,2023-11-02,2023-12-29,422.66,28,1050,119134666,22518358,0.00458304890030917,99.9638996763545,0.192307692307692
449.03,449,1800,1819,3600,5457,2023-11-02,2023-11-10,422.66,19,1857,68344835,21359059,0.00798450972922826,99.9674649883931,0.340296866410116
515.01,515,5405,5405,5405,5405,2023-11-02,2023-11-17,422.66,0,0,436972766,114712146,0.00123691919051999,99.9924322514873,0
530.01,530,5355,5355,5355,5355,2023-11-02,2023-12-29,422.66,0,0,119134666,22518358,0.00449491334453399,99.968394589699,0
490.01,490,5297,5297,5297,5297,2023-11-02,2023-11-17,422.66,0,0,436972766,114712146,0.00121220369143097,99.9936444551787,0
422.39,396,2,2,4640,5278,2023-11-02,2023-12-01,422.66,0,638,49322029,10894195,0.0107011007191128,99.9658915086401,0.120879120879121
415.49,364,1,1,5149,5149,2023-11-02,2023-11-03,422.66,0,0,86263600,31048392,0.00596891388720156,99.8925004289179,0
411.65,386,2,2,5130,5130,2023-11-02,2023-11-10,422.66,0,0,68344835,21359059,0.00750605367618489,99.9749710420692,0
439.01,439,5008,5034,5008,5034,2023-11-02,2023-11-03,422.66,26,26,86263600,31048392,0.00583560157470822,99.8983360304926,0.00516487882399682
515.01,515,4949,4949,4949,4949,2023-11-02,2023-12-29,422.66,0,0,119134666,22518358,0.00415412252886998,99.9725487122279,0
455.01,455,4826,4822,4826,4822,2023-11-02,2023-11-03,422.66,-4,-4,86263600,31048392,0.00558984322472051,99.9039258737173,-0.000829531314807134
438.01,438,4815,4812,4815,4812,2023-11-02,2023-11-03,422.66,-3,-3,86263600,31048392,0.00557825084972109,99.909504124567,-0.000623441396508728
468.01,468,4754,4754,4754,4754,2023-11-02,2023-11-03,422.66,0,0,86263600,31048392,0.00551101507472445,99.9150151396418,0
488.01,488,4695,4702,9390,4702,2023-11-02,2023-11-17,422.66,7,-4688,436972766,114712146,0.00107603959922756,99.9947204947779,-0.997022543598469
441.01,441,4650,4655,9300,4655,2023-11-02,2023-11-03,422.66,5,-4645,86263600,31048392,0.00539625056223019,99.920411390204,-0.997851772287862
445.01,445,4650,4566,4650,4566,2023-11-02,2023-11-03,422.66,-84,-84,86263600,31048392,0.00529307842473535,99.9257044686287,-0.0183968462549277
479.08,479,568,568,4544,4544,2023-11-02,2023-12-29,422.66,0,0,119134666,22518358,0.00381417109945144,99.9763628833274,0
492.03,492,1496,1490,4488,4470,2023-11-02,2023-12-15,422.66,-6,-18,661780848,102231664,0.000675450190725374,99.9990882177962,-0.00402684563758389
505.01,505,4287,4287,4287,4287,2023-11-02,2023-11-17,422.66,0,0,436972766,114712146,0.000981068005505863,99.9957015627835,0
424.15,403,2,2,4230,4230,2023-11-02,2023-12-08,422.66,0,0,58295535,11187777,0.00725613033656866,99.984640333089,0
449.01,449,4190,4210,4190,4210,2023-11-02,2023-11-03,422.66,20,20,86263600,31048392,0.00488038987475598,99.9305848585035,0.00475059382422803
465.01,465,4132,4126,8264,4126,2023-11-02,2023-11-03,422.66,-6,-4138,86263600,31048392,0.00478301392476085,99.9353678724282,-1.00290838584586
443.01,443,4031,3995,4031,3995,2023-11-02,2023-11-03,422.66,-36,-35.9999999999996,86263600,31048392,0.00463115381226844,99.9399990262405,-0.00901126408010001
467.21,467,190,190,3230,3990,2023-11-02,2023-12-29,422.66,0,760,119134666,22518358,0.0033491511194567,99.9797120344468,0.19047619047619
465.04,465,997,988,1994,3952,2023-11-02,2023-11-24,422.66,-9,1958,67048283,15185362,0.00589425981273823,99.9835342539644,0.495445344129555
452.02,452,1943,1947,1943,3894,2023-11-02,2023-11-03,422.66,4,1951,86263600,31048392,0.0045140708247743,99.9445130970653,0.501027221366204
451.02,451,1907,1880,1907,3760,2023-11-02,2023-11-03,422.66,-27,1853,86263600,31048392,0.00435873299978206,99.9488718300651,0.49281914893617
560.01,560,3650,3650,3650,3650,2023-11-02,2023-11-17,422.66,0,0,436972766,114712146,0.000835292330323396,99.9965368551138,0
470.04,470,436,908,872,3632,2023-11-02,2023-12-01,422.66,472,2760,49322029,10894195,0.00736384952857475,99.9732553581687,0.759911894273128
461.01,461,3630,3630,3630,3630,2023-11-02,2023-11-03,422.66,0,0,86263600,31048392,0.0042080321247896,99.9530798621899,0
451.02,451,1815,1813,1815,3626,2023-11-02,2023-11-10,422.66,-2,1811,68344835,21359059,0.005305448465857,99.9802764905351,0.499448428019857
464.04,464,879,879,3516,3516,2023-11-02,2023-12-01,422.66,0,0,49322029,10894195,0.00712866050178106,99.9803840186704,0
416.56,399,2,2,3512,3512,2023-11-02,2023-11-03,422.66,0,0,86263600,31048392,0.00407124209979644,99.9571511042897,0
460.01,460,2567,3510,2567,3510,2023-11-02,2023-11-10,422.66,943,943,68344835,21359059,0.00513572093633703,99.9854122114714,0.268660968660969
496.01,496,3473,3473,3473,3473,2023-11-02,2023-11-17,422.66,0,0,436972766,114712146,0.000794786373483056,99.9973316414872,0
462.08,462,430,430,3010,3440,2023-11-02,2023-12-01,422.66,0,430,49322029,10894195,0.00697457113939899,99.9873585898099,0.125
448.01,448,3397,3396,3397,3396,2023-11-02,2023-11-03,422.66,-1,-1,86263600,31048392,0.00393677054980316,99.9610878748395,-0.000294464075382803
411.1,378,1,1,3310,3310,2023-11-02,2023-11-03,422.66,0,0,86263600,31048392,0.00383707612480815,99.9649249509643,0
605.01,605,3282,3282,3282,3282,2023-11-02,2023-12-15,422.66,0,0,661780848,102231664,0.000495934569566147,99.9995841523658,0
476.01,476,3079,3079,3079,3079,2023-11-02,2023-11-17,422.66,0,0,436972766,114712146,0.000704620571250887,99.9980362620585,0
499.04,499,745,760,1490,3040,2023-11-02,2023-12-29,422.66,15,1550,119134666,22518358,0.00255173418625272,99.9822637686331,0.509868421052632
418.26,388,1,1,3026,3026,2023-11-02,2023-11-10,422.66,0,0,68344835,21359059,0.00442754745109854,99.9898397589225,0
442.51,442.5,2921,2920,2921,2920,2023-11-02,2023-11-03,422.66,-1,-1,86263600,31048392,0.00338497349983075,99.9683099244641,-0.000342465753424658
550.01,550,2852,2852,2852,2852,2023-11-02,2023-12-29,422.66,0,0,119134666,22518358,0.00239392957210288,99.9846576982052,0
590.01,590,2753,2752,0,2752,2023-11-02,2023-12-15,422.66,-1,2752,661780848,102231664,0.000415847634200499,100,1
487.05,487,534,534,2670,2670,2023-11-02,2023-12-29,422.66,0,0,119134666,22518358,0.00224116127542591,99.9868988594806,0
489.04,489,648,648,2592,2592,2023-11-02,2023-12-29,422.66,0,0,119134666,22518358,0.00217568914827864,99.9890745486289,0
458.05,458,460,517,2760,2585,2023-11-02,2023-11-24,422.66,57,-175,67048283,15185362,0.00385543057083207,99.9873896845352,-0.0676982591876209
444.01,444,2559,2559,2559,2559,2023-11-02,2023-11-03,422.66,0,0,86263600,31048392,0.00296648876235168,99.9712764132264,0
492.07,492,357,357,2499,2499,2023-11-02,2023-12-29,422.66,0,0,119134666,22518358,0.0020976262274492,99.9911721748563,0
418.88,394,1,1,2488,2488,2023-11-02,2023-12-01,422.66,0,0,49322029,10894195,0.00504439912640252,99.9924029889362,0
478.01,478,2479,2479,2479,2479,2023-11-02,2023-11-17,422.66,0,0,436972766,114712146,0.000567312242978548,99.9986035743015,0
452.44,452,0,56,0,2464,2023-11-02,2023-12-08,422.66,56,2464,58295535,11187777,0.00422673880598231,99.988867071895,1
422.93,399,1,1,2393,2393,2023-11-02,2023-12-29,422.66,0,0,119134666,22518358,0.00200865128542854,99.9931808261417,0
488.05,488,470,471,2350,2355,2023-11-02,2023-12-29,422.66,1,5,119134666,22518358,0.00197675460810038,99.9951575807498,0.00212314225053079
442.01,442,2036,2353,2036,2353,2023-11-02,2023-11-03,422.66,317,317,86263600,31048392,0.00272768583736362,99.9740040990638,0.134721631959201
460.14,460,151,155,1812,2170,2023-11-02,2023-12-08,422.66,4,358,58295535,11187777,0.00372241201663215,99.9925894839116,0.164976958525346
486.01,486,2043,2101,2043,2101,2023-11-02,2023-11-17,422.66,58,58,436972766,114712146,0.000480807996166974,99.9990843822976,0.0276059019514517
484.01,484,2055,2076,2055,2076,2023-11-02,2023-11-17,422.66,21,21,436972766,114712146,0.000475086815822293,99.9995594691135,0.0101156069364162
411.87,393,1,1,1887,1887,2023-11-02,2023-11-03,422.66,0,0,86263600,31048392,0.00218748116239063,99.9761915802262,0
454.33,454,0,57,0,1881,2023-11-02,2023-12-08,422.66,57,1881,58295535,11187777,0.00322666221349543,99.9958161461251,1
470.01,470,1850,1837,1850,1837,2023-11-02,2023-11-03,422.66,-13,-13,86263600,31048392,0.00212951928739352,99.9783210995136,-0.00707675557974959
447.01,447,1751,1744,3502,1744,2023-11-02,2023-11-03,422.66,-7,-1758,86263600,31048392,0.00202171019989891,99.9803428097135,-1.00802752293578
466.01,466,1654,1654,1654,1654,2023-11-02,2023-11-03,422.66,0,0,86263600,31048392,0.00191737882490413,99.9822601885384,0
480.01,480,1635,1635,1635,1635,2023-11-02,2023-11-03,422.66,0,0,86263600,31048392,0.00189535331240523,99.9841555418508,0
540.02,540,803,803,1606,1606,2023-11-02,2023-12-29,422.66,0,0,119134666,22518358,0.00134805431023746,99.9965056350601,0
454.01,454,1594,1594,1594,1594,2023-11-02,2023-11-03,422.66,0,0,86263600,31048392,0.00184782457490761,99.9860033664257,0
500.01,500,1520,1520,1520,1520,2023-11-02,2023-11-24,422.66,0,0,67048283,15185362,0.00226702300489932,99.9896567075402,0
482.01,482,1464,1489,1464,1489,2023-11-02,2023-11-17,422.66,25,25,436972766,114712146,0.000340753501329188,99.9999002226148,0.0167897918065816
476.1,476,147,147,1470,1470,2023-11-02,2023-12-29,422.66,0,0,119134666,22518358,0.00123389778085247,99.9977395328409,0
447.51,447.5,1455,1454,1455,1454,2023-11-02,2023-11-03,422.66,-1,-1,86263600,31048392,0.00168553132491572,99.9876888977506,-0.000687757909215956
453.01,453,1494,1445,1494,1445,2023-11-02,2023-11-03,422.66,-49,-49,86263600,31048392,0.00167509818741625,99.989363995938,-0.0339100346020761
470.02,470,836,703,836,1406,2023-11-02,2023-11-24,422.66,-133,570,67048283,15185362,0.00209699627953187,99.9917537038197,0.405405405405405
490.01,490,1380,1380,1380,1380,2023-11-02,2023-11-03,422.66,0,0,86263600,31048392,0.00159974774992001,99.990963743688,0
456.07,456,116,156,580,1092,2023-11-02,2023-11-24,422.66,40,512,67048283,15185362,0.00162867705351978,99.9933823808732,0.468864468864469
470.01,470,1089,1089,1089,1089,2023-11-02,2023-11-10,422.66,0,0,68344835,21359059,0.00159339034178662,99.9914331492643,0
486.05,486,215,215,1075,1075,2023-11-02,2023-12-29,422.66,0,0,119134666,22518358,0.00090234021388871,99.9986418730548,0
457.01,457,1067,1067,1067,1067,2023-11-02,2023-11-03,422.66,0,0,86263600,31048392,0.00123690641243815,99.9922006501004,0
465.11,465,85,96,765,1056,2023-11-02,2023-12-08,422.66,11,291,58295535,11187777,0.00181145948827813,99.9976276056134,0.275568181818182
525.01,525,1038,1038,1038,1038,2023-11-02,2023-12-29,422.66,0,0,119134666,22518358,0.000871282922806029,99.9995131559776,0
480.02,480,511,511,1022,1022,2023-11-02,2023-11-10,422.66,0,0,68344835,21359059,0.00149535806180526,99.9929285073261,0
466.03,466,335,335,1005,1005,2023-11-02,2023-11-24,422.66,0,0,67048283,15185362,0.00149891981573935,99.994881300689,0
458.01,458,934,929,934,929,2023-11-02,2023-11-10,422.66,-5,-4.99999999999989,68344835,21359059,0.00135928340451769,99.9942877907306,-0.00538213132400418
475.01,475,907,904,907,904,2023-11-02,2023-11-24,422.66,-3,-2.99999999999989,67048283,15185362,0.00134828210291381,99.9962295827919,-0.00331858407079633
475.03,475,297,291,594,873,2023-11-02,2023-12-01,422.66,-6,279,49322029,10894195,0.00177000017578352,99.994172989112,0.319587628865979
470.07,470,106,124,636,868,2023-11-02,2023-12-08,422.66,18,232,58295535,11187777,0.00148896480665286,99.99911657042,0.267281105990784
458.01,458,839,838,839,838,2023-11-02,2023-11-03,422.66,-1,-0.999999999999886,86263600,31048392,0.000971441024951428,99.9931720911253,-0.00119331742243423
482.01,482,804,804,804,804,2023-11-02,2023-11-03,422.66,0,0,86263600,31048392,0.000932026949953399,99.9941041180753,0
465.01,465,777,777,777,777,2023-11-02,2023-11-10,422.66,0,0,68344835,21359059,0.00113688181411222,99.9954246725448,0
466.01,466,728,728,728,728,2023-11-02,2023-11-10,422.66,0,0,68344835,21359059,0.00106518656457361,99.9964898591093,0
456.01,456,698,698,698,698,2023-11-02,2023-11-03,422.66,0,0,86263600,31048392,0.000809147774959543,99.9949132658503,0
462.01,462,674,664,1348,664,2023-11-02,2023-11-10,422.66,-10,-684,68344835,21359059,0.000971543789666037,99.997461402899,-1.03012048192771
475.01,475,650,650,650,650,2023-11-02,2023-11-03,422.66,0,0,86263600,31048392,0.000753504374962325,99.9956667702252,0
474.01,474,597,597,597,597,2023-11-02,2023-11-03,422.66,0,0,86263600,31048392,0.000692064787465397,99.9963588350127,0
475.01,475,595,595,595,595,2023-11-02,2023-11-10,422.66,0,0,68344835,21359059,0.000870585172968813,99.998331988072,0
480.01,480,595,593,595,593,2023-11-02,2023-11-24,422.66,-2,-2,67048283,15185362,0.00088443726441138,99.9971140200563,-0.00337268128161889
468.05,468,110,115,330,575,2023-11-02,2023-12-01,422.66,5,245,49322029,10894195,0.00116580767591698,99.995338796788,0.426086956521739
500.01,500,574,572,574,572,2023-11-02,2023-12-01,422.66,-2,-2,49322029,10894195,0.00115972520108611,99.996498521989,-0.0034965034965035
462.04,462,142,142,568,568,2023-11-02,2023-11-24,422.66,0,0,67048283,15185362,0.000847150701830799,99.9979611707581,0
464.01,464,540,540,540,540,2023-11-02,2023-11-10,422.66,0,0,68344835,21359059,0.00079011091328262,99.9991220989853,0
452.51,452.5,504,504,504,504,2023-11-02,2023-11-03,422.66,0,0,86263600,31048392,0.000584255699970787,99.9969430907127,0
462.01,462,473,473,473,473,2023-11-02,2023-11-03,422.66,0,0,86263600,31048392,0.000548319337472584,99.9974914100501,0
464.01,464,445,445,445,445,2023-11-02,2023-11-03,422.66,0,0,86263600,31048392,0.000515860687474207,99.9980072707376,0
492.01,492,436,436,436,436,2023-11-02,2023-11-17,422.66,0,0,436972766,114712146,9.97773852112331e-05,100,0
485.01,485,410,410,410,410,2023-11-02,2023-11-03,422.66,0,0,86263600,31048392,0.000475287374976236,99.9984825581126,0
480.02,480,203,198,406,396,2023-11-02,2023-12-01,422.66,-5,-10.0000000000001,49322029,10894195,0.000802886677675,99.9973014086667,-0.0252525252525254
472.01,472,395,395,395,395,2023-11-02,2023-11-03,422.66,0,0,86263600,31048392,0.000457898812477105,99.9989404569251,0
495.02,495,176,176,352,352,2023-11-02,2023-11-24,422.66,0,0,67048283,15185362,0.000524994801134579,99.9984861655592,0
535.01,535,336,336,336,336,2023-11-02,2023-12-29,422.66,0,0,119134666,22518358,0.000282033778480564,99.9997951897561,0
505.01,505,5,303,5,303,2023-11-02,2023-12-01,422.66,298,298,49322029,10894195,0.000614329957917992,99.9979157386246,0.983498349834984
520.01,520,1,301,0,301,2023-11-02,2023-12-01,422.66,300,301,49322029,10894195,0.000610274974697412,99.9985260135993,1
448.58,448,0,5,0,290,2023-11-02,2023-12-08,422.66,5,290,58295535,11187777,0.000497465200379412,99.9996140356204,1
481.01,481,253,253,253,253,2023-11-02,2023-11-03,422.66,0,0,86263600,31048392,0.000293287087485336,99.9992337440126,0
490.03,490,70,70,210,210,2023-11-02,2023-11-10,422.66,0,0,68344835,21359059,0.000307265355165463,99.9994293643404,0
485.01,485,196,196,196,196,2023-11-02,2023-11-10,422.66,0,0,68344835,21359059,0.000286780998154433,99.9997161453386,0
472.04,472,46,48,138,192,2023-11-02,2023-12-01,422.66,2,54,49322029,10894195,0.000389278389175758,99.9989152919885,0.28125
464.03,464,63,63,189,189,2023-11-02,2023-11-24,422.66,0,0,67048283,15185362,0.000281886413109192,99.9987680519723,0
500.01,500,186,186,186,186,2023-11-02,2023-11-10,422.66,0,0,68344835,21359059,0.000272149314575125,99.9999882946531,0
467.01,467,185,185,185,185,2023-11-02,2023-11-03,422.66,0,0,86263600,31048392,0.000214458937489277,99.99944820295,0
495.01,495,176,176,176,176,2023-11-02,2023-11-03,422.66,0,0,86263600,31048392,0.000204025799989799,99.99965222875,0
485.01,485,168,167,168,167,2023-11-02,2023-11-24,422.66,-1,-1,67048283,15185362,0.000249074238038281,99.9990171262104,-0.00598802395209581
490.02,490,78,78,78,156,2023-11-02,2023-12-01,422.66,0,78,49322029,10894195,0.000316288691205303,99.9992315806797,0.5
530.01,530,148,148,148,148,2023-11-02,2023-11-24,422.66,0,0,67048283,15185362,0.000220736450477039,99.9992378626609,0
468.03,468,47,49,94,147,2023-11-02,2023-11-24,422.66,2,53,67048283,15185362,0.000219244987973816,99.9994571076488,0.360544217687075
485.02,485,76,73,76,146,2023-11-02,2023-12-01,422.66,-3,70,49322029,10894195,0.000296013775102399,99.9995275944548,0.479452054794521
466.04,466,35,36,140,144,2023-11-02,2023-12-01,422.66,1,4,49322029,10894195,0.000291958791881818,99.9998195532467,0.0277777777777778
490.01,490,138,139,138,139,2023-11-02,2023-11-24,422.66,1,1,67048283,15185362,0.00020731328794803,99.9996644209368,0.00719424460431655
498.04,498,30,33,90,132,2023-11-02,2023-12-29,422.66,3,42,119134666,22518358,0.000110798984403079,99.9999059887405,0.318181818181818
500.01,500,129,129,129,129,2023-11-02,2023-11-03,422.66,0,0,86263600,31048392,0.000149541637492523,99.9998017703875,0
476.01,476,118,118,118,118,2023-11-02,2023-11-03,422.66,0,0,86263600,31048392,0.000136790024993161,99.9999385604125,0
497.04,497,28,28,112,112,2023-11-02,2023-12-29,422.66,0,0,119134666,22518358,9.40112594935214e-05,100,0
480.04,480,3,27,9,108,2023-11-02,2023-12-08,422.66,24,99,58295535,11187777,0.000185262902210264,99.9997992985226,0.916666666666667
472.02,472,44,44,88,88,2023-11-02,2023-11-24,422.66,0,0,67048283,15185362,0.000131248700283645,99.9997956696371,0
540.01,540,78,78,78,78,2023-11-02,2023-12-01,422.66,0,0,49322029,10894195,0.000158144345602652,99.9999776975923,0
458.21,458,0,3,0,63,2023-11-02,2023-12-08,422.66,3,63,58295535,11187777,0.00010807002628932,99.9999073685489,1
510.01,510,62,62,62,62,2023-11-02,2023-11-24,422.66,0,0,67048283,15185362,9.24706751998407e-05,99.9998881403123,0
469.01,469,50,50,50,50,2023-11-02,2023-11-03,422.66,0,0,86263600,31048392,5.79618749971019e-05,99.9999965222875,0
462.14,462,0,3,0,42,2023-11-02,2023-12-08,422.66,3,42,58295535,11187777,7.20466841928803e-05,99.9999794152331,1
515.01,515,40,40,40,40,2023-11-02,2023-11-24,422.66,0,0,67048283,15185362,5.96585001289295e-05,99.9999477988124,0
505.01,505,20,33,20,33,2023-11-02,2023-11-24,422.66,13,13,67048283,15185362,4.92182626063668e-05,99.999997017075,0.393939393939394
510.01,510,5,5,5,5,2023-11-02,2023-12-01,422.66,0,0,49322029,10894195,1.0137458051452e-05,99.9999878350503,0
468.02,468,2,2,4,4,2023-11-02,2023-11-10,422.66,0,0,68344835,21359059,5.85267343172311e-06,99.9999941473266,0
475.04,475,1,1,4,4,2023-11-02,2023-12-08,422.66,0,0,58295535,11187777,6.8615889707505e-06,99.9999862768221,0
495.02,495,2,2,4,4,2023-11-02,2023-12-08,422.66,0,0,58295535,11187777,6.8615889707505e-06,99.999993138411,0
463.01,463,3,3,3,3,2023-11-02,2023-11-03,422.66,0,0,86263600,31048392,3.47771249982611e-06,100,0
495.01,495,3,3,6,3,2023-11-02,2023-12-01,422.66,0,-3,49322029,10894195,6.08247483087121e-06,99.9999939175252,-1
525.01,525,3,3,3,3,2023-11-02,2023-12-01,422.66,0,0,49322029,10894195,6.08247483087121e-06,100,0
525.01,525,2,2,2,2,2023-11-02,2023-11-10,422.66,0,0,68344835,21359059,2.92633671586156e-06,99.9999970736633,0
520.01,520,2,2,2,2,2023-11-02,2023-11-24,422.66,0,0,67048283,15185362,2.98292500644647e-06,100,0
505.02,505,0,1,0,2,2023-11-02,2023-12-08,422.66,1,2,58295535,11187777,3.43079448537525e-06,99.9999965692055,1
515.02,515,0,1,0,2,2023-11-02,2023-12-08,422.66,1,2,58295535,11187777,3.43079448537525e-06,100,1
469.01,469,0,1,0,1,2023-11-02,2023-11-10,422.66,1,1,68344835,21359059,1.46316835793078e-06,99.9999985368316,1
473.01,473,0,1,0,1,2023-11-02,2023-11-10,422.66,1,1,68344835,21359059,1.46316835793078e-06,100,1
305,305,1,1,0,0,2023-11-02,2023-11-03,422.66,0,0,86263600,31048392,0,100,
310,310,0,0,0,0,2023-11-02,2023-11-03,422.66,0,0,86263600,31048392,0,100,
315,315,0,0,0,0,2023-11-02,2023-11-03,422.66,0,0,86263600,31048392,0,100,
335,335,27,27,0,0,2023-11-02,2023-11-03,422.66,0,0,86263600,31048392,0,100,
345,345,1,1,0,0,2023-11-02,2023-11-03,422.66,0,0,86263600,31048392,0,100,
354,354,0,0,0,0,2023-11-02,2023-11-03,422.66,0,0,86263600,31048392,0,100,
357,357,0,0,0,0,2023-11-02,2023-11-03,422.66,0,0,86263600,31048392,0,100,
358,358,0,0,0,0,2023-11-02,2023-11-03,422.66,0,0,86263600,31048392,0,100,
359,359,0,0,0,0,2023-11-02,2023-11-03,422.66,0,0,86263600,31048392,0,100,
361,361,0,0,0,0,2023-11-02,2023-11-03,422.66,0,0,86263600,31048392,0,100,
362,362,0,0,0,0,2023-11-02,2023-11-03,422.66,0,0,86263600,31048392,0,100,
363,363,0,0,0,0,2023-11-02,2023-11-03,422.66,0,0,86263600,31048392,0,100,
366,366,0,0,0,0,2023-11-02,2023-11-03,422.66,0,0,86263600,31048392,0,100,
367,367,0,0,0,0,2023-11-02,2023-11-03,422.66,0,0,86263600,31048392,0,100,
368,368,0,0,0,0,2023-11-02,2023-11-03,422.66,0,0,86263600,31048392,0,100,
369,369,0,0,0,0,2023-11-02,2023-11-03,422.66,0,0,86263600,31048392,0,100,
371,371,0,0,0,0,2023-11-02,2023-11-03,422.66,0,0,86263600,31048392,0,100,
372,372,0,0,0,0,2023-11-02,2023-11-03,422.66,0,0,86263600,31048392,0,100,
373,373,0,0,0,0,2023-11-02,2023-11-03,422.66,0,0,86263600,31048392,0,100,
374,374,0,0,0,0,2023-11-02,2023-11-03,422.66,0,0,86263600,31048392,0,100,
376,376,0,0,0,0,2023-11-02,2023-11-03,422.66,0,0,86263600,31048392,0,100,
377,377,0,0,0,0,2023-11-02,2023-11-03,422.66,0,0,86263600,31048392,0,100,
379,379,0,0,0,0,2023-11-02,2023-11-03,422.66,0,0,86263600,31048392,0,100,
381,381,0,0,0,0,2023-11-02,2023-11-03,422.66,0,0,86263600,31048392,0,100,
382,382,0,0,0,0,2023-11-02,2023-11-03,422.66,0,0,86263600,31048392,0,100,
383,383,0,0,0,0,2023-11-02,2023-11-03,422.66,0,0,86263600,31048392,0,100,
384,384,0,0,0,0,2023-11-02,2023-11-03,422.66,0,0,86263600,31048392,0,100,
386,386,1,1,0,0,2023-11-02,2023-11-03,422.66,0,0,86263600,31048392,0,100,
387,387,0,0,0,0,2023-11-02,2023-11-03,422.66,0,0,86263600,31048392,0,100,
389,389,0,0,0,0,2023-11-02,2023-11-03,422.66,0,0,86263600,31048392,0,100,
391,391,0,0,0,0,2023-11-02,2023-11-03,422.66,0,0,86263600,31048392,0,100,
394,394,2,2,0,0,2023-11-02,2023-11-03,422.66,0,0,86263600,31048392,0,100,
471,471,0,0,0,0,2023-11-02,2023-11-03,422.66,0,0,86263600,31048392,0,100,
473,473,0,0,0,0,2023-11-02,2023-11-03,422.66,0,0,86263600,31048392,0,100,
477,477,0,0,0,0,2023-11-02,2023-11-03,422.66,0,0,86263600,31048392,0,100,
478,478,0,0,0,0,2023-11-02,2023-11-03,422.66,0,0,86263600,31048392,0,100,
479,479,0,0,0,0,2023-11-02,2023-11-03,422.66,0,0,86263600,31048392,0,100,
483,483,0,0,0,0,2023-11-02,2023-11-03,422.66,0,0,86263600,31048392,0,100,
484,484,0,0,0,0,2023-11-02,2023-11-03,422.66,0,0,86263600,31048392,0,100,
486,486,0,0,0,0,2023-11-02,2023-11-03,422.66,0,0,86263600,31048392,0,100,
487,487,0,0,0,0,2023-11-02,2023-11-03,422.66,0,0,86263600,31048392,0,100,
488,488,0,0,0,0,2023-11-02,2023-11-03,422.66,0,0,86263600,31048392,0,100,
489,489,0,0,0,0,2023-11-02,2023-11-03,422.66,0,0,86263600,31048392,0,100,
505,505,0,0,0,0,2023-11-02,2023-11-03,422.66,0,0,86263600,31048392,0,100,
510,510,0,0,0,0,2023-11-02,2023-11-03,422.66,0,0,86263600,31048392,0,100,
515,515,0,0,0,0,2023-11-02,2023-11-03,422.66,0,0,86263600,31048392,0,100,
520,520,1,1,0,0,2023-11-02,2023-11-03,422.66,0,0,86263600,31048392,0,100,
525,525,0,0,0,0,2023-11-02,2023-11-03,422.66,0,0,86263600,31048392,0,100,
530,530,0,0,0,0,2023-11-02,2023-11-03,422.66,0,0,86263600,31048392,0,100,
540,540,40,40,0,0,2023-11-02,2023-11-03,422.66,0,0,86263600,31048392,0,100,
305,305,0,0,0,0,2023-11-02,2023-11-10,422.66,0,0,68344835,21359059,0,100,
310,310,0,0,0,0,2023-11-02,2023-11-10,422.66,0,0,68344835,21359059,0,100,
315,315,0,0,0,0,2023-11-02,2023-11-10,422.66,0,0,68344835,21359059,0,100,
320,320,4,4,0,0,2023-11-02,2023-11-10,422.66,0,0,68344835,21359059,0,100,
325,325,0,0,0,0,2023-11-02,2023-11-10,422.66,0,0,68344835,21359059,0,100,
330,330,3,3,0,0,2023-11-02,2023-11-10,422.66,0,0,68344835,21359059,0,100,
335,335,0,0,0,0,2023-11-02,2023-11-10,422.66,0,0,68344835,21359059,0,100,
340,340,0,0,0,0,2023-11-02,2023-11-10,422.66,0,0,68344835,21359059,0,100,
354,354,0,0,0,0,2023-11-02,2023-11-10,422.66,0,0,68344835,21359059,0,100,
356,356,0,0,0,0,2023-11-02,2023-11-10,422.66,0,0,68344835,21359059,0,100,
357,357,0,0,0,0,2023-11-02,2023-11-10,422.66,0,0,68344835,21359059,0,100,
358,358,0,0,0,0,2023-11-02,2023-11-10,422.66,0,0,68344835,21359059,0,100,
359,359,0,0,0,0,2023-11-02,2023-11-10,422.66,0,0,68344835,21359059,0,100,
361,361,0,0,0,0,2023-11-02,2023-11-10,422.66,0,0,68344835,21359059,0,100,
362,362,0,0,0,0,2023-11-02,2023-11-10,422.66,0,0,68344835,21359059,0,100,
363,363,0,0,0,0,2023-11-02,2023-11-10,422.66,0,0,68344835,21359059,0,100,
364,364,0,0,0,0,2023-11-02,2023-11-10,422.66,0,0,68344835,21359059,0,100,
365,365,0,0,0,0,2023-11-02,2023-11-10,422.66,0,0,68344835,21359059,0,100,
366,366,0,0,0,0,2023-11-02,2023-11-10,422.66,0,0,68344835,21359059,0,100,
367,367,0,0,0,0,2023-11-02,2023-11-10,422.66,0,0,68344835,21359059,0,100,
368,368,0,0,0,0,2023-11-02,2023-11-10,422.66,0,0,68344835,21359059,0,100,
369,369,0,0,0,0,2023-11-02,2023-11-10,422.66,0,0,68344835,21359059,0,100,
370,370,0,0,0,0,2023-11-02,2023-11-10,422.66,0,0,68344835,21359059,0,100,
371,371,0,0,0,0,2023-11-02,2023-11-10,422.66,0,0,68344835,21359059,0,100,
372,372,0,0,0,0,2023-11-02,2023-11-10,422.66,0,0,68344835,21359059,0,100,
373,373,0,0,0,0,2023-11-02,2023-11-10,422.66,0,0,68344835,21359059,0,100,
374,374,0,0,0,0,2023-11-02,2023-11-10,422.66,0,0,68344835,21359059,0,100,
376,376,0,0,0,0,2023-11-02,2023-11-10,422.66,0,0,68344835,21359059,0,100,
377,377,0,0,0,0,2023-11-02,2023-11-10,422.66,0,0,68344835,21359059,0,100,
378,378,0,0,0,0,2023-11-02,2023-11-10,422.66,0,0,68344835,21359059,0,100,
379,379,0,0,0,0,2023-11-02,2023-11-10,422.66,0,0,68344835,21359059,0,100,
381,381,0,0,0,0,2023-11-02,2023-11-10,422.66,0,0,68344835,21359059,0,100,
382,382,0,0,0,0,2023-11-02,2023-11-10,422.66,0,0,68344835,21359059,0,100,
383,383,0,0,0,0,2023-11-02,2023-11-10,422.66,0,0,68344835,21359059,0,100,
384,384,0,0,0,0,2023-11-02,2023-11-10,422.66,0,0,68344835,21359059,0,100,
387,387,0,0,0,0,2023-11-02,2023-11-10,422.66,0,0,68344835,21359059,0,100,
389,389,0,0,0,0,2023-11-02,2023-11-10,422.66,0,0,68344835,21359059,0,100,
391,391,0,0,0,0,2023-11-02,2023-11-10,422.66,0,0,68344835,21359059,0,100,
393,393,0,0,0,0,2023-11-02,2023-11-10,422.66,0,0,68344835,21359059,0,100,
397,397,0,0,0,0,2023-11-02,2023-11-10,422.66,0,0,68344835,21359059,0,100,
453,453,0,0,0,0,2023-11-02,2023-11-10,422.66,0,0,68344835,21359059,0,100,
457,457,0,0,0,0,2023-11-02,2023-11-10,422.66,0,0,68344835,21359059,0,100,
459,459,0,0,0,0,2023-11-02,2023-11-10,422.66,0,0,68344835,21359059,0,100,
461,461,0,0,0,0,2023-11-02,2023-11-10,422.66,0,0,68344835,21359059,0,100,
463,463,0,0,0,0,2023-11-02,2023-11-10,422.66,0,0,68344835,21359059,0,100,
467,467,0,0,0,0,2023-11-02,2023-11-10,422.66,0,0,68344835,21359059,0,100,
471,471,0,0,0,0,2023-11-02,2023-11-10,422.66,0,0,68344835,21359059,0,100,
472,472,0,0,0,0,2023-11-02,2023-11-10,422.66,0,0,68344835,21359059,0,100,
474,474,0,0,0,0,2023-11-02,2023-11-10,422.66,0,0,68344835,21359059,0,100,
476,476,0,0,0,0,2023-11-02,2023-11-10,422.66,0,0,68344835,21359059,0,100,
477,477,0,0,0,0,2023-11-02,2023-11-10,422.66,0,0,68344835,21359059,0,100,
478,478,0,0,0,0,2023-11-02,2023-11-10,422.66,0,0,68344835,21359059,0,100,
495,495,8068,8068,0,0,2023-11-02,2023-11-10,422.66,0,0,68344835,21359059,0,100,
510,510,102,102,0,0,2023-11-02,2023-11-10,422.66,0,0,68344835,21359059,0,100,
515,515,45,45,0,0,2023-11-02,2023-11-10,422.66,0,0,68344835,21359059,0,100,
520,520,492,492,0,0,2023-11-02,2023-11-10,422.66,0,0,68344835,21359059,0,100,
530,530,0,0,0,0,2023-11-02,2023-11-10,422.66,0,0,68344835,21359059,0,100,
540,540,5,5,0,0,2023-11-02,2023-11-10,422.66,0,0,68344835,21359059,0,100,
215,215,0,0,0,0,2023-11-02,2023-11-17,422.66,0,0,436972766,114712146,0,100,
245,245,0,0,0,0,2023-11-02,2023-11-17,422.66,0,0,436972766,114712146,0,100,
255,255,0,0,0,0,2023-11-02,2023-11-17,422.66,0,0,436972766,114712146,0,100,
260,260,4,4,0,0,2023-11-02,2023-11-17,422.66,0,0,436972766,114712146,0,100,
265,265,2,2,0,0,2023-11-02,2023-11-17,422.66,0,0,436972766,114712146,0,100,
270,270,6,6,0,0,2023-11-02,2023-11-17,422.66,0,0,436972766,114712146,0,100,
275,275,0,0,0,0,2023-11-02,2023-11-17,422.66,0,0,436972766,114712146,0,100,
290,290,0,0,0,0,2023-11-02,2023-11-17,422.66,0,0,436972766,114712146,0,100,
295,295,0,0,0,0,2023-11-02,2023-11-17,422.66,0,0,436972766,114712146,0,100,
305,305,1,1,0,0,2023-11-02,2023-11-17,422.66,0,0,436972766,114712146,0,100,
315,315,2,2,0,0,2023-11-02,2023-11-17,422.66,0,0,436972766,114712146,0,100,
325,325,4,4,0,0,2023-11-02,2023-11-17,422.66,0,0,436972766,114712146,0,100,
378,378,0,0,0,0,2023-11-02,2023-11-17,422.66,0,0,436972766,114712146,0,100,
388,388,125,125,0,0,2023-11-02,2023-11-17,422.66,0,0,436972766,114712146,0,100,
510,510,4828,4828,0,0,2023-11-02,2023-11-17,422.66,0,0,436972766,114712146,0,100,
525,525,2621,2621,0,0,2023-11-02,2023-11-17,422.66,0,0,436972766,114712146,0,100,
530,530,6047,6047,0,0,2023-11-02,2023-11-17,422.66,0,0,436972766,114712146,0,100,
535,535,253,253,0,0,2023-11-02,2023-11-17,422.66,0,0,436972766,114712146,0,100,
540,540,5144,5144,0,0,2023-11-02,2023-11-17,422.66,0,0,436972766,114712146,0,100,
545,545,300,300,0,0,2023-11-02,2023-11-17,422.66,0,0,436972766,114712146,0,100,
550,550,1836,1836,0,0,2023-11-02,2023-11-17,422.66,0,0,436972766,114712146,0,100,
300,300,0,0,0,0,2023-11-02,2023-11-24,422.66,0,0,67048283,15185362,0,100,
420.28,315,0,0,0,0,2023-11-02,2023-11-24,422.66,0,0,67048283,15185362,0,100,
325,325,0,0,0,0,2023-11-02,2023-11-24,422.66,0,0,67048283,15185362,0,100,
330,330,2,2,0,0,2023-11-02,2023-11-24,422.66,0,0,67048283,15185362,0,100,
335,335,1,1,0,0,2023-11-02,2023-11-24,422.66,0,0,67048283,15185362,0,100,
340,340,0,0,0,0,2023-11-02,2023-11-24,422.66,0,0,67048283,15185362,0,100,
345,345,1,1,0,0,2023-11-02,2023-11-24,422.66,0,0,67048283,15185362,0,100,
355,355,65,65,0,0,2023-11-02,2023-11-24,422.66,0,0,67048283,15185362,0,100,
360,360,2,2,0,0,2023-11-02,2023-11-24,422.66,0,0,67048283,15185362,0,100,
370,370,1,1,0,0,2023-11-02,2023-11-24,422.66,0,0,67048283,15185362,0,100,
384,384,0,0,0,0,2023-11-02,2023-11-24,422.66,0,0,67048283,15185362,0,100,
392,392,0,0,0,0,2023-11-02,2023-11-24,422.66,0,0,67048283,15185362,0,100,
394,394,0,0,0,0,2023-11-02,2023-11-24,422.66,0,0,67048283,15185362,0,100,
525,525,141,141,0,0,2023-11-02,2023-11-24,422.66,0,0,67048283,15185362,0,100,
540,540,4,4,0,0,2023-11-02,2023-11-24,422.66,0,0,67048283,15185362,0,100,
285,285,0,0,0,0,2023-11-02,2023-12-01,422.66,0,0,49322029,10894195,0,100,
290,290,0,0,0,0,2023-11-02,2023-12-01,422.66,0,0,49322029,10894195,0,100,
295,295,0,0,0,0,2023-11-02,2023-12-01,422.66,0,0,49322029,10894195,0,100,
305,305,0,0,0,0,2023-11-02,2023-12-01,422.66,0,0,49322029,10894195,0,100,
315,315,0,0,0,0,2023-11-02,2023-12-01,422.66,0,0,49322029,10894195,0,100,
320,320,0,0,0,0,2023-11-02,2023-12-01,422.66,0,0,49322029,10894195,0,100,
325,325,0,0,0,0,2023-11-02,2023-12-01,422.66,0,0,49322029,10894195,0,100,
330,330,0,0,0,0,2023-11-02,2023-12-01,422.66,0,0,49322029,10894195,0,100,
335,335,0,0,0,0,2023-11-02,2023-12-01,422.66,0,0,49322029,10894195,0,100,
355,355,0,0,0,0,2023-11-02,2023-12-01,422.66,0,0,49322029,10894195,0,100,
382,382,0,0,0,0,2023-11-02,2023-12-01,422.66,0,0,49322029,10894195,0,100,
384,384,0,0,0,0,2023-11-02,2023-12-01,422.66,0,0,49322029,10894195,0,100,
386,386,0,0,0,0,2023-11-02,2023-12-01,422.66,0,0,49322029,10894195,0,100,
388,388,0,0,0,0,2023-11-02,2023-12-01,422.66,0,0,49322029,10894195,0,100,
515,515,2,2,0,0,2023-11-02,2023-12-01,422.66,0,0,49322029,10894195,0,100,
530,530,0,0,0,0,2023-11-02,2023-12-01,422.66,0,0,49322029,10894195,0,100,
300,300,0,0,0,0,2023-11-02,2023-12-08,422.66,0,0,58295535,11187777,0,100,
305,305,0,0,0,0,2023-11-02,2023-12-08,422.66,0,0,58295535,11187777,0,100,
310,310,0,0,0,0,2023-11-02,2023-12-08,422.66,0,0,58295535,11187777,0,100,
315,315,0,0,0,0,2023-11-02,2023-12-08,422.66,0,0,58295535,11187777,0,100,
320,320,0,0,0,0,2023-11-02,2023-12-08,422.66,0,0,58295535,11187777,0,100,
335,335,0,0,0,0,2023-11-02,2023-12-08,422.66,0,0,58295535,11187777,0,100,
345,345,0,0,0,0,2023-11-02,2023-12-08,422.66,0,0,58295535,11187777,0,100,
350,350,0,0,0,0,2023-11-02,2023-12-08,422.66,0,0,58295535,11187777,0,100,
360,360,0,0,0,0,2023-11-02,2023-12-08,422.66,0,0,58295535,11187777,0,100,
424.94,365,0,0,0,0,2023-11-02,2023-12-08,422.66,0,0,58295535,11187777,0,100,
380,380,0,0,0,0,2023-11-02,2023-12-08,422.66,0,0,58295535,11187777,0,100,
386,386,0,0,0,0,2023-11-02,2023-12-08,422.66,0,0,58295535,11187777,0,100,
388,388,0,0,0,0,2023-11-02,2023-12-08,422.66,0,0,58295535,11187777,0,100,
392,392,0,0,0,0,2023-11-02,2023-12-08,422.66,0,0,58295535,11187777,0,100,
396,396,0,0,0,0,2023-11-02,2023-12-08,422.66,0,0,58295535,11187777,0,100,
456,456,0,0,0,0,2023-11-02,2023-12-08,422.66,0,0,58295535,11187777,0,100,
485,485,0,0,0,0,2023-11-02,2023-12-08,422.66,0,0,58295535,11187777,0,100,
490,490,0,0,0,0,2023-11-02,2023-12-08,422.66,0,0,58295535,11187777,0,100,
500,500,0,0,0,0,2023-11-02,2023-12-08,422.66,0,0,58295535,11187777,0,100,
510,510,0,0,0,0,2023-11-02,2023-12-08,422.66,0,0,58295535,11187777,0,100,
520,520,0,0,0,0,2023-11-02,2023-12-08,422.66,0,0,58295535,11187777,0,100,
525,525,0,0,0,0,2023-11-02,2023-12-08,422.66,0,0,58295535,11187777,0,100,
155,155,11,11,0,0,2023-11-02,2023-12-15,422.66,0,0,661780848,102231664,0,100,
160,160,0,0,0,0,2023-11-02,2023-12-15,422.66,0,0,661780848,102231664,0,100,
165,165,1,1,0,0,2023-11-02,2023-12-15,422.66,0,0,661780848,102231664,0,100,
180,180,17,17,0,0,2023-11-02,2023-12-15,422.66,0,0,661780848,102231664,0,100,
185,185,33,33,0,0,2023-11-02,2023-12-15,422.66,0,0,661780848,102231664,0,100,
190,190,8,8,0,0,2023-11-02,2023-12-15,422.66,0,0,661780848,102231664,0,100,
195,195,42,42,0,0,2023-11-02,2023-12-15,422.66,0,0,661780848,102231664,0,100,
205,205,13,13,0,0,2023-11-02,2023-12-15,422.66,0,0,661780848,102231664,0,100,
210,210,32,32,0,0,2023-11-02,2023-12-15,422.66,0,0,661780848,102231664,0,100,
215,215,6,6,0,0,2023-11-02,2023-12-15,422.66,0,0,661780848,102231664,0,100,
230,230,9,9,0,0,2023-11-02,2023-12-15,422.66,0,0,661780848,102231664,0,100,
245,245,21,21,0,0,2023-11-02,2023-12-15,422.66,0,0,661780848,102231664,0,100,
255,255,85,85,0,0,2023-11-02,2023-12-15,422.66,0,0,661780848,102231664,0,100,
265,265,761,761,0,0,2023-11-02,2023-12-15,422.66,0,0,661780848,102231664,0,100,
270,270,104,104,0,0,2023-11-02,2023-12-15,422.66,0,0,661780848,102231664,0,100,
275,275,44,44,0,0,2023-11-02,2023-12-15,422.66,0,0,661780848,102231664,0,100,
285,285,11,11,0,0,2023-11-02,2023-12-15,422.66,0,0,661780848,102231664,0,100,
295,295,44,44,0,0,2023-11-02,2023-12-15,422.66,0,0,661780848,102231664,0,100,
305,305,85,85,0,0,2023-11-02,2023-12-15,422.66,0,0,661780848,102231664,0,100,
345,345,483,483,0,0,2023-11-02,2023-12-15,422.66,0,0,661780848,102231664,0,100,
346,346,37,37,0,0,2023-11-02,2023-12-15,422.66,0,0,661780848,102231664,0,100,
347,347,77,77,0,0,2023-11-02,2023-12-15,422.66,0,0,661780848,102231664,0,100,
349,349,54,54,0,0,2023-11-02,2023-12-15,422.66,0,0,661780848,102231664,0,100,
351,351,105,105,0,0,2023-11-02,2023-12-15,422.66,0,0,661780848,102231664,0,100,
352,352,43,43,0,0,2023-11-02,2023-12-15,422.66,0,0,661780848,102231664,0,100,
353,353,2,2,0,0,2023-11-02,2023-12-15,422.66,0,0,661780848,102231664,0,100,
354,354,13,13,0,0,2023-11-02,2023-12-15,422.66,0,0,661780848,102231664,0,100,
356,356,0,0,0,0,2023-11-02,2023-12-15,422.66,0,0,661780848,102231664,0,100,
357,357,6,6,0,0,2023-11-02,2023-12-15,422.66,0,0,661780848,102231664,0,100,
358,358,3,3,0,0,2023-11-02,2023-12-15,422.66,0,0,661780848,102231664,0,100,
359,359,5,5,0,0,2023-11-02,2023-12-15,422.66,0,0,661780848,102231664,0,100,
361,361,3,3,0,0,2023-11-02,2023-12-15,422.66,0,0,661780848,102231664,0,100,
363,363,166,166,0,0,2023-11-02,2023-12-15,422.66,0,0,661780848,102231664,0,100,
364,364,85,85,0,0,2023-11-02,2023-12-15,422.66,0,0,661780848,102231664,0,100,
366,366,45,45,0,0,2023-11-02,2023-12-15,422.66,0,0,661780848,102231664,0,100,
367,367,95,95,0,0,2023-11-02,2023-12-15,422.66,0,0,661780848,102231664,0,100,
369,369,83,83,0,0,2023-11-02,2023-12-15,422.66,0,0,661780848,102231664,0,100,
372,372,48,48,0,0,2023-11-02,2023-12-15,422.66,0,0,661780848,102231664,0,100,
373,373,129,129,0,0,2023-11-02,2023-12-15,422.66,0,0,661780848,102231664,0,100,
374,374,91,91,0,0,2023-11-02,2023-12-15,422.66,0,0,661780848,102231664,0,100,
382,382,25,25,0,0,2023-11-02,2023-12-15,422.66,0,0,661780848,102231664,0,100,
525,525,10479,10479,0,0,2023-11-02,2023-12-15,422.66,0,0,661780848,102231664,0,100,
570,570,6833,6833,0,0,2023-11-02,2023-12-15,422.66,0,0,661780848,102231664,0,100,
575,575,6394,6394,0,0,2023-11-02,2023-12-15,422.66,0,0,661780848,102231664,0,100,
580,580,5345,5345,0,0,2023-11-02,2023-12-15,422.66,0,0,661780848,102231664,0,100,
585,585,1210,1210,0,0,2023-11-02,2023-12-15,422.66,0,0,661780848,102231664,0,100,
595,595,2687,2687,0,0,2023-11-02,2023-12-15,422.66,0,0,661780848,102231664,0,100,
610,610,765,765,0,0,2023-11-02,2023-12-15,422.66,0,0,661780848,102231664,0,100,
615,615,269,269,0,0,2023-11-02,2023-12-15,422.66,0,0,661780848,102231664,0,100,
620,620,989,989,0,0,2023-11-02,2023-12-15,422.66,0,0,661780848,102231664,0,100,
625,625,1996,1996,0,0,2023-11-02,2023-12-15,422.66,0,0,661780848,102231664,0,100,
630,630,7892,7892,0,0,2023-11-02,2023-12-15,422.66,0,0,661780848,102231664,0,100,
635,635,1444,1444,0,0,2023-11-02,2023-12-15,422.66,0,0,661780848,102231664,0,100,
640,640,104,104,0,0,2023-11-02,2023-12-15,422.66,0,0,661780848,102231664,0,100,
645,645,472,472,0,0,2023-11-02,2023-12-15,422.66,0,0,661780848,102231664,0,100,
650,650,5433,5433,0,0,2023-11-02,2023-12-15,422.66,0,0,661780848,102231664,0,100,
655,655,2046,2046,0,0,2023-11-02,2023-12-15,422.66,0,0,661780848,102231664,0,100,
660,660,39312,39312,0,0,2023-11-02,2023-12-15,422.66,0,0,661780848,102231664,0,100,
665,665,3361,3361,0,0,2023-11-02,2023-12-15,422.66,0,0,661780848,102231664,0,100,
670,670,258,258,0,0,2023-11-02,2023-12-15,422.66,0,0,661780848,102231664,0,100,
675,675,220,220,0,0,2023-11-02,2023-12-15,422.66,0,0,661780848,102231664,0,100,
680,680,611,611,0,0,2023-11-02,2023-12-15,422.66,0,0,661780848,102231664,0,100,
685,685,212,212,0,0,2023-11-02,2023-12-15,422.66,0,0,661780848,102231664,0,100,
690,690,163,163,0,0,2023-11-02,2023-12-15,422.66,0,0,661780848,102231664,0,100,
695,695,1179,1179,0,0,2023-11-02,2023-12-15,422.66,0,0,661780848,102231664,0,100,
705,705,109,109,0,0,2023-11-02,2023-12-15,422.66,0,0,661780848,102231664,0,100,
710,710,173,173,0,0,2023-11-02,2023-12-15,422.66,0,0,661780848,102231664,0,100,
715,715,86,86,0,0,2023-11-02,2023-12-15,422.66,0,0,661780848,102231664,0,100,
720,720,1332,1332,0,0,2023-11-02,2023-12-15,422.66,0,0,661780848,102231664,0,100,
270,270,62,62,0,0,2023-11-02,2023-12-29,422.66,0,0,119134666,22518358,0,100,
275,275,59,59,0,0,2023-11-02,2023-12-29,422.66,0,0,119134666,22518358,0,100,
280,280,48,48,0,0,2023-11-02,2023-12-29,422.66,0,0,119134666,22518358,0,100,
285,285,17,17,0,0,2023-11-02,2023-12-29,422.66,0,0,119134666,22518358,0,100,
290,290,16,16,0,0,2023-11-02,2023-12-29,422.66,0,0,119134666,22518358,0,100,
295,295,7,7,0,0,2023-11-02,2023-12-29,422.66,0,0,119134666,22518358,0,100,
305,305,31,31,0,0,2023-11-02,2023-12-29,422.66,0,0,119134666,22518358,0,100,
310,310,66,66,0,0,2023-11-02,2023-12-29,422.66,0,0,119134666,22518358,0,100,
315,315,48,48,0,0,2023-11-02,2023-12-29,422.66,0,0,119134666,22518358,0,100,
320,320,80,80,0,0,2023-11-02,2023-12-29,422.66,0,0,119134666,22518358,0,100,
325,325,49,49,0,0,2023-11-02,2023-12-29,422.66,0,0,119134666,22518358,0,100,
326,326,6,6,0,0,2023-11-02,2023-12-29,422.66,0,0,119134666,22518358,0,100,
327,327,200,200,0,0,2023-11-02,2023-12-29,422.66,0,0,119134666,22518358,0,100,
328,328,24,24,0,0,2023-11-02,2023-12-29,422.66,0,0,119134666,22518358,0,100,
329,329,1,1,0,0,2023-11-02,2023-12-29,422.66,0,0,119134666,22518358,0,100,
330,330,9,9,0,0,2023-11-02,2023-12-29,422.66,0,0,119134666,22518358,0,100,
331,331,5,5,0,0,2023-11-02,2023-12-29,422.66,0,0,119134666,22518358,0,100,
332,332,52,52,0,0,2023-11-02,2023-12-29,422.66,0,0,119134666,22518358,0,100,
333,333,25,25,0,0,2023-11-02,2023-12-29,422.66,0,0,119134666,22518358,0,100,
334,334,9,9,0,0,2023-11-02,2023-12-29,422.66,0,0,119134666,22518358,0,100,
336,336,20,20,0,0,2023-11-02,2023-12-29,422.66,0,0,119134666,22518358,0,100,
337,337,5,5,0,0,2023-11-02,2023-12-29,422.66,0,0,119134666,22518358,0,100,
338,338,47,47,0,0,2023-11-02,2023-12-29,422.66,0,0,119134666,22518358,0,100,
339,339,25,25,0,0,2023-11-02,2023-12-29,422.66,0,0,119134666,22518358,0,100,
341,341,30,30,0,0,2023-11-02,2023-12-29,422.66,0,0,119134666,22518358,0,100,
343,343,8,8,0,0,2023-11-02,2023-12-29,422.66,0,0,119134666,22518358,0,100,
344,344,10,10,0,0,2023-11-02,2023-12-29,422.66,0,0,119134666,22518358,0,100,
345,345,56,56,0,0,2023-11-02,2023-12-29,422.66,0,0,119134666,22518358,0,100,
346,346,23,23,0,0,2023-11-02,2023-12-29,422.66,0,0,119134666,22518358,0,100,
347,347,142,142,0,0,2023-11-02,2023-12-29,422.66,0,0,119134666,22518358,0,100,
351,351,5,5,0,0,2023-11-02,2023-12-29,422.66,0,0,119134666,22518358,0,100,
352,352,6,6,0,0,2023-11-02,2023-12-29,422.66,0,0,119134666,22518358,0,100,
353,353,27,27,0,0,2023-11-02,2023-12-29,422.66,0,0,119134666,22518358,0,100,
354,354,4,4,0,0,2023-11-02,2023-12-29,422.66,0,0,119134666,22518358,0,100,
355,355,54,54,0,0,2023-11-02,2023-12-29,422.66,0,0,119134666,22518358,0,100,
357,357,117,117,0,0,2023-11-02,2023-12-29,422.66,0,0,119134666,22518358,0,100,
358,358,12,12,0,0,2023-11-02,2023-12-29,422.66,0,0,119134666,22518358,0,100,
361,361,15,15,0,0,2023-11-02,2023-12-29,422.66,0,0,119134666,22518358,0,100,
362,362,2,2,0,0,2023-11-02,2023-12-29,422.66,0,0,119134666,22518358,0,100,
363,363,24,24,0,0,2023-11-02,2023-12-29,422.66,0,0,119134666,22518358,0,100,
364,364,61,61,0,0,2023-11-02,2023-12-29,422.66,0,0,119134666,22518358,0,100,
365,365,70,70,0,0,2023-11-02,2023-12-29,422.66,0,0,119134666,22518358,0,100,
366,366,52,52,0,0,2023-11-02,2023-12-29,422.66,0,0,119134666,22518358,0,100,
367,367,372,372,0,0,2023-11-02,2023-12-29,422.66,0,0,119134666,22518358,0,100,
368,368,44,44,0,0,2023-11-02,2023-12-29,422.66,0,0,119134666,22518358,0,100,
369,369,37,37,0,0,2023-11-02,2023-12-29,422.66,0,0,119134666,22518358,0,100,
371,371,17,17,0,0,2023-11-02,2023-12-29,422.66,0,0,119134666,22518358,0,100,
372,372,4,4,0,0,2023-11-02,2023-12-29,422.66,0,0,119134666,22518358,0,100,
373,373,2,2,0,0,2023-11-02,2023-12-29,422.66,0,0,119134666,22518358,0,100,
374,374,9,9,0,0,2023-11-02,2023-12-29,422.66,0,0,119134666,22518358,0,100,
376,376,64,64,0,0,2023-11-02,2023-12-29,422.66,0,0,119134666,22518358,0,100,
377,377,141,141,0,0,2023-11-02,2023-12-29,422.66,0,0,119134666,22518358,0,100,
378,378,40,40,0,0,2023-11-02,2023-12-29,422.66,0,0,119134666,22518358,0,100,
381,381,20,20,0,0,2023-11-02,2023-12-29,422.66,0,0,119134666,22518358,0,100,
382,382,55,55,0,0,2023-11-02,2023-12-29,422.66,0,0,119134666,22518358,0,100,
383,383,5,5,0,0,2023-11-02,2023-12-29,422.66,0,0,119134666,22518358,0,100,
384,384,2,2,0,0,2023-11-02,2023-12-29,422.66,0,0,119134666,22518358,0,100,
388,388,9,9,0,0,2023-11-02,2023-12-29,422.66,0,0,119134666,22518358,0,100,
389,389,22,22,0,0,2023-11-02,2023-12-29,422.66,0,0,119134666,22518358,0,100,
393,393,886,886,0,0,2023-11-02,2023-12-29,422.66,0,0,119134666,22518358,0,100,
396,396,107,107,0,0,2023-11-02,2023-12-29,422.66,0,0,119134666,22518358,0,100,
401,401,1290,1290,0,0,2023-11-02,2023-12-29,422.66,0,0,119134666,22518358,0,100,
