Watch,strike,open_interest.yt,open_interest.td,OI_Dollar.yt,OI_Dollar.td,Date.td,expiry,stkClose,diff_oi,diff_oi_d,totalOI,totalOIdiff,OI_pct,cum_sep_OI,pct
551.49,500,23719,23693,97271619,121995257,2025-04-25,2025-05-16,546.69,-26,24723638,919215858,218728279,13.2716658376013,13.2716658376013,0.202660649339835
574.01,560,67770,67952,68651010,95200752,2025-04-25,2025-06-20,546.69,182,26549742,1174768001,197089681,8.10379172048967,8.10379172048967,0.278881641607201
547.49,490,14596,14595,74395812,83906655,2025-04-25,2025-05-16,546.69,-1,9510843,919215858,218728279,9.12806869787488,22.3997345354762,0.113350281929365
585.74,580,97533,98726,37550205,56668724,2025-04-25,2025-06-20,546.69,1193,19118519,1174768001,197089681,4.82382257192584,12.9276142924155,0.337373380773493
564.46,450,4267,4263,37046094,48794298,2025-04-25,2025-12-19,546.69,-4,11748204,1084502340,72118262,4.49923399888653,4.49923399888653,0.240770017841019
559.84,520,12013,12217,38922120,48672528,2025-04-25,2025-06-20,546.69,204,9750408,1174768001,197089681,4.14316085887327,17.0707751512888,0.20032672229394
556.28,500,8554,8556,41572440,48153168,2025-04-25,2025-06-20,546.69,2,6580728,1174768001,197089681,4.09895127880658,21.1697264300954,0.136662410248896
541.19,200,1358,1369,46150272,46708911,2025-04-25,2025-06-20,546.69,11,558639,1174768001,197089681,3.9760115154856,25.145737945581,0.0119600090869171
549.03,460,5159,5209,40508468,46375727,2025-04-25,2025-05-16,546.69,50,5867259,919215858,218728279,5.04514000671211,27.4448745421883,0.126515730955549
558.71,455,4435,4435,45995385,45995385,2025-04-25,2025-12-19,546.69,0,0,1084502340,72118262,4.24115129156844,8.74038529045498,0
556.02,530,15499,16441,28843639,42779482,2025-04-25,2025-05-16,546.69,942,13935843,919215858,218728279,4.65391035497127,32.0987848971596,0.325759975307789
579.16,570,37103,44986,23857229,41207176,2025-04-25,2025-06-20,546.69,7883,17349947,1174768001,197089681,3.50768628060376,28.6534242261847,0.421041883578724
547.75,210,1206,1206,38932092,40732650,2025-04-25,2025-12-19,546.69,0,1800558,1084502340,72118262,3.75588401220047,12.4962693026554,0.0442042931162102
558.25,400,2490,2489,37489440,39388425,2025-04-25,2025-12-19,546.69,-1,1898985,1084502340,72118262,3.63193545529833,16.1282047579538,0.0482117525643638
562.04,550,34428,31185,25924284,37546740,2025-04-25,2025-05-16,546.69,-3243,11622456,919215858,218728279,4.08464885295745,36.183433750117,0.309546341440029
565.65,540,14664,14512,28990728,37223280,2025-04-25,2025-06-20,546.69,-152,8232552,1174768001,197089681,3.16856434362481,31.8219885698095,0.221166753708969
562.98,530,11090,11239,29044710,37066222,2025-04-25,2025-06-20,546.69,149,8021512,1174768001,197089681,3.15519506561705,34.9771836354266,0.2164102939868
557.92,510,7679,7640,31023160,36610880,2025-04-25,2025-06-20,546.69,-39,5587720,1174768001,197089681,3.11643490194112,38.0936185373677,0.15262457498973
571.73,555,21482,21742,26379896,36374366,2025-04-25,2025-06-20,546.69,260,9994470,1174768001,197089681,3.09630207573214,41.1899206130998,0.274766850919134
563.84,485,4505,4503,32818925,35501652,2025-04-25,2025-09-19,546.69,-2,2682727,612220205,74276563,5.79883703772893,5.79883703772893,0.0755662581560993
575.39,530,7899,7678,30995676,34850442,2025-04-25,2025-09-19,546.69,-221,3854766,612220205,74276563,5.69246844768869,11.4913054854176,0.110608812364561
558.5,515,7999,7996,28348456,34782600,2025-04-25,2025-06-20,546.69,-3,6434144,1174768001,197089681,2.9608058757467,44.1507264888466,0.184981686245422
569.5,550,15794,17108,22790742,33360600,2025-04-25,2025-06-20,546.69,1314,10569858,1174768001,197089681,2.83976069927019,46.9904871881167,0.316836567687632
550.44,485,5046,5047,29887458,33027568,2025-04-25,2025-06-20,546.69,1,3140110,1174768001,197089681,2.81141195298867,49.8018991411054,0.0950754230526451
570.22,540,10561,10624,25673791,32105728,2025-04-25,2025-07-18,546.69,63,6431937,353688576,64788996,9.07740033989676,9.07740033989676,0.200336120707183
561.19,480,3936,3946,29338944,32037574,2025-04-25,2025-09-19,546.69,10,2698630,612220205,74276563,5.2330148104145,16.7243202958321,0.0842332818333873
608.97,600,34413,34973,23435253,31370781,2025-04-25,2025-09-19,546.69,560,7935528,612220205,74276563,5.12410089438326,21.8484211902154,0.252959210674417
573.91,550,12972,13039,24127920,31176249,2025-04-25,2025-07-18,546.69,67,7048329,353688576,64788996,8.81460446152493,17.8920048014217,0.226080084233353
567.7,470,3138,3138,28540110,30658260,2025-04-25,2025-12-19,546.69,0,2118150,1084502340,72118262,2.82694272471556,18.9551474826693,0.0690890481064483
553.32,520,8685,8633,21990420,28765156,2025-04-25,2025-05-16,546.69,-52,6774736,919215858,218728279,3.12931459457045,39.3127483446875,0.23551883396704
554.59,526,9795,9754,20941710,27886686,2025-04-25,2025-05-16,546.69,-41,6944976,919215858,218728279,3.03374727027392,42.3464956149614,0.249042715222598
593.94,575,14587,14722,21953435,27883468,2025-04-25,2025-09-19,546.69,135,5930033,612220205,74276563,4.55448346400132,26.4029046542167,0.212672003353385
549.59,390,1739,1739,27752701,27752701,2025-04-25,2025-12-19,546.69,0,0,1084502340,72118262,2.55902638255257,21.5141738652219,0
533.99,150,696,696,26725704,26725704,2025-04-25,2025-12-19,546.69,0,0,1084502340,72118262,2.46432884598479,23.9785027112067,0
561.57,525,7088,7238,20916688,26469366,2025-04-25,2025-06-20,546.69,150,5552678,1174768001,197089681,2.2531568767168,52.0550560178222,0.20977752168299
556,505,5255,5182,22543950,26428200,2025-04-25,2025-06-20,546.69,-73,3884250,1174768001,197089681,2.24965269546868,54.3047087132909,0.146973687197766
565,535,8659,8788,19638612,26364000,2025-04-25,2025-06-20,546.69,129,6725388,1174768001,197089681,2.24418778665729,56.5488964999482,0.255097405553027
558.38,540,14273,13971,17555790,25678698,2025-04-25,2025-05-16,546.69,-302,8122908,919215858,218728279,2.79354384245186,45.1400394574133,0.316328654980872
588.46,565,11142,10923,21938598,25625358,2025-04-25,2025-09-19,546.69,-219,3686760,612220205,74276563,4.18564395469437,30.5885486089111,0.143871550984771
546.61,175,671,671,24935031,24935031,2025-04-25,2025-12-19,546.69,0,0,1084502340,72118262,2.29921412617699,26.2777168373837,0
580.91,520,4009,3997,21885131,24345727,2025-04-25,2025-12-19,546.69,-12,2460596,1084502340,72118262,2.24487546979382,28.5225923071775,0.101068906260224
564,490,3220,3219,21908880,23820600,2025-04-25,2025-09-19,546.69,-1,1911720,612220205,74276563,3.89085492531237,34.4794035342234,0.0802549054179996
567.58,545,9921,10466,16984752,23632228,2025-04-25,2025-06-20,546.69,545,6647476,1174768001,197089681,2.011650639095,58.5605471390432,0.281288586078299
569,500,3408,3419,20526384,23591100,2025-04-25,2025-09-19,546.69,11,3064716,612220205,74276563,3.85336841341262,38.3327719476361,0.129909838879917
596.34,580,14390,14107,18994800,23050838,2025-04-25,2025-09-19,546.69,-283,4056038,612220205,74276563,3.76512206094211,42.0978940085782,0.1759605442544
543.06,410,1716,1716,22833096,22833096,2025-04-25,2025-12-19,546.69,0,0,1084502340,72118262,2.10539850010835,30.6279908072859,0
591.32,570,10456,10621,17733376,22643972,2025-04-25,2025-09-19,546.69,165,4910596,612220205,74276563,3.69866460059089,45.7965586091691,0.216861070133809
561.06,510,4057,4317,18029308,22042602,2025-04-25,2025-07-18,546.69,260,4013294,353688576,64788996,6.23220638033839,24.1242111817601,0.182069884490043
547.95,530,11981,11534,11190254,20703530,2025-04-25,2025-04-25,546.69,-447,9513276,247323203,111942542,8.37104232391815,8.37104232391815,0.459500191513235
587.98,540,4319,4315,18813564,20703370,2025-04-25,2025-12-19,546.69,-4,1889806,1084502340,72118262,1.90902031617562,32.5370111234615,0.0912801152662586
607.83,585,9024,9015,17912640,20581245,2025-04-25,2025-12-19,546.69,-9,2668605,1084502340,72118262,1.89775939072663,34.4347705141881,0.129661981090065
555.1,525,6854,6655,14729246,20031550,2025-04-25,2025-05-16,546.69,-199,5302304,919215858,218728279,2.17919978486707,47.3192392422804,0.26469763947373
564.98,495,2859,2858,19804293,20000284,2025-04-25,2025-09-19,546.69,-1,195991.000000004,612220205,74276563,3.26684481117378,49.0634034203429,0.00979941084836614
571.37,515,4721,3525,23095132,19870425,2025-04-25,2025-09-19,546.69,-1196,-3224707,612220205,74276563,3.24563365235553,52.3090370726984,-0.162286765381214
565.86,480,2298,2298,19730628,19730628,2025-04-25,2025-12-19,546.69,0,0,1084502340,72118262,1.81932553506524,36.2540960492533,0
552.73,470,2305,2308,16785010,19094084,2025-04-25,2025-06-20,546.69,3,2309074,1174768001,197089681,1.62534934418936,60.1858964832325,0.12093138377311
598.93,585,13168,13169,14879840,18344417,2025-04-25,2025-09-19,546.69,1,3464577,612220205,74276563,2.99637562598902,55.3054126986874,0.18886274772319
549.51,410,1301,1300,17095140,18136300,2025-04-25,2025-06-20,546.69,-1,1041160,1174768001,197089681,1.54381971457869,61.7297161978112,0.0574075197256331
558.63,430,1405,1406,17438860,18085378,2025-04-25,2025-12-19,546.69,1,646518,1084502340,72118262,1.66762000716384,37.9217160564172,0.0357481054584538
612.17,165,401,401,17931517,17931517,2025-04-25,2025-06-20,546.69,0,0,1174768001,197089681,1.52638793231822,63.2561041301294,0
533.64,435,1811,1811,17863704,17863704,2025-04-25,2025-12-19,546.69,0,0,1084502340,72118262,1.64717984840863,39.5688959048258,0
596.07,560,4958,4931,14923580,17786117,2025-04-25,2025-12-19,546.69,-27,2862537,1084502340,72118262,1.64002569141529,41.2089215962411,0.160942211276357
547.39,455,1892,1891,14197568,17470949,2025-04-25,2025-06-20,546.69,-1,3273381,1174768001,197089681,1.48718291485027,64.7432870449797,0.187361373443423
616.65,600,10433,10452,13792426,17402580,2025-04-25,2025-12-19,546.69,19,3610154,1084502340,72118262,1.60466043807706,42.8135820343182,0.207449355210549
550.99,505,3734,3782,13621632,17393418,2025-04-25,2025-05-16,546.69,48,3771786,919215858,218728279,1.89220169001915,49.2114409322995,0.216851339972397
545.5,445,1705,1705,17135250,17135250,2025-04-25,2025-12-19,546.69,0,0,1084502340,72118262,1.58001042210753,44.3935924564257,0
560,415,1176,1176,14675304,17052000,2025-04-25,2025-12-19,546.69,0,2376696,1084502340,72118262,1.57233409012285,45.9659265465485,0.139379310344828
557.36,405,1109,1109,16896724,16896724,2025-04-25,2025-12-19,546.69,0,0,1084502340,72118262,1.55801637090059,47.5239429174491,0
557.5,535,7372,7431,11301276,16719750,2025-04-25,2025-05-16,546.69,59,5418474,919215858,218728279,1.81891444261833,51.0303553749178,0.324076257121069
578,505,2274,2271,14658204,16578300,2025-04-25,2025-12-19,546.69,-3,1920096,1084502340,72118262,1.52865506956859,49.0525979870177,0.115819836774579
616.26,610,28047,26402,13322325,16527652,2025-04-25,2025-09-19,546.69,-1645,3205327,612220205,74276563,2.69962537417399,58.0050380728614,0.1939372271391
582.35,575,21766,22277,10861234,16373595,2025-04-25,2025-06-20,546.69,511,5512361,1174768001,197089681,1.39377264158219,66.1370596865619,0.336661618905317
602.22,590,13217,13372,13534208,16340584,2025-04-25,2025-09-19,546.69,155,2806376,612220205,74276563,2.6690697018077,60.6741077746691,0.17174269903695
545.48,150,396,396,15287184,15661008,2025-04-25,2025-06-20,546.69,0,373824.000000002,1174768001,197089681,1.33311496284108,67.470174649403,0.0238697279255589
552.74,510,3753,3662,12182238,15651388,2025-04-25,2025-05-16,546.69,-91,3469150,919215858,218728279,1.702689076106,52.7330444510238,0.221651268245347
586.48,560,5148,5909,11382228,15647032,2025-04-25,2025-09-19,546.69,761,4264804,612220205,74276563,2.55578497282689,63.229892747496,0.272563128905213
551.35,450,1530,1538,14206050,15587630,2025-04-25,2025-06-20,546.69,8,1381580,1174768001,197089681,1.32686879338996,68.7970434427929,0.0886331020174329
543.2,380,955,955,15585600,15585600,2025-04-25,2025-12-19,546.69,0,0,1084502340,72118262,1.43711999736211,50.4897179843798,0
582.64,550,4689,4755,12951018,15520320,2025-04-25,2025-09-19,546.69,66,2569302,612220205,74276563,2.53508784474044,65.7649805922364,0.165544395991835
562.44,515,2990,3217,12037740,15261448,2025-04-25,2025-07-18,546.69,227,3223708,353688576,64788996,4.31493947941366,28.4391506611737,0.211232118996834
569.25,535,4309,4447,11733407,15230975,2025-04-25,2025-07-18,546.69,138,3497568,353688576,64788996,4.30632370778071,32.7454743689545,0.229635200635547
531.62,180,433,433,15225146,15225146,2025-04-25,2025-12-19,546.69,0,0,1084502340,72118262,1.40388318572001,51.8936011700998,0
576.46,565,13014,13197,10684494,15123762,2025-04-25,2025-06-20,546.69,183,4439268,1174768001,197089681,1.28738286939431,70.0844263121872,0.293529348055067
552.35,465,1715,1712,13514200,14954320,2025-04-25,2025-06-20,546.69,-3,1440120,1174768001,197089681,1.272959425799,71.3573857379862,0.0963012694659468
577.3,575,63816,64630,7977000,14864900,2025-04-25,2025-05-16,546.69,814,6887900,919215858,218728279,1.61712832417214,54.350172775196,0.463366722951382
553.5,475,1894,1892,13661422,14852200,2025-04-25,2025-06-20,546.69,-2,1190778,1174768001,197089681,1.26426664561491,72.6216523836012,0.0801751929007151
575.65,500,1947,1962,13408989,14842530,2025-04-25,2025-12-19,546.69,15,1433541,1084502340,72118262,1.36860285612662,53.2622040262265,0.0965833318174193
592.02,550,4008,3509,14529000,14744818,2025-04-25,2025-12-19,546.69,-499,215818.000000002,1084502340,72118262,1.35959300926912,54.6217970354956,0.0146368710688733
567.68,465,1416,1420,12354600,14580560,2025-04-25,2025-12-19,546.69,4,2225960,1084502340,72118262,1.34444707606624,55.9662441115618,0.152666289909304
600.53,570,4799,4769,12371822,14559757,2025-04-25,2025-12-19,546.69,-30,2187935,1084502340,72118262,1.3425288690479,57.3087729806097,0.150272768975471
569.66,165,354,354,14324964,14324964,2025-04-25,2025-12-19,546.69,0,0,1084502340,72118262,1.32087903102173,58.6296520116314,0
575.58,555,6711,6839,11214081,14074662,2025-04-25,2025-07-18,546.69,128,2860581,353688576,64788996,3.97939400790825,36.7248683768627,0.203243317672566
563.8,520,3171,3213,11561466,14072940,2025-04-25,2025-07-18,546.69,42,2511474,353688576,64788996,3.9789071389176,40.7037755157803,0.178461217059122
539.4,440,1413,1413,14045220,14045220,2025-04-25,2025-12-19,546.69,0,0,1084502340,72118262,1.29508434255661,59.924736354188,0
548.22,350,703,703,13934866,13934866,2025-04-25,2025-12-19,546.69,0,0,1084502340,72118262,1.28490879973574,61.2096451539238,0
539.5,300,575,575,13771250,13771250,2025-04-25,2025-06-20,546.69,0,0,1174768001,197089681,1.17225273315901,73.7939051167602,0
562.38,475,1551,1551,13552638,13552638,2025-04-25,2025-12-19,546.69,0,0,1084502340,72118262,1.24966424692085,62.4593094008446,0
543.05,210,398,398,13255390,13255390,2025-04-25,2025-06-20,546.69,0,0,1174768001,197089681,1.12834108425805,74.9222462010182,0
573.89,525,2698,2701,11485386,13205189,2025-04-25,2025-09-19,546.69,3,1719803,612220205,74276563,2.15693452979063,67.9219151220271,0.130236909142308
574.26,540,3790,3774,10934150,12929724,2025-04-25,2025-08-15,546.69,-16,1995574,282648688,37799117,4.57448576587768,4.57448576587768,0.154340030769412
564.18,525,3235,3247,10788725,12721746,2025-04-25,2025-07-18,546.69,12,1933021,353688576,64788996,3.59687783639356,44.3006533521739,0.151946202981886
567.75,530,3191,3352,9786797,12653800,2025-04-25,2025-07-18,546.69,161,2867003,353688576,64788996,3.57766715088926,47.8783205030631,0.226572492057722
537.64,425,1119,1119,12604416,12604416,2025-04-25,2025-12-19,546.69,0,0,1084502340,72118262,1.16223041067851,63.6215398115231,0
560.1,545,8546,8330,8289620,12578300,2025-04-25,2025-05-16,546.69,-216,4288680,919215858,218728279,1.36837282456892,55.7185455997649,0.340958635109673
571.55,535,3438,3439,10726560,12569545,2025-04-25,2025-08-15,546.69,1,1842985,282648688,37799117,4.44705584481609,9.02154161069377,0.146623048010091
556.03,520,3454,3453,9792090,12441159,2025-04-25,2025-05-30,546.69,-1,2649069,159044187,37473216,7.82245439753168,7.82245439753168,0.212927830919933
583.25,570,9218,9373,9079730,12419225,2025-04-25,2025-07-18,546.69,155,3339495,353688576,64788996,3.51134468080756,51.3896651838707,0.268897213795547
560.8,547,8928,8948,7838784,12348240,2025-04-25,2025-05-16,546.69,20,4509456,919215858,218728279,1.34334497088278,57.0618905706477,0.365190180948864
578.24,560,6393,6762,9078060,12333888,2025-04-25,2025-07-18,546.69,369,3255828,353688576,64788996,3.48721695777926,54.87688214165,0.263974182350286
604.85,580,4949,4954,10491880,12310690,2025-04-25,2025-12-19,546.69,5,1818810,1084502340,72118262,1.13514646727272,64.7566862787959,0.147742328009234
547.94,525,5538,5360,7238166,12295840,2025-04-25,2025-04-25,546.69,-178,5057674,247323203,111942542,4.97156750796245,13.3426098318806,0.411332125336699
578.46,540,3166,3163,10482626,12164898,2025-04-25,2025-09-19,546.69,-3,1682272,612220205,74276563,1.9870134798965,69.9089286019236,0.13828903456486
540.9,395,830,830,12109700,12109700,2025-04-25,2025-12-19,546.69,0,0,1084502340,72118262,1.11661354276101,65.8732998215569,0
562.5,551,10312,10485,7362768,12057750,2025-04-25,2025-05-16,546.69,173,4694982,919215858,218728279,1.31174303566029,58.373633606308,0.389374634571127
547.2,520,4518,4422,7793550,12027840,2025-04-25,2025-04-25,546.69,-96,4234290,247323203,111942542,4.86320727457181,18.2058171064524,0.352040765424216
570.91,495,1564,1565,10009600,11879915,2025-04-25,2025-12-19,546.69,1,1870315,1084502340,72118262,1.09542548336041,66.9687253049173,0.157435048988145
547,350,601,603,11389551,11879100,2025-04-25,2025-06-20,546.69,2,489549,1174768001,197089681,1.01118688880597,75.9334330898242,0.0412109503245195
572,485,1362,1362,11146608,11849400,2025-04-25,2025-12-19,546.69,0,702792,1084502340,72118262,1.09261175038129,68.0613370552986,0.0593103448275862
589.25,580,12008,12783,8057368,11824275,2025-04-25,2025-07-18,546.69,775,3766907,353688576,64788996,3.34313172727411,58.2200138689241,0.318574035194547
567.41,460,1105,1094,11246690,11750654,2025-04-25,2025-12-19,546.69,-11,503964,1084502340,72118262,1.08350656025325,69.1448436155518,0.0428881660544171
551.25,530,5513,5508,7558323,11704500,2025-04-25,2025-05-02,546.69,-5,4146177,157884664,54569672,7.41332293046524,7.41332293046524,0.354237857234397
552.54,470,1415,1415,11679410,11679410,2025-04-25,2025-09-19,546.69,0,0,612220205,74276563,1.90771390826606,71.8166425101896,0
545.1,360,621,621,11494710,11494710,2025-04-25,2025-12-19,546.69,0,0,1084502340,72118262,1.05990642675792,70.2047500423097,0
601.8,575,4265,4287,9997160,11489160,2025-04-25,2025-12-19,546.69,22,1492000,1084502340,72118262,1.05939467129227,71.264144713602,0.129861539050723
548.34,535,10215,8552,6006420,11408368,2025-04-25,2025-04-25,546.69,-1663,5401948,247323203,111942542,4.61273663838164,22.818553744834,0.473507516587824
538.08,380,717,717,11334336,11334336,2025-04-25,2025-05-16,546.69,0,0,919215858,218728279,1.23304400172783,59.6066776080358,0
554.1,524,3754,3736,8577890,11245360,2025-04-25,2025-05-16,546.69,-18,2667470,919215858,218728279,1.22336444722215,60.8300420552579,0.237206278856346
581.5,525,1984,1974,10160064,11153100,2025-04-25,2025-12-19,546.69,-10,993036,1084502340,72118262,1.02840718628602,72.292551899888,0.0890367700459962
573.45,570,27792,32229,5141520,11119005,2025-04-25,2025-05-16,546.69,4437,5977485,919215858,218728279,1.20961849202562,62.0396605472836,0.537591717963973
556.32,540,4205,6726,4381610,10976832,2025-04-25,2025-05-09,546.69,2521,6595222,106424303,36041450,10.3142155415385,10.3142155415385,0.600831095893606
585,555,3379,3646,8366404,10938000,2025-04-25,2025-09-19,546.69,267,2571596,612220205,74276563,1.78661205733973,73.6032545675294,0.235106600841104
606.16,600,17442,17434,7726806,10739344,2025-04-25,2025-08-15,546.69,-8,3012538,282648688,37799117,3.79953789136286,12.8210795020566,0.280514154309611
542.57,455,1187,1187,10394559,10394559,2025-04-25,2025-09-19,546.69,0,0,612220205,74276563,1.69784644725994,75.3011010147893,0
568.52,505,1625,1623,9033375,10309296,2025-04-25,2025-09-19,546.69,-2,1275921,612220205,74276563,1.68391959556448,76.9850206103538,0.123764125115818
563.25,505,1770,1769,10065990,10304425,2025-04-25,2025-08-15,546.69,-1,238435,282648688,37799117,3.64566525070868,16.4667447527653,0.0231390883042965
601.76,600,55782,58437,6470712,10284912,2025-04-25,2025-06-20,546.69,2655,3814200,1174768001,197089681,0.875484520453839,76.808917610278,0.370853926606275
593.59,555,2614,2629,8900670,10145311,2025-04-25,2025-12-19,546.69,15,1244641,1084502340,72118262,0.935480784670322,73.2280326845584,0.12268140424675
570.02,565,19153,20087,5343687,10083674,2025-04-25,2025-05-16,546.69,934,4739987,919215858,218728279,1.0969865143471,63.1366470616307,0.470065474151584
566.01,558,12422,12373,5652010,9910773,2025-04-25,2025-05-16,546.69,-49,4258763,919215858,218728279,1.07817689542079,64.2148239570515,0.429710477679188
553.94,490,1517,1550,8439071,9910700,2025-04-25,2025-06-20,546.69,33,1471629,1174768001,197089681,0.84363040119953,77.6525480114776,0.148488905929955
575.89,570,16559,16703,5961240,9838067,2025-04-25,2025-05-30,546.69,144,3876827,159044187,37473216,6.1857444686111,14.0081988661428,0.394063894868779
531.86,420,879,879,9832494,9832494,2025-04-25,2025-06-20,546.69,0,0,1174768001,197089681,0.836973256986083,78.4895212684636,0
551.82,480,1349,1348,8973548,9681336,2025-04-25,2025-06-20,546.69,-1,707787.999999998,1174768001,197089681,0.824106205800544,79.3136274742642,0.0731085048592465
539.91,275,360,360,9536760,9536760,2025-04-25,2025-12-19,546.69,0,0,1084502340,72118262,0.879367397215574,74.1074000817739,0
577.64,510,1403,1402,8549882,9483128,2025-04-25,2025-12-19,546.69,-1,933246,1084502340,72118262,0.874422087461794,74.9818221692357,0.0984111993426641
610.69,590,4465,4472,7657475,9252568,2025-04-25,2025-12-19,546.69,7,1595093,1084502340,72118262,0.853162566712397,75.8349847359481,0.172394626010855
571.31,490,1133,1136,9203359,9236816,2025-04-25,2025-12-19,546.69,3,33456.9999999981,1084502340,72118262,0.851710103271884,76.68669483922,0.00362213559304398
566.97,560,12469,13234,4887848,9224098,2025-04-25,2025-05-16,546.69,765,4336250,919215858,218728279,1.0034746376188,65.2182985946703,0.470100165891559
571.24,520,1791,1790,8295912,9171960,2025-04-25,2025-09-19,546.69,-1,876048,612220205,74276563,1.49814722302411,78.4831678333779,0.09551371789672
637.05,630,12838,12838,7356174,9050790,2025-04-25,2025-12-19,546.69,0,1694616,1084502340,72118262,0.834556982145377,77.5212518213654,0.187234042553191
561.61,420,638,634,7113700,8978074,2025-04-25,2025-12-19,546.69,-4,1864374,1084502340,72118262,0.827851971255313,78.3491037926207,0.207658569087312
579.97,555,3522,3592,7357458,8969224,2025-04-25,2025-08-15,546.69,70,1611766,282648688,37799117,3.17327636065305,19.6400211134184,0.179699603889924
546.83,500,1941,1915,7239930,8967945,2025-04-25,2025-04-25,546.69,-26,1728015,247323203,111942542,3.62600228818806,26.4445560330221,0.192687956939968
553.07,515,2366,2349,6885060,8942643,2025-04-25,2025-05-16,546.69,-17,2057583,919215858,218728279,0.97285560536968,66.1911542000399,0.230086675717682
589.05,545,2027,2028,7933678,8933340,2025-04-25,2025-12-19,546.69,1,999662,1084502340,72118262,0.823727129994021,79.1728309226147,0.111902379177329
586.2,575,6850,7844,5637550,8785280,2025-04-25,2025-07-18,546.69,994,3147730,353688576,64788996,2.48390267487746,60.7039165438015,0.358295922269979
550.57,525,3404,3392,5854880,8673344,2025-04-25,2025-05-02,546.69,-12,2818464,157884664,54569672,5.49346832064703,12.9067912511123,0.324957017731569
560,500,1425,1429,7679325,8574000,2025-04-25,2025-07-18,546.69,4,894675,353688576,64788996,2.42416650743054,63.1280830512321,0.10434744576627
593.3,590,25078,25941,5416848,8560530,2025-04-25,2025-06-20,546.69,863,3143682,1174768001,197089681,0.728699623475699,80.0423270977399,0.367229832732319
538.35,260,306,306,8517510,8517510,2025-04-25,2025-12-19,546.69,0,0,1084502340,72118262,0.785384197511275,79.958215120126,0
552.07,460,925,925,7788500,8516475,2025-04-25,2025-06-20,546.69,0,727975,1174768001,197089681,0.724949521331063,80.7672766190709,0.08547844031715
522.87,155,229,229,8424223,8424223,2025-04-25,2025-06-20,546.69,0,0,1174768001,197089681,0.717096736787947,81.4843733558589,0
580.3,545,2370,2369,7207170,8362570,2025-04-25,2025-09-19,546.69,-1,1155400,612220205,74276563,1.36594152425923,79.8491093576371,0.138163267990582
542.64,160,218,218,8341552,8341552,2025-04-25,2025-06-20,546.69,0,0,1174768001,197089681,0.710059517530219,82.1944328733891,0
551.51,430,675,675,7533675,8201925,2025-04-25,2025-06-20,546.69,0,668250,1174768001,197089681,0.698174021850975,82.8926068952401,0.0814747757386223
531.36,285,331,331,8154516,8154516,2025-04-25,2025-12-19,546.69,0,0,1084502340,72118262,0.751913177061471,80.7101282971875,0
619.07,605,5739,5760,6640023,8104320,2025-04-25,2025-12-19,546.69,21,1464297,1084502340,72118262,0.747284694655431,81.4574129918429,0.180681044183843
551,440,729,729,7572852,8091900,2025-04-25,2025-06-20,546.69,0,519048.000000001,1174768001,197089681,0.688808342848283,83.5814152380884,0.0641441441441443
552.12,420,609,609,8046108,8046108,2025-04-25,2025-09-19,546.69,0,0,612220205,74276563,1.31425064613802,81.1633600037751,0
629.56,620,8329,8382,6521607,8013192,2025-04-25,2025-12-19,546.69,53,1491585,1084502340,72118262,0.738881946534113,82.196294938377,0.186141178197153
559.22,270,277,277,8011394,8011394,2025-04-25,2025-12-19,546.69,0,0,1084502340,72118262,0.738716156204882,82.9350110945819,0
543.92,390,517,517,7957664,7957664,2025-04-25,2025-07-18,546.69,0,0,353688576,64788996,2.24990699162418,65.3779900428562,0
562.38,555,11134,10782,4420198,7957116,2025-04-25,2025-05-09,546.69,-352,3536918,106424303,36041450,7.47678469644288,17.7910002379814,0.444497478734758
545.32,375,463,463,7885816,7885816,2025-04-25,2025-06-20,546.69,0,0,1174768001,197089681,0.671265815317351,84.2526810534057,0
554.91,532,3451,3420,5918465,7835220,2025-04-25,2025-05-16,546.69,-31,1916755,919215858,218728279,0.852380856118781,67.0435350561587,0.244633207491302
576.6,535,1874,1881,6633960,7824960,2025-04-25,2025-09-19,546.69,7,1191000,612220205,74276563,1.27812834925956,82.4414883530347,0.152205250889462
598.14,565,2388,2361,6889380,7824354,2025-04-25,2025-12-19,546.69,-27,934974.000000001,1084502340,72118262,0.721469535971679,83.6564806305536,0.119495360255939
549.75,515,2259,2251,5365125,7822225,2025-04-25,2025-05-02,546.69,-8,2457100,157884664,54569672,4.95439189711295,17.8611831482252,0.314117786179763
549.28,470,988,986,6025812,7817008,2025-04-25,2025-05-16,546.69,-2,1791196,919215858,218728279,0.850399602222703,67.8939346583814,0.229140868219656
537.4,225,245,245,7653800,7653800,2025-04-25,2025-06-20,546.69,0,0,1174768001,197089681,0.651515873217933,84.9041969266236,0
548.23,533,5677,4995,4030670,7607385,2025-04-25,2025-04-25,546.69,-682,3576715,247323203,111942542,3.0758881122852,29.5204441453073,0.470163531883821
589.29,585,17114,17457,4945946,7489053,2025-04-25,2025-06-20,546.69,343,2543107,1174768001,197089681,0.63749208300065,85.5416890096243,0.339576579308492
559,542,4516,4401,5193400,7481700,2025-04-25,2025-05-16,546.69,-115,2288300,919215858,218728279,0.813921989583431,68.7078566479648,0.305852947859444
556.1,531,2971,2968,5410191,7449680,2025-04-25,2025-05-16,546.69,-3,2039489,919215858,218728279,0.810438585797331,69.5182952337622,0.273768671942956
552.41,410,521,521,7419561,7419561,2025-04-25,2025-09-19,546.69,0,0,612220205,74276563,1.21191050857265,83.6533988616073,0
547.69,510,2001,1956,5178588,7372164,2025-04-25,2025-04-25,546.69,-45,2193576,247323203,111942542,2.98078138669424,32.5012255320015,0.29754845388681
548.91,541,4013,9319,1203900,7371329,2025-04-25,2025-04-25,546.69,5306,6167429,247323203,111942542,2.98044377178796,35.4816693037895,0.836678026445435
587.75,570,4153,4143,5656386,7353825,2025-04-25,2025-08-15,546.69,-10,1697439,282648688,37799117,2.60175451442393,22.2417756278423,0.230823958960133
564.29,555,6346,7799,3572798,7245271,2025-04-25,2025-05-16,546.69,1453,3672473,919215858,218728279,0.78820126273322,70.3064964964954,0.506878624691885
557.4,550,9255,9744,3359565,7210560,2025-04-25,2025-05-02,546.69,489,3850995,157884664,54569672,4.56697934892524,22.4281624971505,0.534077103581414
547,235,232,231,7484784,7207200,2025-04-25,2025-12-19,546.69,-1,-277584,1084502340,72118262,0.664562881441086,84.3210435119946,-0.0385148185148185
580.11,565,4671,4719,5544477,7130409,2025-04-25,2025-07-18,546.69,48,1585932,353688576,64788996,2.01601337556348,67.3940034184197,0.222418096914216
626.03,615,6451,6454,6128450,7118762,2025-04-25,2025-12-19,546.69,3,990312,1084502340,72118262,0.65640817335627,84.9774516853509,0.139112952504944
541.55,385,453,454,7259325,7107370,2025-04-25,2025-06-20,546.69,1,-151954.999999999,1174768001,197089681,0.605002008392294,86.1466910180166,-0.0213799197171386
546.89,180,192,192,7044288,7044288,2025-04-25,2025-06-20,546.69,0,0,1174768001,197089681,0.59963226730756,86.7463232853242,0
571.97,545,2352,2591,5134416,6987927,2025-04-25,2025-07-18,546.69,239,1853511,353688576,64788996,1.97572878350473,69.3697322019244,0.265244757136129
605.66,595,6498,6531,5549292,6962046,2025-04-25,2025-09-19,546.69,33,1412754,612220205,74276563,1.13718004455603,84.7905789061634,0.202922244409187
560.34,505,1257,1257,5924241,6956238,2025-04-25,2025-07-18,546.69,0,1031997,353688576,64788996,1.96676920659151,71.336501408516,0.148355619804843
550.21,520,2339,2301,4970375,6951321,2025-04-25,2025-05-02,546.69,-38,1980946,157884664,54569672,4.4027841741488,26.8309466712993,0.284974035870305
548.8,540,9854,7877,3350360,6931760,2025-04-25,2025-04-25,546.69,-1977,3581400,247323203,111942542,2.80271317689509,38.2843824806846,0.516665320207278
584.16,530,1256,1257,5922040,6807912,2025-04-25,2025-12-19,546.69,1,885872,1084502340,72118262,0.627745256870538,85.6051969422214,0.130123891143129
565.4,550,4346,4372,4580684,6732880,2025-04-25,2025-05-30,546.69,26,2152196,159044187,37473216,4.23333925432936,18.2415381204721,0.3196545906061
561.24,548,4876,5053,4105592,6690172,2025-04-25,2025-05-16,546.69,177,2584580,919215858,218728279,0.727812944236652,71.034309440732,0.386324895682802
524.08,280,273,273,6663384,6663384,2025-04-25,2025-12-19,546.69,0,0,1084502340,72118262,0.614418591295986,86.2196155335174,0
569.58,510,1118,1117,5812482,6655086,2025-04-25,2025-09-19,546.69,-1,842604,612220205,74276563,1.08704122236541,85.8776201285288,0.126610535160628
553.75,523,2154,2138,5122212,6574350,2025-04-25,2025-05-16,546.69,-16,1452138,919215858,218728279,0.715212857000124,71.7495222977322,0.22087932647334
549.37,543,4737,10219,1065825,6509503,2025-04-25,2025-04-25,546.69,5482,5443678,247323203,111942542,2.63198232961588,40.9163648103005,0.836266301743774
538.59,265,237,237,6484083,6484083,2025-04-25,2025-12-19,546.69,0,0,1084502340,72118262,0.597885570260734,86.8175011037782,0
547.23,515,2044,2003,4599000,6455669,2025-04-25,2025-04-25,546.69,-41,1856669,247323203,111942542,2.61021566989815,43.5265804801986,0.28760288050704
539.38,355,349,349,6434862,6434862,2025-04-25,2025-06-20,546.69,0,0,1174768001,197089681,0.547755981991546,87.2940792673157,0
556,534,2924,2919,4666704,6421800,2025-04-25,2025-05-16,546.69,-5,1755096,919215858,218728279,0.698617190305261,72.4481394880374,0.273302812295618
606.26,605,50325,50263,4277625,6333138,2025-04-25,2025-06-20,546.69,-62,2055513,1174768001,197089681,0.539096910590775,87.8331761779065,0.324564694468998
552.21,513,1599,1599,4963296,6269679,2025-04-25,2025-05-16,546.69,0,1306383,919215858,218728279,0.682068193823523,73.1302076818609,0.208365212955879
560.6,546,4087,4257,3862215,6215220,2025-04-25,2025-05-16,546.69,170,2353005,919215858,218728279,0.676143687677764,73.8063513695387,0.378587564076573
550.22,510,2249,1542,7021378,6201924,2025-04-25,2025-05-09,546.69,-707,-819454,106424303,36041450,5.82754486068845,23.6185450986698,-0.132128997388552
550.9,495,1096,1093,5640016,6109870,2025-04-25,2025-06-20,546.69,-3,469854,1174768001,197089681,0.5200916261593,88.3532678040658,0.0769008178570084
542.67,380,375,375,6100125,6100125,2025-04-25,2025-07-18,546.69,0,0,353688576,64788996,1.72471643528571,73.0612178438017,0
616.7,615,35812,35788,4261628,6083960,2025-04-25,2025-07-18,546.69,-24,1822332,353688576,64788996,1.72014603038804,74.7813638741897,0.299530568905778
603.73,600,12508,16258,3314620,6064234,2025-04-25,2025-07-18,546.69,3750,2749614,353688576,64788996,1.71456880756024,76.49593268175,0.453414891311912
602.48,595,8087,8076,4480198,6040848,2025-04-25,2025-08-15,546.69,-11,1560650,282648688,37799117,2.13722838862072,24.379004016463,0.258349490005377
546.28,340,292,292,6023376,6023376,2025-04-25,2025-06-20,546.69,0,0,1174768001,197089681,0.512728980945405,88.8659967850112,0
622.29,610,4858,4853,4896864,5964337,2025-04-25,2025-12-19,546.69,-5,1067473,1084502340,72118262,0.54996073129727,87.3674618350754,0.178975970003036
555.35,545,3094,5755,1732640,5956425,2025-04-25,2025-05-02,546.69,2661,4223785,157884664,54569672,3.77264317451377,30.603589845813,0.70911410787511
579.11,515,920,925,5359000,5930175,2025-04-25,2025-12-19,546.69,5,571175,1084502340,72118262,0.546810715041887,87.9142725501173,0.0963167191524702
550.6,300,235,235,5889100,5889100,2025-04-25,2025-12-19,546.69,0,0,1084502340,72118262,0.543023263555153,88.4572958136725,0
526.81,335,305,305,5850205,5850205,2025-04-25,2025-06-20,546.69,0,0,1174768001,197089681,0.497988112973806,89.363984897985,0
552.91,521,1863,1832,4551309,5845912,2025-04-25,2025-05-16,546.69,-31,1294603,919215858,218728279,0.635967270268742,74.4423186398075,0.221454411219327
547.5,240,190,190,5666940,5842500,2025-04-25,2025-12-19,546.69,0,175560,1084502340,72118262,0.538726361807574,88.9960221754801,0.0300487804878049
549.62,516,1738,1736,5180978,5836432,2025-04-25,2025-05-16,546.69,-2,655453.999999999,919215858,218728279,0.634935956468236,75.0772545962757,0.112303887032351
595.99,590,9639,9740,4096575,5834260,2025-04-25,2025-07-18,546.69,101,1737685,353688576,64788996,1.64954719939838,78.1454798811483,0.29784154288633
653.65,650,15878,15894,4556986,5801310,2025-04-25,2025-12-19,546.69,16,1244324,1084502340,72118262,0.534928306378758,89.5309504818588,0.214490175494845
560.08,550,5146,5738,2922928,5783904,2025-04-25,2025-05-09,546.69,592,2860976,106424303,36041450,5.43475863778972,29.0533037364595,0.494644447764002
549.95,430,481,481,5769595,5769595,2025-04-25,2025-09-19,546.69,0,0,612220205,74276563,0.94240519226248,86.8200253207912,0
573.27,539,1678,1679,5153138,5753933,2025-04-25,2025-08-15,546.69,1,600795,282648688,37799117,2.03571898412633,26.4147230005893,0.104414667324072
530.08,190,167,167,5679336,5679336,2025-04-25,2025-06-20,546.69,0,0,1174768001,197089681,0.483443198586067,89.8474280965711,0
520.71,430,624,624,5660304,5660304,2025-04-25,2025-05-30,546.69,0,0,159044187,37473216,3.55895057013307,21.8004886906052,0
566,521,1255,1255,5647500,5647500,2025-04-25,2025-08-15,546.69,0,0,282648688,37799117,1.99806340512714,28.4127864057165,0
624.05,620,13992,13944,4351512,5647320,2025-04-25,2025-09-19,546.69,-48,1295808,612220205,74276563,0.922432803406088,87.7424581241973,0.229455387688319
553.4,512,1362,1357,4562700,5617980,2025-04-25,2025-05-16,546.69,-5,1055280,919215858,218728279,0.611170918245843,75.6884255145215,0.187839757350507
554.65,527,2061,2026,4241538,5601890,2025-04-25,2025-05-16,546.69,-35,1360352,919215858,218728279,0.609420513282746,76.2978460278043,0.242838042160771
561.76,549,4418,4372,3428368,5578672,2025-04-25,2025-05-16,546.69,-46,2150304,919215858,218728279,0.60689466477851,76.9047406925828,0.385450874329948
633.26,625,6720,6705,4710720,5538330,2025-04-25,2025-12-19,546.69,-15,827610,1084502340,72118262,0.510679396044457,90.0416298779033,0.149433132370227
528.44,300,240,240,5482560,5482560,2025-04-25,2025-05-16,546.69,0,0,919215858,218728279,0.596438796424681,77.5011794890075,0
549.82,400,365,365,5047585,5468430,2025-04-25,2025-06-20,546.69,0,420845,1174768001,197089681,0.46549020703195,90.312918303603,0.0769590174876519
533.73,295,229,229,5466917,5466917,2025-04-25,2025-06-20,546.69,0,0,1174768001,197089681,0.465361415645165,90.7782797192482,0
550.75,547,11303,14376,1435481,5391000,2025-04-25,2025-04-25,546.69,3073,3955519,247323203,111942542,2.1797388739139,45.7063193541125,0.733726395844927
558.84,465,573,573,5377032,5377032,2025-04-25,2025-09-19,546.69,0,0,612220205,74276563,0.878283982803214,88.6207421070006,0
558.61,530,1870,1871,4188800,5352931,2025-04-25,2025-05-30,546.69,1,1164131,159044187,37473216,3.36568792671435,25.1661766173196,0.217475435420333
527,360,319,319,5327300,5327300,2025-04-25,2025-06-20,546.69,0,0,1174768001,197089681,0.453476771197822,91.231756490446,0
554.94,528,1970,1968,3813920,5301792,2025-04-25,2025-05-16,546.69,-2,1487872,919215858,218728279,0.576773339347677,78.0779528283551,0.280635679408019
543.38,375,314,314,5287132,5287132,2025-04-25,2025-07-18,546.69,0,0,353688576,64788996,1.49485518016844,79.6403350613168,0
538.11,255,186,186,5265846,5265846,2025-04-25,2025-12-19,546.69,0,0,1084502340,72118262,0.48555413905331,90.5271840169566,0
550.19,504,1144,1136,3293576,5247184,2025-04-25,2025-05-16,546.69,-8,1953608,919215858,218728279,0.570832623733956,78.6487854520891,0.372315512472976
576.46,545,1587,1646,4008762,5178316,2025-04-25,2025-08-15,546.69,59,1169554,282648688,37799117,1.83206794152888,30.2448543472454,0.225856050499815
585.43,535,1012,1011,4503400,5098473,2025-04-25,2025-12-19,546.69,-1,595073,1084502340,72118262,0.470120977332331,90.9973049942889,0.116715926513684
562.72,500,812,810,4699856,5080320,2025-04-25,2025-08-15,546.69,-2,380463.999999999,282648688,37799117,1.79739734012139,32.0422516873668,0.0748897707231039
545.72,385,316,316,5078752,5078752,2025-04-25,2025-07-18,546.69,0,0,353688576,64788996,1.43593894307743,81.0762740043942,0
552.18,550,17941,23281,1417339,5075258,2025-04-25,2025-04-25,546.69,5340,3657919,247323203,111942542,2.05207515446903,47.7583945085816,0.720735576398284
529.56,250,181,181,5060036,5060036,2025-04-25,2025-06-20,546.69,0,0,1174768001,197089681,0.430726406889934,91.6624828973359,0
564.25,526,1311,1311,4897896,5014575,2025-04-25,2025-08-15,546.69,0,116679,282648688,37799117,1.7741370163374,33.8163887037042,0.0232679738562092
534.17,155,132,132,5005044,5005044,2025-04-25,2025-12-19,546.69,0,0,1084502340,72118262,0.461506058161202,91.4588110524501,0
620.15,615,9711,9703,3806712,4997045,2025-04-25,2025-09-19,546.69,-8,1190333,612220205,74276563,0.816216936192101,89.4369590431927,0.238207380561912
553.66,540,4031,3644,3103870,4977704,2025-04-25,2025-05-02,546.69,-387,1873834,157884664,54569672,3.1527469951103,33.7563368409233,0.376445445530711
612.3,605,6835,6799,4107835,4963270,2025-04-25,2025-09-19,546.69,-36,855435,612220205,74276563,0.810700130355874,90.2476591735485,0.172353105916059
556.87,522,1419,1422,3487902,4958514,2025-04-25,2025-05-16,546.69,3,1470612,919215858,218728279,0.539428683355025,79.1882141354441,0.296583210211769
550,545,7462,9752,1276002,4876000,2025-04-25,2025-04-25,546.69,2290,3599998,247323203,111942542,1.97150932094309,49.7299038295247,0.738309680065628
532.49,200,146,146,4854354,4854354,2025-04-25,2025-12-19,546.69,0,0,1084502340,72118262,0.447611205707495,91.9064222581576,0
553.32,530,2033,2054,3281262,4789928,2025-04-25,2025-05-09,546.69,21,1508666,106424303,36041450,4.50078399855717,33.5540877350167,0.314966320996892
518.99,255,181,181,4778219,4778219,2025-04-25,2025-06-20,546.69,0,0,1174768001,197089681,0.406737244794941,92.0692201421309,0
502.84,215,166,166,4778144,4778144,2025-04-25,2025-06-20,546.69,0,0,1174768001,197089681,0.406730860555675,92.4759510026865,0
556.01,533,2236,2075,3769896,4774575,2025-04-25,2025-05-16,546.69,-161,1004679,919215858,218728279,0.519418258339055,79.7076323937832,0.210422707780274
567.84,555,3695,3699,3103800,4749516,2025-04-25,2025-05-30,546.69,4,1645716,159044187,37473216,2.98628707505041,28.15246369237,0.346501833028881
547.42,495,902,904,4491058,4738768,2025-04-25,2025-05-23,546.69,2,247710,70049480,15954371,6.7648867628996,6.7648867628996,0.0522730802605234
542.87,370,274,274,4736638,4736638,2025-04-25,2025-07-18,546.69,0,0,353688576,64788996,1.33921147625645,82.4154854806506,0
578,552,1782,1816,4014846,4721600,2025-04-25,2025-08-15,546.69,34,706754,282648688,37799117,1.67048360755172,35.4868723112559,0.149685276177567
599.05,590,5144,5211,3477344,4715955,2025-04-25,2025-08-15,546.69,67,1238611,282648688,37799117,1.66848642863681,37.1553587398927,0.262642667285841
554.5,519,1322,1322,3516520,4693100,2025-04-25,2025-05-16,546.69,0,1176580,919215858,218728279,0.510554725438603,80.2181871192218,0.250704225352113
547.8,532,2373,2938,1865178,4642040,2025-04-25,2025-04-25,546.69,565,2776862,247323203,111942542,1.87691245450998,51.6068162840346,0.598198636806232
575.51,205,125,125,4631375,4631375,2025-04-25,2025-06-20,546.69,0,0,1174768001,197089681,0.394237415051961,92.8701884177385,0
557.97,541,2689,2691,3226800,4566627,2025-04-25,2025-05-16,546.69,2,1339827,919215858,218728279,0.496795933213763,80.7149830524356,0.293395322192945
542.88,501,1092,1087,4573296,4552356,2025-04-25,2025-05-16,546.69,-5,-20940,919215858,218728279,0.495243414305849,81.2102264667414,-0.00459981600735971
597.36,595,18704,19256,3030048,4544416,2025-04-25,2025-06-20,546.69,552,1514368,1174768001,197089681,0.386835187554619,93.2570236052931,0.333237098012154
552.36,535,2543,2605,2642177,4522280,2025-04-25,2025-05-02,546.69,62,1880103,157884664,54569672,2.86429339330893,36.6206302342323,0.415742280442609
561.93,540,1994,2061,3186412,4519773,2025-04-25,2025-05-30,546.69,67,1333361,159044187,37473216,2.84183476633447,30.9942984587044,0.295006187257634
552.22,517,1266,1259,3615696,4434198,2025-04-25,2025-05-16,546.69,-7,818502,919215858,218728279,0.482389197423964,81.6926156641654,0.18458850957941
547.36,450,455,455,3971240,4429880,2025-04-25,2025-05-16,546.69,0,458640,919215858,218728279,0.481919449218205,82.1745351133836,0.103533278553821
548.29,528,2411,2183,2524317,4429307,2025-04-25,2025-04-25,546.69,-228,1904990,247323203,111942542,1.79089828462233,53.397714568657,0.430087596095732
546.67,490,796,781,3642496,4425927,2025-04-25,2025-05-02,546.69,-15,783431,157884664,54569672,2.8032659334158,39.4238961676481,0.177009471688078
557.52,530,1599,1591,3249168,4378432,2025-04-25,2025-05-23,546.69,-8,1129264,70049480,15954371,6.25048465741644,13.015371420316,0.25791516232295
542.3,250,149,149,4355270,4355270,2025-04-25,2025-12-19,546.69,0,0,1084502340,72118262,0.401591572407303,92.3080138305649,0
555,529,1701,1674,3291435,4352400,2025-04-25,2025-05-16,546.69,-27,1060965,919215858,218728279,0.473490525878199,82.6480256392618,0.243765508684863
547.84,526,2096,1972,2473280,4306848,2025-04-25,2025-04-25,546.69,-124,1833568,247323203,111942542,1.7413845315597,55.1390991002167,0.425733157984679
543.88,511,1308,1306,4413192,4294128,2025-04-25,2025-05-16,546.69,-2,-119064,919215858,218728279,0.467151209656351,83.1151768489181,-0.0277271660276545
613.99,610,10710,10665,3148740,4255335,2025-04-25,2025-08-15,546.69,-45,1106595,282648688,37799117,1.50552087473337,38.6608796146261,0.26004885631801
548.11,510,1122,1108,3309900,4222588,2025-04-25,2025-05-02,546.69,-14,912688,157884664,54569672,2.67447635066063,42.0983725183087,0.21614422245315
632.78,630,15160,15143,3092640,4209754,2025-04-25,2025-09-19,546.69,-17,1117114,612220205,74276563,0.687620886344318,90.9352800598928,0.265363249253994
549.32,497,802,800,3840778,4185600,2025-04-25,2025-05-16,546.69,-2,344822,919215858,218728279,0.455344624831309,83.5705214737494,0.0823829319571865
543.12,365,234,234,4168008,4168008,2025-04-25,2025-07-18,546.69,0,0,353688576,64788996,1.17844009753937,83.59392557819,0
582.5,560,1768,1848,3132896,4158000,2025-04-25,2025-08-15,546.69,80,1025104,282648688,37799117,1.47108413253983,40.1319637471659,0.246537758537759
553.22,514,1057,1059,3116036,4153398,2025-04-25,2025-05-16,546.69,2,1037362,919215858,218728279,0.451841421560854,84.0223628953103,0.249762242867166
507.12,385,340,340,4152080,4152080,2025-04-25,2025-12-19,546.69,0,0,1084502340,72118262,0.382855789873169,92.6908696204381,0
578.33,550,1471,1465,3421546,4150345,2025-04-25,2025-08-15,546.69,-6,728799,282648688,37799117,1.4683758234887,41.6003395706546,0.175599618826869
574.55,541,1226,1225,3451190,4109875,2025-04-25,2025-08-15,546.69,-1,658685,282648688,37799117,1.45405769582062,43.0543972664752,0.160268864624837
589.9,575,2725,2750,3218225,4097500,2025-04-25,2025-08-15,546.69,25,879275,282648688,37799117,1.44967946923568,44.5040767357109,0.214588163514338
549.3,542,6682,5605,1730638,4091650,2025-04-25,2025-04-25,546.69,-1077,2361012,247323203,111942542,1.65437369012239,56.7934727903391,0.577031759803502
547.72,516,1295,1289,2687125,4088708,2025-04-25,2025-04-25,546.69,-6,1401583,247323203,111942542,1.65318415353047,58.4466569438695,0.342793615978446
681.32,680,23946,30951,2753790,4085532,2025-04-25,2025-12-19,546.69,7005,1331742,1084502340,72118262,0.376719519111411,93.0675891395495,0.325965382231739
548.09,505,946,947,3151126,4080623,2025-04-25,2025-05-02,546.69,1,929497,157884664,54569672,2.58455944777512,44.6829319660838,0.227783110569146
572.92,542,1309,1312,3523828,4056704,2025-04-25,2025-08-15,546.69,3,532876,282648688,37799117,1.43524600404301,45.9393227397539,0.13135688480106
645.2,640,7785,7789,3339765,4050280,2025-04-25,2025-12-19,546.69,4,710515.000000001,1084502340,72118262,0.37346899592674,93.4410581354762,0.175423674412633
546.4,370,227,226,4029250,3986640,2025-04-25,2025-06-20,546.69,-1,-42610,1174768001,197089681,0.339355515012874,93.596379120306,-0.0106881985832681
559.69,544,2355,2537,2359710,3980553,2025-04-25,2025-05-16,546.69,182,1620843,919215858,218728279,0.433037894783578,84.4554007900939,0.407190407965928
536.94,503,1170,1170,3970980,3970980,2025-04-25,2025-05-16,546.69,0,0,919215858,218728279,0.431996463664142,84.887397253758,0
541.84,245,131,131,3888604,3888604,2025-04-25,2025-12-19,546.69,0,0,1084502340,72118262,0.358561144275632,93.7996192797519,0
542.97,380,237,238,3505230,3878686,2025-04-25,2025-06-20,546.69,1,373456,1174768001,197089681,0.330166126137104,93.9265452464431,0.0962841539634813
570.89,530,943,943,3289184,3855927,2025-04-25,2025-08-15,546.69,0,566743,282648688,37799117,1.36421188694851,47.3035346267024,0.146979701638542
565.24,560,6148,7353,1616924,3852972,2025-04-25,2025-05-09,546.69,1205,2236048,106424303,36041450,3.62038734705174,37.1744750820684,0.580343693128318
547.3,500,809,812,3100088,3840760,2025-04-25,2025-05-02,546.69,3,740672,157884664,54569672,2.43263652256941,47.1155684886532,0.192845166060884
545.08,395,255,255,3827040,3827040,2025-04-25,2025-06-20,546.69,0,0,1174768001,197089681,0.325769853855595,94.2523151002987,0
565.39,510,687,687,3283860,3805293,2025-04-25,2025-08-15,546.69,0,521433,282648688,37799117,1.34629777584533,48.6498324025477,0.13702834446651
581.51,580,25370,24665,2105710,3724415,2025-04-25,2025-05-16,546.69,-705,1618705,919215858,218728279,0.405173057839044,85.292570311597,0.43461993360031
551.84,518,1080,1086,3068280,3675024,2025-04-25,2025-05-16,546.69,6,606744.000000001,919215858,218728279,0.399799891180729,85.6923702027778,0.16509932996356
550.71,400,238,238,3362940,3586898,2025-04-25,2025-07-18,546.69,0,223958.000000001,353688576,64788996,1.01414019094583,84.6080657691358,0.0624377944396524
547.29,518,1219,1215,2149097,3558735,2025-04-25,2025-04-25,546.69,-4,1409638,247323203,111942542,1.4389005790128,59.8855575228823,0.396106481657106
592.77,580,2754,2784,2715444,3555168,2025-04-25,2025-08-15,546.69,30,839724,282648688,37799117,1.25780452941639,49.9076369319641,0.236198120595145
544.46,305,148,148,3544008,3544008,2025-04-25,2025-12-19,546.69,0,0,1084502340,72118262,0.326786570142394,94.1264058498943,0
613.07,595,1949,1946,3063828,3516422,2025-04-25,2025-12-19,546.69,-3,452594,1084502340,72118262,0.324242914957657,94.4506487648519,0.128708670347302
549.51,375,200,200,3490200,3490200,2025-04-25,2025-12-19,546.69,0,0,1084502340,72118262,0.321825031746819,94.7724737965987,0
557.51,525,1073,1070,2726493,3478570,2025-04-25,2025-05-30,546.69,-3,752077,159044187,37473216,2.18717204672183,33.1814705054263,0.216202922465266
539.1,175,95,95,3458950,3458950,2025-04-25,2025-06-20,546.69,0,0,1174768001,197089681,0.294436858771743,94.5467519590704,0
508.43,280,149,149,3403607,3403607,2025-04-25,2025-08-15,546.69,0,0,282648688,37799117,1.20418284057275,51.1118197725369,0
546.29,350,172,171,3070716,3356559,2025-04-25,2025-05-16,546.69,-1,285843,919215858,218728279,0.365154601151365,86.0575248039291,0.0851595339155366
610.92,610,35413,36426,2124780,3351192,2025-04-25,2025-06-20,546.69,1013,1226412,1174768001,197089681,0.285264154041254,94.8320161131117,0.365962917075476
561.23,539,1468,1498,2438348,3330054,2025-04-25,2025-05-30,546.69,30,891706,159044187,37473216,2.09379170833826,35.2752622137645,0.267775237278435
545.12,400,229,229,3150353,3323248,2025-04-25,2025-05-16,546.69,0,172895,919215858,218728279,0.361530751572391,86.4190555555015,0.0520259095920619
547.56,509,861,861,3041052,3320016,2025-04-25,2025-05-16,546.69,0,278964.000000001,919215858,218728279,0.361179147542513,86.780234703044,0.0840248962655603
536.96,195,97,97,3317012,3317012,2025-04-25,2025-06-20,546.69,0,0,1174768001,197089681,0.282354643399927,95.1143707565116,0
553.33,380,191,191,2927648,3310603,2025-04-25,2025-09-19,546.69,0,382955,612220205,74276563,0.540753632918731,91.4760336928116,0.115675301448105
557.79,490,490,486,2856700,3294594,2025-04-25,2025-07-18,546.69,-4,437894,353688576,64788996,0.931495734824073,85.5395615039599,0.132912886990021
551.17,548,2565,10393,282150,3294581,2025-04-25,2025-04-25,546.69,7828,3012431,247323203,111942542,1.33209539583716,61.2176529187195,0.914359367701083
612.22,610,14814,14803,2281356,3286266,2025-04-25,2025-07-18,546.69,-11,1004910,353688576,64788996,0.929141121029592,86.4687026249895,0.305790827644506
559.45,460,328,330,3020880,3281850,2025-04-25,2025-09-19,546.69,2,260970,612220205,74276563,0.536057120166428,92.012090812978,0.0795191736368207
551.54,445,308,308,3130512,3281432,2025-04-25,2025-06-20,546.69,0,150920,1174768001,197089681,0.279325960292308,95.3936967168039,0.0459921156373193
544.37,290,128,128,3255936,3255936,2025-04-25,2025-12-19,546.69,0,0,1084502340,72118262,0.300223971854224,95.072697768453,0
547.88,505,759,758,2421210,3250304,2025-04-25,2025-04-25,546.69,-1,829094,247323203,111942542,1.31419291056165,62.5318458292811,0.255081986177293
544.44,420,261,261,3247884,3247884,2025-04-25,2025-07-18,546.69,0,0,353688576,64788996,0.918289201401857,87.3869918263914,0
548.44,538,2755,3096,1170875,3232224,2025-04-25,2025-04-25,546.69,341,2061349,247323203,111942542,1.30688263810007,63.8387284673812,0.637749425782372
545.87,365,178,178,3219486,3219486,2025-04-25,2025-06-20,546.69,0,0,1174768001,197089681,0.274052919151651,95.6677496359556,0
572.58,538,926,930,2715958,3215940,2025-04-25,2025-08-15,546.69,4,499982,282648688,37799117,1.13778699018762,52.2496067627245,0.155469940359584
551.55,508,740,738,2605540,3213990,2025-04-25,2025-05-16,546.69,-2,608450,919215858,218728279,0.349644751233176,87.1298794542772,0.189312972349012
557.31,230,98,98,3207638,3207638,2025-04-25,2025-12-19,546.69,0,0,1084502340,72118262,0.295770500596615,95.3684682690496,0
537.94,330,154,154,3202276,3202276,2025-04-25,2025-06-20,546.69,0,0,1174768001,197089681,0.272587949048163,95.9403375850037,0
547.7,527,1506,1542,1701780,3191940,2025-04-25,2025-04-25,546.69,36,1490160,247323203,111942542,1.29059463943624,65.1293231068174,0.466850880655651
536.98,385,209,209,3176382,3176382,2025-04-25,2025-05-16,546.69,0,0,919215858,218728279,0.34555343800433,87.4754328922816,0
544.84,295,127,127,3172968,3172968,2025-04-25,2025-12-19,546.69,0,0,1084502340,72118262,0.292573642579692,95.6610419116293,0
563.55,545,1823,1702,2428236,3157210,2025-04-25,2025-05-30,546.69,-121,728974,159044187,37473216,1.9851149919739,37.2603772057384,0.230891831712176
547.87,531,1855,1871,1576750,3156377,2025-04-25,2025-04-25,546.69,16,1579627,247323203,111942542,1.27621547906284,66.4055385858803,0.500455744038181
557.63,539,1712,1678,2218752,3126114,2025-04-25,2025-05-16,546.69,-34,907362,919215858,218728279,0.340084863940631,87.8155177562222,0.290252370834845
561.34,315,126,126,3103884,3103884,2025-04-25,2025-12-19,546.69,0,0,1084502340,72118262,0.286203531843002,95.9472454434723,0
567.99,562,5301,5181,1807641,3103419,2025-04-25,2025-05-16,546.69,-120,1295778,919215858,218728279,0.337615911756823,88.153133667979,0.417532405389024
536.5,502,898,898,3098100,3098100,2025-04-25,2025-05-16,546.69,0,0,919215858,218728279,0.337037266387108,88.4901709343661,0
550.6,524,1168,1161,2296288,3088260,2025-04-25,2025-05-02,546.69,-7,791972,157884664,54569672,1.95602278382149,49.0715912724747,0.256446024622279
552.1,520,1040,956,2462720,3068760,2025-04-25,2025-05-09,546.69,-84,606040,106424303,36041450,2.88351430405891,40.0579893861273,0.197486932832805
618.19,615,9625,9590,2473625,3059210,2025-04-25,2025-08-15,546.69,-35,585585,282648688,37799117,1.0823365293668,53.3319432920913,0.191417065190033
537.58,185,86,86,3032188,3032188,2025-04-25,2025-06-20,546.69,0,0,1174768001,197089681,0.258109515871977,96.1984471008757,0
572.83,536,821,815,2501587,3001645,2025-04-25,2025-08-15,546.69,-6,500058,282648688,37799117,1.06197025757997,54.3939135496713,0.166594650599921
555.5,520,858,845,2321748,2999750,2025-04-25,2025-05-23,546.69,-13,678002,70049480,15954371,4.28233014720452,17.2977015675206,0.226019501625135
548.18,536,3224,2459,1676480,2995062,2025-04-25,2025-04-25,546.69,-765,1318582,247323203,111942542,1.21099110947548,67.6165296953558,0.440251988105755
628.46,625,8634,8638,2547030,2988748,2025-04-25,2025-09-19,546.69,4,441718,612220205,74276563,0.488181862602852,92.5002726755809,0.147793658080239
556.95,542,1922,1999,1806680,2988505,2025-04-25,2025-05-09,546.69,77,1181825,106424303,36041450,2.80810389709576,42.8660932832231,0.395456925787308
541.54,165,79,79,2974666,2974666,2025-04-25,2025-09-19,546.69,0,0,612220205,74276563,0.485881709833474,92.9861543854143,0
556.18,480,388,388,2284932,2955784,2025-04-25,2025-07-18,546.69,0,670852.000000001,353688576,64788996,0.835702423139616,88.222694249531,0.226962457337884
546.64,514,907,898,1989958,2931072,2025-04-25,2025-04-25,546.69,-9,941114,247323203,111942542,1.18511808210732,68.8016477774631,0.321081843093585
570.1,560,2824,2902,1866664,2931020,2025-04-25,2025-05-30,546.69,78,1064356,159044187,37473216,1.84289665361992,39.1032738593583,0.363135017843618
560.53,538,1262,1294,2169378,2915382,2025-04-25,2025-05-30,546.69,32,746004,159044187,37473216,1.83306416599809,40.9363380253564,0.255885506599135
551.64,532,1225,1478,1545950,2902792,2025-04-25,2025-05-02,546.69,253,1356842,157884664,54569672,1.83855222315956,50.9101434956343,0.467426532800146
557.03,537,1519,1445,2149385,2894335,2025-04-25,2025-05-16,546.69,-74,744950,919215858,218728279,0.314870003036871,88.805040937403,0.25738209295054
539.19,340,145,145,2888255,2888255,2025-04-25,2025-07-18,546.69,0,0,353688576,64788996,0.816609637965802,89.0393038874968,0
541.65,435,268,268,2858220,2858220,2025-04-25,2025-09-19,546.69,0,0,612220205,74276563,0.466861429377359,93.4530158147917,0
546.81,524,1257,1249,1666782,2848969,2025-04-25,2025-04-25,546.69,-8,1182187,247323203,111942542,1.15192143941303,69.9535692168761,0.414952567051449
557.96,495,452,452,2559224,2845792,2025-04-25,2025-07-18,546.69,0,286568,353688576,64788996,0.804603878413082,89.8439077659099,0.100698856416773
534.72,170,78,78,2844816,2844816,2025-04-25,2025-12-19,546.69,0,0,1084502340,72118262,0.262315339955836,96.2095607834281,0
559.3,543,1766,1745,1893152,2844350,2025-04-25,2025-05-16,546.69,-21,951198,919215858,218728279,0.309432216083461,89.1144731534864,0.33441665055285
533.52,360,163,163,2828376,2828376,2025-04-25,2025-07-18,546.69,0,0,353688576,64788996,0.799679772523951,90.6435875384338,0
508.23,260,113,113,2804999,2804999,2025-04-25,2025-06-20,546.69,0,0,1174768001,197089681,0.238770463411695,96.4372175642874,0
547.8,511,768,756,1906944,2782080,2025-04-25,2025-04-25,546.69,-12,875136,247323203,111942542,1.12487626160979,71.0784454784859,0.31456176673568
555.02,535,1442,1382,1946700,2766764,2025-04-25,2025-05-09,546.69,-60,820064,106424303,36041450,2.59974829245534,45.4658415756784,0.296398247194195
546.56,522,1074,1114,1593816,2735984,2025-04-25,2025-04-25,546.69,40,1142168,247323203,111942542,1.1062383014666,72.1846837799525,0.41746150562284
558,538,1418,1367,1877432,2734000,2025-04-25,2025-05-16,546.69,-51,856568,919215858,218728279,0.297427418838111,89.4119005723245,0.313302121433797
567.87,520,572,571,2313168,2733377,2025-04-25,2025-08-15,546.69,-1,420209,282648688,37799117,0.967058088732398,55.3609716384036,0.15373254402887
547.17,523,1226,1124,1715174,2716708,2025-04-25,2025-04-25,546.69,-102,1001534,247323203,111942542,1.09844445124706,73.2831282311996,0.368657213068169
539.41,375,135,165,2205630,2712765,2025-04-25,2025-05-30,546.69,30,507135,159044187,37473216,1.70566749478244,42.6420055201389,0.186943948333158
563.12,502,447,443,2626125,2707616,2025-04-25,2025-08-15,546.69,-4,81491,282648688,37799117,0.957943947717882,56.3189155861215,0.0300969561414913
554.2,440,237,237,2706540,2706540,2025-04-25,2025-09-19,546.69,0,0,612220205,74276563,0.442086030140087,93.8951018449318,0
549.42,498,527,526,2578084,2704692,2025-04-25,2025-05-16,546.69,-1,126608,919215858,218728279,0.294239049126587,89.7061396214511,0.0468105055954615
539.4,280,104,104,2697760,2697760,2025-04-25,2025-06-20,546.69,0,0,1174768001,197089681,0.229641937616924,96.6668595019043,0
641.77,640,15273,15206,2122947,2691462,2025-04-25,2025-09-19,546.69,-67,568515.000000001,612220205,74276563,0.439623190809261,94.334725035741,0.211229064352386
569.73,562,2661,3471,1285263,2683083,2025-04-25,2025-05-23,546.69,810,1397820,70049480,15954371,3.8302682618058,21.1279698293264,0.520975310864405
552.83,536,1223,1588,1176526,2672604,2025-04-25,2025-05-02,546.69,365,1496078,157884664,54569672,1.69275718888061,52.6029006845149,0.559782893387872
556.29,526,878,879,2111590,2662491,2025-04-25,2025-05-30,546.69,1,550901,159044187,37473216,1.67405741147899,44.3160629316179,0.206911873129336
575.66,544,837,838,2187081,2653108,2025-04-25,2025-08-15,546.69,1,466027,282648688,37799117,0.938659230571061,57.2575748166926,0.1756532338676
555.78,555,13380,33926,468300,2646228,2025-04-25,2025-04-25,546.69,20546,2177928,247323203,111942542,1.06994732718224,74.3530755583818,0.823031122034836
547.32,521,1052,997,1654796,2624104,2025-04-25,2025-04-25,546.69,-55,969308,247323203,111942542,1.0610019473183,75.4140775057001,0.369386274324493
563,541,1222,1191,1862328,2620200,2025-04-25,2025-05-30,546.69,-31,757872,159044187,37473216,1.64746668798401,45.9635296196019,0.289242042592169
546.57,485,417,417,2546202,2567469,2025-04-25,2025-05-02,546.69,0,21267,157884664,54569672,1.62616744080983,54.2290681253247,0.00828325483189865
542.32,445,263,263,2559516,2559516,2025-04-25,2025-09-19,546.69,0,0,612220205,74276563,0.418071141575603,94.7527961773166,0
547.92,512,722,712,1734244,2557504,2025-04-25,2025-04-25,546.69,-10,823260,247323203,111942542,1.03407362066227,76.4481511263624,0.32189978979505
564.2,547,1386,1482,1611918,2549040,2025-04-25,2025-05-30,546.69,96,937122,159044187,37473216,1.60272440513654,47.5662540247384,0.367637228132944
592.75,585,3247,3286,1785850,2546650,2025-04-25,2025-07-18,546.69,39,760800,353688576,64788996,0.720026083059013,91.3636136214928,0.298745410637504
563.39,553,2559,2445,1637760,2540355,2025-04-25,2025-05-16,546.69,-114,902595.000000001,919215858,218728279,0.276361093848753,89.9825007152999,0.355302703755971
550.67,526,1011,1024,1675227,2526208,2025-04-25,2025-05-02,546.69,13,850981,157884664,54569672,1.6000338069567,55.8291019322814,0.336861018570126
546.6,517,844,851,1633140,2518960,2025-04-25,2025-04-25,546.69,7,885820,247323203,111942542,1.01848915485702,77.4666402812194,0.3516610029536
550.43,507,585,580,2126475,2518940,2025-04-25,2025-05-16,546.69,-5,392465,919215858,218728279,0.274031390785689,90.2565321060856,0.155805616648273
575.19,543,781,781,2437501,2514039,2025-04-25,2025-08-15,546.69,0,76538,282648688,37799117,0.889457162454616,58.1470319791472,0.0304442373407891
567.44,561,3790,3900,1440200,2511600,2025-04-25,2025-05-16,546.69,110,1071400,919215858,218728279,0.273232884108925,90.5297649901945,0.426580665711101
551.65,549,2672,9457,251168,2506105,2025-04-25,2025-04-25,546.69,6785,2254937,247323203,111942542,1.01329150261733,78.4799317838367,0.89977754323941
553.5,541,2260,2003,1661100,2503750,2025-04-25,2025-05-02,546.69,-257,842650,157884664,54569672,1.58580949952175,57.4149114318032,0.336555167249126
571.77,568,6676,6639,1515452,2502903,2025-04-25,2025-05-16,546.69,-37,987451,919215858,218728279,0.272286751606498,90.802051741801,0.394522280727619
576.62,547,834,838,2095008,2482156,2025-04-25,2025-08-15,546.69,4,387148,282648688,37799117,0.878177081791372,59.0252090609386,0.155972469095415
547.3,320,109,109,2286057,2477570,2025-04-25,2025-06-20,546.69,0,191513,1174768001,197089681,0.210898662364911,96.8777581642692,0.0772987241531016
548.31,485,405,389,2383830,2462759,2025-04-25,2025-05-16,546.69,-16,78929,919215858,218728279,0.267919551057179,91.0699712928582,0.0320490149462453
511.72,160,70,70,2462040,2462040,2025-04-25,2025-12-19,546.69,0,0,1084502340,72118262,0.227020257051728,96.4365810404798,0
552.9,525,840,882,1582560,2460780,2025-04-25,2025-05-09,546.69,42,878220,106424303,36041450,2.31223501646988,47.7780765921483,0.356886840757809
626.97,625,12271,12368,1914276,2436496,2025-04-25,2025-08-15,546.69,97,522220,282648688,37799117,0.862022752428272,59.8872318133669,0.21433238552413
558.1,545,1809,1850,1470717,2423500,2025-04-25,2025-05-09,546.69,41,952783,106424303,36041450,2.27720542365215,50.0552820158005,0.393143387662472
582.07,561,1076,1141,2017500,2404087,2025-04-25,2025-08-15,546.69,65,386587,282648688,37799117,0.850556575022913,60.7377883883898,0.160804080717545
542.17,435,223,223,2389891,2389891,2025-04-25,2025-06-20,546.69,0,0,1174768001,197089681,0.203435146170618,97.0811933104399,0
546.99,185,65,65,2352935,2352935,2025-04-25,2025-12-19,546.69,0,0,1084502340,72118262,0.216959882262679,96.6535409227425,0
547.23,315,101,101,2345523,2345523,2025-04-25,2025-06-20,546.69,0,0,1174768001,197089681,0.199658400467447,97.2808517109073,0
552.88,510,548,546,1962388,2341248,2025-04-25,2025-05-30,546.69,-2,378860.000000001,159044187,37473216,1.47207392119273,49.0383279459312,0.161819679077142
560.54,537,1037,994,1843786,2339876,2025-04-25,2025-05-30,546.69,-43,496090,159044187,37473216,1.47121126784722,50.5095392137784,0.212015508514126
545.41,495,464,464,2100064,2339024,2025-04-25,2025-05-16,546.69,0,238960,919215858,218728279,0.25445862140468,91.3244299142629,0.102162269390994
548.46,537,3035,2036,1447695,2333256,2025-04-25,2025-04-25,546.69,-999,885561,247323203,111942542,0.943403599701885,79.4233353835386,0.379538721854782
542.46,499,534,534,2320764,2320764,2025-04-25,2025-05-16,546.69,0,0,919215858,218728279,0.252472145666573,91.5769020599294,0
548.06,534,1758,1649,1121604,2318494,2025-04-25,2025-04-25,546.69,-109,1196890,247323203,111942542,0.93743489162236,80.360770275161,0.516235970418729
550.83,527,968,971,1525568,2313893,2025-04-25,2025-05-02,546.69,3,788325,157884664,54569672,1.46555906151848,58.8804704933216,0.340692071759584
515.91,235,82,82,2303462,2303462,2025-04-25,2025-06-20,546.69,0,0,1174768001,197089681,0.196078033964087,97.4769297448714,0
550.35,546,2358,5289,346626,2300715,2025-04-25,2025-04-25,546.69,2931,1954089,247323203,111942542,0.930246322258733,81.2910165974197,0.849339879124533
552,500,439,439,1904382,2282800,2025-04-25,2025-05-30,546.69,0,378418,159044187,37473216,1.435324385669,51.9448635994474,0.165769230769231
553.1,539,1579,1616,1301096,2278560,2025-04-25,2025-05-02,546.69,37,977464,157884664,54569672,1.44318006719133,60.323650560513,0.428983217470683
548.38,529,1358,1169,1337630,2265522,2025-04-25,2025-04-25,546.69,-189,927892,247323203,111942542,0.916016763700088,82.2070333611198,0.409570950977302
565.85,559,3294,3293,1367010,2255705,2025-04-25,2025-05-16,546.69,-1,888695,919215858,218728279,0.245394482739657,91.8222965426691,0.393976605983495
545.59,335,107,107,2253313,2253313,2025-04-25,2025-07-18,546.69,0,0,353688576,64788996,0.637089562089786,92.0007031835826,0
560.03,555,4688,4467,1148560,2246901,2025-04-25,2025-05-02,546.69,-221,1098341,157884664,54569672,1.423128087982,61.746778648495,0.488824830288473
551.8,450,220,220,2239600,2239600,2025-04-25,2025-09-19,546.69,0,0,612220205,74276563,0.3658160873668,95.1186122646834,0
563.9,550,1704,1609,1533600,2236510,2025-04-25,2025-05-23,546.69,-95,702910,70049480,15954371,3.19275746229665,24.320727291623,0.314288780287144
548.55,539,2961,2336,1128141,2230880,2025-04-25,2025-04-25,546.69,-625,1102739,247323203,111942542,0.902009990546662,83.1090433516665,0.494306730976117
536.81,305,96,96,2225376,2225376,2025-04-25,2025-06-20,546.69,0,0,1174768001,197089681,0.189431104533464,97.6663608494049,0
557.45,536,1022,1037,1516648,2224365,2025-04-25,2025-05-16,546.69,15,707717,919215858,218728279,0.241985055048952,92.064281597718,0.318165858570873
549.34,496,424,416,1925384,2218944,2025-04-25,2025-05-16,546.69,-8,293560,919215858,218728279,0.241395313264928,92.305676910983,0.13229716477748
500.29,220,79,79,2214291,2214291,2025-04-25,2025-06-20,546.69,0,0,1174768001,197089681,0.188487513970003,97.8548483633749,0
503.27,240,84,84,2211468,2211468,2025-04-25,2025-06-20,546.69,0,0,1174768001,197089681,0.188247211204044,98.0430955745789,0
555.08,450,210,210,2082360,2206680,2025-04-25,2025-08-15,546.69,0,124320,282648688,37799117,0.780714750743863,61.5185031391336,0.0563380281690142
595.61,585,2038,2077,1663008,2203697,2025-04-25,2025-08-15,546.69,39,540688.999999999,282648688,37799117,0.779659377014338,62.298162516148,0.245355418644214
550.16,506,501,497,1785564,2194752,2025-04-25,2025-05-16,546.69,-4,409188,919215858,218728279,0.238763504882876,92.5444404158659,0.186439287901321
549.8,522,776,786,1526392,2185080,2025-04-25,2025-05-02,546.69,10,658688,157884664,54569672,1.38397229005092,63.1307509385459,0.30144800190382
546.43,450,224,225,1630272,2169675,2025-04-25,2025-05-02,546.69,1,539403,157884664,54569672,1.37421516759855,64.5049661061444,0.24861004528328
551.29,495,384,385,1905024,2167165,2025-04-25,2025-05-30,546.69,1,262141,159044187,37473216,1.36261817604186,53.3074817754892,0.120960332969571
547.4,519,755,759,1351450,2155560,2025-04-25,2025-04-25,546.69,4,804110,247323203,111942542,0.871555913013143,83.9805992646796,0.373039952494943
560.06,540,1107,1073,1578582,2152438,2025-04-25,2025-05-23,546.69,-34,573856,70049480,15954371,3.0727394407496,27.3934667323726,0.266607446997312
579.11,553,773,822,1701373,2146242,2025-04-25,2025-08-15,546.69,49,444869,282648688,37799117,0.759332022797148,63.0574945389451,0.207278116820004
537.83,495,501,501,2250993,2145783,2025-04-25,2025-05-02,546.69,0,-105210,157884664,54569672,1.35908260222158,65.864048708366,-0.0490310530002335
519.93,265,84,84,2141412,2141412,2025-04-25,2025-06-20,546.69,0,0,1174768001,197089681,0.182283820990797,98.2253793955697,0
576.05,546,710,711,1821860,2136555,2025-04-25,2025-08-15,546.69,1,314695,282648688,37799117,0.75590480009587,63.813399339041,0.147290849053734
549.65,544,2927,3760,576619,2124400,2025-04-25,2025-04-25,546.69,833,1547781,247323203,111942542,0.858957014235337,84.8395562789149,0.72857324421013
550.72,515,617,592,1715260,2114624,2025-04-25,2025-05-09,546.69,-25,399364,106424303,36041450,1.98697472324531,52.0422567390458,0.188858161072607
571.94,537,603,603,1929600,2106882,2025-04-25,2025-08-15,546.69,0,177282,282648688,37799117,0.745406608786381,64.5588059478274,0.0841442472810532
510.4,320,110,110,2094400,2094400,2025-04-25,2025-12-19,546.69,0,0,1084502340,72118262,0.193120837341854,96.8466617600844,0
572.16,570,8031,9679,875379,2090664,2025-04-25,2025-05-09,546.69,1648,1215285,106424303,36041450,1.96446106863392,54.0067178076797,0.581291398330865
538.26,285,81,81,2051406,2051406,2025-04-25,2025-06-20,546.69,0,0,1174768001,197089681,0.174622223132889,98.4000016187026,0
563.2,560,6107,6391,897729,2045120,2025-04-25,2025-05-02,546.69,284,1147391,157884664,54569672,1.2953253015125,67.1593740098785,0.561038472070099
568.65,560,2222,2360,1166550,2041400,2025-04-25,2025-05-23,546.69,138,874850,70049480,15954371,2.91422577298218,30.3076925053548,0.428553933574998
565.62,557,2261,2364,1148588,2037768,2025-04-25,2025-05-16,546.69,103,889180,919215858,218728279,0.221685470530688,92.7661258863965,0.436349967219036
547.33,513,590,591,1568220,2028903,2025-04-25,2025-04-25,546.69,1,460683,247323203,111942542,0.820344785846882,85.6599010647618,0.22706014038128
512.62,275,85,85,2019770,2019770,2025-04-25,2025-06-20,546.69,0,0,1174768001,197089681,0.171929265887452,98.57193088459,0
535.33,370,122,122,2017026,2017026,2025-04-25,2025-05-30,546.69,0,0,159044187,37473216,1.26821736653601,54.5756991420252,0
510.15,290,91,91,2003365,2003365,2025-04-25,2025-06-20,546.69,0,0,1174768001,197089681,0.170532819952082,98.7424637045421,0
562.98,552,1816,1822,1220352,2000556,2025-04-25,2025-05-16,546.69,6,780204,919215858,218728279,0.217637237498572,92.9837631238951,0.389993581784264
536.88,330,96,96,1986048,1986048,2025-04-25,2025-12-19,546.69,0,0,1084502340,72118262,0.183129895321388,97.0297916554058,0
563.83,554,2264,2020,1301800,1985660,2025-04-25,2025-05-16,546.69,-244,683860,919215858,218728279,0.21601672585592,93.199779849751,0.344399343291399
548.2,500,407,409,1590149,1971380,2025-04-25,2025-05-09,546.69,2,381231,106424303,36041450,1.85237764723721,55.8590954549169,0.193382807982226
562.11,542,921,978,1329003,1966758,2025-04-25,2025-05-30,546.69,57,637755,159044187,37473216,1.23661105576905,55.8123101977943,0.324267144203811
558.28,546,1551,1574,1115169,1932872,2025-04-25,2025-05-09,546.69,23,817703,106424303,36041450,1.8161941826389,57.6752896375558,0.423050776254196
562.59,509,359,359,1778486,1923881,2025-04-25,2025-08-15,546.69,0,145395,282648688,37799117,0.680661570946333,65.2394675187737,0.0755738010822916
562.24,543,971,993,1365226,1910532,2025-04-25,2025-05-30,546.69,22,545306,159044187,37473216,1.20125861626115,57.0135688140554,0.285421024091719
568.73,563,3087,3272,994014,1874856,2025-04-25,2025-05-16,546.69,185,880842,919215858,218728279,0.203962538688057,93.4037423884391,0.469818482059422
585,565,949,937,1464307,1874000,2025-04-25,2025-08-15,546.69,-12,409693,282648688,37799117,0.66301386829717,65.9024813870709,0.218619530416222
553.48,552,12011,12634,672616,1869832,2025-04-25,2025-04-25,546.69,623,1197216,247323203,111942542,0.756027731049561,86.4159287958114,0.640279982372748
566.69,525,448,448,1671488,1867712,2025-04-25,2025-08-15,546.69,0,196224,282648688,37799117,0.660789198497889,66.5632705855688,0.105061165747182
545.4,490,342,337,1598166,1866980,2025-04-25,2025-04-25,546.69,-5,268814,247323203,111942542,0.754874584088255,87.1708033798996,0.143983331369377
671.83,670,10130,10144,1499240,1856352,2025-04-25,2025-12-19,546.69,14,357112,1084502340,72118262,0.1711708616507,97.2009625170564,0.192372998224475
520.54,310,88,88,1852752,1852752,2025-04-25,2025-12-19,546.69,0,0,1084502340,72118262,0.17083891215947,97.3718014292159,0
567.87,528,465,464,1680045,1849968,2025-04-25,2025-08-15,546.69,-1,169923,282648688,37799117,0.654511440718239,67.217782026287,0.0918518590591837
551.48,531,932,902,1236764,1847296,2025-04-25,2025-05-02,546.69,-30,610532,157884664,54569672,1.17002877492902,68.3294027848075,0.330500363774945
537.63,506,583,583,1844029,1844029,2025-04-25,2025-05-02,546.69,0,0,157884664,54569672,1.16795954292305,69.4973623277306,0
536.61,375,114,114,1842354,1842354,2025-04-25,2025-09-19,546.69,0,0,612220205,74276563,0.300929957056873,95.4195422217403,0
584.97,567,979,1017,1566400,1827549,2025-04-25,2025-08-15,546.69,38,261149,282648688,37799117,0.646579686228722,67.8643617125157,0.142895758198549
622.48,620,7377,7361,1386876,1825528,2025-04-25,2025-08-15,546.69,-16,438652,282648688,37799117,0.645864664335537,68.5102263768513,0.240287741409609
550.1,450,181,182,1600040,1821820,2025-04-25,2025-05-30,546.69,1,221780,159044187,37473216,1.14548040664951,58.1590492207049,0.121735407449693
580,556,523,757,1097254,1816800,2025-04-25,2025-08-15,546.69,234,719546,282648688,37799117,0.642776732082337,69.1530031089336,0.39605129898723
544.72,355,95,95,1802340,1802340,2025-04-25,2025-12-19,546.69,0,0,1084502340,72118262,0.166190512783956,97.5379919419999,0
529.11,390,129,129,1794519,1794519,2025-04-25,2025-06-20,546.69,0,0,1174768001,197089681,0.152755182169794,98.8952188867119,0
549.35,350,90,90,1794150,1794150,2025-04-25,2025-09-19,546.69,0,0,612220205,74276563,0.293056319498635,95.7125985412389,0
564.21,527,478,478,1778638,1778638,2025-04-25,2025-08-15,546.69,0,0,282648688,37799117,0.629275165784601,69.7822782747182,0
640.91,635,3007,3006,1512521,1776546,2025-04-25,2025-12-19,546.69,-1,264025,1084502340,72118262,0.163812094679298,97.7018040366792,0.148617035528492
546.1,495,349,347,1383087,1773170,2025-04-25,2025-04-25,546.69,-2,390083,247323203,111942542,0.716944459109241,87.8877478390089,0.219991878951257
570.68,566,3632,3776,915264,1767168,2025-04-25,2025-05-16,546.69,144,851904,919215858,218728279,0.192247336098503,93.5959897245376,0.482073011734029
514.21,350,107,107,1757047,1757047,2025-04-25,2025-07-18,546.69,0,0,353688576,64788996,0.496777990364043,92.4974811739466,0
533.56,190,51,51,1752156,1752156,2025-04-25,2025-12-19,546.69,0,0,1084502340,72118262,0.161563136876219,97.8633671735554,0
540.49,305,74,74,1742626,1742626,2025-04-25,2025-05-30,546.69,0,0,159044187,37473216,1.09568669743334,59.2547359181383,0
541.08,395,119,119,1738352,1738352,2025-04-25,2025-05-16,546.69,0,0,919215858,218728279,0.189112490267765,93.7851022148054,0
590.08,576,1231,1234,1450118,1737472,2025-04-25,2025-08-15,546.69,3,287354,282648688,37799117,0.614710796039499,70.3969890707577,0.165386262339767
558.91,225,52,52,1736332,1736332,2025-04-25,2025-12-19,546.69,0,0,1084502340,72118262,0.160104034445882,98.0234712080013,0
536.72,480,305,305,1729960,1729960,2025-04-25,2025-04-25,546.69,0,0,247323203,111942542,0.699473393121146,88.58722123213,0
590.63,590,27029,27397,1027102,1726011,2025-04-25,2025-05-16,546.69,368,698909,919215858,218728279,0.187769932924721,93.9728721477301,0.404927315063461
521.36,370,114,114,1725504,1725504,2025-04-25,2025-12-19,546.69,0,0,1084502340,72118262,0.159105604142818,98.1825768121441,0
564.81,531,510,510,1724310,1724310,2025-04-25,2025-08-15,546.69,0,0,282648688,37799117,0.610054131933561,71.0070432026913,0
571.7,345,76,76,1722920,1722920,2025-04-25,2025-12-19,546.69,0,0,1084502340,72118262,0.158867338174669,98.3414441503188,0
548.65,512,468,469,1263600,1718885,2025-04-25,2025-05-02,546.69,1,455285,157884664,54569672,1.08869661970462,70.5860589474352,0.264872286394959
552.29,534,937,936,1071928,1711944,2025-04-25,2025-05-02,546.69,-1,640016,157884664,54569672,1.08430037258084,71.670359320016,0.373853350343236
529.36,340,90,90,1704240,1704240,2025-04-25,2025-12-19,546.69,0,0,1084502340,72118262,0.157144889147957,98.4985890394667,0
558.55,552,1375,2596,462000,1700380,2025-04-25,2025-05-02,546.69,1221,1238380,157884664,54569672,1.07697603866073,72.7473353586768,0.728296027946694
550.99,528,709,738,1070590,1696662,2025-04-25,2025-05-02,546.69,29,626072,157884664,54569672,1.07462115509838,73.8219565137752,0.369002193719197
591.58,578,1245,1246,1325925,1692068,2025-04-25,2025-08-15,546.69,1,366143,282648688,37799117,0.598647038474843,71.6056902411661,0.216387875664571
552.21,505,360,357,1427400,1685397,2025-04-25,2025-05-30,546.69,-3,257997,159044187,37473216,1.05970361557446,60.3144395337127,0.153077880167106
549.37,529,823,824,1232854,1678488,2025-04-25,2025-05-02,546.69,1,445634,157884664,54569672,1.06311022076216,74.8850667345373,0.265497280886131
539.58,394,115,115,1674170,1674170,2025-04-25,2025-05-16,546.69,0,0,919215858,218728279,0.182130234746233,94.1550023824763,0
540.38,315,74,74,1667812,1667812,2025-04-25,2025-05-30,546.69,0,0,159044187,37473216,1.04864693985955,61.3630864735723,0
579.31,575,3650,3867,949000,1666677,2025-04-25,2025-05-30,546.69,217,717677,159044187,37473216,1.04793330170564,62.4110197752779,0.430603530258112
560.41,535,773,651,1466381,1654191,2025-04-25,2025-05-30,546.69,-122,187810,159044187,37473216,1.04008265325661,63.4511024285345,0.113535861336448
569.3,335,70,70,1640100,1640100,2025-04-25,2025-12-19,546.69,0,0,1084502340,72118262,0.151230655712555,98.6498196951793,0
564.92,556,1928,1838,1037264,1639496,2025-04-25,2025-05-16,546.69,-90,602232,919215858,218728279,0.178358106611342,94.3333604890876,0.367327520164734
535.15,390,112,112,1625680,1625680,2025-04-25,2025-09-19,546.69,0,0,612220205,74276563,0.265538442985559,95.9781369842245,0
567.27,522,359,359,1625193,1625193,2025-04-25,2025-08-15,546.69,0,0,282648688,37799117,0.574986925111784,72.1806771662779,0
530.83,260,60,60,1624980,1624980,2025-04-25,2025-04-25,546.69,0,0,247323203,111942542,0.657026910653426,89.2442481427834,0
545.98,508,418,427,1190464,1621746,2025-04-25,2025-04-25,546.69,9,431282,247323203,111942542,0.655719309926615,89.8999674527101,0.265936835978014
541.11,405,119,119,1619709,1619709,2025-04-25,2025-06-20,546.69,0,0,1174768001,197089681,0.137874797289444,99.0330936840014,0
571.56,534,429,429,1479621,1611324,2025-04-25,2025-08-15,546.69,0,131703,282648688,37799117,0.570080127171862,72.7507572934497,0.0817358892438766
548.4,511,430,430,1608200,1608200,2025-04-25,2025-08-15,546.69,0,0,282648688,37799117,0.568974868193975,73.3197321616437,0
548.59,523,658,628,1189664,1607052,2025-04-25,2025-05-02,546.69,-30,417388,157884664,54569672,1.01786453432868,75.902931268866,0.259722771882926
542.3,485,279,279,1598670,1598670,2025-04-25,2025-07-18,546.69,0,0,353688576,64788996,0.451999331751105,92.9494805056978,0
555.89,525,521,517,1200384,1597013,2025-04-25,2025-05-23,546.69,-4,396629,70049480,15954371,2.27983562476124,32.587528130116,0.2483567760563
559.11,325,68,68,1591948,1591948,2025-04-25,2025-12-19,546.69,0,0,1084502340,72118262,0.146790646850979,98.7966103420302,0
560.19,475,186,186,1468656,1584534,2025-04-25,2025-09-19,546.69,0,115878,612220205,74276563,0.25881765859067,96.2369546428152,0.0731306491372227
583.05,580,5710,5150,1044930,1570750,2025-04-25,2025-05-30,546.69,-560,525820,159044187,37473216,0.98761861695706,64.4387210454916,0.334757281553398
583.19,563,768,775,1368576,1564725,2025-04-25,2025-08-15,546.69,7,196149,282648688,37799117,0.553593583282439,73.8733257449262,0.125356851842976
554.29,542,1189,1270,825166,1560830,2025-04-25,2025-05-02,546.69,81,735664,157884664,54569672,0.988588733355381,76.8915200022214,0.471328716131802
587.91,572,978,980,1304652,1559180,2025-04-25,2025-08-15,546.69,2,254528,282648688,37799117,0.551631783976298,74.4249575289025,0.163244782513886
610.05,605,3098,3083,1177240,1556915,2025-04-25,2025-08-15,546.69,-15,379675,282648688,37799117,0.550830435837721,74.9757879647402,0.243863666288783
569.36,564,2922,2898,870756,1553328,2025-04-25,2025-05-16,546.69,-24,682572,919215858,218728279,0.168984029864289,94.5023445189519,0.439425543091993
649.43,645,3527,3505,1410800,1552715,2025-04-25,2025-12-19,546.69,-22,141915,1084502340,72118262,0.143173042853923,98.9397833848842,0.0913979706514074
506.11,393,137,137,1549607,1549607,2025-04-25,2025-05-16,546.69,0,0,919215858,218728279,0.168579228318753,94.6709237472707,0
544.84,470,207,207,1549188,1549188,2025-04-25,2025-07-18,546.69,0,0,353688576,64788996,0.438009058002484,93.3874895637002,0
545,507,402,406,1256652,1542800,2025-04-25,2025-04-25,546.69,4,286148,247323203,111942542,0.62379913460849,90.5237665873185,0.185473165672803
555.72,515,382,377,1219726,1535144,2025-04-25,2025-05-30,546.69,-5,315418,159044187,37473216,0.965231127875173,65.4039521733668,0.205464764217559
547.45,425,124,124,1518380,1518380,2025-04-25,2025-08-15,546.69,0,0,282648688,37799117,0.537196903599284,75.5129848683395,0
553.67,400,98,98,1505966,1505966,2025-04-25,2025-09-19,546.69,0,0,612220205,74276563,0.245984367667186,96.4829390104824,0
539.34,475,233,233,1499122,1499122,2025-04-25,2025-07-18,546.69,0,0,353688576,64788996,0.42385366724426,93.8113432309445,0
533.31,391,104,104,1480024,1480024,2025-04-25,2025-05-16,546.69,0,0,919215858,218728279,0.161009406780709,94.8319331540514,0
607.85,605,5113,5181,1043052,1476585,2025-04-25,2025-07-18,546.69,68,433533,353688576,64788996,0.417481677440439,94.2288249083849,0.293605176810004
567.15,532,420,420,1476300,1476300,2025-04-25,2025-08-15,546.69,0,0,282648688,37799117,0.522309164230049,76.0352940325695,0
574.67,570,3141,3153,844929,1472451,2025-04-25,2025-05-23,546.69,12,627522,70049480,15954371,2.10201560382747,34.6895437339435,0.426175132483186
541.82,425,126,126,1471932,1471932,2025-04-25,2025-06-20,546.69,0,0,1174768001,197089681,0.12529554761,99.1583892316114,0
580.8,557,518,613,1058274,1458940,2025-04-25,2025-08-15,546.69,95,400666,282648688,37799117,0.516167264148065,76.5514612967176,0.27462815468765
547.32,509,378,378,1009260,1448496,2025-04-25,2025-04-25,546.69,0,439236,247323203,111942542,0.585669270990316,91.1094358583089,0.303235908141962
549.73,490,241,241,1305979,1439493,2025-04-25,2025-05-23,546.69,0,133514,70049480,15954371,2.05496600403029,36.7445097379738,0.0927507115352418
700.7,700,20505,20485,1271310,1433950,2025-04-25,2025-12-19,546.69,-20,162640,1084502340,72118262,0.132221936930076,99.0720053218143,0.11342097004777
542.59,250,49,49,1433691,1433691,2025-04-25,2025-04-25,546.69,0,0,247323203,111942542,0.579683176753942,91.6891190350628,0
549.46,460,160,160,1431360,1431360,2025-04-25,2025-07-18,546.69,0,0,353688576,64788996,0.404695004907368,94.6335199132923,0
540.08,480,238,238,1429904,1429904,2025-04-25,2025-05-23,546.69,0,0,70049480,15954371,2.04127710869517,38.785786846669,0
554.64,543,1061,1219,657820,1418916,2025-04-25,2025-05-02,546.69,158,761096,157884664,54569672,0.898704132530567,77.7902241347519,0.536392570102811
545.88,493,268,268,1417184,1417184,2025-04-25,2025-08-15,546.69,0,0,282648688,37799117,0.501394154711236,77.0528554514288,0
557.11,529,503,503,1413933,1413933,2025-04-25,2025-08-15,546.69,0,0,282648688,37799117,0.500243963630215,77.553099415059,0
557.7,544,801,1031,637596,1412470,2025-04-25,2025-05-09,546.69,230,774874,106424303,36041450,1.3272062491215,59.0024958866773,0.548595014407386
569.24,559,1384,1378,943888,1411072,2025-04-25,2025-05-30,546.69,-6,467184,159044187,37473216,0.887220103177993,66.2911722765448,0.331084452104499
581.83,559,572,618,1114256,1410894,2025-04-25,2025-08-15,546.69,46,296638,282648688,37799117,0.49916877731978,78.0522681923788,0.210248253943953
579.05,554,551,563,1173079,1410315,2025-04-25,2025-08-15,546.69,12,237236,282648688,37799117,0.498963929385018,78.5512321217638,0.168214902344512
646.54,645,9138,9141,1060008,1407714,2025-04-25,2025-09-19,546.69,3,347706,612220205,74276563,0.229935893736144,96.7128749042185,0.247000456058546
549.11,460,147,157,1061340,1399027,2025-04-25,2025-05-30,546.69,10,337687,159044187,37473216,0.879646736161442,67.1708190127062,0.241372754064075
585.94,585,14290,14834,771660,1394396,2025-04-25,2025-05-16,546.69,544,622736,919215858,218728279,0.151694075756469,94.9836272298079,0.446599100972751
637.12,635,6549,6559,1146075,1390508,2025-04-25,2025-09-19,546.69,10,244433,612220205,74276563,0.22712546705315,96.9400003712716,0.175786834739534
599.69,595,2915,2951,1011505,1384019,2025-04-25,2025-07-18,546.69,36,372514,353688576,64788996,0.391310065949091,95.0248299792414,0.269153819420109
546.63,360,74,74,1381062,1381062,2025-04-25,2025-09-19,546.69,0,0,612220205,74276563,0.225582558158139,97.1655829294298,0
651.15,650,12227,11992,1088203,1379080,2025-04-25,2025-09-19,546.69,-235,290877,612220205,74276563,0.225258818434455,97.3908417478643,0.210921048815152
586.02,569,791,810,1183336,1378620,2025-04-25,2025-08-15,546.69,19,195284,282648688,37799117,0.487750362386257,79.0389824841501,0.141651796724261
548.2,514,401,403,1147261,1378260,2025-04-25,2025-05-02,546.69,2,230999,157884664,54569672,0.872953689789656,78.6631778245416,0.167601903849782
550.49,523,497,497,1303631,1366253,2025-04-25,2025-05-09,546.69,0,62622,106424303,36041450,1.28377913830453,60.2862750249819,0.0458348490360131
585.98,568,704,757,1037696,1361086,2025-04-25,2025-08-15,546.69,53,323390,282648688,37799117,0.481546901785017,79.5205293859351,0.237597036484102
500.92,170,41,41,1356772,1356772,2025-04-25,2025-06-20,546.69,0,0,1174768001,197089681,0.115492761025587,99.273881992637,0
577.34,549,467,478,1122201,1354652,2025-04-25,2025-08-15,546.69,11,232451,282648688,37799117,0.479270577756936,79.999799963692,0.171594623563838
553.12,538,890,885,766290,1338120,2025-04-25,2025-05-02,546.69,-5,571830,157884664,54569672,0.847530067898172,79.5107078924398,0.427338355304457
527.4,446,164,164,1334960,1334960,2025-04-25,2025-08-15,546.69,0,0,282648688,37799117,0.472303625198501,80.4721035888905,0
544.13,430,116,116,1323908,1323908,2025-04-25,2025-08-15,546.69,0,0,282648688,37799117,0.468393470837551,80.9404970597281,0
524.91,375,88,88,1319208,1319208,2025-04-25,2025-05-23,546.69,0,0,70049480,15954371,1.88325166725006,40.669038513919,0
662.57,660,5136,5129,1032336,1318153,2025-04-25,2025-12-19,546.69,-7,285817,1084502340,72118262,0.121544504920109,99.1935498267344,0.21683143003885
547.25,509,350,342,1066450,1308150,2025-04-25,2025-05-02,546.69,-8,241700,157884664,54569672,0.828547856934351,80.3392557493741,0.184764744104269
554.6,517,466,347,1702764,1304720,2025-04-25,2025-05-30,546.69,-119,-398044,159044187,37473216,0.820350636266889,67.9911696489731,-0.305080017168435
571.29,567,3112,3034,765552,1301586,2025-04-25,2025-05-16,546.69,-78,536034,919215858,218728279,0.141597426618808,95.1252246564267,0.411831411831412
551.34,500,256,253,1111296,1298902,2025-04-25,2025-05-23,546.69,-3,187606,70049480,15954371,1.8542635862536,42.5233021001726,0.144434299123413
549.23,400,87,87,1298301,1298301,2025-04-25,2025-08-15,546.69,0,0,282648688,37799117,0.459333814420536,81.3998308741486,0
540.29,300,54,54,1254204,1297566,2025-04-25,2025-05-30,546.69,0,43362,159044187,37473216,0.815852515250997,68.8070221642241,0.0334179533064214
547.68,521,497,486,975114,1296648,2025-04-25,2025-05-02,546.69,-11,321534,157884664,54569672,0.821262792186073,81.1605185415602,0.24797323560442
552.83,551,4232,7039,275080,1288137,2025-04-25,2025-04-25,546.69,2807,1013057,247323203,111942542,0.520831440145953,92.2099504752088,0.786451285849254
550.1,505,285,285,1023435,1285350,2025-04-25,2025-05-09,546.69,0,261915,106424303,36041450,1.20775984786107,61.4940348728429,0.203769401330377
542.86,480,226,203,1309896,1276058,2025-04-25,2025-05-02,546.69,-23,-33838,157884664,54569672,0.808221626895947,81.9687401684561,-0.0265176034318189
531.43,370,79,79,1275297,1275297,2025-04-25,2025-05-23,546.69,0,0,70049480,15954371,1.82056597707792,44.3438680772505,0
558.5,531,451,461,970552,1267750,2025-04-25,2025-05-30,546.69,10,297198,159044187,37473216,0.797105523888151,69.6041276881122,0.234429501084599
538.31,420,107,107,1265917,1265917,2025-04-25,2025-05-16,546.69,0,0,919215858,218728279,0.137717054050214,95.2629417104769,0
570.54,561,1284,1316,792228,1255464,2025-04-25,2025-05-30,546.69,32,463236,159044187,37473216,0.78938062665566,70.3935083147679,0.368975932404274
547.15,516,399,401,960393,1249115,2025-04-25,2025-05-02,546.69,2,288722,157884664,54569672,0.791156638240684,82.7598968066968,0.231141248003587
546.79,395,82,82,1244678,1244678,2025-04-25,2025-07-18,546.69,0,0,353688576,64788996,0.35191354328617,95.3767435225276,0
555.67,546,1771,1280,966966,1237760,2025-04-25,2025-05-02,546.69,-491,270794,157884664,54569672,0.78396467943207,83.5438614861289,0.218777468976215
565.04,507,213,213,1236252,1236252,2025-04-25,2025-08-15,546.69,0,0,282648688,37799117,0.437381120976581,81.8372119951252,0
525.45,442,148,148,1235060,1235060,2025-04-25,2025-08-15,546.69,0,0,282648688,37799117,0.436959396040077,82.2741713911653,0
551.31,533,661,673,770065,1232263,2025-04-25,2025-05-02,546.69,12,462198,157884664,54569672,0.780483023987688,84.3243445101166,0.375080644310508
552.85,537,609,777,577941,1231545,2025-04-25,2025-05-02,546.69,168,653604,157884664,54569672,0.780028261642942,85.1043727717595,0.530718731349646
572.79,565,1404,1580,694980,1230820,2025-04-25,2025-05-30,546.69,176,535840,159044187,37473216,0.773885561752722,71.1673938765206,0.435352041728279
542.05,495,261,261,1228005,1228005,2025-04-25,2025-05-09,546.69,0,0,106424303,36041450,1.1538764787588,62.6479113516017,0
559.16,535,524,505,892372,1220080,2025-04-25,2025-05-23,546.69,-19,327708,70049480,15954371,1.74174026702268,46.0856083442732,0.268595501934299
565.77,555,1116,1131,794592,1218087,2025-04-25,2025-05-23,546.69,15,423495,70049480,15954371,1.73889513526724,47.8245034795405,0.347672210605646
564.45,552,1073,978,872349,1217610,2025-04-25,2025-05-23,546.69,-95,345261,70049480,15954371,1.73821418802823,49.5627176675687,0.283556311134107
563.6,515,248,248,1205280,1205280,2025-04-25,2025-08-15,546.69,0,0,282648688,37799117,0.426423348549207,82.7005947397145,0
545.22,475,171,171,1200762,1200762,2025-04-25,2025-05-16,546.69,0,0,919215858,218728279,0.130628947439242,95.3935706579161,0
556.14,547,1194,1310,544464,1197340,2025-04-25,2025-05-02,546.69,116,652876,157884664,54569672,0.75836371289361,85.8627364846531,0.545272019643543
548.52,480,176,174,1024144,1192248,2025-04-25,2025-05-16,546.69,-2,168104,919215858,218728279,0.129702723209547,95.5232733811257,0.140997510585046
559.1,548,1080,1072,732240,1189920,2025-04-25,2025-05-09,546.69,-8,457680,106424303,36041450,1.1180904797657,63.7660018313674,0.384630899556273
568.51,565,3398,3348,587854,1175148,2025-04-25,2025-05-09,546.69,-50,587294,106424303,36041450,1.10421019153868,64.8702120229061,0.499761732139271
542.62,490,223,223,1173426,1173426,2025-04-25,2025-05-30,546.69,0,0,159044187,37473216,0.737798735140191,71.9051926116608,0
545.45,285,43,45,1084417,1172025,2025-04-25,2025-05-16,546.69,2,87608,919215858,218728279,0.127502695890175,95.6507760770159,0.0747492587615452
546.14,517,400,400,1165600,1165600,2025-04-25,2025-05-23,546.69,0,0,70049480,15954371,1.6639666704164,51.2266843379851,0
543.28,392,77,77,1164856,1164856,2025-04-25,2025-05-16,546.69,0,0,919215858,218728279,0.126722792025635,95.7774988690415,0
554.21,553,1637,9605,80213,1162205,2025-04-25,2025-04-25,546.69,7968,1081992,247323203,111942542,0.469913451670768,92.6798639268795,0.930982055661437
549.55,475,154,155,1139600,1155525,2025-04-25,2025-05-30,546.69,1,15925,159044187,37473216,0.72654337250314,72.631735984164,0.0137816144176889
545.17,390,74,74,1148258,1148258,2025-04-25,2025-05-30,546.69,0,0,159044187,37473216,0.7219742020499,73.3537101862139,0
556.75,527,385,385,950565,1145375,2025-04-25,2025-05-30,546.69,0,194810,159044187,37473216,0.720161498263373,74.0738716844772,0.170084033613445
544,485,193,193,1138700,1138700,2025-04-25,2025-05-09,546.69,0,0,106424303,36041450,1.06996237504135,65.9401743979474,0
656.01,655,11212,11212,829688,1132412,2025-04-25,2025-09-19,546.69,0,302724,612220205,74276563,0.184968086768714,97.575809834633,0.267326732673268
551.33,519,347,350,974723,1131550,2025-04-25,2025-05-09,546.69,3,156827,106424303,36041450,1.06324398478795,67.0034183827354,0.138594847775176
546.22,465,139,139,1128958,1128958,2025-04-25,2025-07-18,546.69,0,0,353688576,64788996,0.319195494739417,95.695939017267,0
554.78,536,605,599,753225,1124922,2025-04-25,2025-05-09,546.69,-6,371697,106424303,36041450,1.0570160840048,68.0604344667402,0.330420242470145
578.03,551,410,416,949560,1124448,2025-04-25,2025-08-15,546.69,6,174888,282648688,37799117,0.397825303190511,83.098420042905,0.155532314522326
548.16,518,373,369,828060,1112904,2025-04-25,2025-05-02,546.69,-4,284844,157884664,54569672,0.704884167850527,86.5676206525037,0.255946604558884
547.33,405,78,78,1110174,1110174,2025-04-25,2025-08-15,546.69,0,0,282648688,37799117,0.392775217835082,83.4911952607401,0
553.06,526,404,408,761540,1104048,2025-04-25,2025-05-09,546.69,4,342508,106424303,36041450,1.03740214300487,69.097836609745,0.310229265394258
551.74,527,448,446,796096,1103404,2025-04-25,2025-05-09,546.69,-2,307308,106424303,36041450,1.03679701806457,70.1346336278096,0.278509050175638
527.02,425,108,108,1101816,1101816,2025-04-25,2025-05-16,546.69,0,0,919215858,218728279,0.119864772829017,95.8973636418705,0
573.41,548,419,433,1026550,1100253,2025-04-25,2025-08-15,546.69,14,73703,282648688,37799117,0.389265206849289,83.8804604675894,0.0669873201890838
567.72,533,315,315,1093680,1093680,2025-04-25,2025-08-15,546.69,0,0,282648688,37799117,0.386939705165021,84.2674001727544,0
556.56,548,998,1276,428142,1092256,2025-04-25,2025-05-02,546.69,278,664114,157884664,54569672,0.691806266883527,87.2594269193872,0.608020464067032
615.68,615,15885,15884,794250,1080112,2025-04-25,2025-06-20,546.69,-1,285862,1174768001,197089681,0.0919425792224996,99.3658245718595,0.264659590857244
569.48,523,233,232,907302,1078336,2025-04-25,2025-08-15,546.69,-1,171034,282648688,37799117,0.381511057995783,84.6489112307502,0.158609190456407
574.77,571,3697,2840,610005,1070680,2025-04-25,2025-05-16,546.69,-857,460675,919215858,218728279,0.116477537966931,96.0138411798374,0.430263944409161
550.26,485,170,164,1104320,1070264,2025-04-25,2025-05-30,546.69,-6,-34055.9999999998,159044187,37473216,0.672935000133014,74.7468066846102,-0.031820186421294
567.64,518,214,214,798220,1062296,2025-04-25,2025-08-15,546.69,0,264076,282648688,37799117,0.375836168749526,85.0247473994997,0.248589846897663
584.93,566,549,558,892674,1056294,2025-04-25,2025-08-15,546.69,9,163620,282648688,37799117,0.373712684631319,85.398460084131,0.154900056234344
566.31,552,425,732,410550,1047492,2025-04-25,2025-05-30,546.69,307,636942,159044187,37473216,0.658616966616957,75.4054236512272,0.60806383246841
563.95,410,68,68,1046860,1046860,2025-04-25,2025-08-15,546.69,0,0,282648688,37799117,0.370374972340222,85.7688350564712,0
588.39,573,676,679,857844,1044981,2025-04-25,2025-08-15,546.69,3,187137,282648688,37799117,0.369710189491486,86.1385452459627,0.179081724930884
620.53,620,19050,19640,666750,1040920,2025-04-25,2025-06-20,546.69,590,374170,1174768001,197089681,0.0886064311518475,99.4544310030113,0.359460861545556
526.6,230,35,35,1038100,1038100,2025-04-25,2025-06-20,546.69,0,0,1174768001,197089681,0.0883663837554595,99.5427973867668,0
591,579,859,861,878757,1033200,2025-04-25,2025-08-15,546.69,2,154443,282648688,37799117,0.365542117782623,86.5040873637454,0.149480255516841
545.36,470,137,137,1032432,1032432,2025-04-25,2025-05-02,546.69,0,0,157884664,54569672,0.653915316309632,87.9133422356968,0
588.83,574,692,695,868460,1030685,2025-04-25,2025-08-15,546.69,3,162225,282648688,37799117,0.364652320622129,86.8687396843675,0.157395324468679
564,514,204,204,1020000,1020000,2025-04-25,2025-08-15,546.69,0,0,282648688,37799117,0.360872009425354,87.2296116937928,0
549.34,505,229,229,955846,1015386,2025-04-25,2025-05-23,546.69,0,59539.9999999999,70049480,15954371,1.44952682018482,52.6762111581699,0.0586377988272439
581,558,385,441,778855,1014300,2025-04-25,2025-08-15,546.69,56,235445,282648688,37799117,0.358855371725624,87.5884670655185,0.232125603864734
568.32,557,742,896,563920,1014272,2025-04-25,2025-05-30,546.69,154,450352,159044187,37473216,0.637729689548478,76.0431533407757,0.444015017667845
527.17,398,78,78,1007526,1007526,2025-04-25,2025-05-16,546.69,0,0,919215858,218728279,0.109607116895496,96.1234482967329,0
600.68,600,15934,14617,732964,993956,2025-04-25,2025-05-30,546.69,-1317,260992,159044187,37473216,0.62495588097162,76.6681092217473,0.262579027643075
658.09,655,3198,3187,831480,984783,2025-04-25,2025-12-19,546.69,-11,153303,1084502340,72118262,0.0908050599503547,99.2843548866847,0.155671858673434
532.1,350,54,54,983340,983340,2025-04-25,2025-08-15,546.69,0,0,282648688,37799117,0.347901844851302,87.9363689103698,0
572.77,569,2488,2597,519992,979069,2025-04-25,2025-05-16,546.69,109,459077,919215858,218728279,0.106511326091591,96.2299596228245,0.468891365164253
636.23,635,7936,7952,722176,978096,2025-04-25,2025-08-15,546.69,16,255920,282648688,37799117,0.34604653816755,88.2824154485373,0.261651208061376
551.58,509,229,229,564714,975082,2025-04-25,2025-05-09,546.69,0,410368,106424303,36041450,0.916221175533562,71.0508548033432,0.420854861437295
571.48,565,1374,1500,560592,972000,2025-04-25,2025-05-23,546.69,126,411408,70049480,15954371,1.38759060024428,54.0638017584142,0.423259259259259
554.35,534,589,477,793383,970695,2025-04-25,2025-05-09,546.69,-112,177312,106424303,36041450,0.912098996786477,71.9629538001297,0.182664997759338
566.5,553,697,719,667029,970650,2025-04-25,2025-05-30,546.69,22,303621,159044187,37473216,0.610302091707382,77.2784113134547,0.312801730798949
625.95,625,10219,10196,735768,968620,2025-04-25,2025-07-18,546.69,-23,232852,353688576,64788996,0.273862393565123,95.9698014108321,0.24039561437922
591.03,577,689,688,791661,965264,2025-04-25,2025-08-15,546.69,-1,173603,282648688,37799117,0.341506626770544,88.6239220753079,0.179850279301828
544.29,435,88,88,961752,961752,2025-04-25,2025-05-16,546.69,0,0,919215858,218728279,0.104627437791657,96.3345870606162,0
621.29,620,7504,7434,705376,958986,2025-04-25,2025-07-18,546.69,-70,253610,353688576,64788996,0.271138528375878,96.240939939208,0.264456415422123
546.51,498,198,197,778338,955647,2025-04-25,2025-04-25,546.69,-1,177309,247323203,111942542,0.386396014772621,93.0662599416521,0.185538174660727
554.08,510,208,216,731536,952128,2025-04-25,2025-05-23,546.69,8,220592,70049480,15954371,1.35922208130596,55.4230238397202,0.231683135040667
554.09,531,442,411,694824,948999,2025-04-25,2025-05-09,546.69,-31,254175,106424303,36041450,0.891712675816162,72.8546664759458,0.267834844926075
600.28,600,31960,33472,639200,937216,2025-04-25,2025-05-16,546.69,1512,298016,919215858,218728279,0.101958206208405,96.4365452668246,0.317980060092871
552.71,528,379,379,737913,936509,2025-04-25,2025-05-09,546.69,0,198596,106424303,36041450,0.879976634660224,73.7346431106061,0.212059894779442
548.08,517,299,299,880256,929292,2025-04-25,2025-05-09,546.69,0,49036,106424303,36041450,0.873195288861793,74.6078383994678,0.0527670527670528
563.13,544,489,485,651348,927805,2025-04-25,2025-05-30,546.69,-4,276457,159044187,37473216,0.583363037342572,77.8617743507973,0.297968861991474
523.9,436,105,105,922950,922950,2025-04-25,2025-08-15,546.69,0,0,282648688,37799117,0.326536099116795,88.9504581744246,0
564.63,549,514,587,604978,917481,2025-04-25,2025-05-30,546.69,73,312503,159044187,37473216,0.576871759544409,78.4386461103417,0.340609778295136
555.6,539,535,550,575125,913000,2025-04-25,2025-05-09,546.69,15,337875,106424303,36041450,0.857886755434048,75.4657251549019,0.370071193866375
568.55,558,855,864,619875,911520,2025-04-25,2025-05-30,546.69,9,291645,159044187,37473216,0.573123744535222,79.0117698548769,0.31995458135861
535.93,507,315,315,911295,911295,2025-04-25,2025-05-23,546.69,0,0,70049480,15954371,1.30093042803458,56.7239542677547,0
583.14,564,421,474,731277,907236,2025-04-25,2025-08-15,546.69,53,175959,282648688,37799117,0.320976547395118,89.2714347218198,0.193950636879489
545.95,320,39,40,830388,903800,2025-04-25,2025-05-16,546.69,1,73412.0000000001,919215858,218728279,0.0983229338499946,96.5348682006746,0.0812259349413588
564.69,548,505,541,590850,902929,2025-04-25,2025-05-30,546.69,36,312079,159044187,37473216,0.56772210102844,79.5794919559053,0.345629612073596
545.5,365,50,50,902500,902500,2025-04-25,2025-12-19,546.69,0,0,1084502340,72118262,0.0832178932873488,99.3675727799721,0
582.25,580,3744,4006,486720,901350,2025-04-25,2025-05-23,546.69,262,414630,70049480,15954371,1.28673332050431,58.010687588259,0.460009985022466
549.81,330,41,41,901221,901221,2025-04-25,2025-09-19,546.69,0,0,612220205,74276563,0.14720536706233,97.7230152016953,0
554.11,533,545,426,767360,899286,2025-04-25,2025-05-09,546.69,-119,131926,106424303,36041450,0.845000601037528,76.3107257559394,0.146700827100611
538,506,281,281,899200,899200,2025-04-25,2025-05-23,546.69,0,0,70049480,15954371,1.28366406146056,59.2943516497196,0
551.25,524,326,328,687534,893800,2025-04-25,2025-05-09,546.69,2,206266,106424303,36041450,0.83984576342492,77.1505715193643,0.230774222421123
530.05,397,67,67,891435,891435,2025-04-25,2025-05-16,546.69,0,0,919215858,218728279,0.0969777655859371,96.6318459662605,0
550.95,420,68,68,890460,890460,2025-04-25,2025-08-15,546.69,0,0,282648688,37799117,0.315041264228334,89.5864759860481,0
562.47,516,191,191,887577,887577,2025-04-25,2025-08-15,546.69,0,0,282648688,37799117,0.314021270107576,89.9004972561557,0
530.22,415,77,77,887194,887194,2025-04-25,2025-08-15,546.69,0,0,282648688,37799117,0.313885766205998,90.2143830223617,0
554.95,554,5339,9281,229577,881695,2025-04-25,2025-04-25,546.69,3942,652118,247323203,111942542,0.35649505962447,93.4227550012766,0.739618575584528
565.57,551,476,605,535500,881485,2025-04-25,2025-05-30,546.69,129,345985,159044187,37473216,0.554239055590256,80.1337310114956,0.392502424885279
625.39,625,22661,22576,657169,880464,2025-04-25,2025-06-20,546.69,-85,223295,1174768001,197089681,0.07494790454375,99.6177452913105,0.253610596231078
575.68,573,3322,3269,498300,876092,2025-04-25,2025-05-16,546.69,-53,377792,919215858,218728279,0.0953086255393997,96.7271545917999,0.431224118015003
560.39,551,821,932,432667,875148,2025-04-25,2025-05-09,546.69,111,442481,106424303,36041450,0.822319691396053,77.9728912107604,0.505607051607271
541.33,420,72,72,873576,873576,2025-04-25,2025-05-23,546.69,0,0,70049480,15954371,1.24708420390844,60.541435853628,0
557.94,551,1229,1249,422776,866806,2025-04-25,2025-05-02,546.69,20,444030,157884664,54569672,0.54901215738091,88.4623543930777,0.512259952053862
548.17,440,79,80,762666,865360,2025-04-25,2025-05-16,546.69,1,102694,919215858,218728279,0.0941411086926657,96.8212957004926,0.11867199778127
546.46,490,153,153,796977,863838,2025-04-25,2025-05-09,546.69,0,66861.0000000001,106424303,36041450,0.811692419540676,78.7845836303011,0.0773999291533831
548.35,519,292,292,598308,857020,2025-04-25,2025-05-02,546.69,0,258712,157884664,54569672,0.542813961969099,89.0051683550468,0.301873935264055
554.83,465,95,95,853385,853385,2025-04-25,2025-08-15,546.69,0,0,282648688,37799117,0.301924274277898,90.5163072966396,0
556.02,538,432,473,501120,852346,2025-04-25,2025-05-09,546.69,41,351226,106424303,36041450,0.800894134115212,79.5854777644163,0.412069746323676
508.51,170,25,25,846275,846275,2025-04-25,2025-09-19,546.69,0,0,612220205,74276563,0.138230491755822,97.8612456934511,0
567.06,557,929,841,588986,846046,2025-04-25,2025-05-23,546.69,-88,257060,70049480,15954371,1.20778341252498,61.749219266153,0.303836907213083
667.24,665,3800,3775,699200,845600,2025-04-25,2025-12-19,546.69,-25,146400,1084502340,72118262,0.0779712471620854,99.4455440271341,0.173131504257332
591.46,590,5765,5758,501555,840668,2025-04-25,2025-05-30,546.69,-7,339113,159044187,37473216,0.528575118561234,80.6623061300568,0.403385165130587
520.1,345,48,48,840480,840480,2025-04-25,2025-07-18,546.69,0,0,353688576,64788996,0.237632781218243,96.4785727204262,0
511.67,150,23,23,831841,831841,2025-04-25,2025-09-19,546.69,0,0,612220205,74276563,0.135872843334205,97.9971185367853,0
534.32,440,88,88,830016,830016,2025-04-25,2025-08-15,546.69,0,0,282648688,37799117,0.293656413505093,90.8099637101447,0
547.89,517,277,266,677542,821674,2025-04-25,2025-05-02,546.69,-11,144132,157884664,54569672,0.52042673378334,89.5255950888302,0.175412633234105
575.53,572,2454,2327,402456,821431,2025-04-25,2025-05-16,546.69,-127,418975,919215858,218728279,0.0893621441417735,96.9106578446344,0.510055013750394
572.11,215,23,23,821353,821353,2025-04-25,2025-12-19,546.69,0,0,1084502340,72118262,0.075735475130464,99.5212795022646,0
556.19,541,520,540,518440,820260,2025-04-25,2025-05-09,546.69,20,301820,106424303,36041450,0.770745005489958,80.3562227699062,0.367956501597055
523.18,315,39,39,811902,811902,2025-04-25,2025-05-16,546.69,0,0,919215858,218728279,0.0883254997108633,96.9989833443452,0
676.53,675,5264,5290,705376,809370,2025-04-25,2025-12-19,546.69,26,103994,1084502340,72118262,0.0746305443656304,99.5959100466303,0.12848758911252
561.61,545,424,487,496080,808907,2025-04-25,2025-05-23,546.69,63,312827,70049480,15954371,1.15476517455947,62.9039844407125,0.386728016941379
538.42,380,51,51,800649,807942,2025-04-25,2025-05-23,546.69,0,7292.99999999977,70049480,15954371,1.15338757689565,64.0573720176081,0.00902663805075088
645.75,645,10684,10682,641040,801150,2025-04-25,2025-08-15,546.69,-2,160110,282648688,37799117,0.283443735638355,91.093407445783,0.199850215315484
554.12,515,211,204,677732,798048,2025-04-25,2025-05-23,546.69,-7,120316,70049480,15954371,1.13926327504501,65.1966352926532,0.150762861381772
631.53,630,5336,5214,645656,797742,2025-04-25,2025-08-15,546.69,-122,152086,282648688,37799117,0.28223799857157,91.3756454443546,0.190645597198092
550.61,522,276,275,690000,786775,2025-04-25,2025-05-09,546.69,-1,96775,106424303,36041450,0.739281327499039,81.0955040974053,0.123002128944107
544.6,511,234,234,667602,786240,2025-04-25,2025-05-02,546.69,0,118638,157884664,54569672,0.49798376870853,90.0235788575387,0.150892857142857
539.83,504,216,219,846072,784677,2025-04-25,2025-04-25,546.69,3,-61395.0000000001,247323203,111942542,0.317267846478602,93.7400228477552,-0.0782423850832892
547.29,480,86,116,540252,780564,2025-04-25,2025-05-30,546.69,30,240312,159044187,37473216,0.490784362964489,81.1530904930213,0.307869694221102
543.74,400,50,54,627800,776196,2025-04-25,2025-05-02,546.69,4,148396,157884664,54569672,0.491622162872006,90.5152010204107,0.191183670103943
538.24,380,49,49,775376,775376,2025-04-25,2025-05-30,546.69,0,0,159044187,37473216,0.487522376407256,81.6406128694285,0
555.13,544,712,696,452120,774648,2025-04-25,2025-05-02,546.69,-16,322528,157884664,54569672,0.490641700323725,91.0058427207344,0.416354266712107
532.73,335,39,39,771147,771147,2025-04-25,2025-08-15,546.69,0,0,282648688,37799117,0.272828791619935,91.6484742359745,0
552.61,506,136,165,525096,769065,2025-04-25,2025-05-30,546.69,29,243969,159044187,37473216,0.483554296769111,82.1241671661977,0.317228062647501
527.74,470,132,132,762168,762168,2025-04-25,2025-05-09,546.69,0,0,106424303,36041450,0.716159729042341,81.8116638264476,0
576.36,575,5424,5592,379680,760512,2025-04-25,2025-05-09,546.69,168,380832,106424303,36041450,0.714603693481554,82.5262675199292,0.500757384498864
562.16,490,99,105,557172,757680,2025-04-25,2025-08-15,546.69,6,200508,282648688,37799117,0.268064219707257,91.9165384556818,0.264634146341463
546.84,499,160,158,707840,755872,2025-04-25,2025-04-25,546.69,-2,48032,247323203,111942542,0.305621143035253,94.0456439907905,0.0635451505016722
557.52,557,11248,14522,292448,755144,2025-04-25,2025-04-25,546.69,3274,462696,247323203,111942542,0.305326791356491,94.350970782147,0.61272551990084
560.7,556,1573,1605,311454,754350,2025-04-25,2025-05-02,546.69,32,442896,157884664,54569672,0.477785480165445,91.4836282008999,0.587122688407238
557.5,543,328,516,291920,748200,2025-04-25,2025-05-09,546.69,188,456280,106424303,36041450,0.703034907355701,83.2293024272849,0.609836941994119
574,567,850,1043,361250,730100,2025-04-25,2025-05-30,546.69,193,368850,159044187,37473216,0.459054816005316,82.583221982203,0.505204766470347
545.11,506,191,185,635648,723535,2025-04-25,2025-04-25,546.69,-6,87887,247323203,111942542,0.292546348754832,94.6435171309018,0.121468899223949
529.97,305,32,32,719904,719904,2025-04-25,2025-08-15,546.69,0,0,282648688,37799117,0.254699218699363,92.1712376743811,0
542,508,213,211,667755,717400,2025-04-25,2025-05-02,546.69,-2,49645,157884664,54569672,0.454382320502009,91.9380105214019,0.0692012824086981
544.29,390,46,46,709734,709734,2025-04-25,2025-05-16,546.69,0,0,919215858,218728279,0.0772108089545165,97.0761941532997,0
559.63,549,588,667,372792,709021,2025-04-25,2025-05-09,546.69,79,336229,106424303,36041450,0.666220947672075,83.8955233749569,0.474215855383691
550.56,420,53,54,656034,705024,2025-04-25,2025-05-30,546.69,1,48990,159044187,37473216,0.443288128474636,83.0265101106776,0.0694869961873638
567.5,556,569,613,516083,704950,2025-04-25,2025-05-30,546.69,44,188867,159044187,37473216,0.443241600524513,83.4697517112021,0.267915454996808
555.58,537,383,379,448493,704182,2025-04-25,2025-05-09,546.69,-4,255689,106424303,36041450,0.661674053904774,84.5571974288617,0.363100732481092
576.39,574,2278,2914,309808,696446,2025-04-25,2025-05-16,546.69,636,386638,919215858,218728279,0.0757652290197979,97.1519593823195,0.555158619620186
558.16,539,379,363,585934,695508,2025-04-25,2025-05-23,546.69,-16,109574,70049480,15954371,0.992881032093315,66.1895163247465,0.157545276258505
542.93,355,37,37,695341,695341,2025-04-25,2025-07-18,546.69,0,0,353688576,64788996,0.19659696331272,96.675169683739,0
538.88,465,87,94,637884,694472,2025-04-25,2025-05-16,546.69,7,56588,919215858,218728279,0.0755504807664012,97.2275098630859,0.0814834867352464
546.97,494,131,131,693907,693907,2025-04-25,2025-05-16,546.69,0,0,919215858,218728279,0.075489015334198,97.3029988784201,0
538.94,440,70,70,692580,692580,2025-04-25,2025-07-18,546.69,0,0,353688576,64788996,0.195816333066975,96.8709860168059,0
554.31,532,318,310,467142,691610,2025-04-25,2025-05-09,546.69,-8,224468,106424303,36041450,0.649860962678797,85.2070583915405,0.324558638539061
655.5,655,13773,13809,619785,690450,2025-04-25,2025-08-15,546.69,36,70665,282648688,37799117,0.244278508733074,92.4155161831142,0.102346295893982
535.94,430,65,65,688610,688610,2025-04-25,2025-07-18,546.69,0,0,353688576,64788996,0.194693876683198,97.0656798934891,0
561.37,543,333,370,460539,679690,2025-04-25,2025-05-23,546.69,37,219151,70049480,15954371,0.970299850905389,67.1598161756518,0.322427871529668
546,265,24,24,674400,674400,2025-04-25,2025-09-19,546.69,0,0,612220205,74276563,0.110156442811292,98.1072749795966,0
565.47,517,139,139,673733,673733,2025-04-25,2025-08-15,546.69,0,0,282648688,37799117,0.238364099535463,92.6538802826497,0
531.08,315,31,31,669848,669848,2025-04-25,2025-09-19,546.69,0,0,612220205,74276563,0.1094129194903,98.2166878990869,0
503.35,399,64,64,667840,667840,2025-04-25,2025-05-16,546.69,0,0,919215858,218728279,0.0726532287479314,97.3756521071681,0
574.43,568,1026,1030,414504,662290,2025-04-25,2025-05-30,546.69,4,247786,159044187,37473216,0.41641886603501,83.8861705772371,0.374135197572061
545.64,325,30,30,661920,661920,2025-04-25,2025-06-20,546.69,0,0,1174768001,197089681,0.0563447420628203,99.6740900333733,0
560.26,560,11867,25405,178005,660530,2025-04-25,2025-04-25,546.69,13538,482525,247323203,111942542,0.267071585677305,94.9105887165791,0.730511861686827
546.56,445,65,65,660140,660140,2025-04-25,2025-05-30,546.69,0,0,159044187,37473216,0.415067040457128,84.3012376176943,0
556.24,524,204,204,657696,657696,2025-04-25,2025-08-15,546.69,0,0,282648688,37799117,0.232690271677468,92.8865705543272,0
660.71,660,9255,9253,573810,656963,2025-04-25,2025-09-19,546.69,-2,83153,612220205,74276563,0.107308284606517,98.3239961836934,0.126571816068789
554.91,512,150,152,519450,652232,2025-04-25,2025-05-30,546.69,2,132782,159044187,37473216,0.410094837354854,84.7113324550491,0.203580934391444
545.16,502,131,151,482342,651716,2025-04-25,2025-04-25,546.69,20,169374,247323203,111942542,0.263507827852286,95.1740965444314,0.259889276924304
566.71,554,509,512,462681,650752,2025-04-25,2025-05-30,546.69,3,188071,159044187,37473216,0.409164278352405,85.1204967334015,0.289005642702597
566.56,556,636,616,440748,650496,2025-04-25,2025-05-23,546.69,-20,209748,70049480,15954371,0.928623595778298,68.0884397714301,0.322443181818182
587.35,571,392,397,560560,649095,2025-04-25,2025-08-15,546.69,5,88535.0000000001,282648688,37799117,0.229647271527402,93.1162178258545,0.136397599735016
630.75,630,8642,8617,492594,646275,2025-04-25,2025-07-18,546.69,-25,153681,353688576,64788996,0.18272430715998,97.2484042006491,0.23779505628409
563.41,546,394,370,492894,644170,2025-04-25,2025-05-30,546.69,-24,151276,159044187,37473216,0.405025805815839,85.5255225392174,0.23483862955431
517.29,410,60,60,643740,643740,2025-04-25,2025-07-18,546.69,0,0,353688576,64788996,0.182007574935075,97.4304117755842,0
542.8,485,111,111,575757,641580,2025-04-25,2025-04-25,546.69,0,65822.9999999999,247323203,111942542,0.259409546786437,95.4335060912178,0.102595155709342
543.76,444,64,64,638464,638464,2025-04-25,2025-08-15,546.69,0,0,282648688,37799117,0.225886065319362,93.3421038911739,0
548.41,355,33,33,638253,638253,2025-04-25,2025-09-19,546.69,0,0,612220205,74276563,0.104252194682141,98.4282483783756,0
561.84,558,1420,1655,254180,635520,2025-04-25,2025-05-02,546.69,235,381340,157884664,54569672,0.402521678736321,92.3405322001382,0.600044058408862
556.3,547.5,640,722,284800,635360,2025-04-25,2025-05-02,546.69,82,350560,157884664,54569672,0.402420338938049,92.7429525390762,0.551750188869303
690.95,690,6660,6661,539460,632795,2025-04-25,2025-12-19,546.69,1,93335,1084502340,72118262,0.0583488828617926,99.654258929492,0.147496424592483
539.38,507,195,195,631410,631410,2025-04-25,2025-05-02,546.69,0,0,157884664,54569672,0.39991851266821,93.1428710517445,0
553.41,405,42,42,623322,623322,2025-04-25,2025-09-19,546.69,0,0,612220205,74276563,0.101813366319722,98.5300617446953,0
558.41,558,2776,15198,58296,623118,2025-04-25,2025-04-25,546.69,12422,564822,247323203,111942542,0.251944820559355,95.6854509117772,0.906444686239204
551.78,511,152,152,475456,619856,2025-04-25,2025-05-09,546.69,0,144400,106424303,36041450,0.582438392854685,85.7894967843952,0.232957332025503
541.93,492,123,124,559773,619132,2025-04-25,2025-04-25,546.69,1,59359,247323203,111942542,0.250333164252284,95.9357840760295,0.0958745469463701
536.75,400,45,45,615375,615375,2025-04-25,2025-05-23,546.69,0,0,70049480,15954371,0.878486178626879,68.966925950057,0
539.75,390,31,41,384896,613975,2025-04-25,2025-05-23,546.69,10,229079,70049480,15954371,0.876487591342577,69.8434135413996,0.373108025571074
546.97,503,140,139,464660,611183,2025-04-25,2025-04-25,546.69,-1,146523,247323203,111942542,0.24711915121041,96.1829032272399,0.239736707336428
571.01,570,4008,6049,184368,610949,2025-04-25,2025-05-02,546.69,2041,426581,157884664,54569672,0.38695905259044,93.5298301043349,0.698226856906223
555.22,526,208,209,484224,610698,2025-04-25,2025-05-23,546.69,1,126474,70049480,15954371,0.871809469534963,70.7152230109346,0.207097452423293
575.1,569,948,991,366876,604510,2025-04-25,2025-05-30,546.69,43,237634,159044187,37473216,0.380089339574542,85.9056118787919,0.393101851086004
531.8,310,27,27,598860,598860,2025-04-25,2025-08-15,546.69,0,0,282648688,37799117,0.211874325063204,93.5539782162371,0
578.95,577,2411,3053,245922,595335,2025-04-25,2025-05-16,546.69,642,349413,919215858,218728279,0.0647655275764401,97.4404176347445,0.586918289702436
545.34,300,24,24,588816,588816,2025-04-25,2025-07-18,546.69,0,0,353688576,64788996,0.166478659463403,97.5968904350476,0
580.06,576,1358,1449,321846,588294,2025-04-25,2025-05-30,546.69,91,266448,159044187,37473216,0.369893430936901,86.2755053097288,0.452916398943385
695.75,695,7812,7817,617148,586275,2025-04-25,2025-12-19,546.69,5,-30873,1084502340,72118262,0.0540593577695738,99.7083182872616,-0.0526595880772675
553.99,519,166,167,461148,584333,2025-04-25,2025-05-23,546.69,1,123185,70049480,15954371,0.83417178828451,71.5493947992191,0.210813012443247
528.94,455,79,79,584126,584126,2025-04-25,2025-08-15,546.69,0,0,282648688,37799117,0.206661493507446,93.7606397097445,0
577,572,1124,1166,347316,583000,2025-04-25,2025-05-30,546.69,42,235684,159044187,37473216,0.366564796234898,86.6420701059637,0.404260720411664
554.46,518,168,159,352464,579714,2025-04-25,2025-05-23,546.69,-9,227250,70049480,15954371,0.827577877808658,72.3769726770277,0.392003643175773
630.3,630,19233,19227,442359,576810,2025-04-25,2025-06-20,546.69,-6,134451,1174768001,197089681,0.0490999073441736,99.7231899407175,0.233094086440942
543.56,455,65,65,575640,575640,2025-04-25,2025-07-18,546.69,0,0,353688576,64788996,0.16275334830153,97.7596437833491,0
582.73,562,266,276,487312,572148,2025-04-25,2025-08-15,546.69,10,84836,282648688,37799117,0.202423723969311,93.9630634337139,0.148276320112978
571.93,564,736,717,398176,568581,2025-04-25,2025-05-30,546.69,-19,170405,159044187,37473216,0.357498762277932,86.9995688682416,0.299702241193427
635.59,635,9551,9567,458448,564453,2025-04-25,2025-07-18,546.69,16,106005,353688576,64788996,0.159590396269966,97.9192341796191,0.187801287263953
525.71,437,63,63,558873,558873,2025-04-25,2025-08-15,546.69,0,0,282648688,37799117,0.197727080905467,94.1607905146193,0
549,295,22,22,558800,558800,2025-04-25,2025-09-19,546.69,0,0,612220205,74276563,0.0912743479284549,98.6213360926237,0
556.95,549,636,702,265848,558090,2025-04-25,2025-05-02,546.69,66,292242,157884664,54569672,0.353479550110073,93.883309654445,0.523646723646724
562.31,546,261,342,279531,557802,2025-04-25,2025-05-23,546.69,81,278271,70049480,15954371,0.796297131684632,73.1732698087124,0.498870566975378
528.83,250,20,20,557660,557660,2025-04-25,2025-09-19,546.69,0,0,612220205,74276563,0.0910881404183647,98.7124242330421,0
550.84,365,30,30,557520,557520,2025-04-25,2025-09-19,546.69,0,0,612220205,74276563,0.0910652728294062,98.8034895058715,0
640.94,640,5909,5921,454993,556574,2025-04-25,2025-08-15,546.69,12,101581,282648688,37799117,0.196913703699909,94.3577042183192,0.182511220430706
551,345,26,27,414128,556200,2025-04-25,2025-05-30,546.69,1,142072,159044187,37473216,0.349714133217582,87.3492830014592,0.255433297375045
545.19,480,85,85,537965,554115,2025-04-25,2025-05-09,546.69,0,16150,106424303,36041450,0.520665848288431,86.3101626326836,0.0291455744746127
560.71,536,217,224,392119,553504,2025-04-25,2025-05-30,546.69,7,161385,159044187,37473216,0.348019006818527,87.6973020082777,0.291569708619992
578.22,574,1243,1310,357984,552820,2025-04-25,2025-05-30,546.69,67,194836,159044187,37473216,0.347588937657935,88.0448909459357,0.352440215621721
546.25,295,22,22,542410,552750,2025-04-25,2025-07-18,546.69,0,10340,353688576,64788996,0.156281553181972,98.0755157328011,0.0187064676616915
555.49,522,156,165,504348,552585,2025-04-25,2025-05-30,546.69,9,48237.0000000001,159044187,37473216,0.347441179978492,88.3923321259142,0.0872933575829964
542.18,370,32,32,550976,550976,2025-04-25,2025-08-15,546.69,0,0,282648688,37799117,0.194933153201122,94.5526373715204,0
512.27,405,51,51,547077,547077,2025-04-25,2025-05-16,546.69,0,0,919215858,218728279,0.0595156181476582,97.4999332528922,0
581.55,578,1524,1541,315468,547055,2025-04-25,2025-05-30,546.69,17,231587,159044187,37473216,0.343964158840964,88.7362962847551,0.423334034055077
547.65,320,24,24,546360,546360,2025-04-25,2025-09-19,546.69,0,0,612220205,74276563,0.0892423993095752,98.8927319051811,0
566.85,565,2770,2953,235450,546305,2025-04-25,2025-05-02,546.69,183,310855,157884664,54569672,0.346015240593602,94.2293248950386,0.569013646223264
556.13,527,190,187,449160,544731,2025-04-25,2025-05-23,546.69,-3,95570.9999999999,70049480,15954371,0.777637464260977,73.9509072729733,0.17544622942333
534.02,435,55,55,544610,544610,2025-04-25,2025-05-30,546.69,0,0,159044187,37473216,0.342426850218675,89.0787231349738,0
549.63,518,157,172,458283,544036,2025-04-25,2025-05-09,546.69,15,85753,106424303,36041450,0.511195267118639,86.8213578998023,0.15762376019234
519.37,345,31,31,540547,540547,2025-04-25,2025-09-19,546.69,0,0,612220205,74276563,0.088292904348036,98.9810248095291,0
580.79,577,1378,1426,310050,540454,2025-04-25,2025-05-30,546.69,48,230404,159044187,37473216,0.339813739938826,89.4185368749126,0.426315653136067
538.6,460,68,68,534480,534480,2025-04-25,2025-08-15,546.69,0,0,282648688,37799117,0.189096932938886,94.7417343044593,0
550.4,512,140,139,424480,533760,2025-04-25,2025-05-09,546.69,-1,109280,106424303,36041450,0.501539577853754,87.322897477656,0.204736211031175
542.58,300,21,22,507864,533676,2025-04-25,2025-04-25,546.69,1,25811.9999999999,247323203,111942542,0.215780805652917,96.3986840328928,0.0483664245722123
740.26,740,20400,20420,489600,530920,2025-04-25,2025-12-19,546.69,20,41320,1084502340,72118262,0.0489551733009631,99.7572734605626,0.0778271679349055
587.11,585,2282,2516,294378,530876,2025-04-25,2025-05-30,546.69,234,236498,159044187,37473216,0.333791514178384,89.752328389091,0.445486328257446
640.45,640,11581,11722,486402,527490,2025-04-25,2025-07-18,546.69,141,41088.0000000001,353688576,64788996,0.149139677047415,98.2246554098485,0.0778934197804699
558.89,553,804,894,250044,526566,2025-04-25,2025-05-02,546.69,90,276522,157884664,54569672,0.333513076355535,94.5628379713941,0.525142147423115
502.83,375,41,41,524103,524103,2025-04-25,2025-05-16,546.69,0,0,919215858,218728279,0.0570163140070632,97.5569495668992,0
640.18,640,28743,28776,488631,517968,2025-04-25,2025-06-20,546.69,33,29336.9999999999,1174768001,197089681,0.0440910885859241,99.7672810293034,0.0566386340468907
577.77,573,916,1082,266556,516114,2025-04-25,2025-05-30,546.69,166,249558,159044187,37473216,0.32450981688504,90.0768382059761,0.483532707890117
543.33,400,36,36,489564,515988,2025-04-25,2025-04-25,546.69,0,26423.9999999999,247323203,111942542,0.208629030249135,96.6073130631419,0.0512104932672852
557.26,529,182,182,423878,514332,2025-04-25,2025-05-30,546.69,0,90454.0000000001,159044187,37473216,0.323389373545605,90.4002275795217,0.1758669497523
534.84,396,37,37,513708,513708,2025-04-25,2025-05-16,546.69,0,0,919215858,218728279,0.0558854588429,97.6128350257421,0
530.93,385,35,35,510755,510755,2025-04-25,2025-05-30,546.69,0,0,159044187,37473216,0.321140313037659,90.7213678925593,0
581.11,579,2450,2418,213150,510198,2025-04-25,2025-05-16,546.69,-32,297048,919215858,218728279,0.0555036116446111,97.6683386373868,0.582221020074559
551.31,514,136,136,452200,507416,2025-04-25,2025-05-23,546.69,0,55216,70049480,15954371,0.724367975322586,74.6752752482959,0.108818011257036
540.31,487,95,95,506445,506445,2025-04-25,2025-08-15,546.69,0,0,282648688,37799117,0.179178259621003,94.9209125640803,0
538.9,395,35,35,503650,503650,2025-04-25,2025-05-30,546.69,0,0,159044187,37473216,0.316673001069822,91.0380408936292,0
549.56,445,48,48,402240,501888,2025-04-25,2025-07-18,546.69,0,99648.0000000001,353688576,64788996,0.141901105677781,98.3665565155263,0.198546289211936
521.66,450,70,70,501620,501620,2025-04-25,2025-07-18,546.69,0,0,353688576,64788996,0.141825332803511,98.5083818483298,0
522.77,330,26,26,501202,501202,2025-04-25,2025-05-16,546.69,0,0,919215858,218728279,0.0545249514178856,97.7228635888046,0
585.05,584,4758,4772,280722,501060,2025-04-25,2025-05-16,546.69,14,220338,919215858,218728279,0.0545095034685531,97.7773730922732,0.43974374326428
568.43,330,21,21,500703,500703,2025-04-25,2025-07-18,546.69,0,0,353688576,64788996,0.141566065170281,98.6499479135001,0
563.21,549,414,352,409446,500192,2025-04-25,2025-05-23,546.69,-62,90746,70049480,15954371,0.714055264935586,75.3893305132315,0.181422333823812
576.54,571,842,898,303120,497492,2025-04-25,2025-05-30,546.69,56,194372,159044187,37473216,0.312801121112336,91.3508420147415,0.390703770110876
578.11,576,2473,2357,281922,497327,2025-04-25,2025-05-16,546.69,-116,215405,919215858,218728279,0.0541033964625097,97.8314764887357,0.433125488863464
547.43,506,120,120,497160,497160,2025-04-25,2025-08-15,546.69,0,0,282648688,37799117,0.17589326294697,95.0968058270272,0
536.91,496,119,119,486829,486829,2025-04-25,2025-04-25,546.69,0,0,247323203,111942542,0.196839194258696,96.8041522574006,0
583.17,582,3921,4119,329364,481923,2025-04-25,2025-05-16,546.69,198,152559,919215858,218728279,0.0524276203250619,97.8839041090608,0.316563019403515
531.03,385,33,33,481899,481899,2025-04-25,2025-09-19,546.69,0,0,612220205,74276563,0.0787133446534977,99.0597381541826,0
545.42,305,20,20,480840,480840,2025-04-25,2025-07-18,546.69,0,0,353688576,64788996,0.135950107701528,98.7858980212016,0
563.08,556,671,674,252296,477192,2025-04-25,2025-05-09,546.69,3,224896,106424303,36041450,0.448386305146861,87.7712837828029,0.471290382068434
540.03,501,121,122,428703,476166,2025-04-25,2025-04-25,546.69,1,47463,247323203,111942542,0.192527831689128,96.9966800890897,0.0996774234195638
555.19,522,148,143,373848,474617,2025-04-25,2025-05-23,546.69,-5,100769,70049480,15954371,0.677545357938417,76.0668758711699,0.212316457269756
557.5,532,184,186,344816,474300,2025-04-25,2025-05-23,546.69,2,129484,70049480,15954371,0.677092820674757,76.7439686918447,0.273000210837023
529.7,305,21,21,471870,471870,2025-04-25,2025-09-19,546.69,0,0,612220205,74276563,0.0770752085844668,99.1368133627671,0
547.55,430,39,40,425178,470200,2025-04-25,2025-05-16,546.69,1,45022,919215858,218728279,0.0511522941981273,97.9350564032589,0.0957507443641004
571.1,562,477,514,274275,467740,2025-04-25,2025-05-30,546.69,37,193465,159044187,37473216,0.294094370138784,91.6449363848803,0.41361653910292
558.75,552.5,697,745,215373,465625,2025-04-25,2025-05-02,546.69,48,250252,157884664,54569672,0.294914647314954,94.8577526187091,0.537453959731544
541.38,503,121,121,464398,464398,2025-04-25,2025-08-15,546.69,0,0,282648688,37799117,0.164302195522662,95.2611080225499,0
546.07,470,55,61,283800,464027,2025-04-25,2025-05-23,546.69,6,180227,70049480,15954371,0.662427472695015,77.4063961645397,0.388397657894907
548.9,493,83,83,463970,463970,2025-04-25,2025-05-16,546.69,0,0,919215858,218728279,0.0504745426182585,97.9855309458771,0
558.44,536,109,206,182466,462264,2025-04-25,2025-05-23,546.69,97,279798,70049480,15954371,0.65991068027914,78.0663068448188,0.605277503764083
570.91,564,660,668,285120,461588,2025-04-25,2025-05-23,546.69,8,176468,70049480,15954371,0.658945648133291,78.7252524929521,0.382306299123894
558.16,480,59,59,434830,461144,2025-04-25,2025-08-15,546.69,0,26313.9999999999,282648688,37799117,0.163150943053378,95.4242589656033,0.057062436028659
558.73,547,343,393,231868,460989,2025-04-25,2025-05-09,546.69,50,229121,106424303,36041450,0.433161399234158,88.204445182037,0.497020536281777
563.21,548,292,303,294920,460863,2025-04-25,2025-05-23,546.69,11,165943,70049480,15954371,0.657910665432492,79.3831631583846,0.360070129300899
579.71,578,2605,2693,250080,460503,2025-04-25,2025-05-16,546.69,88,210423,919215858,218728279,0.0500973733201195,98.0356283191973,0.456941648588609
561.92,554,488,581,205448,460152,2025-04-25,2025-05-09,546.69,93,254704,106424303,36041450,0.43237492473876,88.6368201067758,0.55352144508771
524.72,443,56,56,457632,457632,2025-04-25,2025-08-15,546.69,0,0,282648688,37799117,0.161908411193474,95.5861673767967,0
562.82,512,91,90,381836,457380,2025-04-25,2025-08-15,546.69,-1,75544,282648688,37799117,0.161819254579381,95.7479866313761,0.165166819712274
553.67,521,138,138,378120,450846,2025-04-25,2025-05-23,546.69,0,72726,70049480,15954371,0.643610773413307,80.0267739317979,0.16131007040098
565.41,340,20,20,450820,450820,2025-04-25,2025-08-15,546.69,0,0,282648688,37799117,0.159498352244253,95.9074849836204,0
562.45,559,1236,1301,192816,448845,2025-04-25,2025-05-02,546.69,65,256029,157884664,54569672,0.28428663597118,95.1420392546802,0.570417404671991
548.32,488,74,74,337588,446368,2025-04-25,2025-05-16,546.69,0,108780,919215858,218728279,0.0485596496312839,98.0841879688285,0.24370026525199
561.43,553,553,525,275394,442575,2025-04-25,2025-05-09,546.69,-28,167181,106424303,36041450,0.415858960335404,89.0526790671112,0.377746144721234
532.68,370,27,27,439236,439236,2025-04-25,2025-05-16,546.69,0,0,919215858,218728279,0.0477837709366411,98.1319717397652,0
522.97,340,24,24,439128,439128,2025-04-25,2025-05-16,546.69,0,0,919215858,218728279,0.0477720217920784,98.1797437615572,0
544.2,497,93,93,438960,438960,2025-04-25,2025-04-25,546.69,0,0,247323203,111942542,0.177484358392366,97.1741644474821,0
559.33,534,155,173,298375,438209,2025-04-25,2025-05-30,546.69,18,139834,159044187,37473216,0.275526574259517,91.9204629591398,0.319103441508504
557.77,528,151,147,356058,437619,2025-04-25,2025-05-30,546.69,-4,81561,159044187,37473216,0.275155608170703,92.1956185673105,0.186374449007013
571.56,563,488,511,296216,437416,2025-04-25,2025-05-30,546.69,23,141200,159044187,37473216,0.275027970685908,92.4706465379964,0.322804835671306
635.25,635,17498,17480,349960,437000,2025-04-25,2025-06-20,546.69,-18,87040,1174768001,197089681,0.0371988341211211,99.8044798634245,0.199176201372998
536.04,415,36,36,435744,435744,2025-04-25,2025-05-16,546.69,0,0,919215858,218728279,0.0474038819291127,98.2271476434864,0
582.37,581,3169,3172,231337,434564,2025-04-25,2025-05-16,546.69,3,203227,919215858,218728279,0.0472755116459273,98.2744231551323,0.467657238059296
573.17,566,556,602,271884,431634,2025-04-25,2025-05-30,546.69,46,159750,159044187,37473216,0.27139250301553,92.7420390410119,0.370105228040423
596,595,4366,4312,275058,431200,2025-04-25,2025-05-30,546.69,-54,156142,159044187,37473216,0.271119622875623,93.0131586638875,0.36211038961039
513.26,445,63,63,430038,430038,2025-04-25,2025-05-16,546.69,0,0,919215858,218728279,0.0467831354580482,98.3212062905903,0
528.08,415,38,38,429704,429704,2025-04-25,2025-06-20,546.69,0,0,1174768001,197089681,0.0365777753253598,99.8410576387499,0
544.16,350,22,22,427152,427152,2025-04-25,2025-04-25,546.69,0,0,247323203,111942542,0.172710038855513,97.3468744863376,0
558,532,183,164,408639,426400,2025-04-25,2025-05-30,546.69,-19,17761,159044187,37473216,0.268101593678491,93.281260257566,0.0416533771106942
531.73,320,20,20,423460,423460,2025-04-25,2025-07-18,546.69,0,0,353688576,64788996,0.119726796038784,98.9056248172404,0
551.64,513,109,109,421176,421176,2025-04-25,2025-05-23,546.69,0,0,70049480,15954371,0.601254998609554,80.6280289304075,0
512.71,405,39,39,420069,420069,2025-04-25,2025-07-18,546.69,0,0,353688576,64788996,0.118768042991584,99.0243928602319,0
586.54,585,1957,2700,174173,415800,2025-04-25,2025-05-23,546.69,743,241627,70049480,15954371,0.593580423437833,81.2216093538453,0.581113516113516
583.84,583,4953,4947,302133,415548,2025-04-25,2025-05-16,546.69,-6,113415,919215858,218728279,0.0452067918958813,98.3664130824862,0.272928759132519
550.69,513,111,110,317793,414590,2025-04-25,2025-05-09,546.69,-1,96797,106424303,36041450,0.389563274847099,89.4422423419583,0.233476446609904
686.1,685,3771,3722,369558,409420,2025-04-25,2025-12-19,546.69,-49,39862,1084502340,72118262,0.0377518779719738,99.7950253385346,0.0973621220262811
535.09,492,95,95,409355,409355,2025-04-25,2025-05-16,546.69,0,0,919215858,218728279,0.044533065485909,98.4109461479721,0
545.24,425,34,34,408816,408816,2025-04-25,2025-09-19,546.69,0,0,612220205,74276563,0.0667759731974217,99.2035893359645,0
563.88,558,673,695,207284,408660,2025-04-25,2025-05-09,546.69,22,201376,106424303,36041450,0.38399123929428,89.8262335812526,0.492771497088044
539.14,460,51,51,403614,403614,2025-04-25,2025-05-23,546.69,0,0,70049480,15954371,0.576184148690326,81.7977935025357,0
549.84,435,35,35,401940,401940,2025-04-25,2025-08-15,546.69,0,0,282648688,37799117,0.14220479947885,96.0496897830992,0
595.42,595,8571,9530,248559,400260,2025-04-25,2025-05-16,546.69,959,151701,919215858,218728279,0.0435436352100009,98.4544897831822,0.379006146005097
557.28,504,73,75,365219,399600,2025-04-25,2025-08-15,546.69,2,34381,282648688,37799117,0.141376916633698,96.1910666997329,0.0860385385385385
587.75,586,2169,2254,262449,394450,2025-04-25,2025-05-30,546.69,85,132001,159044187,37473216,0.248012836835087,93.5292730944011,0.334645709215363
523.1,475,82,82,394420,394420,2025-04-25,2025-05-09,546.69,0,0,106424303,36041450,0.370610836887511,90.1968444181401,0
554.94,475,49,49,391706,391706,2025-04-25,2025-08-15,546.69,0,0,282648688,37799117,0.138584050317615,96.3296507500505,0
526.38,370,25,25,390950,390950,2025-04-25,2025-05-09,546.69,0,0,106424303,36041450,0.367350303435861,90.564194721576,0
563.68,551,343,308,313502,390544,2025-04-25,2025-05-23,546.69,-35,77042,70049480,15954371,0.557525908829016,82.3553194113647,0.197268425580728
530.04,491,100,100,390400,390400,2025-04-25,2025-05-16,546.69,0,0,919215858,218728279,0.0424709818267735,98.4969607650089,0
527.56,406,32,32,388992,388992,2025-04-25,2025-05-16,546.69,0,0,919215858,218728279,0.0423178077939556,98.5392785728029,0
645.38,645,10266,10232,328512,388816,2025-04-25,2025-07-18,546.69,-34,60304,353688576,64788996,0.109931738366353,99.1343245985983,0.155096498086499
540.92,465,51,51,387192,387192,2025-04-25,2025-04-25,546.69,0,0,247323203,111942542,0.156553042861894,97.5034275291995,0
550.23,470,50,48,258350,385104,2025-04-25,2025-05-30,546.69,-2,126754,159044187,37473216,0.242136482485839,93.771409576887,0.329142257675849
553.04,521,123,120,350550,384480,2025-04-25,2025-05-30,546.69,-3,33930,159044187,37473216,0.241744138690212,94.0131537155772,0.088249063670412
539.94,220,12,12,383928,383928,2025-04-25,2025-12-19,546.69,0,0,1084502340,72118262,0.0354013067413022,99.8304266452759,0
559.05,533,141,147,285525,382935,2025-04-25,2025-05-30,546.69,6,97410,159044187,37473216,0.240772710542385,94.2539264261196,0.254377374750284
578.4,575,1011,1125,187035,382500,2025-04-25,2025-05-23,546.69,114,195465,70049480,15954371,0.546042597318353,82.901362008683,0.511019607843137
561.15,544,215,223,268320,382445,2025-04-25,2025-05-23,546.69,8,114125,70049480,15954371,0.545964081389327,83.4473260900723,0.298408921544274
583.84,581,1270,1346,223520,382264,2025-04-25,2025-05-30,546.69,76,158744,159044187,37473216,0.24035081521087,94.4942772413304,0.415273214323086
521.7,447,51,51,380970,380970,2025-04-25,2025-08-15,546.69,0,0,282648688,37799117,0.13478569552037,96.4644364455709,0
558.63,537,200,176,317800,380688,2025-04-25,2025-05-23,546.69,-24,62888,70049480,15954371,0.543455854347527,83.9907819444199,0.16519564577817
548.42,489,64,64,367552,380288,2025-04-25,2025-05-16,546.69,0,12736,919215858,218728279,0.0413709137728997,98.5806494865758,0.0334904072702794
562.59,557.5,736,747,131008,380223,2025-04-25,2025-05-02,546.69,11,249215,157884664,54569672,0.240823263239804,95.3828625179201,0.655444305052561
556.57,523,114,113,352716,379341,2025-04-25,2025-05-30,546.69,-1,26624.9999999999,159044187,37473216,0.238512961181033,94.7327902025115,0.0701875093912863
571.85,571,4379,4458,166402,378930,2025-04-25,2025-05-02,546.69,79,212528,157884664,54569672,0.240004310995018,95.6228668289151,0.560863484020795
507.04,335,22,22,378488,378488,2025-04-25,2025-09-19,546.69,0,0,612220205,74276563,0.0618222000693362,99.2654115360338,0
570.52,568,1463,1490,187264,375480,2025-04-25,2025-05-09,546.69,27,188216,106424303,36041450,0.352814149978506,90.9170088715545,0.501267710663684
540.19,455,34,44,257414,374836,2025-04-25,2025-05-30,546.69,10,117422,159044187,37473216,0.235680415028309,94.9684706175398,0.313262333393804
528.27,425,36,36,371772,371772,2025-04-25,2025-07-18,546.69,0,0,353688576,64788996,0.105112809750463,99.2394374083488,0
550.03,529,130,175,237250,368025,2025-04-25,2025-05-09,546.69,45,130775,106424303,36041450,0.345809171049962,91.2628180426044,0.355342707696488
535.95,320,17,17,367115,367115,2025-04-25,2025-04-25,546.69,0,0,247323203,111942542,0.148435324929865,97.6518628541294,0
555.9,524,113,114,302840,363660,2025-04-25,2025-05-30,546.69,1,60820,159044187,37473216,0.228653437047655,95.1971240545874,0.167244129131606
539.79,395,25,25,361975,361975,2025-04-25,2025-04-25,546.69,0,0,247323203,111942542,0.146357072692448,97.7982199268218,0
585.24,583,1059,1611,154614,360864,2025-04-25,2025-05-30,546.69,552,206250,159044187,37473216,0.226895435040326,95.4240194896277,0.571544958765629
549.28,340,17,17,355776,355776,2025-04-25,2025-09-19,546.69,0,0,612220205,74276563,0.0581124237805905,99.3235239598144,0
507.32,360,24,24,353568,353568,2025-04-25,2025-05-09,546.69,0,0,106424303,36041450,0.332224867848089,91.5950429104525,0
650.6,650,5737,5891,304061,353460,2025-04-25,2025-08-15,546.69,154,49399,282648688,37799117,0.125052765148515,96.5894892107194,0.139758388502235
530.78,345,19,19,352982,352982,2025-04-25,2025-06-20,546.69,0,0,1174768001,197089681,0.0300469539261821,99.8711045926761,0
525.1,290,15,15,352650,352650,2025-04-25,2025-05-16,546.69,0,0,919215858,218728279,0.0383642206485955,98.6190137072244,0
546.95,514,107,107,307411,352565,2025-04-25,2025-05-09,546.69,0,45154,106424303,36041450,0.331282413942612,91.9263253243951,0.128072837632777
535.11,395,25,25,350275,350275,2025-04-25,2025-09-19,546.69,0,0,612220205,74276563,0.0572138908744444,99.3807378506889,0
547,494,63,66,292698,349800,2025-04-25,2025-04-25,546.69,3,57102,247323203,111942542,0.141434364328526,97.9396542911504,0.163241852487136
560.28,542,173,191,229917,349148,2025-04-25,2025-05-23,546.69,18,119231,70049480,15954371,0.498430537956884,84.4892124823767,0.341491287362379
559.28,554,705,661,176250,349008,2025-04-25,2025-05-02,546.69,-44,172758,157884664,54569672,0.221052501970679,95.8439193308857,0.49499724934672
528.05,405,28,28,344540,344540,2025-04-25,2025-05-09,546.69,0,0,106424303,36041450,0.323741843063797,92.2500671674589,0
552,265,4,12,90384,344400,2025-04-25,2025-08-15,546.69,8,254016,282648688,37799117,0.121847372594208,96.7113365833136,0.737560975609756
650.12,650,28712,28535,344544,342420,2025-04-25,2025-06-20,546.69,-177,-2124,1174768001,197089681,0.0291478827911997,99.9002524754673,-0.00620290870860347
562.74,547,319,217,331122,341558,2025-04-25,2025-05-23,546.69,-102,10436,70049480,15954371,0.487595339751273,84.976807822128,0.0305541079406719
565.57,561,724,744,181000,340008,2025-04-25,2025-05-09,546.69,20,159008,106424303,36041450,0.319483417241643,92.5695505847006,0.467659584480365
543.77,513,110,110,371250,338470,2025-04-25,2025-05-02,546.69,0,-32780,157884664,54569672,0.214378009506991,96.0582973403927,-0.0968475788105297
559.91,541,190,177,261250,334707,2025-04-25,2025-05-23,546.69,-13,73457,70049480,15954371,0.477815110119304,85.4546229322473,0.21946657823111
554.39,516,98,87,349370,333993,2025-04-25,2025-05-30,546.69,-11,-15377,159044187,37473216,0.210000130341136,95.6340196199689,-0.0460398870635013
563.6,557,508,505,168656,333300,2025-04-25,2025-05-09,546.69,-3,164644,106424303,36041450,0.313180345658454,92.882730930359,0.493981398139814
548.75,521,122,120,277062,333000,2025-04-25,2025-05-09,546.69,-2,55938,106424303,36041450,0.312898455158311,93.1956293855173,0.167981981981982
547,508,86,85,336260,331500,2025-04-25,2025-05-23,546.69,-1,-4760,70049480,15954371,0.473236917675906,85.9278598499232,-0.0143589743589744
545.49,310,14,14,329686,329686,2025-04-25,2025-07-18,546.69,0,0,353688576,64788996,0.0932136411440103,99.3326510494928,0
527.4,453,44,44,327360,327360,2025-04-25,2025-08-15,546.69,0,0,282648688,37799117,0.115818687260278,96.8271552705739,0
556.02,519,85,88,275825,325776,2025-04-25,2025-05-30,546.69,3,49951,159044187,37473216,0.204833641609297,95.8388532615782,0.153329281469476
555.84,528,122,117,277184,325728,2025-04-25,2025-05-23,546.69,-5,48544.0000000001,70049480,15954371,0.464997027815196,86.3928568777384,0.149032321446115
572.06,566,523,537,192987,325422,2025-04-25,2025-05-23,546.69,14,132435,70049480,15954371,0.464560193737341,86.8574170714758,0.406963880745616
559.8,499,53,53,322240,322240,2025-04-25,2025-08-15,546.69,0,0,282648688,37799117,0.114007251291398,96.9411625218653,0
567.95,559,272,359,164560,321305,2025-04-25,2025-05-23,546.69,87,156745,70049480,15954371,0.458682919559146,87.3160999910349,0.487838657972954
556.18,513,74,74,319532,319532,2025-04-25,2025-08-15,546.69,0,0,282648688,37799117,0.113049171485983,97.0542116933513,0
564.58,559,575,572,161575,319176,2025-04-25,2025-05-09,546.69,-3,157601,106424303,36041450,0.299908940911739,93.4955383264291,0.493774594581046
546.3,440,30,30,318210,318900,2025-04-25,2025-05-30,546.69,0,690,159044187,37473216,0.200510314784406,96.0393635763626,0.00216368767638758
549.34,523,119,121,310947,318714,2025-04-25,2025-05-23,546.69,2,7767,70049480,15954371,0.454984105520841,87.7710840965558,0.0243698111786743
576.27,573,974,974,75972,318498,2025-04-25,2025-05-09,546.69,0,242526,106424303,36041450,0.299271868381417,93.7948101948105,0.761467889908257
538.4,455,38,38,316920,316920,2025-04-25,2025-04-25,546.69,0,0,247323203,111942542,0.128140019276719,98.0677943104271,0
532.05,445,36,36,313380,313380,2025-04-25,2025-08-15,546.69,0,0,282648688,37799117,0.110872617954625,97.1650843113059,0
551.3,518,94,94,313020,313020,2025-04-25,2025-05-30,546.69,0,0,159044187,37473216,0.196813229017921,96.2361768053805,0
710.52,710,6012,5973,294588,310596,2025-04-25,2025-12-19,546.69,-39,16008,1084502340,72118262,0.0286394956049611,99.8590661408808,0.0515396206003941
504.3,413,34,34,310420,310420,2025-04-25,2025-05-16,546.69,0,0,919215858,218728279,0.0337700875478151,98.6527837947722,0
586.02,584,1552,1532,254528,309464,2025-04-25,2025-05-30,546.69,-20,54936,159044187,37473216,0.194577372387713,96.4307541777682,0.177519840756922
541.93,395,21,21,308553,308553,2025-04-25,2025-05-23,546.69,0,0,70049480,15954371,0.440478644523842,88.2115627410796,0
545.2,290,12,12,306240,306240,2025-04-25,2025-07-18,546.69,0,0,353688576,64788996,0.0865846455838031,99.4192356950766,0
575.42,571,675,692,169425,305864,2025-04-25,2025-05-23,546.69,17,136439,70049480,15954371,0.436639929375636,88.6482026704552,0.446077341563571
568,564,732,761,143472,304400,2025-04-25,2025-05-09,546.69,29,160928,106424303,36041450,0.286024894144714,94.0808350889552,0.528672798948752
546.58,345,14,15,248948,302370,2025-04-25,2025-05-16,546.69,1,53422,919215858,218728279,0.0328943411243891,98.6856781358966,0.176677580447796
527.83,402,24,24,301992,301992,2025-04-25,2025-05-16,546.69,0,0,919215858,218728279,0.0328532191184195,98.718531355015,0
559.32,559,5848,9402,116960,300864,2025-04-25,2025-04-25,546.69,3554,183904,247323203,111942542,0.121648109174779,98.1894424196019,0.611252924909594
526.91,200,9,9,294219,294219,2025-04-25,2025-09-19,546.69,0,0,612220205,74276563,0.0480577082554797,99.4287955589444,0
556.75,529,96,106,248544,294150,2025-04-25,2025-05-23,546.69,10,45606,70049480,15954371,0.419917464055408,89.0681201345107,0.155043345232024
566.49,562,595,654,132090,293646,2025-04-25,2025-05-09,546.69,59,161556,106424303,36041450,0.275920059349602,94.3567551483048,0.550172656872561
542.92,250,0,10,0,292920,2025-04-25,2025-05-09,546.69,10,292920,106424303,36041450,0.275237884339257,94.6319930326441,1
545.62,400,20,20,291240,291240,2025-04-25,2025-05-30,546.69,0,0,159044187,37473216,0.183118921535938,96.6138730993042,0
551.58,513,74,75,272320,289350,2025-04-25,2025-05-30,546.69,1,17030,159044187,37473216,0.181930572539567,96.7958036718437,0.0588560566787627
536.16,405,22,22,288552,288552,2025-04-25,2025-05-30,546.69,0,0,159044187,37473216,0.181428825185544,96.9772324970293,0
547.21,506,69,70,197961,288470,2025-04-25,2025-05-09,546.69,1,90509,106424303,36041450,0.271056508587141,94.9030495412312,0.313755329843658
588.73,588,4217,3949,198199,288277,2025-04-25,2025-05-16,546.69,-268,90078,919215858,218728279,0.0313611865473278,98.7498925415623,0.312470297665093
529.2,468,47,47,287640,287640,2025-04-25,2025-05-16,546.69,0,0,919215858,218728279,0.0312918883520828,98.7811844299144,0
555.24,533,129,129,232200,286896,2025-04-25,2025-05-23,546.69,0,54695.9999999999,70049480,15954371,0.409561926798029,89.4776820613087,0.190647482014388
587.85,587,3184,3360,156016,285600,2025-04-25,2025-05-16,546.69,176,129584,919215858,218728279,0.0310699600658978,98.8122543899803,0.453725490196078
565.04,554,229,258,169231,284832,2025-04-25,2025-05-23,546.69,29,115601,70049480,15954371,0.406615438116029,89.8842974994247,0.40585678575441
560.72,552,329,326,168448,284272,2025-04-25,2025-05-09,546.69,-3,115824,106424303,36041450,0.267111920855145,95.1701614620863,0.407440760961333
542.29,325,13,13,282477,282477,2025-04-25,2025-07-18,546.69,0,0,353688576,64788996,0.0798660231536571,99.4991017182302,0
566.08,564,1209,1347,118482,280176,2025-04-25,2025-05-02,546.69,138,161694,157884664,54569672,0.177456120754071,96.2357534611468,0.577115812917595
556.64,556,1458,4362,42282,279168,2025-04-25,2025-04-25,546.69,2904,236886,247323203,111942542,0.112875782220886,98.3023182018228,0.848542812929849
549.1,410,10,20,105090,278200,2025-04-25,2025-05-23,546.69,10,173110,70049480,15954371,0.397147844637819,90.2814453440625,0.622250179726815
541.31,416,22,22,275682,275682,2025-04-25,2025-05-16,546.69,0,0,919215858,218728279,0.0299909969568867,98.8422453869372,0
610.13,610,21517,21203,236687,275639,2025-04-25,2025-05-16,546.69,-314,38952,919215858,218728279,0.0299863190567367,98.8722317059939,0.141315271061062
542.11,498,62,62,273482,273482,2025-04-25,2025-08-15,546.69,0,0,282648688,37799117,0.0967568616486909,97.2618411729546,0
537.62,310,12,12,273144,273144,2025-04-25,2025-06-20,546.69,0,0,1174768001,197089681,0.0232508886663146,99.9235033641336,0
543.32,470,39,37,280800,271284,2025-04-25,2025-04-25,546.69,-2,-9516.00000000006,247323203,111942542,0.109688050578902,98.4120062524016,-0.0350776308223119
559.35,538,149,127,233334,271145,2025-04-25,2025-05-23,546.69,-22,37811,70049480,15954371,0.38707639228728,90.6685217363498,0.139449372107175
563.82,561,1615,961,200260,271002,2025-04-25,2025-05-02,546.69,-654,70742,157884664,54569672,0.171645550070652,96.4073990112175,0.261038663921299
559.51,534,109,106,185300,270406,2025-04-25,2025-05-23,546.69,-3,85106,70049480,15954371,0.386021423713638,91.0545431600634,0.314734140514634
700.21,700,12807,12845,256140,269745,2025-04-25,2025-09-19,546.69,38,13605,612220205,74276563,0.0440601270256999,99.47285568597,0.0504365233831952
519.63,250,10,10,269630,269630,2025-04-25,2025-07-18,546.69,0,0,353688576,64788996,0.0762337316769881,99.5753354499072,0
552.71,509,61,61,219844,266631,2025-04-25,2025-05-23,546.69,0,46787,70049480,15954371,0.380632375857751,91.4351755359212,0.175474719743766
561.2,557,496,632,95232,265440,2025-04-25,2025-05-02,546.69,136,170208,157884664,54569672,0.168122725333222,96.5755217365507,0.64122965641953
573.48,568,462,484,150150,265232,2025-04-25,2025-05-23,546.69,22,115082,70049480,15954371,0.378635216135794,91.813810752057,0.433891838088918
546.2,455,29,29,264480,264480,2025-04-25,2025-05-16,546.69,0,0,919215858,218728279,0.0287723495736297,98.9010040555675,0
512.1,250,10,10,262100,262100,2025-04-25,2025-05-02,546.69,0,0,157884664,54569672,0.166007257044294,96.741528993595,0
623.15,623,17255,17400,224315,261000,2025-04-25,2025-05-30,546.69,145,36685,159044187,37473216,0.164105337594011,97.1413378346233,0.140555555555556
534.2,485,53,53,260760,260760,2025-04-25,2025-08-15,546.69,0,0,282648688,37799117,0.0922558678213288,97.354097040776,0
555,524,84,84,204960,260400,2025-04-25,2025-05-23,546.69,0,55440,70049480,15954371,0.371737234880259,92.1855479869372,0.212903225806452
546.27,516,84,86,216972,260322,2025-04-25,2025-05-09,546.69,2,43350,106424303,36041450,0.244607662593759,95.4147691246801,0.166524534998963
542,360,14,14,254800,254800,2025-04-25,2025-08-15,546.69,0,0,282648688,37799117,0.0901472431388042,97.4442442839148,0
545.57,315,11,11,253627,253627,2025-04-25,2025-07-18,546.69,0,0,353688576,64788996,0.0717091297854076,99.6470445796926,0
564.54,562,951,998,116973,253492,2025-04-25,2025-05-02,546.69,47,136519,157884664,54569672,0.160555175897261,96.9020841694922,0.538553484922601
561.68,495,37,38,234025,253384,2025-04-25,2025-08-15,546.69,1,19359,282648688,37799117,0.0896462678786607,97.5338905517934,0.0764018248981783
564.24,553,217,224,194215,251776,2025-04-25,2025-05-23,546.69,7,57561,70049480,15954371,0.359425937208956,92.5449739241462,0.228619884341637
552.7,531,116,116,251720,251720,2025-04-25,2025-05-23,546.69,0,0,70049480,15954371,0.359345993717584,92.9043199178638,0
531.1,280,10,10,251100,251100,2025-04-25,2025-07-18,546.69,0,0,353688576,64788996,0.0709946594373464,99.71803923913,0
542.55,465,32,32,248160,248160,2025-04-25,2025-05-23,546.69,0,0,70049480,15954371,0.354263871766072,93.2585837896298,0
705.64,705,3853,3855,223474,246720,2025-04-25,2025-12-19,546.69,2,23246.0000000001,1084502340,72118262,0.022749605132249,99.8818157460131,0.0942201686121922
645.16,645,15365,15399,230475,246384,2025-04-25,2025-06-20,546.69,34,15909,1174768001,197089681,0.0209729920963348,99.9444763562299,0.064569939606468
564.45,557.5,315,354,100800,246030,2025-04-25,2025-05-09,546.69,39,145230,106424303,36041450,0.231178399166965,95.6459475238471,0.590293866601634
541.4,475,37,37,245680,245680,2025-04-25,2025-04-25,546.69,0,0,247323203,111942542,0.0993356049978052,98.5113418573994,0
559.11,508,47,48,206095,245328,2025-04-25,2025-08-15,546.69,1,39232.9999999999,282648688,37799117,0.0867960865963758,97.6206866383898,0.159920596099915
554.24,516,63,63,194103,240912,2025-04-25,2025-05-23,546.69,0,46809,70049480,15954371,0.343916899882769,93.6025006895126,0.194299163179916
501.19,360,17,17,240023,240023,2025-04-25,2025-05-30,546.69,0,0,159044187,37473216,0.150915921246465,97.2922537558698,0
567.96,468,24,24,239904,239904,2025-04-25,2025-08-15,546.69,0,0,282648688,37799117,0.0848770966168433,97.7055637350066,0
547.17,502,53,53,239401,239401,2025-04-25,2025-05-09,546.69,0,0,106424303,36041450,0.224949558748813,95.8708970825959,0
660.42,660,5864,5673,234560,238266,2025-04-25,2025-08-15,546.69,-191,3706,282648688,37799117,0.0842975786252367,97.7898613136319,0.0155540446391848
569.58,567,798,923,124488,238134,2025-04-25,2025-05-09,546.69,125,113646,106424303,36041450,0.223759041203211,96.0946561237991,0.477235506059613
584.66,582,850,889,138550,236474,2025-04-25,2025-05-30,546.69,39,97924,159044187,37473216,0.148684465908836,97.4409382217786,0.414100493077463
567.33,558,238,253,147084,236049,2025-04-25,2025-05-23,546.69,15,88965,70049480,15954371,0.336974664194509,93.9394753537071,0.376892085965202
574.15,569,554,458,168416,235870,2025-04-25,2025-05-23,546.69,-96,67454,70049480,15954371,0.336719130534588,94.2761944842417,0.285979565014627
569.96,562.5,309,315,146157,234990,2025-04-25,2025-05-23,546.69,6,88833,70049480,15954371,0.335462875670169,94.6116573599119,0.378028852291587
557,470,26,27,160966,234900,2025-04-25,2025-08-15,546.69,1,73934,282648688,37799117,0.083106700994133,97.872968014626,0.314746700723712
540.26,465,31,31,233306,233306,2025-04-25,2025-05-30,546.69,0,0,159044187,37473216,0.146692566638729,97.5876307884173,0
570.09,563,328,329,144648,233261,2025-04-25,2025-05-23,546.69,1,88613,70049480,15954371,0.332994620374056,94.9446519802859,0.379887765207214
565.26,563,797,1032,82888,233232,2025-04-25,2025-05-02,546.69,235,150344,157884664,54569672,0.147723023941071,97.0498071934333,0.644611374082459
573.87,572,1155,1246,114345,233002,2025-04-25,2025-05-09,546.69,91,118657,106424303,36041450,0.218936834380771,96.3135929581799,0.50925313945803
535.9,205,7,7,231630,231630,2025-04-25,2025-12-19,546.69,0,0,1084502340,72118262,0.0213581835148461,99.9031739295279,0
541.24,310,10,10,231240,231240,2025-04-25,2025-09-19,546.69,0,0,612220205,74276563,0.0377707233625195,99.5106264093326,0
530.63,421,21,21,230223,230223,2025-04-25,2025-05-16,546.69,0,0,919215858,218728279,0.0250455861913557,98.9260496417589,0
544.66,475,33,33,229878,229878,2025-04-25,2025-05-02,546.69,0,0,157884664,54569672,0.145598688419795,97.1954058818531,0
562.16,562,12468,14326,137148,229216,2025-04-25,2025-04-25,546.69,1858,92068,247323203,111942542,0.0926787285704043,98.6040205859699,0.401664805249197
546.95,519,82,82,229190,229190,2025-04-25,2025-08-15,546.69,0,0,282648688,37799117,0.0810865253335264,97.9540545399595,0
588.86,587,1211,1227,152586,228222,2025-04-25,2025-05-30,546.69,16,75636,159044187,37473216,0.143495970714101,97.7311267591314,0.331414149380866
534.4,508,86,86,227040,227040,2025-04-25,2025-05-09,546.69,0,0,106424303,36041450,0.213334730507937,96.5269276886878,0
546.09,420,21,18,250425,226962,2025-04-25,2025-04-25,546.69,-3,-23463,247323203,111942542,0.0917673704880815,98.6957879564579,-0.10337853913871
586.79,586,2895,2867,150540,226493,2025-04-25,2025-05-16,546.69,-28,75953,919215858,218728279,0.0246398055504391,98.9506894473094,0.335343697156204
596.39,596,5806,5806,150956,226434,2025-04-25,2025-05-16,546.69,0,75478,919215858,218728279,0.0246333870362798,98.9753228343456,0.333333333333333
542,435,21,21,224700,224700,2025-04-25,2025-05-23,546.69,0,0,70049480,15954371,0.320773259130546,95.2654252394165,0
530.64,484,48,48,223872,223872,2025-04-25,2025-05-16,546.69,0,0,919215858,218728279,0.0243546712180416,98.9996775055637,0
542.55,403,16,16,223280,223280,2025-04-25,2025-05-16,546.69,0,0,919215858,218728279,0.0242902684996977,99.0239677740634,0
512.87,412,22,22,221914,221914,2025-04-25,2025-05-16,546.69,0,0,919215858,218728279,0.0241416635786542,99.048109437642,0
548.16,503,27,49,93501,221284,2025-04-25,2025-05-02,546.69,22,127783,157884664,54569672,0.140155474505111,97.3355613563582,0.577461542632996
491.25,270,10,10,221250,221250,2025-04-25,2025-08-15,546.69,0,0,282648688,37799117,0.0782773843974114,98.0323319243569,0
529.15,456,30,30,219450,219450,2025-04-25,2025-08-15,546.69,0,0,282648688,37799117,0.0776405514396019,98.1099724757965,0
507.7,310,11,11,217470,217470,2025-04-25,2025-05-16,546.69,0,0,919215858,218728279,0.0236582080375728,99.0717676456796,0
539.78,450,24,24,215472,215472,2025-04-25,2025-04-25,546.69,0,0,247323203,111942542,0.0871216276460725,98.782909584104,0
526.08,438,24,24,211392,211392,2025-04-25,2025-08-15,546.69,0,0,282648688,37799117,0.0747896625651417,98.1847621383617,0
545.86,450,22,22,210892,210892,2025-04-25,2025-05-09,546.69,0,0,106424303,36041450,0.19816150452026,96.7250891932081,0
543.68,474,30,30,209040,209040,2025-04-25,2025-05-16,546.69,0,0,919215858,218728279,0.022741122031426,99.094508767711,0
543.96,422,17,17,207332,207332,2025-04-25,2025-05-16,546.69,0,0,919215858,218728279,0.0225553114859339,99.117064079197,0
511.16,417,22,22,207152,207152,2025-04-25,2025-05-16,546.69,0,0,919215858,218728279,0.0225357295783294,99.1395998087753,0
569.12,566,660,661,99660,206232,2025-04-25,2025-05-09,546.69,1,106572,106424303,36041450,0.193782805418044,96.9188719986261,0.516757826137554
532.45,459,28,28,205660,205660,2025-04-25,2025-05-16,546.69,0,0,919215858,218728279,0.0223734173219627,99.1619732260972,0
564.9,562.5,734,855,85878,205200,2025-04-25,2025-05-02,546.69,121,119322,157884664,54569672,0.12996829128382,97.465529647642,0.581491228070175
520,375,14,14,203000,203000,2025-04-25,2025-05-02,546.69,0,0,157884664,54569672,0.12857486905758,97.5941045166996,0
520.8,300,9,9,198720,198720,2025-04-25,2025-09-19,546.69,0,0,612220205,74276563,0.0324589091273131,99.5430853184599,0
541.2,507,58,58,198360,198360,2025-04-25,2025-05-09,546.69,0,0,106424303,36041450,0.186385998694302,97.1052579973204,0
576.72,573,539,533,122353,198276,2025-04-25,2025-05-23,546.69,-6,75923,70049480,15954371,0.283051351701683,95.5484765911182,0.382915733623837
650.32,650,5793,6082,150618,194624,2025-04-25,2025-07-18,546.69,289,44006,353688576,64788996,0.0550269398579614,99.7730661789879,0.226107777047024
506.06,414,21,21,193326,193326,2025-04-25,2025-05-16,546.69,0,0,919215858,218728279,0.0210316214975482,99.1830048475948,0
540.02,300,8,8,192016,192016,2025-04-25,2025-08-15,546.69,0,0,282648688,37799117,0.0679345095704106,98.2526966479321,0
524.41,467,33,33,189453,189453,2025-04-25,2025-05-16,546.69,0,0,919215858,218728279,0.0206102841189235,99.2036151317137,0
570.79,195,5,5,187895,187895,2025-04-25,2025-12-19,546.69,0,0,1084502340,72118262,0.01732545823737,99.9204993877653,0
532.23,415,16,16,187568,187568,2025-04-25,2025-09-19,546.69,0,0,612220205,74276563,0.0306373423268512,99.5737226607867,0
548.7,450,23,19,210450,187530,2025-04-25,2025-05-23,546.69,-4,-22920,70049480,15954371,0.267710766732316,95.8161873578505,-0.122220444728843
547.54,280,7,7,187278,187278,2025-04-25,2025-09-19,546.69,0,0,612220205,74276563,0.030589973749723,99.6043126345365,0
552.65,507,37,41,142191,187165,2025-04-25,2025-05-30,546.69,4,44974,159044187,37473216,0.117681132225222,97.8488078913566,0.240290652632704
563.9,330,8,8,187120,187120,2025-04-25,2025-08-15,546.69,0,0,282648688,37799117,0.0662023239251689,98.3188989718573,0
571.38,569,761,779,94364,185402,2025-04-25,2025-05-09,546.69,18,91038,106424303,36041450,0.174210208358142,97.2794682056785,0.491030301722743
545,315,8,8,184000,184000,2025-04-25,2025-08-15,546.69,0,0,282648688,37799117,0.0650984801316325,98.3839974519889,0
546,487,31,31,182900,182900,2025-04-25,2025-05-16,546.69,0,0,919215858,218728279,0.019897393893742,99.2235125256074,0
547,345,9,9,181800,181800,2025-04-25,2025-08-15,546.69,0,0,282648688,37799117,0.0643201287387543,98.4483175807276,0
526.47,448,23,23,180481,180481,2025-04-25,2025-08-15,546.69,0,0,282648688,37799117,0.0638534716991151,98.5121710524268,0
527.5,461,27,27,179550,179550,2025-04-25,2025-05-16,546.69,0,0,919215858,218728279,0.0195329528355461,99.243045478443,0
675.39,675,4592,4589,179088,178971,2025-04-25,2025-09-19,546.69,-3,-117,612220205,74276563,0.029233109024881,99.6335457435613,-0.000653737197646546
605.49,605,3136,3621,106624,177429,2025-04-25,2025-05-30,546.69,485,70805,159044187,37473216,0.111559563003708,97.9603674543603,0.39906103286385
590.95,590,1819,1858,110959,176510,2025-04-25,2025-05-23,546.69,39,65551,70049480,15954371,0.251979029680163,96.0681663875306,0.371372726757691
566.3,557.5,204,199,123012,175120,2025-04-25,2025-05-23,546.69,-5,52108,70049480,15954371,0.24999471801932,96.31816110555,0.297555961626313
543.09,483,29,29,165735,174261,2025-04-25,2025-05-16,546.69,0,8526,919215858,218728279,0.0189575711170988,99.2620030495601,0.0489266100848727
575.51,575,4028,3407,104728,173757,2025-04-25,2025-05-02,546.69,-621,69029,157884664,54569672,0.110053120802157,97.7041576375018,0.397273203381734
670.52,670,3334,3334,156698,173368,2025-04-25,2025-09-19,546.69,0,16670,612220205,74276563,0.0283179154467795,99.6618636590081,0.0961538461538462
526.3,180,5,5,173150,173150,2025-04-25,2025-09-19,546.69,0,0,612220205,74276563,0.0282823073439727,99.6901459663521,0
550.33,512,45,45,169830,172485,2025-04-25,2025-05-23,546.69,0,2654.99999999997,70049480,15954371,0.246233091237794,96.5643941967878,0.0153926428385075
592.31,591,1287,1314,102960,172134,2025-04-25,2025-05-30,546.69,27,69174,159044187,37473216,0.108230299545623,98.068597753906,0.401861340583499
578.49,577.5,1728,1733,86400,171567,2025-04-25,2025-05-09,546.69,5,85167,106424303,36041450,0.161210358126564,97.4406785638051,0.49640665162881
568.43,567,1103,1199,76107,171457,2025-04-25,2025-05-02,546.69,96,95350,157884664,54569672,0.108596361201997,97.8127539987038,0.556116110744968
605.21,605,8092,8125,121380,170625,2025-04-25,2025-05-16,546.69,33,49245,919215858,218728279,0.0185620165834868,99.2805650661436,0.288615384615385
595.69,595,2461,2465,103362,170085,2025-04-25,2025-05-23,546.69,4,66723,70049480,15954371,0.242806941607561,96.8072011383953,0.392292089249493
529,360,10,10,169000,169000,2025-04-25,2025-05-02,546.69,0,0,157884664,54569672,0.107040161924783,97.9197941606285,0
513.73,437,22,22,168806,168806,2025-04-25,2025-05-16,546.69,0,0,919215858,218728279,0.0183641305283051,99.2989291966719,0
542.57,493,35,34,113925,168538,2025-04-25,2025-04-25,546.69,-1,54613,247323203,111942542,0.0681448396089226,98.8510544237129,0.324039682445502
543.15,390,11,11,168465,168465,2025-04-25,2025-04-25,546.69,0,0,247323203,111942542,0.0681153235752005,98.9191697472881,0
546.9,498,33,34,100881,166260,2025-04-25,2025-05-02,546.69,1,65379,157884664,54569672,0.105304717879376,98.0250988785079,0.393233489714904
570.11,569,1416,1493,76464,165723,2025-04-25,2025-05-02,546.69,77,89259,157884664,54569672,0.104964596181425,98.1300634746894,0.538603573432777
506.64,410,17,17,164288,164288,2025-04-25,2025-05-16,546.69,0,0,919215858,218728279,0.0178726246474307,99.3168018213193,0
537.42,460,21,21,162582,162582,2025-04-25,2025-04-25,546.69,0,0,247323203,111942542,0.0657366547205844,98.9849064020087,0
539.96,405,12,12,161952,161952,2025-04-25,2025-04-25,546.69,0,0,247323203,111942542,0.0654819273062706,99.050388329315,0
577.22,574,464,496,98832,159712,2025-04-25,2025-05-23,546.69,32,60880,70049480,15954371,0.227998837393225,97.0351999757886,0.381186135043078
521.5,449,22,22,159500,159500,2025-04-25,2025-08-15,546.69,0,0,282648688,37799117,0.0564304759836706,98.5686015284104,0
590.58,589,1007,1009,153064,159422,2025-04-25,2025-05-30,546.69,2,6358,159044187,37473216,0.100237552221887,98.1688353061278,0.0398815721794984
680.36,680,4417,4421,167846,159156,2025-04-25,2025-09-19,546.69,4,-8690,612220205,74276563,0.0259965284876542,99.7161424948398,-0.0546005177310312
546.08,440,18,15,174852,159120,2025-04-25,2025-05-02,546.69,-3,-15732,157884664,54569672,0.100782429381488,98.2308459040708,-0.098868778280543
561.21,561,2368,7496,30784,157416,2025-04-25,2025-04-25,546.69,5128,126632,247323203,111942542,0.0636478899232111,99.1140362192382,0.804441734004167
559.77,497,25,25,156925,156925,2025-04-25,2025-08-15,546.69,0,0,282648688,37799117,0.0555194510579154,98.6241209794683,0
545.77,390,10,10,155770,155770,2025-04-25,2025-08-15,546.69,0,0,282648688,37799117,0.0551108165766543,98.679231796045,0
576.15,572.5,381,426,87630,155490,2025-04-25,2025-05-23,546.69,45,67860,70049480,15954371,0.221971669168708,97.2571716449573,0.436426779857226
542.84,155,4,4,155136,155136,2025-04-25,2025-09-19,546.69,0,0,612220205,74276563,0.0253399020047043,99.7414823968445,0
604.24,604,6383,6444,108511,154656,2025-04-25,2025-05-16,546.69,61,46145,919215858,218728279,0.0168247750138358,99.3336265963332,0.298371870473826
665.6,665,2572,2572,154320,154320,2025-04-25,2025-09-19,546.69,0,0,612220205,74276563,0.0252066166290608,99.7666890134735,0
513.83,466,32,32,153056,153056,2025-04-25,2025-05-16,546.69,0,0,919215858,218728279,0.0166507136129064,99.3502773099461,0
572.97,571,743,776,75043,152872,2025-04-25,2025-05-09,546.69,33,77829,106424303,36041450,0.143643881792677,97.5843224455978,0.509112198440525
537.5,385,10,10,152500,152500,2025-04-25,2025-05-23,546.69,0,0,70049480,15954371,0.217703257754376,97.4748749027116,0
521.37,486,43,43,152091,152091,2025-04-25,2025-05-16,546.69,0,0,919215858,218728279,0.0165457328304708,99.3668230427765,0
526.17,491,43,43,151231,151231,2025-04-25,2025-04-25,546.69,0,0,247323203,111942542,0.061147113641416,99.1751833328796,0
533.24,408,12,12,150288,150288,2025-04-25,2025-05-16,546.69,0,0,919215858,218728279,0.0163495873892985,99.3831726301658,0
581.86,579,502,523,114958,149578,2025-04-25,2025-05-30,546.69,21,34620,159044187,37473216,0.0940480773434366,98.2628833834713,0.231451149233176
567.67,566,884,882,68952,147294,2025-04-25,2025-05-02,546.69,-2,78342,157884664,54569672,0.0932921515417102,98.3241380556126,0.531875025459286
592.49,592,2933,3000,111454,147000,2025-04-25,2025-05-16,546.69,67,35546,919215858,218728279,0.0159918912103886,99.3991645213762,0.241809523809524
545.94,460,17,17,117963,146098,2025-04-25,2025-05-02,546.69,0,28135,157884664,54569672,0.0925346365496271,98.4166726921622,0.192576215964626
589.7,589,1981,2060,79240,144200,2025-04-25,2025-05-16,546.69,79,64960,919215858,218728279,0.0156872837587621,99.414851805135,0.450485436893204
549.41,370,8,8,143528,143528,2025-04-25,2025-09-19,546.69,0,0,612220205,74276563,0.0234438522002063,99.7901328656737,0
543.63,472,20,20,143260,143260,2025-04-25,2025-05-16,546.69,0,0,919215858,218728279,0.0155850226857161,99.4304368278207,0
540.96,432,13,13,141648,141648,2025-04-25,2025-05-16,546.69,0,0,919215858,218728279,0.0154096558242797,99.445846483645,0
529.37,455,19,19,141303,141303,2025-04-25,2025-05-02,546.69,0,0,157884664,54569672,0.0894976094701636,98.5061703016324,0
609.72,260,4,4,139888,139888,2025-04-25,2025-08-15,546.69,0,0,282648688,37799117,0.049491827112249,98.7287236231573,0
655.11,655,12652,12653,139172,139183,2025-04-25,2025-06-20,546.69,1,11,1174768001,197089681,0.0118477009827918,99.9563240572127,7.90326404805185e-05
530.6,415,12,12,138720,138720,2025-04-25,2025-05-23,546.69,0,0,70049480,15954371,0.198031448627456,97.6729063513391,0
549.03,395,8,9,138720,138627,2025-04-25,2025-08-15,546.69,1,-93,282648688,37799117,0.0490456902456947,98.7777693134029,-0.000670864983011967
527.34,465,22,22,137148,137148,2025-04-25,2025-05-09,546.69,0,0,106424303,36041450,0.128869061045201,97.713191506643,0
597.89,597,1578,1540,104148,137060,2025-04-25,2025-05-30,546.69,-38,32912,159044187,37473216,0.0861773086997515,98.3490606921711,0.240128410914928
506.09,401,13,13,136617,136617,2025-04-25,2025-05-16,546.69,0,0,919215858,218728279,0.0148623415067324,99.4607088251517,0
521.68,485,37,37,135716,135716,2025-04-25,2025-05-23,546.69,0,0,70049480,15954371,0.193743051340281,97.8666494026794,0
548.42,355,7,7,135394,135394,2025-04-25,2025-05-16,546.69,0,0,919215858,218728279,0.0147292933233969,99.4754381184751,0
572.56,567.5,247,267,81510,135102,2025-04-25,2025-05-23,546.69,20,53592,70049480,15954371,0.19286652805988,98.0595159307392,0.396678065461651
545.01,410,10,10,135010,135010,2025-04-25,2025-04-25,546.69,0,0,247323203,111942542,0.054588489216679,99.2297718220963,0
609.6,275,4,4,133840,133840,2025-04-25,2025-08-15,546.69,0,0,282648688,37799117,0.0473520683740092,98.825121381777,0
602.25,602,5323,5332,101137,133300,2025-04-25,2025-05-16,546.69,9,32163,919215858,218728279,0.0145014904649306,99.48993960894,0.241282820705176
615.28,615,4633,4749,88027,132972,2025-04-25,2025-05-30,546.69,116,44945,159044187,37473216,0.083606953833528,98.4326676460046,0.338003489456427
519.77,390,10,10,129770,129770,2025-04-25,2025-05-02,546.69,0,0,157884664,54569672,0.0821929101359712,98.5883632117683,0
593.11,592,977,1168,92815,129648,2025-04-25,2025-05-30,546.69,191,36833,159044187,37473216,0.0815169686145147,98.5141846146191,0.284100024682216
620.18,620,7151,7179,121567,129222,2025-04-25,2025-05-30,546.69,28,7655,159044187,37473216,0.0812491185232693,98.5954337331424,0.0592391388463265
526.26,455,18,18,128268,128268,2025-04-25,2025-05-09,546.69,0,0,106424303,36041450,0.12052510224098,97.833716608884,0
513.32,300,6,6,127992,127992,2025-04-25,2025-05-09,546.69,0,0,106424303,36041450,0.120265762980848,97.9539823718648,0
580.26,580,3499,4907,55984,127582,2025-04-25,2025-05-02,546.69,1408,71598,157884664,54569672,0.0808070883946018,98.6691703001629,0.561192017682745
542.45,415,10,10,127450,127450,2025-04-25,2025-07-18,546.69,0,0,353688576,64788996,0.0360345254690952,99.809100704457,0
524.39,410,11,11,125829,125829,2025-04-25,2025-05-09,546.69,0,0,106424303,36041450,0.11823333247482,98.0722157043397,0
715.15,715,8331,8342,116634,125130,2025-04-25,2025-09-19,546.69,11,8495.99999999999,612220205,74276563,0.0204387243312233,99.8105715900049,0.0678973867178134
514.36,360,8,8,123488,123488,2025-04-25,2025-05-16,546.69,0,0,919215858,218728279,0.0134340589237311,99.5033736678638,0
537,460,16,16,123200,123200,2025-04-25,2025-05-09,546.69,0,0,106424303,36041450,0.11576303205857,98.1879787363982,0
541.4,430,11,11,122540,122540,2025-04-25,2025-04-25,546.69,0,0,247323203,111942542,0.0495465037301818,99.2793183258265,0
543.64,300,5,5,121820,121820,2025-04-25,2025-05-02,546.69,0,0,157884664,54569672,0.0771575889093319,98.7463278890722,0
725.36,725,3344,3359,120384,120924,2025-04-25,2025-12-19,546.69,15,540.000000000015,1084502340,72118262,0.0111501834103926,99.9316495711757,0.00446561476629961
554,511,29,28,105299,120400,2025-04-25,2025-05-23,546.69,-1,15101,70049480,15954371,0.171878506450012,98.2313944371893,0.125423588039867
568.8,567.5,955,915,64940,118950,2025-04-25,2025-05-02,546.69,-40,54010,157884664,54569672,0.0753398062778282,98.8216676953501,0.454056326187474
534.04,435,12,12,118848,118848,2025-04-25,2025-07-18,546.69,0,0,353688576,64788996,0.033602442392711,99.8427031468497,0
670.27,670,4394,4399,118638,118773,2025-04-25,2025-08-15,546.69,5,134.999999999985,282648688,37799117,0.0420214227210565,98.867142804498,0.00113662195953614
543.76,425,10,10,118760,118760,2025-04-25,2025-05-09,546.69,0,0,106424303,36041450,0.11159105265646,98.2995697890547,0
538.91,440,12,12,118692,118692,2025-04-25,2025-05-09,546.69,0,0,106424303,36041450,0.111527157476427,98.4110969465311,0
537.13,463,16,16,118608,118608,2025-04-25,2025-05-16,546.69,0,0,919215858,218728279,0.0129031716508964,99.5162768395147,0
577.12,574,363,380,27951,118560,2025-04-25,2025-05-09,546.69,17,90609,106424303,36041450,0.111403125656364,98.5225000721875,0.764245951417004
567.01,563,295,295,65490,118295,2025-04-25,2025-05-09,546.69,0,52805,106424303,36041450,0.111154122381238,98.6336541945687,0.446384039900249
536.5,458,15,15,117750,117750,2025-04-25,2025-05-16,546.69,0,0,919215858,218728279,0.012809831224648,99.5290866707393,0
544.12,427,10,10,117120,117120,2025-04-25,2025-05-16,546.69,0,0,919215858,218728279,0.012741294548032,99.5418279652873,0
593.54,593,2145,2165,66495,116910,2025-04-25,2025-05-16,546.69,20,50415,919215858,218728279,0.0127184489891601,99.5545464142765,0.431229150628689
547.62,479,17,17,116654,116654,2025-04-25,2025-05-16,546.69,0,0,919215858,218728279,0.0126905991650114,99.5672370134415,0
538.2,305,5,5,116600,116600,2025-04-25,2025-05-16,546.69,0,0,919215858,218728279,0.01268472459273,99.5799217380343,0
579.01,578,1160,1153,88160,116453,2025-04-25,2025-05-09,546.69,-7,28293,106424303,36041450,0.109423314710363,98.7430775092791,0.242956385838063
615.08,615,14336,14504,143360,116032,2025-04-25,2025-05-16,546.69,168,-27328,919215858,218728279,0.0126229327954001,99.5925446708296,-0.235521235521236
544,400,8,8,115200,115200,2025-04-25,2025-05-09,546.69,0,0,106424303,36041450,0.108245952054767,98.8513234613338,0
543.75,489,21,21,114975,114975,2025-04-25,2025-08-15,546.69,0,0,282648688,37799117,0.0406777051800785,98.9078205096781,0
580.81,580,1396,1404,62820,113724,2025-04-25,2025-05-09,546.69,8,50904,106424303,36041450,0.106859050794065,98.9581825121279,0.447610003165559
530.88,464,17,17,113696,113696,2025-04-25,2025-05-16,546.69,0,0,919215858,218728279,0.0123688031500431,99.6049134739797,0
544.28,501,26,26,98436,112528,2025-04-25,2025-05-02,546.69,0,14092,157884664,54569672,0.0712722801246865,98.8929399754748,0.125231053604436
561.94,496,17,17,112098,112098,2025-04-25,2025-08-15,546.69,0,0,282648688,37799117,0.0396598338358464,98.9474803435139,0
600.05,600,19346,22377,96730,111885,2025-04-25,2025-05-02,546.69,3031,15155,157884664,54569672,0.070865020810381,98.9638049962851,0.135451579747062
720.39,720,2906,2865,110428,111735,2025-04-25,2025-12-19,546.69,-41,1307.00000000001,1084502340,72118262,0.0103028823340298,99.9419524535097,0.0116973195507228
530.43,465,17,17,111231,111231,2025-04-25,2025-05-02,546.69,0,0,157884664,54569672,0.0704507943849442,99.0342557906701,0
568.92,561,86,140,43000,110880,2025-04-25,2025-05-23,546.69,54,67880,70049480,15954371,0.158288112916755,98.389682550106,0.612193362193362
551.31,511,28,27,115780,108837,2025-04-25,2025-05-30,546.69,-1,-6942.99999999999,159044187,37473216,0.0684319257767026,98.6638656589191,-0.0637926440456829
520.66,423,11,11,107426,107426,2025-04-25,2025-05-16,546.69,0,0,919215858,218728279,0.011686700035151,99.6166001740148,0
537.32,430,10,10,107320,107320,2025-04-25,2025-05-02,546.69,0,0,157884664,54569672,0.0679736696909334,99.102229460361,0
690.17,690,6295,6294,107015,106998,2025-04-25,2025-08-15,546.69,-1,-17.0000000000146,282648688,37799117,0.0378554737887197,98.9853358173026,-0.000158881474420219
563.12,385,6,6,106872,106872,2025-04-25,2025-08-15,546.69,0,0,282648688,37799117,0.037810895481673,99.0231467127843,0
660.22,660,4803,4819,96060,106018,2025-04-25,2025-07-18,546.69,16,9958,353688576,64788996,0.0299749574043353,99.8726781042541,0.0939274462827067
589.6,588,674,660,74140,105600,2025-04-25,2025-05-30,546.69,-14,31460,159044187,37473216,0.0663966423368872,98.7302623012559,0.297916666666667
559.56,486,14,14,102984,102984,2025-04-25,2025-08-15,546.69,0,0,282648688,37799117,0.0364353362928046,99.0595820490771,0
600.48,600,2465,2130,78880,102240,2025-04-25,2025-05-23,546.69,-335,23360,70049480,15954371,0.145953974247917,98.5356365243539,0.22848200312989
548.07,504,22,23,75372,101361,2025-04-25,2025-05-02,546.69,1,25989,157884664,54569672,0.0641993955790412,99.1664288559401,0.256400390682807
700.11,700,9118,9209,109416,101299,2025-04-25,2025-08-15,546.69,91,-8116.99999999999,282648688,37799117,0.0358391898850774,99.0954212389622,-0.0801291226961765
569.25,568,554,810,30470,101250,2025-04-25,2025-05-02,546.69,256,70780,157884664,54569672,0.06412909109399,99.2305579470341,0.699061728395062
505.58,405,10,10,100580,100580,2025-04-25,2025-05-23,546.69,0,0,70049480,15954371,0.143584220753673,98.6792207451076,0
539.98,340,5,5,101565,99990,2025-04-25,2025-04-25,546.69,0,-1575,247323203,111942542,0.0404288796146636,99.3197472054411,-0.0157515751575158
580.49,578,427,401,64050,99849,2025-04-25,2025-05-23,546.69,-26,35799,70049480,15954371,0.142540672678798,98.8217614177864,0.358531382387405
524.45,475,20,20,98900,98900,2025-04-25,2025-05-23,546.69,0,0,70049480,15954371,0.14118591601251,98.9629473337989,0
528.51,458,14,14,98714,98714,2025-04-25,2025-08-15,546.69,0,0,282648688,37799117,0.0349246269984455,99.1303458659607,0
543.12,482,16,16,97792,97792,2025-04-25,2025-05-16,546.69,0,0,919215858,218728279,0.0106386328248049,99.6272388068397,0
513.62,433,12,12,96744,96744,2025-04-25,2025-05-16,546.69,0,0,919215858,218728279,0.0105246226071961,99.6377634294468,0
566.76,562.5,229,223,47174,94998,2025-04-25,2025-05-09,546.69,-6,47824,106424303,36041450,0.0892634457751628,99.0474459579031,0.503421124655256
572.76,567,161,164,56672,94464,2025-04-25,2025-05-23,546.69,3,37792,70049480,15954371,0.134853249445963,99.0978005832449,0.400067750677507
576.02,572,200,234,59200,94068,2025-04-25,2025-05-23,546.69,34,34868,70049480,15954371,0.134287934756975,99.2320885180018,0.370668027384445
690.3,690,3117,3117,84159,93510,2025-04-25,2025-09-19,546.69,0,9350.99999999998,612220205,74276563,0.0152739160250355,99.82584550603,0.0999999999999999
565.09,565,5109,10367,40872,93303,2025-04-25,2025-04-25,546.69,5258,52431,247323203,111942542,0.0377251300598755,99.357472335501,0.561943345873123
572.76,572,1084,1226,37940,93176,2025-04-25,2025-05-02,546.69,142,55236,157884664,54569672,0.05901523152369,99.2895731785577,0.592813600068687
515.63,431,11,11,93093,93093,2025-04-25,2025-05-16,546.69,0,0,919215858,218728279,0.0101274362479504,99.6478908656948,0
543.06,481,15,15,93090,93090,2025-04-25,2025-05-16,546.69,0,0,919215858,218728279,0.0101271098828236,99.6580179755776,0
578.03,577,856,891,47936,91773,2025-04-25,2025-05-09,546.69,35,43837,106424303,36041450,0.0862331228986297,99.1336790808017,0.477667723622416
550.61,514,25,25,91525,91525,2025-04-25,2025-05-30,546.69,0,0,159044187,37473216,0.0575469004723826,98.7878092017283,0
685.25,685,3656,3656,91400,91400,2025-04-25,2025-09-19,546.69,0,0,612220205,74276563,0.0149292687914474,99.8407747748214,0
524.55,434,10,10,90550,90550,2025-04-25,2025-05-16,546.69,0,0,919215858,218728279,0.00985078740884821,99.6678687629865,0
569.35,469,9,9,90315,90315,2025-04-25,2025-08-15,546.69,0,0,282648688,37799117,0.0319530936580891,99.1622989596187,0
527.46,446,11,11,89606,89606,2025-04-25,2025-05-16,546.69,0,0,919215858,218728279,0.00974809118229986,99.6776168541688,0
532.35,355,5,5,88675,88675,2025-04-25,2025-04-25,546.69,0,0,247323203,111942542,0.0358538943877417,99.3933262298888,0
598.3,598,3161,2922,82186,87660,2025-04-25,2025-05-16,546.69,-239,5474,919215858,218728279,0.00953638900341948,99.6871532431722,0.062445813369838
577.24,576,709,700,60974,86800,2025-04-25,2025-05-09,546.69,-9,25826,106424303,36041450,0.0815603180412654,99.215239398843,0.297534562211982
549.19,477,12,12,86628,86628,2025-04-25,2025-05-16,546.69,0,0,919215858,218728279,0.00942411939982002,99.696577362572,0
532.77,425,8,8,86216,86216,2025-04-25,2025-05-23,546.69,0,0,70049480,15954371,0.12307871521673,99.3551672332186,0
507.41,335,5,5,86205,86205,2025-04-25,2025-05-30,546.69,0,0,159044187,37473216,0.0542019181122288,98.8420111198405,0
591.53,591,1612,1610,56420,85330,2025-04-25,2025-05-16,546.69,-2,28910,919215858,218728279,0.00928291208831604,99.7058602746603,0.338802296964725
518.39,453,13,13,85007,85007,2025-04-25,2025-05-16,546.69,0,0,919215858,218728279,0.00924777344300342,99.7151080481033,0
554.7,494,14,14,84980,84980,2025-04-25,2025-08-15,546.69,0,0,282648688,37799117,0.0300655915303594,99.1923645511491,0
620.09,620,9501,9398,76008,84582,2025-04-25,2025-05-16,546.69,-103,8574,919215858,218728279,0.00920153838338154,99.7243095864867,0.101369085621054
602.55,602,1519,1530,71393,84150,2025-04-25,2025-05-30,546.69,11,12757,159044187,37473216,0.052909824362207,98.8949209442028,0.151598336304219
574.57,574,1205,1472,36150,83904,2025-04-25,2025-05-02,546.69,267,47754,157884664,54569672,0.0531425902138285,99.3427157687716,0.569150457665904
730.34,730,2468,2450,76508,83300,2025-04-25,2025-12-19,546.69,-18,6792.00000000002,1084502340,72118262,0.00768094239427828,99.949633395904,0.0815366146458585
665.33,665,2458,2508,98320,82764,2025-04-25,2025-08-15,546.69,50,-15556,282648688,37799117,0.0292815794000785,99.2216461305492,-0.187956116185781
610.36,610,2312,2289,60112,82404,2025-04-25,2025-05-30,546.69,-23,22292,159044187,37473216,0.0518120162417505,98.9467329604445,0.2705208485025
655.23,655,3584,3582,89600,82386,2025-04-25,2025-07-18,546.69,-2,-7214,353688576,64788996,0.0232933732075078,99.8959714774616,-0.0875634209695822
547.83,473,11,11,82313,82313,2025-04-25,2025-08-15,546.69,0,0,282648688,37799117,0.0291220173645384,99.2507681479137,0
601.25,601,3331,3291,63289,82275,2025-04-25,2025-05-16,546.69,-40,18986,919215858,218728279,0.00895056360091647,99.7332601500876,0.230762686113643
569.09,478,9,9,81981,81981,2025-04-25,2025-08-15,546.69,0,0,282648688,37799117,0.0290045570634313,99.2797727049772,0
594.4,594,1963,2045,56927,81800,2025-04-25,2025-05-16,546.69,82,24873,919215858,218728279,0.00889888912251555,99.7421590392101,0.304070904645477
518.57,456,13,13,81341,81341,2025-04-25,2025-05-16,546.69,0,0,919215858,218728279,0.00884895525812393,99.7510079944683,0
508.99,436,11,11,80289,80289,2025-04-25,2025-05-16,546.69,0,0,919215858,218728279,0.00873450988701285,99.7597425043553,0
670.15,670,5302,5298,79530,79470,2025-04-25,2025-07-18,546.69,-4,-60,353688576,64788996,0.0224689190979128,99.9184403965595,-0.000755001887504719
600.14,600,5459,5675,60049,79450,2025-04-25,2025-05-09,546.69,216,19401,106424303,36041450,0.0746540007877712,99.2898933996307,0.244191315292637
574.23,572.5,404,456,50096,78888,2025-04-25,2025-05-09,546.69,52,28792,106424303,36041450,0.074125925917504,99.3640193255482,0.364973126457763
508.55,457,15,15,77325,77325,2025-04-25,2025-05-16,546.69,0,0,919215858,218728279,0.00841206114179114,99.7681545654971,0
502.97,310,4,4,77188,77188,2025-04-25,2025-05-30,546.69,0,0,159044187,37473216,0.0485324245142012,98.9952653849587,0
527.92,451,10,10,76920,76920,2025-04-25,2025-08-15,546.69,0,0,282648688,37799117,0.0272139950637238,99.3069867000409,0
529.03,454,10,10,75030,75030,2025-04-25,2025-08-15,546.69,0,0,282648688,37799117,0.0265453204580239,99.3335320204989,0
538,488,15,15,75000,75000,2025-04-25,2025-08-15,546.69,0,0,282648688,37799117,0.0265347065753937,99.3600667270743,0
597.35,597,2143,2133,53575,74655,2025-04-25,2025-05-16,546.69,-10,21080,919215858,218728279,0.0081215961789902,99.7762761616761,0.282365548188333
530.32,425,7,7,73724,73724,2025-04-25,2025-05-30,546.69,0,0,159044187,37473216,0.0463544134436048,99.0416197984023,0
542.57,300,3,3,72771,72771,2025-04-25,2025-05-23,546.69,0,0,70049480,15954371,0.103885139475696,99.4590523726943,0
530.93,350,4,4,72372,72372,2025-04-25,2025-05-30,546.69,0,0,159044187,37473216,0.0455043352197462,99.0871241336221,0
527.46,407,6,6,72276,72276,2025-04-25,2025-05-16,546.69,0,0,919215858,218728279,0.0078627886334833,99.7841389503095,0
705.2,705,3599,3603,68381,72060,2025-04-25,2025-09-19,546.69,4,3679,612220205,74276563,0.0117702747167582,99.8525450495382,0.0510546766583403
569.54,427,5,5,71270,71270,2025-04-25,2025-08-15,546.69,0,0,282648688,37799117,0.0252150471683774,99.3852817742427,0
507.14,365,5,5,71070,71070,2025-04-25,2025-08-15,546.69,0,0,282648688,37799117,0.0251442879508431,99.4104260621935,0
595.09,594,620,644,50220,70196,2025-04-25,2025-05-30,546.69,24,19976,159044187,37473216,0.0441361619837134,99.1312602956058,0.284574619636446
529.78,355,4,4,69912,69912,2025-04-25,2025-05-23,546.69,0,0,70049480,15954371,0.0998037387286815,99.558856111423,0
504.69,330,4,4,69876,69876,2025-04-25,2025-05-30,546.69,0,0,159044187,37473216,0.043934960037238,99.175195255643,0
630.06,630,11633,11627,58165,69762,2025-04-25,2025-05-16,546.69,-6,11597,919215858,218728279,0.00758929465727298,99.7917282449668,0.16623663312405
573.62,573,1046,1119,34518,69378,2025-04-25,2025-05-02,546.69,73,34860,157884664,54569672,0.0439422032782107,99.3866579720498,0.502464758280723
528.09,459,10,10,69090,69090,2025-04-25,2025-08-15,546.69,0,0,282648688,37799117,0.0244437716972527,99.4348698338908,0
552.1,509,16,16,68960,68960,2025-04-25,2025-05-30,546.69,0,0,159044187,37473216,0.0433590194654521,99.2185542751085,0
547.46,471,9,9,68814,68814,2025-04-25,2025-08-15,546.69,0,0,282648688,37799117,0.0243461239770552,99.4592159578678,0
625.14,625,4910,4897,63830,68558,2025-04-25,2025-05-30,546.69,-13,4727.99999999999,159044187,37473216,0.0431062595201923,99.2616605346287,0.0689635053531316
511.27,449,11,11,68497,68497,2025-04-25,2025-05-16,546.69,0,0,919215858,218728279,0.00745167736216318,99.799179922329,0
594.15,593,478,591,42542,67965,2025-04-25,2025-05-30,546.69,113,25423,159044187,37473216,0.0427334071631301,99.3043939417918,0.374060178032811
544.37,493,13,13,66781,66781,2025-04-25,2025-05-02,546.69,0,0,157884664,54569672,0.0422973316775086,99.4289553037273,0
545.38,325,3,3,66114,66114,2025-04-25,2025-09-19,546.69,0,0,612220205,74276563,0.0107990555457084,99.8633441050839,0
552.01,492,11,11,66011,66011,2025-04-25,2025-08-15,546.69,0,0,282648688,37799117,0.0233544335433108,99.4825703914111,0
640.08,640,8023,8018,64184,64144,2025-04-25,2025-05-30,546.69,-5,-39.9999999999927,159044187,37473216,0.0403309301709971,99.3447248719628,-0.000623596906959228
690.05,690,12160,12673,48640,63365,2025-04-25,2025-06-20,546.69,513,14725,1174768001,197089681,0.00539383094756256,99.9617178881603,0.232383808095952
599.27,599,2441,2341,53702,63207,2025-04-25,2025-05-16,546.69,-100,9505.00000000001,919215858,218728279,0.00687618685534035,99.8060561091843,0.15037891372791
549.53,501,3,13,8628,63089,2025-04-25,2025-05-09,546.69,10,54461,106424303,36041450,0.059280632544993,99.4232999580932,0.863240818526209
550.76,472,8,8,63008,63008,2025-04-25,2025-08-15,546.69,0,0,282648688,37799117,0.0222919838920321,99.5048623753032,0
680.21,680,2989,2989,74725,62769,2025-04-25,2025-08-15,546.69,0,-11956,282648688,37799117,0.0222074266270785,99.5270698019302,-0.190476190476191
608.4,608,1544,1567,43232,62680,2025-04-25,2025-05-30,546.69,23,19448,159044187,37473216,0.0394104312658721,99.3841353032287,0.310274409700064
750.21,750,2954,2982,59080,62622,2025-04-25,2025-12-19,546.69,28,3541.99999999999,1084502340,72118262,0.00577426139993391,99.9554076573039,0.0565615917728593
559.19,481,8,8,62552,62552,2025-04-25,2025-08-15,546.69,0,0,282648688,37799117,0.0221306528760537,99.5492004548063,0
596.93,596,652,665,38468,61845,2025-04-25,2025-05-30,546.69,13,23377,159044187,37473216,0.0388854199367878,99.4230207231654,0.377993370523082
546.49,444,6,6,61494,61494,2025-04-25,2025-05-16,546.69,0,0,919215858,218728279,0.00668983236797031,99.8127459415523,0
542.9,487,4,11,21748,61490,2025-04-25,2025-04-25,546.69,7,39742,247323203,111942542,0.0248622042954862,99.4181884341842,0.646316474223451
543.78,476,9,9,61002,61002,2025-04-25,2025-05-16,546.69,0,0,919215858,218728279,0.00663630848718452,99.8193822500395,0
599.75,599,801,803,40851,60225,2025-04-25,2025-05-30,546.69,2,19374,159044187,37473216,0.037866835082756,99.4608875582482,0.321693648816936
660.09,660,6511,6507,71621,58563,2025-04-25,2025-06-20,546.69,-4,-13058,1174768001,197089681,0.00498506938818127,99.9667029575485,-0.222973549852296
564.69,552.5,48,48,45600,58512,2025-04-25,2025-05-23,546.69,0,12912,70049480,15954371,0.0835295279850757,99.642385639408,0.220672682526661
542.59,255,2,2,57518,57518,2025-04-25,2025-04-25,546.69,0,0,247323203,111942542,0.023256208597622,99.4414446427819,0
571.01,457,5,5,57005,57005,2025-04-25,2025-08-15,546.69,0,0,282648688,37799117,0.0201681459777376,99.569368600784,0
579,295,2,2,56800,56800,2025-04-25,2025-08-15,546.69,0,0,282648688,37799117,0.0200956177797648,99.5894642185638,0
528.78,245,2,2,56756,56756,2025-04-25,2025-09-19,546.69,0,0,612220205,74276563,0.00927052056375696,99.8726146256477,0
715.43,715,1314,1314,56502,56502,2025-04-25,2025-12-19,546.69,0,0,1084502340,72118262,0.00520994726484408,99.9606176045688,0
569.79,431,4,4,55516,55516,2025-04-25,2025-08-15,546.69,0,0,282648688,37799117,0.0196413436031941,99.609105562167,0
566.63,428,4,4,55452,55452,2025-04-25,2025-08-15,546.69,0,0,282648688,37799117,0.0196187006535831,99.6287242628206,0
539,489,11,11,55000,55000,2025-04-25,2025-04-25,546.69,0,0,247323203,111942542,0.0222381075988248,99.4636827503807,0
568.45,477,6,6,54870,54870,2025-04-25,2025-08-15,546.69,0,0,282648688,37799117,0.019412791330558,99.6481370541511,0
590.3,590,1763,1818,31734,54540,2025-04-25,2025-05-09,546.69,55,22806,106424303,36041450,0.0512476929259288,99.4745476510192,0.418151815181518
538.86,430,5,5,54430,54430,2025-04-25,2025-05-23,546.69,0,0,70049480,15954371,0.0777022184889881,99.720087857897,0
603.25,603,2170,2159,36890,53975,2025-04-25,2025-05-16,546.69,-11,17085,919215858,218728279,0.00587185257197771,99.8252541026114,0.316535433070866
618.11,618,4888,4888,39104,53768,2025-04-25,2025-05-16,546.69,0,14664,919215858,218728279,0.00584933337823247,99.8311034359897,0.272727272727273
539.33,501,14,14,53662,53662,2025-04-25,2025-08-15,546.69,0,0,282648688,37799117,0.0189854056566504,99.6671224598078,0
780.13,780,4114,4127,57596,53651,2025-04-25,2025-12-19,546.69,13,-3945,1084502340,72118262,0.00494706170942886,99.9655646662782,-0.0735307822780563
543.48,365,3,3,53544,53544,2025-04-25,2025-05-16,546.69,0,0,919215858,218728279,0.00582496478210235,99.8369284007718,0
625.03,625,17602,17602,35204,52806,2025-04-25,2025-05-02,546.69,0,17602,157884664,54569672,0.03344593367219,99.4624012373995,0.333333333333333
546.68,285,2,2,52336,52336,2025-04-25,2025-09-19,546.69,0,0,612220205,74276563,0.00854855811235436,99.88116318376,0
522.89,471,10,10,51890,51890,2025-04-25,2025-05-16,546.69,0,0,919215858,218728279,0.00564502880889159,99.8425734295807,0
565.86,441,4,4,49944,49944,2025-04-25,2025-08-15,546.69,0,0,282648688,37799117,0.0176699918026862,99.6847924516105,0
805.08,805,4235,6235,29645,49880,2025-04-25,2025-12-19,546.69,2000,20235,1084502340,72118262,0.00459934461736616,99.9701640108955,0.405673616680032
532.23,503,17,17,49691,49691,2025-04-25,2025-05-09,546.69,0,0,106424303,36041450,0.0466914028086235,99.5212390538278,0
533.47,451,6,6,49482,49482,2025-04-25,2025-05-16,546.69,0,0,919215858,218728279,0.00538306640049284,99.8479564959812,0
573.24,572.5,734,668,23488,49432,2025-04-25,2025-05-02,546.69,-66,25944,157884664,54569672,0.0313089306761295,99.4937101680756,0.524842207476938
576.44,576,924,1123,21252,49412,2025-04-25,2025-05-02,546.69,199,28160,157884664,54569672,0.0312962632013455,99.525006431277,0.569902048085485
625.06,625,8211,8194,65688,49164,2025-04-25,2025-05-16,546.69,-17,-16524,919215858,218728279,0.00534847169705812,99.8533049676782,-0.336099585062241
585.5,585,889,947,23114,47350,2025-04-25,2025-05-09,546.69,58,24236,106424303,36041450,0.0444917172725106,99.5657307711003,0.511847940865892
735.26,735,1819,1819,47294,47294,2025-04-25,2025-12-19,546.69,0,0,1084502340,72118262,0.0043608942328331,99.9745249051284,0
603.54,603,892,857,35680,46278,2025-04-25,2025-05-30,546.69,-35,10598,159044187,37473216,0.0290975739968415,99.489985132245,0.229007303686417
528.65,375,3,3,46095,46095,2025-04-25,2025-05-09,546.69,0,0,106424303,36041450,0.043312475346914,99.6090432464472,0
585.14,585,2935,3289,29350,46046,2025-04-25,2025-05-02,546.69,354,16696,157884664,54569672,0.0291643271951986,99.5541707584722,0.362593927811319
563.1,411,3,3,45630,45630,2025-04-25,2025-05-16,546.69,0,0,919215858,218728279,0.00496401357775531,99.858268981256,0
840.05,840,9093,9102,45465,45510,2025-04-25,2025-12-19,546.69,9,45,1084502340,72118262,0.00419639481829057,99.9787212999467,0.000988793671720501
542.04,454,5,5,44020,44020,2025-04-25,2025-04-25,546.69,0,0,247323203,111942542,0.0177985726636413,99.4814813230443,0
524.43,415,4,4,43772,43772,2025-04-25,2025-05-30,546.69,0,0,159044187,37473216,0.0275219112535059,99.5175070434986,0
735.1,735,4371,4371,43710,43710,2025-04-25,2025-09-19,546.69,0,0,612220205,74276563,0.00713958795267138,99.8883027717127,0
675.06,675,7251,7250,43506,43500,2025-04-25,2025-06-20,546.69,-1,-6,1174768001,197089681,0.0037028587740704,99.9704058163226,-0.000137931034482759
598.73,598,441,593,21609,43289,2025-04-25,2025-05-30,546.69,152,21680,159044187,37473216,0.0272182220655446,99.5447252655641,0.500820069763681
609.17,609,2544,2544,30528,43248,2025-04-25,2025-05-16,546.69,0,12720,919215858,218728279,0.00470487966712167,99.8629738609231,0.294117647058824
568.69,461,4,4,43076,43076,2025-04-25,2025-08-15,546.69,0,0,282648688,37799117,0.0152401202725554,99.700032571883,0
581.77,581,554,558,26592,42966,2025-04-25,2025-05-09,546.69,4,16374,106424303,36041450,0.0403723574304264,99.6494156038776,0.381092026253317
568.7,462,4,4,42680,42680,2025-04-25,2025-08-15,546.69,0,0,282648688,37799117,0.0151000170218374,99.7151325889049,0
551,340,1,2,19202,42200,2025-04-25,2025-05-30,546.69,1,22998,159044187,37473216,0.0265335066914454,99.5712587722555,0.544976303317536
569.21,429,3,3,42063,42063,2025-04-25,2025-08-15,546.69,0,0,282648688,37799117,0.0148817248357438,99.7300143137406,0
547.84,478,6,6,41904,41904,2025-04-25,2025-05-16,546.69,0,0,919215858,218728279,0.00455866809034098,99.8675325290134,0
613.3,613,1395,1395,29295,41850,2025-04-25,2025-05-30,546.69,0,12555,159044187,37473216,0.026313442062488,99.597572214318,0.3
532.56,428,4,4,41824,41824,2025-04-25,2025-05-16,546.69,0,0,919215858,218728279,0.0045499650202945,99.8720824940337,0
628.13,628,3197,3197,35167,41561,2025-04-25,2025-05-30,546.69,0,6394,159044187,37473216,0.0261317315545773,99.6237039458726,0.153846153846154
608.15,608,2785,2756,36205,41340,2025-04-25,2025-05-16,546.69,-29,5135,919215858,218728279,0.00449731144651336,99.8765798054803,0.124213836477987
630.12,630,3445,3440,37895,41280,2025-04-25,2025-05-30,546.69,-5,3385,159044187,37473216,0.0259550510953286,99.6496589969679,0.0820009689922481
539.13,502,11,11,40843,40843,2025-04-25,2025-05-02,546.69,0,0,157884664,54569672,0.0258688836301416,99.5800396421023,0
519.98,452,6,6,40788,40788,2025-04-25,2025-05-16,546.69,0,0,919215858,218728279,0.00443726026319272,99.8810170657434,0
568.5,433,3,3,40650,40650,2025-04-25,2025-08-15,546.69,0,0,282648688,37799117,0.0143818109638634,99.7443961247045,0
583.15,582.5,613,624,22068,40560,2025-04-25,2025-05-09,546.69,11,18492,106424303,36041450,0.0381115956192826,99.6875271994969,0.455917159763314
611.29,611,1341,1393,33525,40397,2025-04-25,2025-05-30,546.69,52,6872,159044187,37473216,0.025399859474273,99.6750588564422,0.17011164195361
563.41,429,3,3,40323,40323,2025-04-25,2025-05-16,546.69,0,0,919215858,218728279,0.00438667366854761,99.885403739412,0
695.26,695,1546,1546,35558,40196,2025-04-25,2025-09-19,546.69,0,4637.99999999999,612220205,74276563,0.0065656114698142,99.8948683831825,0.115384615384615
542.63,410,3,3,39789,39789,2025-04-25,2025-05-30,546.69,0,0,159044187,37473216,0.0250175757759697,99.7000764322182,0
725.13,725,3018,3022,36216,39286,2025-04-25,2025-09-19,546.69,4,3070,612220205,74276563,0.00641697214158425,99.9012853553241,0.0781448862190093
700.03,700,13043,13088,39129,39264,2025-04-25,2025-06-20,546.69,45,135,1174768001,197089681,0.00334227694034714,99.9737480932629,0.00343826405867971
538.01,482,7,7,39207,39207,2025-04-25,2025-04-25,546.69,0,0,247323203,111942542,0.0158525360841296,99.4973338591285,0
539.85,484,4,7,21604,39095,2025-04-25,2025-04-25,546.69,3,17491,247323203,111942542,0.0158072512104738,99.5131411103389,0.447397365391994
541.35,444,4,4,38940,38940,2025-04-25,2025-04-25,546.69,0,0,247323203,111942542,0.015744580179968,99.5288856905189,0
635.1,635,3889,3893,46668,38930,2025-04-25,2025-05-30,546.69,4,-7738,159044187,37473216,0.0244774743008998,99.7245539065191,-0.19876701772412
675.27,675,1431,1441,35775,38907,2025-04-25,2025-08-15,546.69,10,3132.00000000001,282648688,37799117,0.0137651443830512,99.7581612690875,0.0804996530187372
720.15,720,2595,2593,36330,38895,2025-04-25,2025-09-19,546.69,-2,2565,612220205,74276563,0.00635310623242172,99.9076384615565,0.065946779791747
542.27,350,2,2,38454,38454,2025-04-25,2025-05-09,546.69,0,0,106424303,36041450,0.0361327243082814,99.7236599238052,0
745.25,745,1529,1535,32109,38375,2025-04-25,2025-12-19,546.69,6,6266,1084502340,72118262,0.00353848936831247,99.982259789315,0.16328338762215
613.48,230,1,1,38348,38348,2025-04-25,2025-09-19,546.69,0,0,612220205,74276563,0.00626375929556262,99.9139022208521,0
590.08,590,4097,4786,28679,38288,2025-04-25,2025-05-02,546.69,689,9609,157884664,54569672,0.0242506137264858,99.6042902558288,0.2509663602173
528.54,452,5,5,38270,38270,2025-04-25,2025-08-15,546.69,0,0,282648688,37799117,0.0135397762752042,99.7717010453627,0
606.2,606,1900,1901,36100,38020,2025-04-25,2025-05-16,546.69,1,1920.00000000001,919215858,218728279,0.00413613403958486,99.8895398734516,0.0504997369805367
570.04,570,9389,9449,56334,37796,2025-04-25,2025-04-25,546.69,60,-18538,247323203,111942542,0.0152820275419124,99.5441677180608,-0.490475182559001
566.54,380,2,2,37308,37308,2025-04-25,2025-08-15,546.69,0,0,282648688,37799117,0.0131994244388638,99.7849004698016,0
690.07,690,5326,5328,37282,37296,2025-04-25,2025-07-18,546.69,2,13.9999999999927,353688576,64788996,0.0105448698461779,99.9289852664057,0.00037537537537518
607.42,607,884,886,25636,37212,2025-04-25,2025-05-30,546.69,2,11576,159044187,37473216,0.0233972713507599,99.7479511778698,0.311082446522627
645.03,645,12249,12257,36747,36771,2025-04-25,2025-05-16,546.69,8,24,919215858,218728279,0.00400025735848434,99.8935401308101,0.000652688259769927
609.37,609,982,992,26514,36704,2025-04-25,2025-05-30,546.69,10,10190,159044187,37473216,0.0230778632607302,99.7710290411306,0.27762641673932
570.28,567.5,132,132,17292,36696,2025-04-25,2025-05-09,546.69,0,19404,106424303,36041450,0.0344808459774456,99.7581407697826,0.528776978417266
525.19,404,3,3,36357,36357,2025-04-25,2025-05-16,546.69,0,0,919215858,218728279,0.00395521897099386,99.8974953497811,0
635.05,635,7262,7267,29048,36335,2025-04-25,2025-05-16,546.69,5,7287,919215858,218728279,0.00395282562673108,99.9014481754078,0.200550433466355
695.07,695,5189,5189,31134,36323,2025-04-25,2025-07-18,546.69,0,5189,353688576,64788996,0.0102697690750407,99.9392550354807,0.142857142857143
567.94,447,3,3,36282,36282,2025-04-25,2025-05-16,546.69,0,0,919215858,218728279,0.0039470598428253,99.9053952352506,0
525.24,435,4,4,36096,36096,2025-04-25,2025-04-25,546.69,0,0,247323203,111942542,0.0145946678524942,99.5587623859133,0
534.41,175,1,1,35941,35941,2025-04-25,2025-09-19,546.69,0,0,612220205,74276563,0.00587060010539835,99.9197728209575,0
577.39,577,763,911,19838,35529,2025-04-25,2025-05-02,546.69,148,15691,157884664,54569672,0.0225031355800333,99.6267933914088,0.441639224295646
564.11,564,2281,3219,22810,35409,2025-04-25,2025-04-25,546.69,938,12599,247323203,111942542,0.0143168936721234,99.5730792795854,0.355813493744528
621.2,621,1719,1730,27504,34600,2025-04-25,2025-05-30,546.69,11,7096,159044187,37473216,0.0217549604626543,99.7927840015932,0.205086705202312
499.07,160,1,1,33907,33907,2025-04-25,2025-09-19,546.69,0,0,612220205,74276563,0.00553836670581625,99.9253111876633,0
539.06,370,2,2,33812,33812,2025-04-25,2025-04-25,546.69,0,0,247323203,111942542,0.0136711798932994,99.5867504594787,0
604.5,604,649,675,22715,33750,2025-04-25,2025-05-30,546.69,26,11035,159044187,37473216,0.021220517792329,99.8140045193855,0.326962962962963
526.6,190,1,1,33660,33660,2025-04-25,2025-09-19,546.69,0,0,612220205,74276563,0.00549802174529669,99.9308092094086,0
542.63,375,2,2,33526,33526,2025-04-25,2025-08-15,546.69,0,0,282648688,37799117,0.0118613676352887,99.7967618374369,0
508.68,425,4,4,33472,33472,2025-04-25,2025-05-02,546.69,0,0,157884664,54569672,0.0212002857984991,99.6479936772073,0
576.91,245,1,1,33191,33191,2025-04-25,2025-06-20,546.69,0,0,1174768001,197089681,0.00282532380621082,99.9765734170691,0
526.76,195,1,1,33176,33176,2025-04-25,2025-09-19,546.69,0,0,612220205,74276563,0.0054189652234689,99.936228174632,0
670.07,670,4737,4739,33159,33173,2025-04-25,2025-06-20,546.69,2,14,1174768001,197089681,0.00282379158878707,99.9793972086579,0.000422029964127453
539.91,376,2,2,32782,32782,2025-04-25,2025-04-25,546.69,0,0,247323203,111942542,0.0132547207873577,99.6000051802661,0
579.88,579,350,371,16100,32648,2025-04-25,2025-05-09,546.69,21,16548,106424303,36041450,0.0306772034955211,99.7888179732782,0.506861063464837
601.55,601,585,588,24570,32340,2025-04-25,2025-05-30,546.69,3,7770,159044187,37473216,0.0203339717156717,99.8343384911012,0.24025974025974
527.07,205,1,1,32207,32207,2025-04-25,2025-09-19,546.69,0,0,612220205,74276563,0.00526068883989218,99.9414888634719,0
675.12,675,2656,2673,29216,32076,2025-04-25,2025-07-18,546.69,17,2860,353688576,64788996,0.00906899520554489,99.9483240306863,0.0891632373113854
617.1,617,2918,3168,23344,31680,2025-04-25,2025-05-16,546.69,250,8336,919215858,218728279,0.00344641573840211,99.908841650989,0.263131313131313
571.53,466,3,3,31659,31659,2025-04-25,2025-08-15,546.69,0,0,282648688,37799117,0.0112008303396052,99.8079626677765,0
680.1,680,3165,3165,31650,31650,2025-04-25,2025-07-18,546.69,0,0,353688576,64788996,0.00894855026360817,99.9572725809499,0
513.13,435,4,4,31252,31252,2025-04-25,2025-05-02,546.69,0,0,157884664,54569672,0.0197941960974753,99.6677878733048,0
567.12,463,3,3,31236,31236,2025-04-25,2025-08-15,546.69,0,0,282648688,37799117,0.01105117459452,99.819013842371,0
710.1,710,3109,3110,27981,31100,2025-04-25,2025-08-15,546.69,1,3119,282648688,37799117,0.0110030583265966,99.8300169006976,0.100289389067524
563.13,563,1584,2379,15840,30927,2025-04-25,2025-04-25,546.69,795,15087,247323203,111942542,0.0125046900674337,99.6125098703335,0.487826171306625
523.04,420,3,3,30912,30912,2025-04-25,2025-05-02,546.69,0,0,157884664,54569672,0.0195788490261473,99.6873667223309,0
515.62,210,1,1,30562,30562,2025-04-25,2025-09-19,546.69,0,0,612220205,74276563,0.00499199466963035,99.9464808581416,0
605.34,605,877,891,20171,30294,2025-04-25,2025-05-23,546.69,14,10123,70049480,15954371,0.0432465737076135,99.7633344316046,0.334158579256618
592,290,1,1,30200,30200,2025-04-25,2025-08-15,546.69,0,0,282648688,37799117,0.0106846418476919,99.8407015425453,0
650.03,650,10089,10042,30267,30126,2025-04-25,2025-05-16,546.69,-47,-141,919215858,218728279,0.00327735860274943,99.9121190095918,-0.00468034256124278
685.2,685,1490,1490,25330,29800,2025-04-25,2025-08-15,546.69,0,4470,282648688,37799117,0.0105431234126231,99.8512446659579,0.15
548.41,474,4,4,29764,29764,2025-04-25,2025-08-15,546.69,0,0,282648688,37799117,0.0105303867534669,99.8617750527114,0
528.37,454,4,4,29748,29748,2025-04-25,2025-05-16,546.69,0,0,919215858,218728279,0.00323623659677986,99.9153552461885,0
537.12,488,6,6,29472,29472,2025-04-25,2025-04-25,546.69,0,0,247323203,111942542,0.0119163910391376,99.6244262613727,0
605.1,605,2877,2946,20139,29460,2025-04-25,2025-05-09,546.69,69,9321,106424303,36041450,0.0276816471140055,99.8164996203922,0.316395112016293
606.45,606,660,654,23100,29430,2025-04-25,2025-05-30,546.69,-6,6330,159044187,37473216,0.0185042915149109,99.8528427826161,0.215086646279307
524.95,483,7,7,29365,29365,2025-04-25,2025-04-25,546.69,0,0,247323203,111942542,0.0118731278116271,99.6362993891843,0
538.46,245,1,1,29346,29346,2025-04-25,2025-08-15,546.69,0,0,282648688,37799117,0.01038249998882,99.8721575527002,0
517.65,445,4,4,29060,29060,2025-04-25,2025-05-23,546.69,0,0,70049480,15954371,0.0414849617727355,99.8048193933774,0
517.63,445,4,4,29052,29052,2025-04-25,2025-04-25,546.69,0,0,247323203,111942542,0.0117465727629284,99.6480459619472,0
578.34,578,740,847,14800,28798,2025-04-25,2025-05-02,546.69,107,13998,157884664,54569672,0.0182398969414788,99.7056066192724,0.486075421904299
582.66,582,423,436,14805,28776,2025-04-25,2025-05-09,546.69,13,13971,106424303,36041450,0.0270389367736804,99.8435385571658,0.485508757297748
544.84,473,4,4,28736,28736,2025-04-25,2025-05-16,546.69,0,0,919215858,218728279,0.00312614276069202,99.9184813889492,0
498.05,215,1,1,28305,28305,2025-04-25,2025-09-19,546.69,0,0,612220205,74276563,0.00462333646763586,99.9511041946092,0
528.37,497,9,9,28233,28233,2025-04-25,2025-05-02,546.69,0,0,157884664,54569672,0.0178820407788308,99.7234886600512,0
579.59,577,99,109,15939,28231,2025-04-25,2025-05-23,546.69,10,12292,70049480,15954371,0.0403015125879593,99.8451209059653,0.435407884949169
607.16,607,1751,1748,24514,27968,2025-04-25,2025-05-16,546.69,-3,3454,919215858,218728279,0.0030425932882459,99.9215239822375,0.12349828375286
710.15,710,1862,1861,35378,27915,2025-04-25,2025-09-19,546.69,-1,-7463,612220205,74276563,0.00455963389839445,99.9556638285076,-0.267347304316676
603.79,325,1,1,27879,27879,2025-04-25,2025-08-15,546.69,0,0,282648688,37799117,0.00986348112820534,99.8820210338284,0
563.13,424,2,2,27826,27826,2025-04-25,2025-05-16,546.69,0,0,919215858,218728279,0.00302714533891342,99.9245511275764,0
700.06,700,4629,4622,27774,27732,2025-04-25,2025-07-18,546.69,-7,-42,353688576,64788996,0.00784079607931697,99.9651133770292,-0.00151449588922544
536.9,445,3,3,27570,27570,2025-04-25,2025-05-09,546.69,0,0,106424303,36041450,0.025905736963107,99.8694442941289,0
539.73,402,2,2,27546,27546,2025-04-25,2025-04-25,546.69,0,0,247323203,111942542,0.0111376529439496,99.6591836148912,0
544,270,1,1,27400,27400,2025-04-25,2025-04-25,546.69,0,0,247323203,111942542,0.0110786208765055,99.6702622357677,0
529.8,439,3,3,27240,27240,2025-04-25,2025-05-16,546.69,0,0,919215858,218728279,0.00296339535082303,99.9275145229272,0
539.99,404,2,2,27198,27198,2025-04-25,2025-04-25,546.69,0,0,247323203,111942542,0.0109969463722334,99.6812591821399,0
523.65,255,1,1,26865,26865,2025-04-25,2025-05-02,546.69,0,0,157884664,54569672,0.0170155855036053,99.7405042455549,0
531.78,479,5,5,26390,26390,2025-04-25,2025-08-15,546.69,0,0,282648688,37799117,0.00933667875366186,99.8913577125821,0
498.82,235,1,1,26382,26382,2025-04-25,2025-09-19,546.69,0,0,612220205,74276563,0.00430923379929939,99.9599730623069,0
750.08,750,3287,3287,23009,26296,2025-04-25,2025-09-19,546.69,0,3286.99999999999,612220205,74276563,0.00429518656608205,99.964268248873,0.125
665.19,665,1372,1374,20580,26106,2025-04-25,2025-07-18,546.69,2,5526,353688576,64788996,0.00738106961079795,99.97249444664,0.211675476901862
815.07,815,3693,3724,22158,26068,2025-04-25,2025-12-19,546.69,31,3910,1084502340,72118262,0.00240368314926826,99.9846634724643,0.149992327758171
569.63,483,3,3,25989,25989,2025-04-25,2025-08-15,546.69,0,0,282648688,37799117,0.00919480652250542,99.9005525191046,0
499.02,240,1,1,25902,25902,2025-04-25,2025-09-19,546.69,0,0,612220205,74276563,0.00423083063715612,99.9684990795101,0
541.29,477,4,4,25716,25716,2025-04-25,2025-04-25,546.69,0,0,247323203,111942542,0.0103977304547524,99.6916569125947,0
524.62,439,3,3,25686,25686,2025-04-25,2025-08-15,546.69,0,0,282648688,37799117,0.00908760630794083,99.9096401254125,0
583.16,583,1600,1596,20800,25536,2025-04-25,2025-05-02,546.69,-4,4736,157884664,54569672,0.0161738318042087,99.7566780773591,0.18546365914787
578.86,576,85,89,14535,25454,2025-04-25,2025-05-23,546.69,4,10919,70049480,15954371,0.0363371719533107,99.8814580779186,0.428969906497996
825.02,825,12685,12685,38055,25370,2025-04-25,2025-09-19,546.69,0,-12685,612220205,74276563,0.004143933799114,99.9726430133092,-0.5
765.14,765,1800,1800,25200,25200,2025-04-25,2025-12-19,546.69,0,0,1084502340,72118262,0.0023236464386052,99.9869871189029,0
524.4,275,1,1,24940,24940,2025-04-25,2025-09-19,546.69,0,0,612220205,74276563,0.00407369763302732,99.9767167109423,0
611.15,611,1628,1644,19536,24660,2025-04-25,2025-05-16,546.69,16,5124,919215858,218728279,0.00268272134182437,99.930197244269,0.207785888077859
499.66,255,1,1,24466,24466,2025-04-25,2025-09-19,546.69,0,0,612220205,74276563,0.00399627451041084,99.9807129854527,0
582.65,582.5,1489,1626,28291,24390,2025-04-25,2025-05-02,546.69,137,-3901.00000000001,157884664,54569672,0.0154479854990856,99.7721260628581,-0.159942599425995
563.15,320,1,1,24315,24315,2025-04-25,2025-08-15,546.69,0,0,282648688,37799117,0.00860255187174264,99.9182426772843,0
568.44,448,2,2,24088,24088,2025-04-25,2025-05-16,546.69,0,0,919215858,218728279,0.00262049439099211,99.93281773866,0
562.64,562.5,1524,1717,15240,24038,2025-04-25,2025-04-25,546.69,193,8798,247323203,111942542,0.00971926600837367,99.701376178603,0.366003827273484
509.08,390,2,2,23816,23816,2025-04-25,2025-05-09,546.69,0,0,106424303,36041450,0.0223783471713223,99.8918226413003,0
537.98,422,2,2,23196,23196,2025-04-25,2025-04-25,546.69,0,0,247323203,111942542,0.00937882079749711,99.7107549994005,0
612.32,612,722,722,18050,23104,2025-04-25,2025-05-30,546.69,0,5054,159044187,37473216,0.014526780535525,99.8673695631517,0.21875
695.04,695,5688,5775,22752,23100,2025-04-25,2025-06-20,546.69,87,348,1174768001,197089681,0.0019663456938167,99.9813635543517,0.0150649350649351
695.12,695,1924,1924,21164,23088,2025-04-25,2025-08-15,546.69,0,1924,282648688,37799117,0.00816844407216919,99.9264111213564,0.0833333333333333
785.03,785,7674,7674,23022,23022,2025-04-25,2025-06-20,546.69,0,0,1174768001,197089681,0.00195970608498043,99.9833232604367,0
530.01,415,2,2,23002,23002,2025-04-25,2025-05-02,546.69,0,0,157884664,54569672,0.0145688627490761,99.7866949256072,0
537.94,424,2,2,22788,22788,2025-04-25,2025-04-25,546.69,0,0,247323203,111942542,0.00921385447203674,99.7199688538726,0
547.9,434,2,2,21136,22780,2025-04-25,2025-04-25,546.69,0,1644,247323203,111942542,0.00921061983820418,99.7291794737108,0.0721685689201054
715.05,715,4141,4531,16564,22655,2025-04-25,2025-07-18,546.69,390,6091,353688576,64788996,0.00640535248726835,99.9788997991272,0.268858971529464
595.06,595,3648,3768,21888,22608,2025-04-25,2025-05-02,546.69,120,720,157884664,54569672,0.0143193134958314,99.8010142391031,0.0318471337579618
543.69,320,1,1,22369,22369,2025-04-25,2025-05-02,546.69,0,0,157884664,54569672,0.0141679371721626,99.8151821762752,0
630.02,630,10734,11099,21468,22198,2025-04-25,2025-05-02,546.69,365,730,157884664,54569672,0.0140596302627594,99.829241806538,0.0328858455716731
613.13,613,1683,1697,21879,22061,2025-04-25,2025-05-16,546.69,14,181.999999999996,919215858,218728279,0.00239998035368968,99.9352177190137,0.00824985268120196
610.23,610,908,953,16344,21919,2025-04-25,2025-05-23,546.69,45,5575,70049480,15954371,0.031290739060447,99.9127488169791,0.254345544960993
533.61,315,1,1,21861,21861,2025-04-25,2025-05-02,546.69,0,0,157884664,54569672,0.013846183312649,99.8430879898506,0
530.14,499,7,7,21798,21798,2025-04-25,2025-05-02,546.69,0,0,157884664,54569672,0.0138062807670794,99.8568942706177,0
546.32,438,2,2,21664,21664,2025-04-25,2025-05-16,546.69,0,0,919215858,218728279,0.00235679136858407,99.9375745103823,0
526.6,310,1,1,21660,21660,2025-04-25,2025-05-02,546.69,0,0,157884664,54569672,0.0137188751910699,99.8706131458088,0
685.05,685,4298,4306,17192,21530,2025-04-25,2025-06-20,546.69,8,4338,1174768001,197089681,0.00183270228518933,99.9851559627219,0.201486298188574
755.21,755,998,1023,16966,21483,2025-04-25,2025-12-19,546.69,25,4517,1084502340,72118262,0.00198090858891093,99.9889680274918,0.210259274775404
760.01,760,21411,21414,21411,21414,2025-04-25,2025-05-16,546.69,3,3,919215858,218728279,0.00232959427468885,99.939904104657,0.00014009526478005
550.64,508,5,5,19875,21320,2025-04-25,2025-05-30,546.69,0,1445,159044187,37473216,0.0134050796839246,99.8807746428356,0.0677767354596623
612.12,612,1770,1770,28320,21240,2025-04-25,2025-05-16,546.69,0,-7080,919215858,218728279,0.00231066509733778,99.9422147697543,-0.333333333333333
546.47,441,2,2,21094,21094,2025-04-25,2025-05-16,546.69,0,0,919215858,218728279,0.00229478199450297,99.9445095517488,0
564.77,355,1,1,20977,20977,2025-04-25,2025-08-15,546.69,0,0,282648688,37799117,0.00742158053109378,99.9338327018875,0
546.44,442,2,2,20888,20888,2025-04-25,2025-05-16,546.69,0,0,919215858,218728279,0.00227237158913331,99.946781923338,0
665.09,665,2292,2293,16044,20637,2025-04-25,2025-06-20,546.69,1,4593,1174768001,197089681,0.00175668727633313,99.9869126499982,0.222561418810874
618.24,618,858,858,20592,20592,2025-04-25,2025-05-30,546.69,0,0,159044187,37473216,0.012947345255693,99.8937219880913,0
621.08,621,2401,2566,24010,20528,2025-04-25,2025-05-16,546.69,165,-3482,919215858,218728279,0.0022332077739242,99.9490151311119,-0.169621979734996
508.25,305,1,1,20325,20325,2025-04-25,2025-04-25,546.69,0,0,247323203,111942542,0.00821799158083845,99.7373974652916,0
541.4,440,2,2,20280,20280,2025-04-25,2025-04-25,546.69,0,0,247323203,111942542,0.00819979676553033,99.7455972620571,0
730.12,730,1683,1682,13464,20184,2025-04-25,2025-09-19,546.69,-1,6720,612220205,74276563,0.00329685296812443,99.9840098384208,0.332936979785969
535.6,335,1,1,20060,20060,2025-04-25,2025-04-25,546.69,0,0,247323203,111942542,0.00811084433513503,99.7537081063923,0
579.29,579,448,687,6272,19923,2025-04-25,2025-05-02,546.69,239,13651,157884664,54569672,0.0126187050060796,99.8832318508149,0.68518797369874
532.68,335,1,1,19768,19768,2025-04-25,2025-05-23,546.69,0,0,70049480,15954371,0.0282200524543508,99.9409688694334,0
537.12,340,1,1,19712,19712,2025-04-25,2025-05-02,546.69,0,0,157884664,54569672,0.0124850631471084,99.895716913962,0
500.95,305,1,1,19595,19595,2025-04-25,2025-05-09,546.69,0,0,106424303,36041450,0.0184121478343156,99.9102347891346,0
506.56,409,2,2,19512,19512,2025-04-25,2025-05-16,546.69,0,0,919215858,218728279,0.00212267878433403,99.9511378098962,0
526.82,462,3,3,19446,19446,2025-04-25,2025-05-16,546.69,0,0,919215858,218728279,0.00211549875154569,99.9532533086478,0
640.03,640,6374,6467,19122,19401,2025-04-25,2025-05-16,546.69,93,279,919215858,218728279,0.00211060327464455,99.9553639119224,0.0143807020256688
517.07,469,4,4,19228,19228,2025-04-25,2025-05-16,546.69,0,0,919215858,218728279,0.00209178288566906,99.9574556948081,0
616.1,616,1863,1860,14904,18600,2025-04-25,2025-05-16,546.69,-3,3696,919215858,218728279,0.00202346378580427,99.9594791585939,0.198709677419355
614.1,614,1858,1852,18580,18520,2025-04-25,2025-05-16,546.69,-6,-60,919215858,218728279,0.0020147607157578,99.9614939193096,-0.00323974082073434
655.03,655,6171,6171,18513,18513,2025-04-25,2025-05-16,546.69,0,0,919215858,218728279,0.00201399919712873,99.9635079185068,0
522.86,486,5,5,18430,18430,2025-04-25,2025-04-25,546.69,0,0,247323203,111942542,0.00745178769175167,99.761159894084,0
518.06,426,2,2,18412,18412,2025-04-25,2025-05-16,546.69,0,0,919215858,218728279,0.00200301157119507,99.965510930078,0
567.45,476,2,2,18290,18290,2025-04-25,2025-08-15,546.69,0,0,282648688,37799117,0.00647093044351934,99.940303632331,0
685.1,685,1813,1813,18130,18130,2025-04-25,2025-07-18,546.69,0,0,353688576,64788996,0.00512597839744759,99.9840257775247,0
740.09,740,2011,2012,18099,18108,2025-04-25,2025-09-19,546.69,1,9.00000000000364,612220205,74276563,0.0029577592918548,99.9869675977127,0.000497017892644336
557.53,467,2,2,18106,18106,2025-04-25,2025-08-15,546.69,0,0,282648688,37799117,0.00640583196338771,99.9467094642944,0
567.06,567,2560,3001,15360,18006,2025-04-25,2025-04-25,546.69,441,2646,247323203,111942542,0.00728035209862619,99.7684402461827,0.146951016327891
583.52,583,342,342,14364,17784,2025-04-25,2025-05-09,546.69,0,3420,106424303,36041450,0.0167104688484547,99.926945257983,0.192307692307692
566.06,566,1768,2916,12376,17496,2025-04-25,2025-04-25,546.69,1148,5120,247323203,111942542,0.00707414419180072,99.7755143903744,0.292638317329675
617.24,617,728,729,14560,17496,2025-04-25,2025-05-30,546.69,1,2936,159044187,37473216,0.0110007164235433,99.9047227045148,0.167809785093736
569.36,482,2,2,17472,17472,2025-04-25,2025-08-15,546.69,0,0,282648688,37799117,0.00618152524380371,99.9528909895382,0
680.05,680,3171,3488,19026,17440,2025-04-25,2025-06-20,546.69,317,-1586,1174768001,197089681,0.0014845484372365,99.9883971984355,-0.0909403669724771
536.44,364,1,1,17244,17244,2025-04-25,2025-04-25,546.69,0,0,247323203,111942542,0.00697225322607519,99.7824866436005,0
541.23,372,1,1,16923,16923,2025-04-25,2025-04-25,546.69,0,0,247323203,111942542,0.00684246354354387,99.7893291071441,0
541.3,457,2,2,16860,16860,2025-04-25,2025-04-25,546.69,0,0,247323203,111942542,0.00681699080211249,99.7961460979462,0
541.24,374,1,1,16724,16724,2025-04-25,2025-04-25,546.69,0,0,247323203,111942542,0.00676200202695903,99.8029080999731,0
582.2,582,791,832,13447,16640,2025-04-25,2025-05-02,546.69,41,3193,157884664,54569672,0.0105393390202864,99.9062562529823,0.191887019230769
525.58,443,2,2,16516,16516,2025-04-25,2025-05-16,546.69,0,0,919215858,218728279,0.00179674881109373,99.9673076788891,0
633.06,633,2744,2726,10976,16356,2025-04-25,2025-05-16,546.69,-18,5380,919215858,218728279,0.00177934267100079,99.9690870215601,0.32893127904133
622.1,622,1634,1634,16340,16340,2025-04-25,2025-05-16,546.69,0,0,919215858,218728279,0.00177760205699149,99.9708646236171,0
660.03,660,5427,5426,10854,16278,2025-04-25,2025-05-16,546.69,-1,5424,919215858,218728279,0.00177085717770548,99.9726354807948,0.333210468116476
539.87,378,1,1,16187,16187,2025-04-25,2025-04-25,546.69,0,0,247323203,111942542,0.00654487723094869,99.8094529772041,0
755.01,755,16025,16025,16025,16025,2025-04-25,2025-05-16,546.69,0,0,919215858,218728279,0.00174333371868352,99.9743788145135,0
543.54,464,2,2,15908,15908,2025-04-25,2025-08-15,546.69,0,0,282648688,37799117,0.00562818816268484,99.9585191777009,0
628.07,628,2283,2272,11415,15904,2025-04-25,2025-05-16,546.69,-11,4489,919215858,218728279,0.00173017032523823,99.9761089848387,0.282256036217304
615.17,615,892,935,10704,15895,2025-04-25,2025-05-23,546.69,43,5191,70049480,15954371,0.0226911034885627,99.963659972922,0.326580685750236
745.07,745,2265,2265,15855,15855,2025-04-25,2025-09-19,546.69,0,0,612220205,74276563,0.00258975444954483,99.9895573521622,0
605.04,605,3780,3853,15120,15412,2025-04-25,2025-05-02,546.69,73,291.999999999998,157884664,54569672,0.00976155606854887,99.9160178090508,0.0189462756293796
542.09,491,3,3,15327,15327,2025-04-25,2025-08-15,546.69,0,0,282648688,37799117,0.00542263263574746,99.9639418103366,0
785.17,785,894,894,15198,15198,2025-04-25,2025-12-19,546.69,0,0,1084502340,72118262,0.00140138010213975,99.9903694075939,0
501.08,350,1,1,15108,15108,2025-04-25,2025-05-02,546.69,0,0,157884664,54569672,0.00956901045183211,99.9255868195026,0
534.2,504,5,5,15100,15100,2025-04-25,2025-05-09,546.69,0,0,106424303,36041450,0.0141884885071787,99.9411337464902,0
595.17,595,891,877,10692,14909,2025-04-25,2025-05-09,546.69,-14,4217,106424303,36041450,0.0140090182220879,99.9551427647123,0.282849285666376
539.71,391,1,1,14871,14871,2025-04-25,2025-04-25,546.69,0,0,247323203,111942542,0.00601277996549317,99.8154657571696,0
575.02,575,7409,7413,22227,14826,2025-04-25,2025-04-25,546.69,4,-7401,247323203,111942542,0.00599458515018504,99.8214603423198,-0.499190611088628
539.78,393,1,1,14678,14678,2025-04-25,2025-04-25,546.69,0,0,247323203,111942542,0.00593474442428275,99.8273950867441,0
510.61,365,1,1,14561,14561,2025-04-25,2025-05-30,546.69,0,0,159044187,37473216,0.00915531732071415,99.9138780218355,0
564.16,419,1,1,14516,14516,2025-04-25,2025-05-16,546.69,0,0,919215858,218728279,0.00157917205993198,99.9776881568986,0
546.52,474,1,2,6732,14504,2025-04-25,2025-04-25,546.69,1,7772,247323203,111942542,0.00586439113842465,99.8332594778825,0.535852178709322
528.76,385,1,1,14376,14376,2025-04-25,2025-04-25,546.69,0,0,247323203,111942542,0.00581263699710375,99.8390721148796,0
558.53,418,1,1,14053,14053,2025-04-25,2025-05-16,546.69,0,0,919215858,218728279,0.00152880304203803,99.9792169599407,0
581.18,581,725,778,8700,14004,2025-04-25,2025-05-02,546.69,53,5304,157884664,54569672,0.00886976584375541,99.9344565853464,0.378748928877464
624.07,624,1995,1996,13965,13972,2025-04-25,2025-05-16,546.69,1,7.00000000000364,919215858,218728279,0.00151999118361598,99.9807369511243,0.000501002004008276
800.08,800,1573,1722,14157,13776,2025-04-25,2025-12-19,546.69,149,-381,1084502340,72118262,0.00127026005310417,99.991639667647,-0.0276567944250871
548.4,411,1,1,13098,13740,2025-04-25,2025-04-25,546.69,0,642.000000000002,247323203,111942542,0.00555548360741552,99.844627598487,0.0467248908296945
539.92,403,1,1,13692,13692,2025-04-25,2025-04-25,546.69,0,0,247323203,111942542,0.00553607580442018,99.8501636742914,0
548.37,413,1,1,12835,13537,2025-04-25,2025-04-25,546.69,0,702,247323203,111942542,0.0054734047739144,99.8556370790653,0.051857871020167
548.44,415,1,1,12494,13344,2025-04-25,2025-04-25,546.69,0,850,247323203,111942542,0.00539536923270398,99.861032448298,0.0636990407673861
564.99,432,1,1,13299,13299,2025-04-25,2025-08-15,546.69,0,0,282648688,37799117,0.00470513416994881,99.9686469445066,0
497.62,365,1,1,13262,13262,2025-04-25,2025-04-25,546.69,0,0,247323203,111942542,0.00536221423592028,99.866394662534,0
544.83,479,2,2,13166,13166,2025-04-25,2025-05-02,546.69,0,0,157884664,54569672,0.0083389986503059,99.9427955839967,0
548.37,417,1,1,12290,13137,2025-04-25,2025-04-25,546.69,0,847,247323203,111942542,0.00531167308228658,99.8717063356163,0.0644743853238944
565.31,434,1,1,13131,13131,2025-04-25,2025-08-15,546.69,0,0,282648688,37799117,0.00464569642721993,99.9732926409338,0
616.2,616,656,656,12464,13120,2025-04-25,2025-05-30,546.69,0,656.000000000002,159044187,37473216,0.00824927980549204,99.922127301641,0.0500000000000001
770.15,770,846,866,16074,12990,2025-04-25,2025-12-19,546.69,20,-3084,1084502340,72118262,0.00119778441418577,99.9928374520612,-0.237413394919169
541.35,412,1,1,12935,12935,2025-04-25,2025-04-25,546.69,0,0,247323203,111942542,0.00522999857801453,99.8769363341943,0
541.35,414,1,1,12735,12735,2025-04-25,2025-04-25,546.69,0,0,247323203,111942542,0.00514913273220063,99.8820854669265,0
760.19,760,663,670,11934,12730,2025-04-25,2025-12-19,546.69,7,796.000000000002,1084502340,72118262,0.00117381028426366,99.9940112623455,0.0625294579732916
795.1,795,1272,1272,12720,12720,2025-04-25,2025-12-19,546.69,0,0,1084502340,72118262,0.00117288820234357,99.9951841505478,0
775.14,775,896,907,11648,12698,2025-04-25,2025-12-19,546.69,11,1050,1084502340,72118262,0.0011708596221194,99.9963550101699,0.0826901874310916
623.07,623,1806,1806,12642,12642,2025-04-25,2025-05-16,546.69,0,0,919215858,218728279,0.00137530264409342,99.9821122537684,0
785.01,785,12561,12561,12561,12561,2025-04-25,2025-05-16,546.69,0,0,919215858,218728279,0.00136649078567137,99.983478744554,0
705.03,705,4175,4170,12525,12510,2025-04-25,2025-06-20,546.69,-5,-15,1174768001,197089681,0.00106489110950852,99.9894620895449,-0.00119904076738609
619.08,619,1480,1471,11840,11768,2025-04-25,2025-05-16,546.69,-9,-72,919215858,218728279,0.00128022160383573,99.9847589661579,-0.00611828687967369
541.88,425,1,1,11688,11688,2025-04-25,2025-04-25,546.69,0,0,247323203,111942542,0.00472580002936481,99.8868112669558,0
547.92,432,1,1,10933,11592,2025-04-25,2025-04-25,546.69,0,659,247323203,111942542,0.00468698442337414,99.8914982513792,0.0568495514147688
760.12,760,962,962,11544,11544,2025-04-25,2025-09-19,546.69,0,0,612220205,74276563,0.0018855960495456,99.9914429482118,0
541.36,427,1,1,11436,11436,2025-04-25,2025-04-25,546.69,0,0,247323203,111942542,0.00462390906363929,99.8961221604428,0
541.31,428,1,1,11331,11331,2025-04-25,2025-04-25,546.69,0,0,247323203,111942542,0.00458145449458699,99.9007036149374,0
541.99,429,1,1,11299,11299,2025-04-25,2025-04-25,546.69,0,0,247323203,111942542,0.00456851595925676,99.9052721308967,0
545.45,489,2,2,11290,11290,2025-04-25,2025-05-02,546.69,0,0,157884664,54569672,0.00715078951556688,99.9499463735123,0
775.01,775,11093,11093,11093,11093,2025-04-25,2025-05-16,546.69,0,0,919215858,218728279,0.00120678945031864,99.9859657556082,0
720.08,720,1285,1342,10280,10736,2025-04-25,2025-08-15,546.69,57,456,282648688,37799117,0.00379835479724569,99.9770909957311,0.0424739195230999
546.58,440,1,1,10658,10658,2025-04-25,2025-05-23,546.69,0,0,70049480,15954371,0.0152149594829255,99.9788749324049,0
539.68,436,1,1,10368,10368,2025-04-25,2025-04-25,546.69,0,0,247323203,111942542,0.00419208544699302,99.9094642163437,0
790.1,790,966,994,9660,9940,2025-04-25,2025-12-19,546.69,28,280,1084502340,72118262,0.000916549428560938,99.9972715595985,0.028169014084507
825.05,825,1977,1977,9885,9885,2025-04-25,2025-12-19,546.69,0,0,1084502340,72118262,0.00091147797800049,99.9981830375765,0
541.8,445,1,1,9680,9680,2025-04-25,2025-05-02,546.69,0,0,157884664,54569672,0.00613105779545504,99.9560774313077,0
631.12,631,804,804,9648,9648,2025-04-25,2025-05-30,546.69,0,0,159044187,37473216,0.00606623868623378,99.9281935403273,0
526.19,430,1,1,9619,9619,2025-04-25,2025-05-09,546.69,0,0,106424303,36041450,0.00903834906957295,99.9641811137819,0
705.06,705,1433,1595,8598,9570,2025-04-25,2025-07-18,546.69,162,972.000000000002,353688576,64788996,0.00270577017449385,99.9867315476992,0.101567398119122
541.33,446,1,1,9533,9533,2025-04-25,2025-04-25,546.69,0,0,247323203,111942542,0.00385447054071995,99.9133186868844,0
546.03,451,0,1,0,9503,2025-04-25,2025-05-02,546.69,1,9503,157884664,54569672,0.00601895064361666,99.9620963819513,1
775.05,775,1899,1899,9495,9495,2025-04-25,2025-09-19,546.69,0,0,612220205,74276563,0.00155091255114653,99.9929938607629,0
528.25,481,2,2,9450,9450,2025-04-25,2025-04-25,546.69,0,0,247323203,111942542,0.00382091121470718,99.9171395980991,0
541.75,448,1,1,9375,9375,2025-04-25,2025-05-02,546.69,0,0,157884664,54569672,0.00593787880499907,99.9680342607563,0
614.27,614,348,343,7656,9261,2025-04-25,2025-05-30,546.69,-5,1605,159044187,37473216,0.00582291008221508,99.9340164504095,0.173307418205377
750.01,750,9247,9247,18494,9247,2025-04-25,2025-06-20,546.69,0,-9247,1174768001,197089681,0.000787134139858139,99.9902492236848,-1
634.05,634,1825,1835,7300,9175,2025-04-25,2025-05-16,546.69,10,1875,919215858,218728279,0.000998133345954525,99.9869638889541,0.204359673024523
569.04,569,2159,2258,10795,9032,2025-04-25,2025-04-25,546.69,99,-1763,247323203,111942542,0.00365190159695611,99.9207914996961,-0.195194862710363
750.02,750,4496,4496,13488,8992,2025-04-25,2025-07-18,546.69,0,-4496,353688576,64788996,0.00254234957252337,99.9892738972717,-0.5
528.34,439,1,1,8934,8934,2025-04-25,2025-04-25,546.69,0,0,247323203,111942542,0.00361227733250729,99.9244037770286,0
508.89,420,1,1,8889,8889,2025-04-25,2025-05-09,546.69,0,0,106424303,36041450,0.00835241551922591,99.9725335293011,0
512.96,469,2,2,8792,8792,2025-04-25,2025-04-25,546.69,0,0,247323203,111942542,0.00355486258197942,99.9279586396105,0
522.81,479,2,2,8762,8762,2025-04-25,2025-04-25,546.69,0,0,247323203,111942542,0.00354273270510733,99.9315013723156,0
720.03,720,2896,2897,8688,8691,2025-04-25,2025-06-20,546.69,1,3,1174768001,197089681,0.000739805646102204,99.9909890293309,0.000345184673800483
537.73,451,1,1,8673,8673,2025-04-25,2025-04-25,546.69,0,0,247323203,111942542,0.00350674740372014,99.9350081197194,0
830.06,830,1331,1440,5324,8640,2025-04-25,2025-12-19,546.69,109,3316,1084502340,72118262,0.000796678778950353,99.9989797163554,0.383796296296296
620.02,620,4315,4305,12945,8610,2025-04-25,2025-05-02,546.69,-10,-4335,157884664,54569672,0.00545334789451115,99.9734876086508,-0.503484320557491
569.68,484,1,1,8568,8568,2025-04-25,2025-08-15,546.69,0,0,282648688,37799117,0.00303132487917298,99.9801223206102,0
538.1,453,1,1,8510,8510,2025-04-25,2025-04-25,546.69,0,0,247323203,111942542,0.00344084173938181,99.9384489614588,0
541.3,459,1,1,8230,8230,2025-04-25,2025-04-25,546.69,0,0,247323203,111942542,0.00332762955524234,99.941776591014,0
572.03,572,2419,2728,12095,8184,2025-04-25,2025-04-25,546.69,309,-3911,247323203,111942542,0.00330903041070514,99.9450856214247,-0.477883675464321
660.04,660,2035,2035,8140,8140,2025-04-25,2025-05-30,546.69,0,0,159044187,37473216,0.00511807451346839,99.9391345249229,0
610.07,610,1139,1159,7973,8113,2025-04-25,2025-05-09,546.69,20,140.000000000001,106424303,36041450,0.00762325875885699,99.98015678806,0.0172562553925799
665.02,665,3811,3910,7622,7820,2025-04-25,2025-05-16,546.69,99,198,919215858,218728279,0.00085072509704244,99.9878146140512,0.0253196930946292
730.03,730,2599,2597,5198,7791,2025-04-25,2025-06-20,546.69,-2,2593,1174768001,197089681,0.000663194774914541,99.9916522241058,0.332819920420999
735.02,735,3892,3893,7784,7786,2025-04-25,2025-06-20,546.69,1,2,1174768001,197089681,0.000662769158963498,99.9923149932648,0.000256871307474955
710.03,710,2392,2587,11960,7761,2025-04-25,2025-06-20,546.69,195,-4199,1174768001,197089681,0.000660641079208285,99.992975634344,-0.541038525963149
705.11,705,700,700,7700,7700,2025-04-25,2025-08-15,546.69,0,0,282648688,37799117,0.00272422987507375,99.9828465504853,0
622.15,622,503,502,7545,7530,2025-04-25,2025-05-30,546.69,-1,-15,159044187,37473216,0.00473453330299962,99.9438690582259,-0.00199203187250996
619.19,619,394,395,6698,7505,2025-04-25,2025-05-30,546.69,1,807,159044187,37473216,0.00471881440093123,99.9485878726269,0.107528314457029
637.05,637,1466,1485,4398,7425,2025-04-25,2025-05-16,546.69,19,3027,919215858,218728279,0.000807753688687995,99.9886223677399,0.407676767676768
546,472,1,1,7400,7400,2025-04-25,2025-05-02,546.69,0,0,157884664,54569672,0.00468696567007927,99.9781745743209,0
805.04,805,1839,1839,7356,7356,2025-04-25,2025-09-19,546.69,0,0,612220205,74276563,0.00120152845984559,99.9941953892228,0
627.07,627,1051,1050,4204,7350,2025-04-25,2025-05-16,546.69,-1,3146,919215858,218728279,0.000799594560519429,99.9894219623004,0.428027210884354
820.03,820,2419,2406,7257,7218,2025-04-25,2025-09-19,546.69,-13,-39,612220205,74276563,0.0011789875507294,99.9953743767735,-0.00540315876974231
568.04,568,1193,1779,5965,7116,2025-04-25,2025-04-25,546.69,586,1151,247323203,111942542,0.00287720679405887,99.9479628282188,0.161748173130972
725.02,725,3543,3543,7086,7086,2025-04-25,2025-06-20,546.69,0,0,1174768001,197089681,0.000603182925817538,99.9935788172698,0
825.02,825,3539,3539,7078,7078,2025-04-25,2025-06-20,546.69,0,0,1174768001,197089681,0.00060250194029587,99.9941813192101,0
815.02,815,3525,3526,7050,7052,2025-04-25,2025-06-20,546.69,1,2,1174768001,197089681,0.000600288737350448,99.9947816079475,0.000283607487237663
632.11,632,639,641,5751,7051,2025-04-25,2025-05-30,546.69,2,1300,159044187,37473216,0.00443335913936924,99.9530212317663,0.184371011204085
541.38,471,1,1,7038,7038,2025-04-25,2025-04-25,546.69,0,0,247323203,111942542,0.00284566911419144,99.950808497333,0
541.34,472,1,1,6934,6934,2025-04-25,2025-04-25,546.69,0,0,247323203,111942542,0.00280361887436821,99.9536121162073,0
629.06,629,1142,1147,5710,6882,2025-04-25,2025-05-16,546.69,5,1172,919215858,218728279,0.00074868160074758,99.9901706439011,0.170299331589654
541.38,473,1,1,6838,6838,2025-04-25,2025-04-25,546.69,0,0,247323203,111942542,0.00276480326837753,99.9563769194757,0
740.02,740,3401,3403,6802,6806,2025-04-25,2025-06-20,546.69,2,4,1174768001,197089681,0.000579348432559153,99.99536095638,0.0005877167205407
710.05,710,1347,1348,5388,6740,2025-04-25,2025-07-18,546.69,1,1352,353688576,64788996,0.00190563124097059,99.9911795285127,0.200593471810089
650.06,650,1104,1114,5520,6684,2025-04-25,2025-05-30,546.69,10,1164,159044187,37473216,0.00420260565700525,99.9572238374233,0.174147217235189
690.02,690,3301,3301,6602,6602,2025-04-25,2025-05-16,546.69,0,0,919215858,218728279,0.000718220855584935,99.9908888647567,0
631.05,631,1313,1313,9191,6565,2025-04-25,2025-05-16,546.69,0,-2626,919215858,218728279,0.000714195685688443,99.9916030604424,-0.4
500.36,435,1,1,6536,6536,2025-04-25,2025-05-09,546.69,0,0,106424303,36041450,0.00614145436310727,99.9862982424231,0
670.02,670,3266,3266,6532,6532,2025-04-25,2025-05-16,546.69,0,0,919215858,218728279,0.000710605669294274,99.9923136661117,0
760.03,760,2173,2173,6519,6519,2025-04-25,2025-06-20,546.69,0,0,1174768001,197089681,0.00055491807696931,99.995915874457,0
790.03,790,2157,2157,6471,6471,2025-04-25,2025-07-18,546.69,0,0,353688576,64788996,0.00182957563209506,99.9930091041448,0
636.05,636,1263,1283,5052,6415,2025-04-25,2025-05-16,546.69,20,1363,919215858,218728279,0.000697877429351311,99.9930115435411,0.212470771628995
517.27,496,3,3,6381,6381,2025-04-25,2025-05-02,546.69,0,0,157884664,54569672,0.00404155782983457,99.9822161321507,0
600.01,600,6275,6372,12550,6372,2025-04-25,2025-04-25,546.69,97,-6178,247323203,111942542,0.00257638584763113,99.9589533053233,-0.969554300062775
526.7,463,1,1,6370,6370,2025-04-25,2025-04-25,546.69,0,0,247323203,111942542,0.00257557718917299,99.9615288825125,0
830.03,830,2114,2113,10570,6339,2025-04-25,2025-09-19,546.69,-1,-4231,612220205,74276563,0.00103541176005454,99.9964097885335,-0.667455434611138
770.01,770,6277,6277,6277,6277,2025-04-25,2025-05-16,546.69,0,0,919215858,218728279,0.000682864633521151,99.9936944081746,0
571.03,571,1898,2081,7592,6243,2025-04-25,2025-04-25,546.69,183,-1349,247323203,111942542,0.00252422737708116,99.9640531098896,-0.216082011853276
700.02,700,3114,3114,6228,6228,2025-04-25,2025-05-30,546.69,0,0,159044187,37473216,0.00391589288327778,99.9611397303065,0
620.13,620,525,476,6300,6188,2025-04-25,2025-05-23,546.69,-49,-112,70049480,15954371,0.0088337557966169,99.9877086882015,-0.0180995475113122
830.02,830,3057,3057,6114,6114,2025-04-25,2025-06-20,546.69,0,0,1174768001,197089681,0.000520443184934861,99.9964363176419,0
538.94,478,1,1,6094,6094,2025-04-25,2025-04-25,546.69,0,0,247323203,111942542,0.00246398232194979,99.9665170922115,0
626.18,626,331,331,5958,5958,2025-04-25,2025-05-30,546.69,0,0,159044187,37473216,0.00374612874093915,99.9648858590475,0
680.02,680,2950,2950,5900,5900,2025-04-25,2025-05-30,546.69,0,0,159044187,37473216,0.00370966088814048,99.9685955199356,0
670.04,670,1476,1473,4428,5892,2025-04-25,2025-05-30,546.69,-3,1464,159044187,37473216,0.00370463083947859,99.9723001507751,0.24847250509165
700.01,700,5738,5738,5738,5738,2025-04-25,2025-05-16,546.69,0,0,919215858,218728279,0.000624227699083059,99.9943186358737,0
638.05,638,1115,1115,4460,5575,2025-04-25,2025-05-16,546.69,0,1115,919215858,218728279,0.000606495193863377,99.9949251310675,0.2
800.02,800,2767,2782,5534,5564,2025-04-25,2025-06-20,546.69,15,30,1174768001,197089681,0.000473625430320178,99.9969099430722,0.00539180445722502
815.02,815,2757,2757,5514,5514,2025-04-25,2025-08-15,546.69,0,0,282648688,37799117,0.00195083162742294,99.9847973821127,0
800.03,800,1819,1829,5457,5487,2025-04-25,2025-08-15,546.69,10,30,282648688,37799117,0.0019412791330558,99.9867386612458,0.00546746856205577
538.46,484,1,1,5446,5446,2025-04-25,2025-05-02,546.69,0,0,157884664,54569672,0.00344935338368266,99.9856654855344,0
715.03,715,1786,1793,5358,5379,2025-04-25,2025-06-20,546.69,7,21,1174768001,197089681,0.000457877640131603,99.9973678207124,0.00390407138873397
629.14,629,382,382,3820,5348,2025-04-25,2025-05-30,546.69,0,1528,159044187,37473216,0.00336258753047038,99.9756627383056,0.285714285714286
615.05,615,1064,1065,6384,5325,2025-04-25,2025-05-09,546.69,1,-1059,106424303,36041450,0.00500355637753155,99.9913017988006,-0.19887323943662
538.32,486,1,1,5232,5232,2025-04-25,2025-05-02,546.69,0,0,157884664,54569672,0.00331381140349388,99.9889792969379,0
720.03,720,1705,1705,5115,5115,2025-04-25,2025-05-16,546.69,0,0,919215858,218728279,0.000556452541096174,99.9954815836086,0
577.02,577,2194,2541,6582,5082,2025-04-25,2025-04-25,546.69,347,-1500,247323203,111942542,0.00205480114213142,99.9685718933537,-0.295159386068477
633.1,633,478,499,5258,4990,2025-04-25,2025-05-30,546.69,21,-267.999999999999,159044187,37473216,0.00313749285285101,99.9788002311584,-0.0537074148296591
615.01,615,4824,4824,4824,4824,2025-04-25,2025-04-25,546.69,0,0,247323203,111942542,0.00195048420103147,99.9705223775547,0
725.04,725,363,1197,1089,4788,2025-04-25,2025-07-18,546.69,834,3699,353688576,64788996,0.00135373329106338,99.9943628374358,0.772556390977444
580.01,580,4652,4693,13956,4693,2025-04-25,2025-04-25,546.69,41,-9263,247323203,111942542,0.00189751707202336,99.9724198946267,-1.9737907521841
685.01,685,4660,4660,9320,4660,2025-04-25,2025-05-16,546.69,0,-4660,919215858,218728279,0.000506953830206876,99.9959885374388,-1
790.02,790,2308,2308,4616,4616,2025-04-25,2025-06-20,546.69,0,0,1174768001,197089681,0.000392928646002506,99.9977607493584,0
574.02,574,2114,2292,8456,4584,2025-04-25,2025-04-25,546.69,178,-3872,247323203,111942542,0.00185344518605478,99.9742733398128,-0.844677137870855
645.07,645,646,647,3876,4529,2025-04-25,2025-05-30,546.69,1,653.000000000001,159044187,37473216,0.00284763629870987,99.9816478674571,0.144181938617797
720.05,720,773,890,4638,4450,2025-04-25,2025-07-18,546.69,117,-188,353688576,64788996,0.00125816899440936,99.9956210064303,-0.042247191011236
538.01,494,1,1,4401,4401,2025-04-25,2025-05-02,546.69,0,0,157884664,54569672,0.00278747782621876,99.9917667747641,0
624.14,624,310,310,4340,4340,2025-04-25,2025-05-30,546.69,0,0,159044187,37473216,0.00272880139907283,99.9843766688562,0
780.02,780,2142,2142,4284,4284,2025-04-25,2025-06-20,546.69,0,0,1174768001,197089681,0.000364667746853279,99.9981254171052,0
675.01,675,4258,4258,4258,4258,2025-04-25,2025-04-25,546.69,0,0,247323203,111942542,0.00172163385737811,99.9759949736701,0
579.02,579,1918,2114,5754,4228,2025-04-25,2025-04-25,546.69,196,-1526,247323203,111942542,0.00170950398050603,99.9777044776507,-0.360927152317881
610.03,610,1354,1351,5416,4053,2025-04-25,2025-05-02,546.69,-3,-1363,157884664,54569672,0.0025670637649772,99.9943338385291,-0.336294103133481
785.02,785,2017,2017,4034,4034,2025-04-25,2025-07-18,546.69,0,0,353688576,64788996,0.0011405513985275,99.9967615578288,0
780.01,780,4033,4033,4033,4033,2025-04-25,2025-05-16,546.69,0,0,919215858,218728279,0.000438743518717668,99.9964272809576,0
800.03,800,1342,1342,4026,4026,2025-04-25,2025-09-19,546.69,0,0,612220205,74276563,0.000657606522476664,99.997067395056,0
755.01,755,4025,4025,4025,4025,2025-04-25,2025-06-20,546.69,0,0,1174768001,197089681,0.000342620840589273,99.9984680379458,0
820.02,820,1997,1997,3994,3994,2025-04-25,2025-08-15,546.69,0,0,282648688,37799117,0.00141306157416163,99.98815172282,0
625.04,625,331,981,1324,3924,2025-04-25,2025-05-09,546.69,650,2600,106424303,36041450,0.0036871277418655,99.9949889265425,0.662589194699287
725.06,725,651,651,3906,3906,2025-04-25,2025-08-15,546.69,0,0,282648688,37799117,0.0013819275184465,99.9895336503384,0
634.07,634,555,555,3885,3885,2025-04-25,2025-05-30,546.69,0,0,159044187,37473216,0.00244271738142809,99.9868193862376,0
810.1,810,387,387,3870,3870,2025-04-25,2025-12-19,546.69,0,0,1084502340,72118262,0.000356845703071512,99.9993365620585,0
745.02,745,1911,1919,5733,3838,2025-04-25,2025-06-20,546.69,8,-1895,1174768001,197089681,0.000326702804020281,99.9987947407499,-0.493746743095362
835.05,835,720,721,4320,3605,2025-04-25,2025-12-19,546.69,1,-715,1084502340,72118262,0.000332410532189354,99.9996689725907,-0.198335644937587
820.1,820,359,359,3590,3590,2025-04-25,2025-12-19,546.69,0,0,1084502340,72118262,0.000331027409309232,100,0
627.12,627,299,299,3588,3588,2025-04-25,2025-05-30,546.69,0,0,159044187,37473216,0.0022559768248556,99.9890753630625,0
765.06,765,590,590,3540,3540,2025-04-25,2025-09-19,546.69,0,0,612220205,74276563,0.000578223320806604,99.9976456183768,0
750.04,750,856,871,2568,3484,2025-04-25,2025-08-15,546.69,15,916.000000000001,282648688,37799117,0.00123262556944896,99.9907662759079,0.262916188289323
665.05,665,692,692,2076,3460,2025-04-25,2025-05-30,546.69,0,1384,159044187,37473216,0.00217549604626543,99.9912508591087,0.4
755.07,755,475,487,3325,3409,2025-04-25,2025-09-19,546.69,12,84.0000000000005,612220205,74276563,0.000556825791138337,99.998202444168,0.024640657084189
585.01,585,3114,3371,6228,3371,2025-04-25,2025-04-25,546.69,257,-2857,247323203,111942542,0.00136299383119343,99.9790674714819,-0.84752299021062
610.01,610,3216,3208,3216,3208,2025-04-25,2025-04-25,546.69,-8,-8.00000000000046,247323203,111942542,0.00129708816685509,99.9803645596487,-0.00249376558603505
810.03,810,1020,1020,3060,3060,2025-04-25,2025-09-19,546.69,0,0,612220205,74276563,0.000499820158663336,99.9987022643266,0
639.04,639,762,762,3810,3048,2025-04-25,2025-05-16,546.69,0,-762,919215858,218728279,0.000331586968770506,99.9967588679263,-0.25
615.03,615,1009,1007,3027,3021,2025-04-25,2025-05-02,546.69,-2,-6.00000000000046,157884664,54569672,0.0019134220661229,99.9962472605952,-0.00198609731876877
655.06,655,499,498,1996,2988,2025-04-25,2025-05-30,546.69,-1,992,159044187,37473216,0.00187872317521419,99.9931295822839,0.331994645247657
780.05,780,587,587,3522,2935,2025-04-25,2025-09-19,546.69,0,-587,612220205,74276563,0.00047940266852186,99.9991816669951,-0.2
605.01,605,2915,2914,2915,2914,2025-04-25,2025-04-25,546.69,-1,-1,247323203,111942542,0.00117821537350865,99.9815427750222,-0.000343170899107756
675.01,675,2921,2886,8763,2886,2025-04-25,2025-05-16,546.69,-35,-5877,919215858,218728279,0.000313963251926404,99.9970728311783,-2.03638253638254
765.02,765,1403,1438,4209,2876,2025-04-25,2025-06-20,546.69,35,-1333,1174768001,197089681,0.000244814295039689,99.9990395550449,-0.463490959666203
715.07,715,405,409,3240,2863,2025-04-25,2025-08-15,546.69,4,-377,282648688,37799117,0.0010129181990047,99.9917791941069,-0.131680055885435
730.07,730,402,403,2412,2821,2025-04-25,2025-08-15,546.69,1,409.000000000001,282648688,37799117,0.000998058763322475,99.9927772528702,0.144984048209855
675.05,675,541,541,2705,2705,2025-04-25,2025-05-30,546.69,0,0,159044187,37473216,0.0017007852038,99.9948303674878,0
660.01,660,2679,2679,2679,2679,2025-04-25,2025-04-25,546.69,0,0,247323203,111942542,0.0010831980046773,99.9826259730269,0
632.04,632,576,652,2880,2608,2025-04-25,2025-05-16,546.69,76,-272,919215858,218728279,0.000283720083514921,99.9973565512618,-0.104294478527607
625.11,625,211,235,2110,2585,2025-04-25,2025-05-23,546.69,24,475,70049480,15954371,0.00369024866422991,99.9913989368658,0.183752417794971
820.01,820,2540,2541,5080,2541,2025-04-25,2025-06-20,546.69,1,-2539,1174768001,197089681,0.000216298026319837,99.9992558530712,-0.999212908303817
690.02,690,1253,1252,3759,2504,2025-04-25,2025-05-30,546.69,-1,-1255,159044187,37473216,0.00157440523117013,99.9964047727189,-0.501198083067092
705.01,705,2512,2503,7536,2503,2025-04-25,2025-05-16,546.69,-9,-5033,919215858,218728279,0.000272297304078929,99.9976288485658,-2.01078705553336
765.01,765,2451,2451,2451,2451,2025-04-25,2025-05-16,546.69,0,0,919215858,218728279,0.000266640308548724,99.9978954888744,0
590.01,590,1975,2431,1975,2431,2025-04-25,2025-04-25,546.69,456,456,247323203,111942542,0.000982924355868058,99.9836088973828,0.187577128753599
725.04,725,605,605,2420,2420,2025-04-25,2025-05-16,546.69,0,0,919215858,218728279,0.000263267868905717,99.9981587567433,0
695.02,695,1187,1187,2374,2374,2025-04-25,2025-05-16,546.69,0,0,919215858,218728279,0.000258263603628997,99.9984170203469,0
745.04,745,582,582,2328,2328,2025-04-25,2025-08-15,546.69,0,0,282648688,37799117,0.00082363729210022,99.9936008901623,0
775.02,775,1148,1147,3444,2294,2025-04-25,2025-06-20,546.69,-1,-1150,1174768001,197089681,0.000195272598338334,99.9994511256696,-0.501307759372276
805.02,805,1142,1142,2284,2284,2025-04-25,2025-08-15,546.69,0,0,282648688,37799117,0.000808070264242656,99.9944089604265,0
640.02,640,1038,1140,1038,2280,2025-04-25,2025-05-02,546.69,102,1242,157884664,54569672,0.00144409212537577,99.9976913527206,0.544736842105263
635.02,635,1136,1136,2272,2272,2025-04-25,2025-05-02,546.69,0,0,157884664,54569672,0.00143902513546218,99.9991303778561,0
650.04,650,530,567,1590,2268,2025-04-25,2025-05-23,546.69,37,678,70049480,15954371,0.00323771140057,99.9946366482664,0.298941798941799
775.03,775,739,739,2217,2217,2025-04-25,2025-08-15,546.69,0,0,282648688,37799117,0.000784365926368638,99.9951933263529,0
573.02,573,1280,1093,5120,2186,2025-04-25,2025-04-25,546.69,-187,-2934,247323203,111942542,0.00088386369474602,99.9844927610775,-1.34217749313815
626.07,626,309,309,1545,2163,2025-04-25,2025-05-16,546.69,0,618.000000000001,919215858,218728279,0.000235309256381432,99.9986523296033,0.285714285714286
795.01,795,2156,2156,2156,2156,2025-04-25,2025-06-20,546.69,0,0,1174768001,197089681,0.000183525598089558,99.9996346512676,0
745.03,745,763,709,2289,2127,2025-04-25,2025-07-18,546.69,-54,-162,353688576,64788996,0.000601376505867128,99.9973629343346,-0.076163610719323
635.07,635,266,296,1862,2072,2025-04-25,2025-05-23,546.69,30,210,70049480,15954371,0.00295790918076765,99.9975945574471,0.101351351351352
595.01,595,2017,2059,4034,2059,2025-04-25,2025-04-25,546.69,42,-1975,247323203,111942542,0.000832513882654188,99.9853252749602,-0.959203496843128
635.03,635,676,686,2028,2058,2025-04-25,2025-05-09,546.69,10,30.0000000000002,106424303,36041450,0.00193376883097839,99.9969226953734,0.0145772594752188
576.01,576,1827,2013,5481,2013,2025-04-25,2025-04-25,546.69,186,-3468,247323203,111942542,0.000813914738116989,99.9861391896983,-1.72280178837556
830.01,830,2007,2007,4014,2007,2025-04-25,2025-08-15,546.69,0,-2007,282648688,37799117,0.000710068747957535,99.9959033951009,-1
592.01,592,1906,1968,3812,1968,2025-04-25,2025-04-25,546.69,62,-1844,247323203,111942542,0.00079571992280886,99.9869349096211,-0.936991869918699
785.05,785,374,374,1870,1870,2025-04-25,2025-09-19,546.69,0,0,612220205,74276563,0.000305445652516483,99.9994871126476,0
805.01,805,1849,1849,1849,1849,2025-04-25,2025-06-20,546.69,0,0,1174768001,197089681,0.000157392778695544,99.9997920440463,0
602.01,602,1838,1833,3676,1833,2025-04-25,2025-04-25,546.69,-5,-1843,247323203,111942542,0.000741135476884472,99.987676045098,-1.00545553737043
705.02,705,873,910,873,1820,2025-04-25,2025-05-30,546.69,37,947,159044187,37473216,0.00114433607057893,99.9975491087895,0.52032967032967
800.02,800,779,904,1558,1808,2025-04-25,2025-07-18,546.69,125,250,353688576,64788996,0.000511184166717333,99.9978741185014,0.138274336283186
770.03,770,594,594,1782,1782,2025-04-25,2025-06-20,546.69,0,0,1174768001,197089681,0.000151689524951574,99.9999437335713,0
597.01,597,1734,1740,3468,1740,2025-04-25,2025-04-25,546.69,6,-1728,247323203,111942542,0.000703532858581004,99.9883795779566,-0.993103448275862
735.06,735,287,287,1148,1722,2025-04-25,2025-08-15,546.69,0,574,282648688,37799117,0.000609236862971039,99.9965126319638,0.333333333333333
680.02,680,835,835,1670,1670,2025-04-25,2025-05-16,546.69,0,0,919215858,218728279,0.000181676587220061,99.9988340061905,0
795.01,795,1657,1657,1657,1657,2025-04-25,2025-05-16,546.69,0,0,919215858,218728279,0.000180262338337509,99.9990142685289,0
620.01,620,1630,1631,1630,1631,2025-04-25,2025-04-25,546.69,1,0.999999999999773,247323203,111942542,0.000659460972612424,99.9890390389292,0.000613120784794465
710.02,710,808,808,1616,1616,2025-04-25,2025-05-16,546.69,0,0,919215858,218728279,0.000175802014938694,99.9991900705438,0
578.01,578,1460,1608,4380,1608,2025-04-25,2025-04-25,546.69,148,-2772,247323203,111942542,0.000650161400343825,99.9896892003295,-1.72388059701493
581.01,581,1654,1594,3308,1594,2025-04-25,2025-04-25,546.69,-60,-1714,247323203,111942542,0.000644500791136851,99.9903337011206,-1.07528230865747
620.05,620,304,318,1216,1590,2025-04-25,2025-05-09,546.69,14,374,106424303,36041450,0.0014940196507559,99.9984167150242,0.235220125786164
685.02,685,793,793,2379,1586,2025-04-25,2025-05-30,546.69,0,-793,159044187,37473216,0.000997207147218779,99.9985463159367,-0.5
599.01,599,1481,1502,1481,1502,2025-04-25,2025-04-25,546.69,21,21,247323203,111942542,0.000607302502062453,99.9909410036227,0.0139813581890812
604.01,604,1498,1497,1498,1497,2025-04-25,2025-04-25,546.69,-1,-1,247323203,111942542,0.000605280855917105,99.9915462844786,-0.000668002672010688
596.01,596,1461,1496,2922,1496,2025-04-25,2025-04-25,546.69,35,-1426,247323203,111942542,0.000604876526688036,99.9921511610053,-0.953208556149733
680.01,680,1463,1463,1463,1463,2025-04-25,2025-04-25,546.69,0,0,247323203,111942542,0.000591533662128741,99.9927426946674,0
800.01,800,1361,1459,2722,1459,2025-04-25,2025-05-16,546.69,98,-1263,919215858,218728279,0.000158722239972496,99.9993487927838,-0.865661411925977
765.02,765,728,728,1456,1456,2025-04-25,2025-07-18,546.69,0,0,353688576,64788996,0.000411661585586525,99.998285780087,0
603.01,603,1341,1340,2682,1340,2025-04-25,2025-04-25,546.69,-1,-1342,247323203,111942542,0.000541801166953187,99.9932844958344,-1.00149253731343
735.04,735,298,335,1490,1340,2025-04-25,2025-07-18,546.69,37,-150,353688576,64788996,0.000378864371350236,99.9986646444583,-0.111940298507463
785.02,785,667,667,1334,1334,2025-04-25,2025-08-15,546.69,0,0,282648688,37799117,0.000471963980954336,99.9969845959448,0
825.01,825,1330,1329,6650,1329,2025-04-25,2025-08-15,546.69,-1,-5321,282648688,37799117,0.000470195000515976,99.9974547909453,-4.00376222723853
790.01,790,1316,1316,1316,1316,2025-04-25,2025-05-16,546.69,0,0,919215858,218728279,0.000143165502264431,99.999491958286,0
589.01,589,632,1310,632,1310,2025-04-25,2025-04-25,546.69,678,678,247323203,111942542,0.000529671290081101,99.9938141671245,0.517557251908397
815.02,815,654,654,1308,1308,2025-04-25,2025-09-19,546.69,0,0,612220205,74276563,0.000213648616840406,99.9997007612645,0
586.01,586,1171,1263,2342,1263,2025-04-25,2025-04-25,546.69,92,-1079,247323203,111942542,0.000510667816314832,99.9943248349408,-0.854315122723674
740.03,740,407,407,1221,1221,2025-04-25,2025-07-18,546.69,0,0,353688576,64788996,0.000345218953297491,99.9990098634116,0
583.01,583,861,1202,1722,1202,2025-04-25,2025-04-25,546.69,341,-520,247323203,111942542,0.00048600373334159,99.9948108386741,-0.43261231281198
735.03,735,398,398,1194,1194,2025-04-25,2025-05-16,546.69,0,0,919215858,218728279,0.000129893320443564,99.9996218516065,0
594.01,594,914,1182,914,1182,2025-04-25,2025-04-25,546.69,268,268,247323203,111942542,0.000477917148760199,99.9952887558229,0.22673434856176
795.04,795,287,287,1148,1148,2025-04-25,2025-08-15,546.69,0,0,282648688,37799117,0.000406157908647359,99.9978609488539,0
790.03,790,379,379,1137,1137,2025-04-25,2025-08-15,546.69,0,0,282648688,37799117,0.000402266151682968,99.9982632150056,0
755.04,755,245,284,980,1136,2025-04-25,2025-08-15,546.69,39,156,282648688,37799117,0.000401912355595297,99.9986651273612,0.137323943661972
650.01,650,1144,1094,1144,1094,2025-04-25,2025-05-02,546.69,-50,-50,157884664,54569672,0.000692910870684692,99.9998232887268,-0.0457038391224863
780.02,780,514,516,1028,1032,2025-04-25,2025-07-18,546.69,2,4,353688576,64788996,0.000291782112860778,99.9993016455245,0.00387596899224806
601.02,601,515,514,1030,1028,2025-04-25,2025-04-25,546.69,-1,-2,247323203,111942542,0.00041565044748349,99.9957044062704,-0.00194552529182879
582.01,582,812,1015,3248,1015,2025-04-25,2025-04-25,546.69,203,-2233,247323203,111942542,0.000410394167505586,99.9961148004379,-2.2
770.04,770,229,229,916,916,2025-04-25,2025-09-19,546.69,0,0,612220205,74276563,0.000149619367756737,99.9998503806322,0
588.01,588,881,887,1762,887,2025-04-25,2025-04-25,546.69,6,-875,247323203,111942542,0.000358640026184684,99.9964734404641,-0.986471251409244
715.01,715,873,873,873,873,2025-04-25,2025-05-16,546.69,0,0,919215858,218728279,9.49722518821036e-05,99.9997168238584,0
770.03,770,289,289,867,867,2025-04-25,2025-08-15,546.69,0,0,282648688,37799117,0.000306741208011551,99.9989718685692,0
750.01,750,758,857,758,857,2025-04-25,2025-05-16,546.69,99,99,919215858,218728279,9.32316378728096e-05,99.9998100554962,0.115519253208868
695.02,695,362,426,1086,852,2025-04-25,2025-05-30,546.69,64,-234,159044187,37473216,0.000535700182490794,99.9990820161192,-0.274647887323944
795.04,795,211,211,844,844,2025-04-25,2025-09-19,546.69,0,0,612220205,74276563,0.000137858893435247,99.9999882395257,0
700.01,700,819,822,819,822,2025-04-25,2025-04-25,546.69,3,3.00000000000011,247323203,111942542,0.000332358626295164,99.9968057990904,0.00364963503649649
591.01,591,797,795,1594,795,2025-04-25,2025-04-25,546.69,-2,-799,247323203,111942542,0.000321441737110286,99.9971272408275,-1.00503144654088
780.03,780,265,265,795,795,2025-04-25,2025-08-15,546.69,0,0,282648688,37799117,0.000281267889699173,99.9992531364589,0
640.01,640,784,784,784,784,2025-04-25,2025-04-25,546.69,0,0,247323203,111942542,0.000316994115590521,99.9974442349431,0
810.02,810,385,385,770,770,2025-04-25,2025-08-15,546.69,0,0,282648688,37799117,0.000272422987507375,99.9995255594464,0
745.02,745,364,373,364,746,2025-04-25,2025-05-16,546.69,9,382,919215858,218728279,8.11561281833325e-05,99.9998912116244,0.512064343163539
720.02,720,372,372,744,744,2025-04-25,2025-05-30,546.69,0,0,159044187,37473216,0.000467794525555341,99.9995498106448,0
587.01,587,723,713,1446,713,2025-04-25,2025-04-25,546.69,-10,-733,247323203,111942542,0.000288286740326584,99.9977325216834,-1.02805049088359
760.04,760,174,174,696,696,2025-04-25,2025-08-15,546.69,0,0,282648688,37799117,0.000246242077019653,99.9997718015235,0
635.01,635,694,694,694,694,2025-04-25,2025-04-25,546.69,0,0,247323203,111942542,0.000280604484974263,99.9980131261684,0
645.03,645,227,227,681,681,2025-04-25,2025-05-09,546.69,0,0,106424303,36041450,0.000639891435323753,99.9990566064595,0
795.02,795,338,338,676,676,2025-04-25,2025-07-18,546.69,0,0,353688576,64788996,0.000191128593308029,99.9994927741178,0
810.01,810,657,661,3942,661,2025-04-25,2025-06-20,546.69,4,-3281,1174768001,197089681,5.62664287278285e-05,100,-4.96369137670197
640.05,640,128,128,640,640,2025-04-25,2025-05-23,546.69,0,0,70049480,15954371,0.000913639901395413,99.9985081973485,0
598.01,598,629,629,1258,629,2025-04-25,2025-04-25,546.69,0,-629,247323203,111942542,0.000254323085084742,99.9982674492534,-1
593.01,593,553,578,553,578,2025-04-25,2025-04-25,546.69,25,25,247323203,111942542,0.000233702294402196,99.9985011515479,0.0432525951557093
730.04,730,123,139,369,556,2025-04-25,2025-07-18,546.69,16,187,353688576,64788996,0.000157200440649799,99.9996499745584,0.336330935251799
730.02,730,272,272,544,544,2025-04-25,2025-05-16,546.69,0,0,919215858,218728279,5.91808763159959e-05,99.9999503925007,0
630.1,630,39,53,273,530,2025-04-25,2025-05-23,546.69,14,257,70049480,15954371,0.000756608043343077,99.9992648053919,0.484905660377359
645.05,645,61,103,244,515,2025-04-25,2025-05-23,546.69,42,271,70049480,15954371,0.000735194608154122,100,0.52621359223301
630.01,630,499,499,499,499,2025-04-25,2025-04-25,546.69,0,0,247323203,111942542,0.000201760285305702,99.9987029118332,0
770.02,770,241,242,482,484,2025-04-25,2025-07-18,546.69,1,2,353688576,64788996,0.000136843549054861,99.9997868181075,0.00413223140495868
665.01,665,480,480,480,480,2025-04-25,2025-04-25,546.69,0,0,247323203,111942542,0.00019407802995338,99.9988969898631,0
655.01,655,457,457,457,457,2025-04-25,2025-04-25,546.69,0,0,247323203,111942542,0.000184778457684781,99.9990817683208,0
740.02,740,228,228,456,456,2025-04-25,2025-05-16,546.69,0,0,919215858,218728279,4.96074992648789e-05,100,0
650.01,650,425,424,1275,424,2025-04-25,2025-05-09,546.69,-1,-851,106424303,36041450,0.000398405240201573,99.9994550116997,-2.00707547169811
690.02,690,208,208,416,416,2025-04-25,2025-04-25,546.69,0,0,247323203,111942542,0.00016820095929293,99.9992499692801,0
630.04,630,102,102,306,408,2025-04-25,2025-05-09,546.69,0,102,106424303,36041450,0.000383371080193967,99.9998383827799,0.25
765.03,765,134,135,402,405,2025-04-25,2025-08-15,546.69,1,3.00000000000006,282648688,37799117,0.000143287415507126,99.999915088939,0.00740740740740755
584.01,584,398,399,796,399,2025-04-25,2025-04-25,546.69,1,-397,247323203,111942542,0.000161327362398748,99.9994112966425,-0.994987468671679
695.01,695,396,396,396,396,2025-04-25,2025-04-25,546.69,0,0,247323203,111942542,0.000160114374711539,99.9995714110172,0
715.02,715,176,180,352,360,2025-04-25,2025-05-30,546.69,4,8,159044187,37473216,0.000226352189784843,99.9997761628346,0.0222222222222222
710.02,710,179,178,358,356,2025-04-25,2025-05-30,546.69,-1,-2,159044187,37473216,0.0002238371654539,100,-0.00561797752808989
755.02,755,162,164,324,328,2025-04-25,2025-07-18,546.69,2,4,353688576,64788996,9.27369505991621e-05,99.9998795550581,0.0121951219512195
645.01,645,296,296,296,296,2025-04-25,2025-04-25,546.69,0,0,247323203,111942542,0.000119681451804585,99.999691092469,0
645.01,645,278,279,278,279,2025-04-25,2025-05-02,546.69,1,1,157884664,54569672,0.000176711273236772,100,0.003584229390681
650.01,650,277,277,277,277,2025-04-25,2025-04-25,546.69,0,0,247323203,111942542,0.000111999196452263,99.9998030916655,0
775.02,775,119,122,238,244,2025-04-25,2025-07-18,546.69,3,6,353688576,64788996,6.89872437384011e-05,99.9999485423018,0.0245901639344262
740.04,740,60,60,240,240,2025-04-25,2025-08-15,546.69,0,0,282648688,37799117,8.49110610412598e-05,100,0
625.01,625,228,228,228,228,2025-04-25,2025-04-25,546.69,0,0,247323203,111942542,9.21870642278557e-05,99.9998952787297,0
685.01,685,195,195,195,195,2025-04-25,2025-04-25,546.69,0,0,247323203,111942542,7.88441996685608e-05,99.9999741229293,0
760.02,760,86,91,172,182,2025-04-25,2025-07-18,546.69,5,10,353688576,64788996,5.14576981983156e-05,100,0.054945054945055
640.02,640,88,86,176,172,2025-04-25,2025-05-09,546.69,-2,-4,106424303,36041450,0.00016161722008177,100,-0.0232558139534884
790.04,790,18,18,72,72,2025-04-25,2025-09-19,546.69,0,0,612220205,74276563,1.17604743214903e-05,100,0
670.01,670,64,64,64,64,2025-04-25,2025-04-25,546.69,0,0,247323203,111942542,2.58770706604507e-05,100,0
265,265,0,0,0,0,2025-04-25,2025-04-25,546.69,0,0,247323203,111942542,0,100,
275,275,0,0,0,0,2025-04-25,2025-04-25,546.69,0,0,247323203,111942542,0,100,
539.97,280,0,0,0,0,2025-04-25,2025-04-25,546.69,0,0,247323203,111942542,0,100,
285,285,0,0,0,0,2025-04-25,2025-04-25,546.69,0,0,247323203,111942542,0,100,
290,290,0,0,0,0,2025-04-25,2025-04-25,546.69,0,0,247323203,111942542,0,100,
295,295,0,0,0,0,2025-04-25,2025-04-25,546.69,0,0,247323203,111942542,0,100,
310,310,0,0,0,0,2025-04-25,2025-04-25,546.69,0,0,247323203,111942542,0,100,
315,315,0,0,0,0,2025-04-25,2025-04-25,546.69,0,0,247323203,111942542,0,100,
325,325,0,0,0,0,2025-04-25,2025-04-25,546.69,0,0,247323203,111942542,0,100,
544.99,330,0,0,0,0,2025-04-25,2025-04-25,546.69,0,0,247323203,111942542,0,100,
345,345,0,0,0,0,2025-04-25,2025-04-25,546.69,0,0,247323203,111942542,0,100,
356,356,0,0,0,0,2025-04-25,2025-04-25,546.69,0,0,247323203,111942542,0,100,
357,357,0,0,0,0,2025-04-25,2025-04-25,546.69,0,0,247323203,111942542,0,100,
358,358,0,0,0,0,2025-04-25,2025-04-25,546.69,0,0,247323203,111942542,0,100,
359,359,0,0,0,0,2025-04-25,2025-04-25,546.69,0,0,247323203,111942542,0,100,
360,360,0,0,0,0,2025-04-25,2025-04-25,546.69,0,0,247323203,111942542,0,100,
361,361,0,0,0,0,2025-04-25,2025-04-25,546.69,0,0,247323203,111942542,0,100,
362,362,0,0,0,0,2025-04-25,2025-04-25,546.69,0,0,247323203,111942542,0,100,
363,363,0,0,0,0,2025-04-25,2025-04-25,546.69,0,0,247323203,111942542,0,100,
366,366,0,0,0,0,2025-04-25,2025-04-25,546.69,0,0,247323203,111942542,0,100,
367,367,0,0,0,0,2025-04-25,2025-04-25,546.69,0,0,247323203,111942542,0,100,
368,368,0,0,0,0,2025-04-25,2025-04-25,546.69,0,0,247323203,111942542,0,100,
369,369,0,0,0,0,2025-04-25,2025-04-25,546.69,0,0,247323203,111942542,0,100,
371,371,0,0,0,0,2025-04-25,2025-04-25,546.69,0,0,247323203,111942542,0,100,
373,373,0,0,0,0,2025-04-25,2025-04-25,546.69,0,0,247323203,111942542,0,100,
375,375,0,0,0,0,2025-04-25,2025-04-25,546.69,0,0,247323203,111942542,0,100,
377,377,0,0,0,0,2025-04-25,2025-04-25,546.69,0,0,247323203,111942542,0,100,
379,379,0,0,0,0,2025-04-25,2025-04-25,546.69,0,0,247323203,111942542,0,100,
521.44,380,0,0,0,0,2025-04-25,2025-04-25,546.69,0,0,247323203,111942542,0,100,
381,381,0,0,0,0,2025-04-25,2025-04-25,546.69,0,0,247323203,111942542,0,100,
382,382,0,0,0,0,2025-04-25,2025-04-25,546.69,0,0,247323203,111942542,0,100,
383,383,0,0,0,0,2025-04-25,2025-04-25,546.69,0,0,247323203,111942542,0,100,
384,384,0,0,0,0,2025-04-25,2025-04-25,546.69,0,0,247323203,111942542,0,100,
386,386,0,0,0,0,2025-04-25,2025-04-25,546.69,0,0,247323203,111942542,0,100,
387,387,0,0,0,0,2025-04-25,2025-04-25,546.69,0,0,247323203,111942542,0,100,
388,388,0,0,0,0,2025-04-25,2025-04-25,546.69,0,0,247323203,111942542,0,100,
389,389,0,0,0,0,2025-04-25,2025-04-25,546.69,0,0,247323203,111942542,0,100,
392,392,0,0,0,0,2025-04-25,2025-04-25,546.69,0,0,247323203,111942542,0,100,
394,394,0,0,0,0,2025-04-25,2025-04-25,546.69,0,0,247323203,111942542,0,100,
396,396,0,0,0,0,2025-04-25,2025-04-25,546.69,0,0,247323203,111942542,0,100,
397,397,0,0,0,0,2025-04-25,2025-04-25,546.69,0,0,247323203,111942542,0,100,
398,398,0,0,0,0,2025-04-25,2025-04-25,546.69,0,0,247323203,111942542,0,100,
399,399,0,0,0,0,2025-04-25,2025-04-25,546.69,0,0,247323203,111942542,0,100,
401,401,0,0,0,0,2025-04-25,2025-04-25,546.69,0,0,247323203,111942542,0,100,
406,406,0,0,0,0,2025-04-25,2025-04-25,546.69,0,0,247323203,111942542,0,100,
407,407,0,0,0,0,2025-04-25,2025-04-25,546.69,0,0,247323203,111942542,0,100,
408,408,0,0,0,0,2025-04-25,2025-04-25,546.69,0,0,247323203,111942542,0,100,
409,409,0,0,0,0,2025-04-25,2025-04-25,546.69,0,0,247323203,111942542,0,100,
416,416,0,0,0,0,2025-04-25,2025-04-25,546.69,0,0,247323203,111942542,0,100,
418,418,0,0,0,0,2025-04-25,2025-04-25,546.69,0,0,247323203,111942542,0,100,
419,419,0,0,0,0,2025-04-25,2025-04-25,546.69,0,0,247323203,111942542,0,100,
421,421,0,0,0,0,2025-04-25,2025-04-25,546.69,0,0,247323203,111942542,0,100,
423,423,0,0,0,0,2025-04-25,2025-04-25,546.69,0,0,247323203,111942542,0,100,
426,426,0,0,0,0,2025-04-25,2025-04-25,546.69,0,0,247323203,111942542,0,100,
431,431,0,0,0,0,2025-04-25,2025-04-25,546.69,0,0,247323203,111942542,0,100,
433,433,0,0,0,0,2025-04-25,2025-04-25,546.69,0,0,247323203,111942542,0,100,
437,437,0,0,0,0,2025-04-25,2025-04-25,546.69,0,0,247323203,111942542,0,100,
438,438,0,0,0,0,2025-04-25,2025-04-25,546.69,0,0,247323203,111942542,0,100,
441,441,0,0,0,0,2025-04-25,2025-04-25,546.69,0,0,247323203,111942542,0,100,
442,442,0,0,0,0,2025-04-25,2025-04-25,546.69,0,0,247323203,111942542,0,100,
443,443,0,0,0,0,2025-04-25,2025-04-25,546.69,0,0,247323203,111942542,0,100,
447,447,0,0,0,0,2025-04-25,2025-04-25,546.69,0,0,247323203,111942542,0,100,
535.6,448,0,0,0,0,2025-04-25,2025-04-25,546.69,0,0,247323203,111942542,0,100,
449,449,0,0,0,0,2025-04-25,2025-04-25,546.69,0,0,247323203,111942542,0,100,
452,452,0,0,0,0,2025-04-25,2025-04-25,546.69,0,0,247323203,111942542,0,100,
456,456,0,0,0,0,2025-04-25,2025-04-25,546.69,0,0,247323203,111942542,0,100,
458,458,0,0,0,0,2025-04-25,2025-04-25,546.69,0,0,247323203,111942542,0,100,
461,461,0,0,0,0,2025-04-25,2025-04-25,546.69,0,0,247323203,111942542,0,100,
462,462,0,0,0,0,2025-04-25,2025-04-25,546.69,0,0,247323203,111942542,0,100,
464,464,0,0,0,0,2025-04-25,2025-04-25,546.69,0,0,247323203,111942542,0,100,
466,466,0,0,0,0,2025-04-25,2025-04-25,546.69,0,0,247323203,111942542,0,100,
467,467,0,0,0,0,2025-04-25,2025-04-25,546.69,0,0,247323203,111942542,0,100,
468,468,0,0,0,0,2025-04-25,2025-04-25,546.69,0,0,247323203,111942542,0,100,
476,476,0,0,0,0,2025-04-25,2025-04-25,546.69,0,0,247323203,111942542,0,100,
260,260,0,0,0,0,2025-04-25,2025-05-02,546.69,0,0,157884664,54569672,0,100,
265,265,0,0,0,0,2025-04-25,2025-05-02,546.69,0,0,157884664,54569672,0,100,
270,270,0,0,0,0,2025-04-25,2025-05-02,546.69,0,0,157884664,54569672,0,100,
275,275,0,0,0,0,2025-04-25,2025-05-02,546.69,0,0,157884664,54569672,0,100,
280,280,0,0,0,0,2025-04-25,2025-05-02,546.69,0,0,157884664,54569672,0,100,
285,285,0,0,0,0,2025-04-25,2025-05-02,546.69,0,0,157884664,54569672,0,100,
290,290,0,0,0,0,2025-04-25,2025-05-02,546.69,0,0,157884664,54569672,0,100,
295,295,0,0,0,0,2025-04-25,2025-05-02,546.69,0,0,157884664,54569672,0,100,
305,305,0,0,0,0,2025-04-25,2025-05-02,546.69,0,0,157884664,54569672,0,100,
325,325,0,0,0,0,2025-04-25,2025-05-02,546.69,0,0,157884664,54569672,0,100,
330,330,0,0,0,0,2025-04-25,2025-05-02,546.69,0,0,157884664,54569672,0,100,
335,335,0,0,0,0,2025-04-25,2025-05-02,546.69,0,0,157884664,54569672,0,100,
345,345,0,0,0,0,2025-04-25,2025-05-02,546.69,0,0,157884664,54569672,0,100,
355,355,0,0,0,0,2025-04-25,2025-05-02,546.69,0,0,157884664,54569672,0,100,
365,365,0,0,0,0,2025-04-25,2025-05-02,546.69,0,0,157884664,54569672,0,100,
370,370,0,0,0,0,2025-04-25,2025-05-02,546.69,0,0,157884664,54569672,0,100,
380,380,0,0,0,0,2025-04-25,2025-05-02,546.69,0,0,157884664,54569672,0,100,
385,385,0,0,0,0,2025-04-25,2025-05-02,546.69,0,0,157884664,54569672,0,100,
395,395,0,0,0,0,2025-04-25,2025-05-02,546.69,0,0,157884664,54569672,0,100,
405,405,0,0,0,0,2025-04-25,2025-05-02,546.69,0,0,157884664,54569672,0,100,
410,410,0,0,0,0,2025-04-25,2025-05-02,546.69,0,0,157884664,54569672,0,100,
426,426,0,0,0,0,2025-04-25,2025-05-02,546.69,0,0,157884664,54569672,0,100,
427,427,0,0,0,0,2025-04-25,2025-05-02,546.69,0,0,157884664,54569672,0,100,
428,428,0,0,0,0,2025-04-25,2025-05-02,546.69,0,0,157884664,54569672,0,100,
429,429,0,0,0,0,2025-04-25,2025-05-02,546.69,0,0,157884664,54569672,0,100,
431,431,0,0,0,0,2025-04-25,2025-05-02,546.69,0,0,157884664,54569672,0,100,
432,432,0,0,0,0,2025-04-25,2025-05-02,546.69,0,0,157884664,54569672,0,100,
433,433,0,0,0,0,2025-04-25,2025-05-02,546.69,0,0,157884664,54569672,0,100,
434,434,0,0,0,0,2025-04-25,2025-05-02,546.69,0,0,157884664,54569672,0,100,
436,436,0,0,0,0,2025-04-25,2025-05-02,546.69,0,0,157884664,54569672,0,100,
437,437,0,0,0,0,2025-04-25,2025-05-02,546.69,0,0,157884664,54569672,0,100,
438,438,0,0,0,0,2025-04-25,2025-05-02,546.69,0,0,157884664,54569672,0,100,
439,439,0,0,0,0,2025-04-25,2025-05-02,546.69,0,0,157884664,54569672,0,100,
441,441,0,0,0,0,2025-04-25,2025-05-02,546.69,0,0,157884664,54569672,0,100,
442,442,0,0,0,0,2025-04-25,2025-05-02,546.69,0,0,157884664,54569672,0,100,
443,443,0,0,0,0,2025-04-25,2025-05-02,546.69,0,0,157884664,54569672,0,100,
444,444,0,0,0,0,2025-04-25,2025-05-02,546.69,0,0,157884664,54569672,0,100,
446,446,0,0,0,0,2025-04-25,2025-05-02,546.69,0,0,157884664,54569672,0,100,
447,447,0,0,0,0,2025-04-25,2025-05-02,546.69,0,0,157884664,54569672,0,100,
449,449,0,0,0,0,2025-04-25,2025-05-02,546.69,0,0,157884664,54569672,0,100,
452,452,0,0,0,0,2025-04-25,2025-05-02,546.69,0,0,157884664,54569672,0,100,
453,453,0,0,0,0,2025-04-25,2025-05-02,546.69,0,0,157884664,54569672,0,100,
454,454,0,0,0,0,2025-04-25,2025-05-02,546.69,0,0,157884664,54569672,0,100,
456,456,0,0,0,0,2025-04-25,2025-05-02,546.69,0,0,157884664,54569672,0,100,
457,457,0,0,0,0,2025-04-25,2025-05-02,546.69,0,0,157884664,54569672,0,100,
458,458,0,0,0,0,2025-04-25,2025-05-02,546.69,0,0,157884664,54569672,0,100,
459,459,0,0,0,0,2025-04-25,2025-05-02,546.69,0,0,157884664,54569672,0,100,
461,461,0,0,0,0,2025-04-25,2025-05-02,546.69,0,0,157884664,54569672,0,100,
462,462,0,0,0,0,2025-04-25,2025-05-02,546.69,0,0,157884664,54569672,0,100,
463,463,0,0,0,0,2025-04-25,2025-05-02,546.69,0,0,157884664,54569672,0,100,
464,464,0,0,0,0,2025-04-25,2025-05-02,546.69,0,0,157884664,54569672,0,100,
466,466,0,0,0,0,2025-04-25,2025-05-02,546.69,0,0,157884664,54569672,0,100,
467,467,0,0,0,0,2025-04-25,2025-05-02,546.69,0,0,157884664,54569672,0,100,
468,468,0,0,0,0,2025-04-25,2025-05-02,546.69,0,0,157884664,54569672,0,100,
469,469,0,0,0,0,2025-04-25,2025-05-02,546.69,0,0,157884664,54569672,0,100,
471,471,0,0,0,0,2025-04-25,2025-05-02,546.69,0,0,157884664,54569672,0,100,
473,473,0,0,0,0,2025-04-25,2025-05-02,546.69,0,0,157884664,54569672,0,100,
474,474,0,0,0,0,2025-04-25,2025-05-02,546.69,0,0,157884664,54569672,0,100,
476,476,0,0,0,0,2025-04-25,2025-05-02,546.69,0,0,157884664,54569672,0,100,
477,477,0,0,0,0,2025-04-25,2025-05-02,546.69,0,0,157884664,54569672,0,100,
478,478,0,0,0,0,2025-04-25,2025-05-02,546.69,0,0,157884664,54569672,0,100,
481,481,0,0,0,0,2025-04-25,2025-05-02,546.69,0,0,157884664,54569672,0,100,
482,482,0,0,0,0,2025-04-25,2025-05-02,546.69,0,0,157884664,54569672,0,100,
483,483,0,0,0,0,2025-04-25,2025-05-02,546.69,0,0,157884664,54569672,0,100,
487,487,0,0,0,0,2025-04-25,2025-05-02,546.69,0,0,157884664,54569672,0,100,
488,488,0,0,0,0,2025-04-25,2025-05-02,546.69,0,0,157884664,54569672,0,100,
491,491,0,0,0,0,2025-04-25,2025-05-02,546.69,0,0,157884664,54569672,0,100,
492,492,0,0,0,0,2025-04-25,2025-05-02,546.69,0,0,157884664,54569672,0,100,
255,255,0,0,0,0,2025-04-25,2025-05-09,546.69,0,0,106424303,36041450,0,100,
260,260,0,0,0,0,2025-04-25,2025-05-09,546.69,0,0,106424303,36041450,0,100,
265,265,0,0,0,0,2025-04-25,2025-05-09,546.69,0,0,106424303,36041450,0,100,
270,270,0,0,0,0,2025-04-25,2025-05-09,546.69,0,0,106424303,36041450,0,100,
275,275,0,0,0,0,2025-04-25,2025-05-09,546.69,0,0,106424303,36041450,0,100,
280,280,0,0,0,0,2025-04-25,2025-05-09,546.69,0,0,106424303,36041450,0,100,
285,285,0,0,0,0,2025-04-25,2025-05-09,546.69,0,0,106424303,36041450,0,100,
290,290,0,0,0,0,2025-04-25,2025-05-09,546.69,0,0,106424303,36041450,0,100,
295,295,0,0,0,0,2025-04-25,2025-05-09,546.69,0,0,106424303,36041450,0,100,
310,310,0,0,0,0,2025-04-25,2025-05-09,546.69,0,0,106424303,36041450,0,100,
315,315,0,0,0,0,2025-04-25,2025-05-09,546.69,0,0,106424303,36041450,0,100,
320,320,0,0,0,0,2025-04-25,2025-05-09,546.69,0,0,106424303,36041450,0,100,
325,325,0,0,0,0,2025-04-25,2025-05-09,546.69,0,0,106424303,36041450,0,100,
330,330,0,0,0,0,2025-04-25,2025-05-09,546.69,0,0,106424303,36041450,0,100,
335,335,0,0,0,0,2025-04-25,2025-05-09,546.69,0,0,106424303,36041450,0,100,
340,340,0,0,0,0,2025-04-25,2025-05-09,546.69,0,0,106424303,36041450,0,100,
345,345,0,0,0,0,2025-04-25,2025-05-09,546.69,0,0,106424303,36041450,0,100,
355,355,0,0,0,0,2025-04-25,2025-05-09,546.69,0,0,106424303,36041450,0,100,
365,365,0,0,0,0,2025-04-25,2025-05-09,546.69,0,0,106424303,36041450,0,100,
380,380,0,0,0,0,2025-04-25,2025-05-09,546.69,0,0,106424303,36041450,0,100,
385,385,0,0,0,0,2025-04-25,2025-05-09,546.69,0,0,106424303,36041450,0,100,
395,395,0,0,0,0,2025-04-25,2025-05-09,546.69,0,0,106424303,36041450,0,100,
415,415,0,0,0,0,2025-04-25,2025-05-09,546.69,0,0,106424303,36041450,0,100,
295,295,0,0,0,0,2025-04-25,2025-05-16,546.69,0,0,919215858,218728279,0,100,
325,325,0,0,0,0,2025-04-25,2025-05-16,546.69,0,0,919215858,218728279,0,100,
335,335,0,0,0,0,2025-04-25,2025-05-16,546.69,0,0,919215858,218728279,0,100,
305,305,0,0,0,0,2025-04-25,2025-05-23,546.69,0,0,70049480,15954371,0,100,
310,310,0,0,0,0,2025-04-25,2025-05-23,546.69,0,0,70049480,15954371,0,100,
315,315,0,0,0,0,2025-04-25,2025-05-23,546.69,0,0,70049480,15954371,0,100,
320,320,0,0,0,0,2025-04-25,2025-05-23,546.69,0,0,70049480,15954371,0,100,
325,325,0,0,0,0,2025-04-25,2025-05-23,546.69,0,0,70049480,15954371,0,100,
330,330,0,0,0,0,2025-04-25,2025-05-23,546.69,0,0,70049480,15954371,0,100,
340,340,0,0,0,0,2025-04-25,2025-05-23,546.69,0,0,70049480,15954371,0,100,
345,345,0,0,0,0,2025-04-25,2025-05-23,546.69,0,0,70049480,15954371,0,100,
350,350,0,0,0,0,2025-04-25,2025-05-23,546.69,0,0,70049480,15954371,0,100,
360,360,0,0,0,0,2025-04-25,2025-05-23,546.69,0,0,70049480,15954371,0,100,
365,365,0,0,0,0,2025-04-25,2025-05-23,546.69,0,0,70049480,15954371,0,100,
455,455,0,0,0,0,2025-04-25,2025-05-23,546.69,0,0,70049480,15954371,0,100,
320,320,0,0,0,0,2025-04-25,2025-05-30,546.69,0,0,159044187,37473216,0,100,
325,325,0,0,0,0,2025-04-25,2025-05-30,546.69,0,0,159044187,37473216,0,100,
523.73,355,0,0,0,0,2025-04-25,2025-05-30,546.69,0,0,159044187,37473216,0,100,
270,270,15,15,0,0,2025-04-25,2025-06-20,546.69,0,0,1174768001,197089681,0,100,
245,245,0,0,0,0,2025-04-25,2025-07-18,546.69,0,0,353688576,64788996,0,100,
255,255,0,0,0,0,2025-04-25,2025-07-18,546.69,0,0,353688576,64788996,0,100,
260,260,0,0,0,0,2025-04-25,2025-07-18,546.69,0,0,353688576,64788996,0,100,
265,265,0,0,0,0,2025-04-25,2025-07-18,546.69,0,0,353688576,64788996,0,100,
270,270,0,0,0,0,2025-04-25,2025-07-18,546.69,0,0,353688576,64788996,0,100,
275,275,0,0,0,0,2025-04-25,2025-07-18,546.69,0,0,353688576,64788996,0,100,
285,285,0,0,0,0,2025-04-25,2025-07-18,546.69,0,0,353688576,64788996,0,100,
250,250,0,0,0,0,2025-04-25,2025-08-15,546.69,0,0,282648688,37799117,0,100,
255,255,0,0,0,0,2025-04-25,2025-08-15,546.69,0,0,282648688,37799117,0,100,
285,285,0,0,0,0,2025-04-25,2025-08-15,546.69,0,0,282648688,37799117,0,100,
185,185,0,0,0,0,2025-04-25,2025-09-19,546.69,0,0,612220205,74276563,0,100,
571.87,220,0,0,0,0,2025-04-25,2025-09-19,546.69,0,0,612220205,74276563,0,100,
561.35,225,0,0,0,0,2025-04-25,2025-09-19,546.69,0,0,612220205,74276563,0,100,
260,260,0,0,0,0,2025-04-25,2025-09-19,546.69,0,0,612220205,74276563,0,100,
613.75,270,0,0,0,0,2025-04-25,2025-09-19,546.69,0,0,612220205,74276563,0,100,
290,290,0,0,0,0,2025-04-25,2025-09-19,546.69,0,0,612220205,74276563,0,100,
