Watch,strike,open_interest.yt,open_interest.td,OI_Dollar.yt,OI_Dollar.td,Date.td,expiry,stkClose,diff_oi,diff_oi_d,totalOI,totalOIdiff,OI_pct,cum_sep_OI,pct
557.75,210,1206,1206,41938650,41938650,2025-04-07,2025-12-19,505.28,0,0,850516954,-173881469,4.93095990653233,4.93095990653233,0
515.98,200,1280,1281,46823680,40477038,2025-04-07,2025-06-20,505.28,1,-6346642,478977607,-137482950,8.4507161521645,8.4507161521645,-0.156796107462211
536.73,455,4473,4467,46988865,36508791,2025-04-07,2025-12-19,505.28,-6,-10480074,850516954,-173881469,4.29254123957181,9.22350114610414,-0.287056177784688
526.5,400,2604,2596,39953172,32839400,2025-04-07,2025-12-19,505.28,-8,-7113772,850516954,-173881469,3.86111056876122,13.0846117148654,-0.216623080811464
536.17,450,3666,3670,40227018,31624390,2025-04-07,2025-12-19,505.28,4,-8602628,850516954,-173881469,3.71825509782842,16.8028668126938,-0.272025104673956
557.49,150,696,696,28361304,28361304,2025-04-07,2025-12-19,505.28,0,0,850516954,-173881469,3.33459596150508,20.1374627741989,0
570.21,175,671,671,26518591,26518591,2025-04-07,2025-12-19,505.28,0,0,850516954,-173881469,3.11793796411494,23.2554007383138,0
530.92,390,1742,1744,28378922,24576448,2025-04-07,2025-12-19,505.28,2,-3802474,850516954,-173881469,2.88958942963058,26.1449901679444,-0.15472024272995
533.7,500,5531,6954,28622925,23434980,2025-04-07,2025-06-20,505.28,1423,-5187945,478977607,-137482950,4.89270889860202,13.3434250507665,-0.221376122360676
559.57,435,1844,1844,22970708,22970708,2025-04-07,2025-12-19,505.28,0,0,850516954,-173881469,2.70079366342649,28.8457838313709,0
531.52,410,1818,1773,27199098,21545496,2025-04-07,2025-12-19,505.28,-45,-5653602,850516954,-173881469,2.53322357639916,31.37900740777,-0.262402963477843
525.23,490,195,5790,1090050,20398170,2025-04-07,2025-05-16,505.28,5595,19308120,191683614,-460736.000000003,10.6415825402791,10.6415825402791,0.946561382712273
544.05,470,2610,2607,24583590,19304835,2025-04-07,2025-12-19,505.28,-3,-5278755,850516954,-173881469,2.26977662340638,33.6487840311764,-0.273442119551915
537.54,510,6098,6854,27190982,18875916,2025-04-07,2025-06-20,505.28,756,-8315066,478977607,-137482950,3.94087650949411,17.2843015602606,-0.440511920057284
612.17,165,401,401,17931517,17931517,2025-04-07,2025-06-20,505.28,0,0,478977607,-137482950,3.74370674911322,21.0280083093738,0
532.67,485,3499,3566,22663023,16999122,2025-04-07,2025-06-20,505.28,67,-5663901,478977607,-137482950,3.54904316017429,24.5770514695481,-0.333187855231582
558.1,520,4482,4460,24839244,16992600,2025-04-07,2025-12-19,505.28,-22,-7846644,850516954,-173881469,1.99791431788437,35.6466983490608,-0.46176829914198
571.79,180,433,433,16964507,16964507,2025-04-07,2025-12-19,505.28,0,0,850516954,-173881469,1.99461126791366,37.6413096169744,0
555.95,380,954,954,16785630,16785630,2025-04-07,2025-12-19,505.28,0,0,850516954,-173881469,1.97357970597256,39.614889322947,0
539.68,515,1447,6764,6291556,16693552,2025-04-07,2025-06-20,505.28,5317,10401996,478977607,-137482950,3.48524685831503,28.0622983278632,0.623114601374231
542.31,445,1697,1696,19249071,16503776,2025-04-07,2025-12-19,505.28,-1,-2745295,850516954,-173881469,1.94044056645577,41.5553298894028,-0.166343447705543
559.27,530,4181,5267,17029213,15416509,2025-04-07,2025-09-19,505.28,1086,-1612704,264848567,-73847933,5.82087687867309,5.82087687867309,-0.104608896865042
526.8,455,2152,2141,20119048,15372380,2025-04-07,2025-06-20,505.28,-11,-4746668,478977607,-137482950,3.20941517418371,31.2717135020469,-0.308778991932284
540.43,490,3015,3018,24783300,15219774,2025-04-07,2025-09-19,505.28,3,-9563526,264848567,-73847933,5.74659480789262,11.5674716865657,-0.628361892890131
533.02,430,1373,1432,18346026,14752464,2025-04-07,2025-12-19,505.28,59,-3593562,850516954,-173881469,1.73452909205617,43.2898589814589,-0.243590630012722
549.21,480,2082,2080,17655360,14395680,2025-04-07,2025-12-19,505.28,-2,-3259680,850516954,-173881469,1.69258001645902,44.982438997918,-0.226434597045781
569.66,165,354,354,14324964,14324964,2025-04-07,2025-12-19,505.28,0,0,850516954,-173881469,1.68426554375305,46.666704541671,0
530.3,405,1128,1120,17197488,14033600,2025-04-07,2025-12-19,505.28,-8,-3163888,850516954,-173881469,1.65000826074068,48.3167128024117,-0.225450917797287
572.52,455,1191,1191,13996632,13996632,2025-04-07,2025-09-19,505.28,0,0,264848567,-73847933,5.2847678802053,16.852239566771,0
528.31,470,2388,2387,18507000,13918597,2025-04-07,2025-06-20,505.28,-1,-4588403,478977607,-137482950,2.90589722704928,34.1776107290962,-0.329659878793818
539.35,526,7,10343,21385,13807905,2025-04-07,2025-05-16,505.28,10336,13786520,191683614,-460736.000000003,7.20348740920546,17.8450699494846,0.998451249483539
535.38,440,1441,1436,17453392,13696568,2025-04-07,2025-12-19,505.28,-5,-3756824,850516954,-173881469,1.61038153743847,49.9270943398502,-0.274289442435506
516.46,410,1266,1266,17389776,13477836,2025-04-07,2025-06-20,505.28,0,-3911940,478977607,-137482950,2.81387601487599,36.9914867439721,-0.29024985910201
527.25,415,1175,1175,16947025,13189375,2025-04-07,2025-12-19,505.28,0,-3757650,850516954,-173881469,1.55074804070278,51.4778423805529,-0.284899777282851
533.38,350,698,699,14438828,12818262,2025-04-07,2025-12-19,505.28,1,-1620566,850516954,-173881469,1.50711422502696,52.9849566055799,-0.126426343914643
539.16,525,8158,9044,23046350,12806304,2025-04-07,2025-05-16,505.28,886,-10240046,191683614,-460736.000000003,6.68095917682353,24.5260291263081,-0.799609785930429
562.78,555,15143,15566,23214219,12110348,2025-04-07,2025-06-20,505.28,423,-11103871,478977607,-137482950,2.52837456762358,39.5198613115957,-0.916891157875892
548.19,475,1643,1642,14596412,12017798,2025-04-07,2025-12-19,505.28,-1,-2578614,850516954,-173881469,1.41299922870203,54.3979558342819,-0.214566262471711
529.22,425,1155,1148,15774990,11964456,2025-04-07,2025-12-19,505.28,-7,-3810534,850516954,-173881469,1.40672751362932,55.8046833479113,-0.318487861044414
544.19,500,726,2707,4475064,11962233,2025-04-07,2025-09-19,505.28,1981,7487169,264848567,-73847933,4.51663119627149,21.3688707630425,0.625900615712802
529.65,395,839,840,13241937,11310600,2025-04-07,2025-12-19,505.28,1,-1931337,850516954,-173881469,1.32985003377134,57.1345333816826,-0.170754601877885
543.5,465,1419,1421,14260950,11154850,2025-04-07,2025-12-19,505.28,2,-3106100,850516954,-173881469,1.31153764161179,58.4460710232944,-0.278452870276158
582.5,560,4935,4940,15337980,11115000,2025-04-07,2025-12-19,505.28,5,-4222980,850516954,-173881469,1.30685225588107,59.7529232791755,-0.379935222672065
523.25,450,1485,1494,14738625,10943550,2025-04-07,2025-06-20,505.28,9,-3795075,478977607,-137482950,2.28477278270756,41.8046340943033,-0.34678646325918
522.5,420,1066,1066,13580840,10926500,2025-04-07,2025-06-20,505.28,0,-2654340,478977607,-137482950,2.28121311733891,44.0858472116422,-0.242926829268293
551.4,505,2299,2342,15132018,10866880,2025-04-07,2025-12-19,505.28,43,-4265138,850516954,-173881469,1.2776794100215,61.030602689197,-0.392489656644778
552.8,540,7876,8454,18626740,10821120,2025-04-07,2025-06-20,505.28,578,-7805620,478977607,-137482950,2.25921208880231,46.3450593004445,-0.721331987816418
530.98,360,617,618,12186367,10566564,2025-04-07,2025-12-19,505.28,1,-1619803,850516954,-173881469,1.24236959067132,62.2729722798683,-0.153295148735199
561.86,550,7192,8896,15052856,10550656,2025-04-07,2025-07-18,505.28,1704,-4502200,104857395,-33238059,10.0619093197957,10.0619093197957,-0.426722281533963
561.31,275,359,359,10278529,10278529,2025-04-07,2025-12-19,505.28,0,0,850516954,-173881469,1.20850371667018,63.4814759965385,0
523.42,430,1089,1095,12851289,10229490,2025-04-07,2025-06-20,505.28,6,-2621799,478977607,-137482950,2.13569274440005,48.4807520448446,-0.256298114568762
574.11,560,5098,7204,11710106,10164844,2025-04-07,2025-09-19,505.28,2106,-1545262,264848567,-73847933,3.83798338618158,25.2068541492241,-0.152020237595383
549.99,500,2013,1998,14121195,9988002,2025-04-07,2025-12-19,505.28,-15,-4133193,850516954,-173881469,1.17434484439448,64.6558208409329,-0.413815796192272
530.85,475,1787,1785,13481128,9969225,2025-04-07,2025-06-20,505.28,-2,-3511903,478977607,-137482950,2.0813551310761,50.5621071759207,-0.352274424541527
587.77,580,9058,12820,12391344,9961140,2025-04-07,2025-09-19,505.28,3762,-2430204,264848567,-73847933,3.76107000042783,28.9679241496519,-0.24396846144116
533.82,490,2191,2225,14425544,9749950,2025-04-07,2025-06-20,505.28,34,-4675594,478977607,-137482950,2.03557532909884,52.5976825050195,-0.479550561797753
559.39,550,7650,10339,13670550,9708321,2025-04-07,2025-06-20,505.28,2689,-3962229,478977607,-137482950,2.02688410859258,54.6245666136121,-0.408127110753754
524.11,465,1589,1589,13137852,9392579,2025-04-07,2025-06-20,505.28,0,-3745273,478977607,-137482950,1.96096411663771,56.5855307302498,-0.398748096768736
571.84,420,616,616,9353344,9353344,2025-04-07,2025-09-19,505.28,0,0,264848567,-73847933,3.53158187939148,32.4995060290434,0
571.61,410,574,574,9276414,9276414,2025-04-07,2025-09-19,505.28,0,0,264848567,-73847933,3.50253509206263,36.002041121106,0
558.98,260,306,306,9148788,9148788,2025-04-07,2025-12-19,505.28,0,0,850516954,-173881469,1.07567379544559,65.7314946363785,0
576.97,565,7662,7519,15714762,9000243,2025-04-07,2025-09-19,505.28,-143,-6714519,264848567,-73847933,3.3982600328738,39.4003011539798,-0.746037523653528
538.58,470,1250,1308,10867500,8970264,2025-04-07,2025-09-19,505.28,58,-1897236,264848567,-73847933,3.38694073432536,42.7872418883052,-0.211502805268607
584,575,10102,9908,15829834,8917200,2025-04-07,2025-09-19,505.28,-194,-6912634,264848567,-73847933,3.36690513413274,46.1541470224379,-0.775202305656484
547.79,485,1382,1396,11188672,8765484,2025-04-07,2025-12-19,505.28,14,-2423188,850516954,-173881469,1.03060661622037,66.7621012525989,-0.276446571575511
540.18,460,1085,1085,11202625,8699530,2025-04-07,2025-12-19,505.28,0,-2503095,850516954,-173881469,1.02285203829106,67.78495329089,-0.28772761287104
574.4,570,16815,19701,14780385,8668440,2025-04-07,2025-06-20,505.28,2886,-6111945,478977607,-137482950,1.80977980459116,58.3953105348409,-0.705080152830267
568.54,540,3038,3033,12856816,8656182,2025-04-07,2025-12-19,505.28,-5,-4200634,850516954,-173881469,1.0177553732809,68.8027086641709,-0.485275609962914
549.98,495,1554,1552,11602164,8532896,2025-04-07,2025-12-19,505.28,-2,-3069268,850516954,-173881469,1.00325995382803,69.8059686179989,-0.359698278286762
566.77,560,11592,12581,14872536,8517337,2025-04-07,2025-06-20,505.28,989,-6355199,478977607,-137482950,1.77823281830376,60.1735433531447,-0.746148590809546
583.02,580,27058,27765,14990132,8385030,2025-04-07,2025-06-20,505.28,707,-6605102,478977607,-137482950,1.75061002382101,61.9241533769657,-0.787725506050664
544.1,525,3281,4359,11158681,8325690,2025-04-07,2025-06-20,505.28,1078,-2832991,478977607,-137482950,1.73822113566992,63.6623745126356,-0.340271016576404
510.93,300,378,394,9922500,8310642,2025-04-07,2025-06-20,505.28,16,-1611858,478977607,-137482950,1.73507944391229,65.3974539565479,-0.193951081035617
607.75,600,11014,10706,14197046,8297150,2025-04-07,2025-12-19,505.28,-308,-5899896,850516954,-173881469,0.975541987843784,70.7815106058427,-0.711075007683361
520.52,150,226,221,8917508,8188492,2025-04-07,2025-06-20,505.28,-5,-729016,478977607,-137482950,1.70957720785473,67.1070311644026,-0.0890293353159532
531.36,285,331,331,9220998,8154516,2025-04-07,2025-12-19,505.28,0,-1066482,850516954,-173881469,0.958771716618832,71.7402823224615,-0.130784218217243
559.22,270,277,277,8011394,8011394,2025-04-07,2025-12-19,505.28,0,0,850516954,-173881469,0.941944068524706,72.6822263909862,0
542.01,530,556,6649,1362200,7985449,2025-04-07,2025-05-16,505.28,6093,6623249,191683614,-460736.000000003,4.16595286021684,28.6919819865249,0.829414726711047
547.14,530,3676,4623,10917720,7923822,2025-04-07,2025-06-20,505.28,947,-2993898,478977607,-137482950,1.65431992731969,68.7613510917223,-0.377835090187538
565.25,280,275,275,7844375,7844375,2025-04-07,2025-12-19,505.28,0,0,850516954,-173881469,0.922306717474323,73.6045331084605,0
591.65,585,6970,11392,8182780,7575680,2025-04-07,2025-09-19,505.28,4422,-607100,264848567,-73847933,2.86038172145368,49.0145287438916,-0.0801380206133311
542.05,520,1988,3435,7355600,7574175,2025-04-07,2025-06-20,505.28,1447,218575,478977607,-137482950,1.58132131634287,70.3426724080652,0.0288579284212472
536.49,520,3336,4588,10425000,7565612,2025-04-07,2025-05-16,505.28,1252,-2859388,191683614,-460736.000000003,3.94692683538406,32.638908821909,-0.377945366481919
596.9,585,6258,6355,11652396,7562450,2025-04-07,2025-12-19,505.28,97,-4089946,850516954,-173881469,0.889159230093372,74.4936923385539,-0.540822881473597
557.62,235,232,232,7484784,7484784,2025-04-07,2025-12-19,505.28,0,0,850516954,-173881469,0.880027607303875,75.3737199458578,0
576.63,575,44863,44818,15567461,7305334,2025-04-07,2025-05-16,505.28,-45,-8262127,191683614,-460736.000000003,3.8111416242392,36.4500504461482,-1.13097183510022
555.6,550,5714,12852,7182498,7197120,2025-04-07,2025-05-16,505.28,7138,14622,191683614,-460736.000000003,3.75468713773312,40.2047375838813,0.00203164599173003
530.77,420,638,638,8971556,7067126,2025-04-07,2025-12-19,505.28,0,-1904430,850516954,-173881469,0.830921237579469,76.2046411834373,-0.269477295296561
559.81,265,237,237,6986997,6986997,2025-04-07,2025-12-19,505.28,0,0,850516954,-173881469,0.821500026206415,77.0261412096437,0
580.45,570,6574,6473,11866070,6764285,2025-04-07,2025-09-19,505.28,-101,-5101785,264848567,-73847933,2.5540198599602,51.5685486038518,-0.754223838883194
573.75,550,2667,2819,9729216,6695125,2025-04-07,2025-12-19,505.28,152,-3034091,850516954,-173881469,0.787183014813835,77.8133242244575,-0.453179141539553
612.85,610,23360,23413,11212800,6672705,2025-04-07,2025-09-19,505.28,53,-4540095,264848567,-73847933,2.51944160981622,54.087990213668,-0.680397979530041
516.24,350,389,389,8256914,6466736,2025-04-07,2025-06-20,505.28,0,-1790178,478977607,-137482950,1.35011238636048,71.6927847944257,-0.276828681424447
578.65,575,17839,17693,12398105,6457945,2025-04-07,2025-06-20,505.28,-146,-5940160,478977607,-137482950,1.34827701872084,73.0410618131465,-0.919822017685192
554.02,525,1966,2218,8668094,6436636,2025-04-07,2025-09-19,505.28,252,-2231458,264848567,-73847933,2.43030803334496,56.518298247013,-0.346680781700255
554,510,1407,1445,9032940,6358000,2025-04-07,2025-12-19,505.28,38,-2674940,850516954,-173881469,0.747545356985324,78.5608695814428,-0.420720352312048
565.1,555,6216,6270,11369064,6332700,2025-04-07,2025-07-18,505.28,54,-5036364,104857395,-33238059,6.03934515062099,16.1012544704167,-0.795294897910844
562.8,240,190,190,6133200,6133200,2025-04-07,2025-12-19,505.28,0,0,850516954,-173881469,0.721114372988737,79.2819839544316,0
546.65,385,379,379,6126535,6126535,2025-04-07,2025-06-20,505.28,0,0,478977607,-137482950,1.2790858926313,74.3201477057778,0
545.41,490,1100,1100,8457900,6095100,2025-04-07,2025-12-19,505.28,0,-2362800,850516954,-173881469,0.716634744473301,79.9986186989049,-0.387655657823498
525.55,440,706,706,7695400,6039830,2025-04-07,2025-06-20,505.28,0,-1655570,478977607,-137482950,1.26098379375802,75.5811314995358,-0.274108708357686
527,480,1279,1281,8953000,6020700,2025-04-07,2025-06-20,505.28,2,-2932300,478977607,-137482950,1.25698987009219,76.838121369628,-0.487036391117312
562.09,525,1603,1618,8636964,6001162,2025-04-07,2025-12-19,505.28,15,-2635802,850516954,-173881469,0.705589932308392,80.7042086312133,-0.439215271975661
558.55,540,1592,3208,4868336,5950840,2025-04-07,2025-08-15,505.28,1616,1082504,112162086,-42661174,5.3055717954461,5.3055717954461,0.181907764282017
563.59,495,864,864,5926176,5926176,2025-04-07,2025-09-19,505.28,0,0,264848567,-73847933,2.23757147985626,58.7558697268693,0
586.74,570,3452,3483,8906160,5830542,2025-04-07,2025-12-19,505.28,31,-3075618,850516954,-173881469,0.685529191696748,81.38973782291,-0.527501216868003
567,550,2825,3400,8037125,5780000,2025-04-07,2025-09-19,505.28,575,-2257125,264848567,-73847933,2.18237918576316,60.9382489126324,-0.390506055363322
565.9,385,316,316,5716440,5716440,2025-04-07,2025-07-18,505.28,0,0,104857395,-33238059,5.45163266739556,21.5528871378123,0
559.81,255,186,186,5669466,5669466,2025-04-07,2025-12-19,505.28,0,0,850516954,-173881469,0.666590592149442,82.0563284150594,0
523.5,460,879,883,7665759,5607050,2025-04-07,2025-06-20,505.28,4,-2058709,478977607,-137482950,1.17062883902211,78.0087502086502,-0.367164373422745
576.23,570,8575,8803,9861250,5484269,2025-04-07,2025-07-18,505.28,228,-4376981,104857395,-33238059,5.23021671480586,26.7831038526181,-0.798097431034109
546.16,505,1312,1316,7680448,5416656,2025-04-07,2025-09-19,505.28,4,-2263792,264848567,-73847933,2.04518984616594,62.9834387587983,-0.417931653773103
534.24,530,155,12637,228625,5358088,2025-04-07,2025-04-11,505.28,12482,5129463,52569756,25897074,10.1923394888879,10.1923394888879,0.957330861307242
592.74,580,4095,4198,8574930,5348252,2025-04-07,2025-12-19,505.28,103,-3226678,850516954,-173881469,0.628823678922219,82.6851520939817,-0.603314503505071
555.4,200,150,150,5331000,5331000,2025-04-07,2025-12-19,505.28,0,0,850516954,-173881469,0.626795265506254,83.3119473594879,0
556.21,551,932,10227,1128652,5328267,2025-04-07,2025-05-16,505.28,9295,4199615,191683614,-460736.000000003,2.77971960607963,42.9844571899609,0.788176530943363
515.55,300,242,246,5947150,5302530,2025-04-07,2025-12-19,505.28,4,-644620,850516954,-173881469,0.623447889552593,83.9353952490405,-0.121568383394342
555.99,545,3559,4805,7367130,5280695,2025-04-07,2025-06-20,505.28,1246,-2086435,478977607,-137482950,1.10249308586153,79.1112432945117,-0.39510613659755
540.7,510,584,1715,2874448,5265050,2025-04-07,2025-07-18,505.28,1131,2390602,104857395,-33238059,5.02115277611083,31.804256628729,0.454051148612074
553.86,155,132,132,5264952,5264952,2025-04-07,2025-12-19,505.28,0,0,850516954,-173881469,0.619029635475085,84.5544248845156,0
591.9,590,26957,27437,9030595,5213030,2025-04-07,2025-06-20,505.28,480,-3817565,478977607,-137482950,1.08836612063161,80.1996094151433,-0.732312110231478
589.16,575,3663,3674,8578746,5202384,2025-04-07,2025-12-19,505.28,11,-3376362,850516954,-173881469,0.611673168363438,85.166098052879,-0.649002841774079
603.03,600,16576,16822,8122240,5097066,2025-04-07,2025-08-15,505.28,246,-3025174,112162086,-42661174,4.54437518218055,9.84994697762665,-0.593512816981377
535.8,505,901,1642,4705022,5057360,2025-04-07,2025-06-20,505.28,741,352338,478977607,-137482950,1.05586564509267,81.255475060236,0.0696683645222013
541.42,480,819,819,6494670,5030298,2025-04-07,2025-09-19,505.28,0,-1464372,264848567,-73847933,1.89931101269655,64.8827497714949,-0.29111038749593
530.46,430,468,495,6165432,4972770,2025-04-07,2025-09-19,505.28,27,-1192662,264848567,-73847933,1.8775899210359,66.7603396925308,-0.239838560802129
578.8,555,2024,2084,6818856,4959920,2025-04-07,2025-12-19,505.28,60,-1858936,850516954,-173881469,0.583165329823631,85.7492633827027,-0.374791528895627
595.74,590,8690,8621,8646550,4948454,2025-04-07,2025-09-19,505.28,-69,-3698096,264848567,-73847933,1.86840882548555,68.6287485180163,-0.747323507503556
541.93,515,1050,1830,4935000,4928190,2025-04-07,2025-07-18,505.28,780,-6810,104857395,-33238059,4.69989741782161,36.5041540465506,-0.0013818460733048
545.29,520,738,1935,2966022,4893615,2025-04-07,2025-07-18,505.28,1197,1927593,104857395,-33238059,4.66692406386789,41.1710781104184,0.393899601828097
528.38,385,338,340,5807854,4874920,2025-04-07,2025-12-19,505.28,2,-932934,850516954,-173881469,0.573171407938801,86.3224347906415,-0.191374217423055
551.25,515,1290,1342,6633180,4864750,2025-04-07,2025-09-19,505.28,52,-1768430,264848567,-73847933,1.83680435016286,70.4655528681792,-0.363519194203196
524.09,470,854,891,6737206,4819419,2025-04-07,2025-05-16,505.28,37,-1917787,191683614,-460736.000000003,2.51425716545599,45.498714355417,-0.397929086472872
548.46,540,5024,5590,9078368,4729140,2025-04-07,2025-05-16,505.28,566,-4349228,191683614,-460736.000000003,2.46715924293873,47.9658735983557,-0.919665732035846
605.96,605,48497,48605,6983568,4666080,2025-04-07,2025-06-20,505.28,108,-2317488,478977607,-137482950,0.974174978497481,82.2296500387335,-0.496667009566917
575.51,205,125,125,4631375,4631375,2025-04-07,2025-06-20,505.28,0,0,478977607,-137482950,0.966929337053538,83.196579375787,0
527.65,520,37,6035,82917,4616775,2025-04-07,2025-04-11,505.28,5998,4533858,52569756,25897074,8.78218837462362,18.9745278635115,0.982040060431795
570.41,565,8355,8328,9006690,4505448,2025-04-07,2025-06-20,505.28,-27,-4501242,478977607,-137482950,0.940638546386157,84.1372179221732,-0.999066463534814
530.78,525,46,7559,85100,4369102,2025-04-07,2025-04-11,505.28,7513,4284002,52569756,25897074,8.31105626588794,27.2855841293994,0.980522313280853
561.6,540,1765,2022,6075130,4367520,2025-04-07,2025-09-19,505.28,257,-1707610,264848567,-73847933,1.64906310404919,72.1146159722284,-0.390979320071803
559.24,515,955,968,5649780,4282432,2025-04-07,2025-12-19,505.28,13,-1367348,850516954,-173881469,0.503509304530572,86.825944095172,-0.319292402074335
584.45,565,2177,2200,6171795,4279000,2025-04-07,2025-12-19,505.28,23,-1892795,850516954,-173881469,0.503105785237528,87.3290498804096,-0.4423451741061
550.8,510,763,1044,4149957,4259520,2025-04-07,2025-09-19,505.28,281,109563,264848567,-73847933,1.60828508466123,73.7229010568896,0.0257219123281497
604.17,600,11311,10073,7996877,4200441,2025-04-07,2025-09-19,505.28,-1238,-3796436,264848567,-73847933,1.58597837533325,75.3088794322229,-0.903818432397932
562.96,245,132,132,4197072,4197072,2025-04-07,2025-12-19,505.28,0,0,850516954,-173881469,0.49347305544717,87.8225229358567,0
551.76,520,838,1312,4034132,4166912,2025-04-07,2025-09-19,505.28,474,132780,264848567,-73847933,1.57331868818456,76.8821981204074,0.0318653237697365
601.21,600,32571,34256,6253632,4144976,2025-04-07,2025-06-20,505.28,1685,-2108656,478977607,-137482950,0.86537991326179,85.0025978354349,-0.508725744129761
560.52,535,1597,1617,5988750,4126584,2025-04-07,2025-09-19,505.28,20,-1862166,264848567,-73847933,1.55809187368569,78.4402899940931,-0.451260897633491
599.85,590,3961,4106,6599026,4044410,2025-04-07,2025-12-19,505.28,145,-2554616,850516954,-173881469,0.475523736590911,88.2980466724476,-0.631641203537722
516.25,250,151,150,4729924,3993750,2025-04-07,2025-12-19,505.28,-1,-736174,850516954,-173881469,0.469567359147552,88.7676140315952,-0.18433151799687
602.76,210,101,101,3966876,3966876,2025-04-07,2025-06-20,505.28,0,0,478977607,-137482950,0.82819654656632,85.8307943820013,0
566.31,530,1073,1084,5252335,3936004,2025-04-07,2025-12-19,505.28,11,-1316331,850516954,-173881469,0.462777841345653,89.2303918729409,-0.334433349153101
568.73,560,4281,4467,6828195,3899691,2025-04-07,2025-07-18,505.28,186,-2928504,104857395,-33238059,3.71904241946884,44.8901205298873,-0.750957960515333
554.64,550,1305,8351,1444635,3874864,2025-04-07,2025-05-09,505.28,7046,2430229,21122544,7108655,18.3446842387925,18.3446842387925,0.627177882888277
552.61,535,2070,2185,6210000,3847785,2025-04-07,2025-07-18,505.28,115,-2362215,104857395,-33238059,3.66954090362439,48.5596614335117,-0.613915538420156
633,630,12056,12577,6064168,3773100,2025-04-07,2025-12-19,505.28,521,-2291068,850516954,-173881469,0.443624313690048,89.6740161866309,-0.607211046619491
561.19,305,147,147,3765993,3765993,2025-04-07,2025-12-19,505.28,0,0,850516954,-173881469,0.442788704244924,90.1168048908758,0
551.88,545,1395,5457,2113425,3754416,2025-04-07,2025-05-16,505.28,4062,1640991,191683614,-460736.000000003,1.95865255336849,49.9245261517242,0.437082891187338
529.85,510,46,1891,176870,3753635,2025-04-07,2025-05-09,505.28,1845,3576765,21122544,7108655,17.7707524245186,36.115436663311,0.952880341322478
572.11,570,18117,17770,8659926,3749470,2025-04-07,2025-05-16,505.28,-347,-4910456,191683614,-460736.000000003,1.95607225978116,51.8805984115053,-1.30964002912412
570.7,545,1447,1447,5701180,3718790,2025-04-07,2025-12-19,505.28,0,-1982390,850516954,-173881469,0.437238785483399,90.5540436763592,-0.53307392996109
611.5,605,5669,5662,6400301,3680300,2025-04-07,2025-12-19,505.28,-7,-2720001,850516954,-173881469,0.432713302502845,90.9867569788621,-0.739070456212809
515,340,211,209,4710575,3657500,2025-04-07,2025-06-20,505.28,-2,-1053075,478977607,-137482950,0.76360563553444,86.5944000175357,-0.287922077922078
577.98,570,4516,4561,6652068,3639678,2025-04-07,2025-08-15,505.28,45,-3012390,112162086,-42661174,3.2450163239653,13.0949633015919,-0.827652885777259
570.63,555,2247,2323,5819730,3630849,2025-04-07,2025-09-19,505.28,76,-2188881,264848567,-73847933,1.37091510108114,79.8112050951743,-0.602856521987006
547.24,540,1828,4923,3067384,3564252,2025-04-07,2025-05-09,505.28,3095,496868,21122544,7108655,16.8741606124717,52.9895972757827,0.139403162290433
532,445,405,406,4163400,3532200,2025-04-07,2025-06-20,505.28,1,-631200,478977607,-137482950,0.737445748690293,87.331845766226,-0.178698827925939
615.98,615,35433,35644,5350383,3493112,2025-04-07,2025-07-18,505.28,211,-1857271,104857395,-33238059,3.33129771152526,51.8909591450369,-0.531695233362114
558.51,375,190,190,3486690,3486690,2025-04-07,2025-12-19,505.28,0,0,850516954,-173881469,0.409949499960232,91.3967064788223,0
538.58,505,592,1032,3197392,3465456,2025-04-07,2025-07-18,505.28,440,268064,104857395,-33238059,3.30492284306701,55.195881988104,0.0773531679525003
553.15,547,5239,5621,7507487,3456915,2025-04-07,2025-05-16,505.28,382,-4050572,191683614,-460736.000000003,1.80344836361443,53.6840467751198,-1.17173028552915
624.24,620,8095,8116,5787925,3441184,2025-04-07,2025-12-19,505.28,21,-2346741,850516954,-173881469,0.404599106909749,91.801305585732,-0.681957430930749
562.99,290,126,126,3439674,3439674,2025-04-07,2025-12-19,505.28,0,0,850516954,-173881469,0.404421567826854,92.2057271535589,0
566.66,295,126,126,3422916,3422916,2025-04-07,2025-12-19,505.28,0,0,850516954,-173881469,0.402451236733372,92.6081783902923,0
549.52,335,157,157,3367964,3367964,2025-04-07,2025-06-20,505.28,0,0,478977607,-137482950,0.703156880567905,88.0350026467939,0
536.62,500,440,907,2427040,3321434,2025-04-07,2025-07-18,505.28,467,894394,104857395,-33238059,3.16757249214516,58.3634544802491,0.269279473865806
516.14,450,297,502,2757348,3320228,2025-04-07,2025-05-16,505.28,205,562880,191683614,-460736.000000003,1.73213971226565,55.4161864873854,0.169530526216874
559.42,555,4164,7499,4255608,3314558,2025-04-07,2025-05-16,505.28,3335,-941050,191683614,-460736.000000003,1.72918171294496,57.1453682003304,-0.283914174982004
572.25,565,3831,4540,5206329,3291500,2025-04-07,2025-07-18,505.28,709,-1914829,104857395,-33238059,3.13902514934688,61.502479629596,-0.581749658210542
549.68,535,1423,2224,3842100,3264832,2025-04-07,2025-06-20,505.28,801,-577268,478977607,-137482950,0.681625185037095,88.716627831831,-0.176813998392567
587.48,585,13304,12979,5734024,3218792,2025-04-07,2025-06-20,505.28,-325,-2515232,478977607,-137482950,0.672013044651584,89.3886408764826,-0.781421104563451
557.31,230,98,98,3207638,3207638,2025-04-07,2025-12-19,505.28,0,0,850516954,-173881469,0.377139807138989,92.9853181974313,0
538.45,524,14,2206,39942,3187670,2025-04-07,2025-05-16,505.28,2192,3147728,191683614,-460736.000000003,1.66298513132166,58.808353331652,0.987469844745535
570.36,170,78,78,3122808,3122808,2025-04-07,2025-12-19,505.28,0,0,850516954,-173881469,0.367165873097928,93.3524840705292,0
553.7,526,30,1126,123000,3119020,2025-04-07,2025-08-15,505.28,1096,2996020,112162086,-42661174,2.78081490032202,15.875778201914,0.960564536296657
561.34,315,126,126,3103884,3103884,2025-04-07,2025-12-19,505.28,0,0,850516954,-173881469,0.36494087335971,93.7174249438889,0
578.49,375,152,152,3093048,3093048,2025-04-07,2025-06-20,505.28,0,0,478977607,-137482950,0.645760460363234,90.0344013368458,0
610.84,610,36266,36531,3807930,3068604,2025-04-07,2025-06-20,505.28,265,-739326.000000001,478977607,-137482950,0.640657090259336,90.6750584271051,-0.240932358818538
621.95,620,15519,15586,4888485,3039270,2025-04-07,2025-09-19,505.28,67,-1849215,264848567,-73847933,1.14755010171529,80.9587551968895,-0.608440513675981
567.73,555,2388,2383,5418372,3033559,2025-04-07,2025-08-15,505.28,-5,-2384813,112162086,-42661174,2.7046207040051,18.5803989059191,-0.786143602283654
517,400,251,259,3693214,3030300,2025-04-07,2025-06-20,505.28,8,-662914,478977607,-137482950,0.632660056694467,91.3077184837996,-0.218761838761839
513.99,375,150,218,2439600,3029982,2025-04-07,2025-04-11,505.28,68,590382.000000001,52569756,25897074,5.76373609190806,33.0493202213075,0.194846702059616
568.17,380,161,161,3029537,3029537,2025-04-07,2025-09-19,505.28,0,0,264848567,-73847933,1.14387517150508,82.1026303683946,0
540.28,500,741,747,4349670,3008916,2025-04-07,2025-08-15,505.28,6,-1340754,112162086,-42661174,2.68264982161619,21.2630487275353,-0.445593695536864
531.87,495,423,794,2595528,2927478,2025-04-07,2025-06-20,505.28,371,331950,478977607,-137482950,0.611193082352178,91.9189115661518,0.113391116858948
564,545,1479,1536,4618917,2918400,2025-04-07,2025-09-19,505.28,57,-1700517,264848567,-73847933,1.1019127016836,83.2045430700782,-0.582688116776316
620.02,615,5790,5790,4846230,2906580,2025-04-07,2025-12-19,505.28,0,-1939650,850516954,-173881469,0.341742746729538,94.0591676906184,-0.667330677290837
599.79,595,6006,6013,5135130,2880227,2025-04-07,2025-09-19,505.28,7,-2254903,264848567,-73847933,1.08749955970122,84.2920426297795,-0.782890723543665
547.14,395,189,189,2875446,2875446,2025-04-07,2025-06-20,505.28,0,0,478977607,-137482950,0.600329944025964,92.5192415101777,0
615.85,610,4639,4820,4471996,2819700,2025-04-07,2025-12-19,505.28,181,-1652296,850516954,-173881469,0.331527782807725,94.3906954734262,-0.585982905982906
608.28,605,8289,8400,4815909,2755200,2025-04-07,2025-09-19,505.28,111,-2060709,264848567,-73847933,1.04029258349735,85.3323352132768,-0.747934451219512
585.9,580,2515,4655,2638235,2746450,2025-04-07,2025-08-15,505.28,2140,108215,112162086,-42661174,2.44864383139237,23.7116925589276,0.0394017731981285
547.42,525,1051,1222,3954913,2739724,2025-04-07,2025-07-18,505.28,171,-1215189,104857395,-33238059,2.61280952096893,64.1152891505649,-0.443544313222792
567.92,535,728,832,3494400,2738944,2025-04-07,2025-12-19,505.28,104,-755456,850516954,-173881469,0.322032851563827,94.71272832499,-0.275820170109356
581.25,580,21472,21651,5410944,2706375,2025-04-07,2025-05-16,505.28,179,-2704569,191683614,-460736.000000003,1.41189689797898,60.220250229631,-0.99933268671193
598.27,595,8191,8163,4939173,2669301,2025-04-07,2025-08-15,505.28,-28,-2269872,112162086,-42661174,2.37986033890276,26.0915528978304,-0.850361948689938
557.93,435,217,217,2667581,2667581,2025-04-07,2025-09-19,505.28,0,0,264848567,-73847933,1.00720990497185,86.3395451182487,0
544.09,360,144,144,2650896,2650896,2025-04-07,2025-06-20,505.28,0,0,478977607,-137482950,0.553448837953713,93.0726903481315,0
538.03,485,497,498,3810499,2640894,2025-04-07,2025-09-19,505.28,1,-1169605,264848567,-73847933,0.997133580866231,87.3366786991149,-0.442882220944877
584.23,580,6150,6240,4846200,2639520,2025-04-07,2025-07-18,505.28,90,-2206680,104857395,-33238059,2.51724735294063,66.6325365035056,-0.836015639207128
572.07,445,207,207,2630349,2630349,2025-04-07,2025-09-19,505.28,0,0,264848567,-73847933,0.993152060362101,88.329830759477,0
587.99,509,331,331,2614569,2614569,2025-04-07,2025-08-15,505.28,0,0,112162086,-42661174,2.33106310094839,28.4226159987788,0
561.02,320,108,108,2603016,2603016,2025-04-07,2025-12-19,505.28,0,0,850516954,-173881469,0.306051041987812,95.0187793669778,0
557.86,539,1339,1368,4204460,2580048,2025-04-07,2025-08-15,505.28,29,-1624412,112162086,-42661174,2.30028532101302,30.7229013197918,-0.629605340675832
532.04,510,296,1159,1145520,2554436,2025-04-07,2025-05-16,505.28,863,1408916,191683614,-460736.000000003,1.33263138496544,61.5528816145964,0.551556586267967
534.39,515,463,1309,1734398,2538151,2025-04-07,2025-05-16,505.28,846,803753,191683614,-460736.000000003,1.32413561442972,62.8770172290262,0.316668708835684
617.35,615,10776,10746,4310400,2525310,2025-04-07,2025-09-19,505.28,-30,-1785090,264848567,-73847933,0.953492038339026,89.283322797816,-0.70687955142141
579.9,575,5959,5150,5839820,2523500,2025-04-07,2025-07-18,505.28,-809,-3316320,104857395,-33238059,2.40660184243562,69.0391383459412,-1.31417475728155
602,600,12094,12617,3894268,2523400,2025-04-07,2025-07-18,505.28,523,-1370868,104857395,-33238059,2.40650647481754,71.4456448207587,-0.543262265197749
563.6,560,5025,6964,4100400,2507040,2025-04-07,2025-05-16,505.28,1939,-1593360,191683614,-460736.000000003,1.30790522344805,64.1849224524742,-0.635554279149914
522.71,160,69,68,2826102,2466428,2025-04-07,2025-12-19,505.28,-1,-359674,850516954,-173881469,0.289991632547751,95.3087709995255,-0.145827893617815
628.48,625,6867,6833,4078998,2377884,2025-04-07,2025-12-19,505.28,-34,-1701114,850516954,-173881469,0.279581022908098,95.5883520224336,-0.715389817165177
522.1,510,12,1929,41580,2334090,2025-04-07,2025-04-11,505.28,1917,2292510,52569756,25897074,4.43998636782716,37.4893065891346,0.982185776898063
651.65,650,13604,13702,3346584,2260830,2025-04-07,2025-12-19,505.28,98,-1085754,850516954,-173881469,0.265818334292722,95.8541703567264,-0.480245750454479
536.52,490,334,481,2252496,2237612,2025-04-07,2025-07-18,505.28,147,-14883.9999999995,104857395,-33238059,2.13395726643791,73.5796020871966,-0.00665173408079664
596.47,595,14455,14988,3686025,2203236,2025-04-07,2025-06-20,505.28,533,-1482789,478977607,-137482950,0.459987266168792,93.5326776143002,-0.673005070723245
603.57,160,49,49,2173493,2173493,2025-04-07,2025-06-20,505.28,0,0,478977607,-137482950,0.45377758129724,93.9864551955975,0
594.1,590,5206,5239,3904500,2147990,2025-04-07,2025-08-15,505.28,33,-1756510,112162086,-42661174,1.91507672209306,32.6379780418849,-0.817745892671754
568.91,185,54,54,2073114,2073114,2025-04-07,2025-12-19,505.28,0,0,850516954,-173881469,0.24374752205116,96.0979178787775,0
550.96,370,114,114,2062944,2062944,2025-04-07,2025-12-19,505.28,0,0,850516954,-173881469,0.242551778691527,96.340469657469,0
631.4,630,14392,14403,2979144,2016420,2025-04-07,2025-09-19,505.28,11,-962724,264848567,-73847933,0.761348276428469,90.0446710742445,-0.477442199541762
521.65,509,0,1563,0,1977195,2025-04-07,2025-04-11,505.28,1563,1977195,52569756,25897074,3.76108840984539,41.25039499898,1
567.78,565,7271,7081,4588001,1968518,2025-04-07,2025-05-16,505.28,-190,-2619483,191683614,-460736.000000003,1.02696206468645,65.2118845171607,-1.33068785756595
580.94,561,983,983,1960102,1960102,2025-04-07,2025-08-15,505.28,0,0,112162086,-42661174,1.74756200593488,34.3855400478197,0
611.32,610,15272,14796,2978040,1953072,2025-04-07,2025-07-18,505.28,-476,-1024968,104857395,-33238059,1.86259824593201,75.4422003331286,-0.524797856914645
569.37,460,178,178,1946786,1946786,2025-04-07,2025-09-19,505.28,0,0,264848567,-73847933,0.735056270853827,90.7797273450983,0
680.7,680,27556,27709,2397372,1939630,2025-04-07,2025-12-19,505.28,153,-457742,850516954,-173881469,0.228053067123222,96.5685227245923,-0.235994493795208
560.1,542,1051,1050,3383169,1900500,2025-04-07,2025-08-15,505.28,-1,-1482669,112162086,-42661174,1.69442283732134,36.0799628851411,-0.78014680347277
547.49,405,133,133,1895117,1895117,2025-04-07,2025-06-20,505.28,0,0,478977607,-137482950,0.395658789117463,94.3821139847149,0
557.3,190,51,51,1873230,1873230,2025-04-07,2025-12-19,505.28,0,0,850516954,-173881469,0.220246050497895,96.7887687750902,0
520.54,310,88,88,2215400,1852752,2025-04-07,2025-12-19,505.28,0,-362648,850516954,-173881469,0.217838338352512,97.0066071134427,-0.195734777239479
519.89,390,144,142,2261520,1844438,2025-04-07,2025-06-20,505.28,-2,-417082,478977607,-137482950,0.385078127462439,94.7671921121774,-0.226129585272045
541.98,540,2418,9296,2115750,1840608,2025-04-07,2025-04-11,505.28,6878,-275142,52569756,25897074,3.501267915339,44.751662914319,-0.149484300839723
531,480,295,359,2209550,1830900,2025-04-07,2025-07-18,505.28,64,-378650,104857395,-33238059,1.74608571956227,77.1882860526909,-0.206810858047955
571.76,330,75,75,1813200,1813200,2025-04-07,2025-12-19,505.28,0,0,850516954,-173881469,0.213187990136173,97.2197951035788,0
527.22,500,419,654,1981870,1780188,2025-04-07,2025-05-16,505.28,235,-201682,191683614,-460736.000000003,0.928711621641274,66.1405961388019,-0.113292528654277
585.96,585,14573,18286,2564848,1755456,2025-04-07,2025-05-16,505.28,3713,-809392,191683614,-460736.000000003,0.915809110318632,67.0564052491206,-0.461072222829852
526,375,116,115,2071992,1736500,2025-04-07,2025-09-19,505.28,-1,-335492,264848567,-73847933,0.655657691362929,91.4353850364612,-0.193200115174201
558.91,225,52,52,1736332,1736332,2025-04-07,2025-12-19,505.28,0,0,850516954,-173881469,0.204150192636842,97.4239452962157,0
531.3,515,42,1063,145446,1732690,2025-04-07,2025-05-02,505.28,1021,1587244,15637149,-467056,11.0806004342607,11.0806004342607,0.916057690642873
528,450,197,221,2070273,1723800,2025-04-07,2025-09-19,505.28,24,-346473,264848567,-73847933,0.650862498342307,92.0862475348035,-0.200993734772015
571.7,345,76,76,1722920,1722920,2025-04-07,2025-12-19,505.28,0,0,850516954,-173881469,0.202573269338967,97.6265185655547,0
549.71,530,690,869,2297700,1712799,2025-04-07,2025-07-18,505.28,179,-584900.999999999,104857395,-33238059,1.63345560892486,78.8217416616158,-0.341488405819947
521.87,435,197,197,2175471,1711339,2025-04-07,2025-06-20,505.28,0,-464132.000000001,478977607,-137482950,0.35728998078192,95.1244820929593,-0.271209853804536
532,440,186,186,2455014,1711200,2025-04-07,2025-09-19,505.28,0,-743814.000000001,264848567,-73847933,0.646105062747045,92.7323525975506,-0.434673913043479
534.52,340,85,85,1950835,1653420,2025-04-07,2025-12-19,505.28,0,-297415,850516954,-173881469,0.194401768503723,97.8209203340584,-0.179878675714579
642.17,640,7237,7606,2540187,1650502,2025-04-07,2025-12-19,505.28,369,-889685,850516954,-173881469,0.194058683044195,98.0149790171026,-0.539039031761246
590.67,590,24455,24612,2934600,1649004,2025-04-07,2025-05-16,505.28,157,-1285596,191683614,-460736.000000003,0.860273846881873,67.9166790960024,-0.779619697708435
569.3,335,70,70,1640100,1640100,2025-04-07,2025-12-19,505.28,0,0,850516954,-173881469,0.192835662156595,98.2078146792592,0
561.3,545,936,1006,2583360,1639780,2025-04-07,2025-08-15,505.28,70,-943580,112162086,-42661174,1.46197352285335,37.5419364079944,-0.575430850479942
543.93,510,493,476,2499510,1615068,2025-04-07,2025-08-15,505.28,-17,-884442,112162086,-42661174,1.43994112235038,38.9818775303448,-0.547619047619048
562.1,170,41,41,1607610,1607610,2025-04-07,2025-06-20,505.28,0,0,478977607,-137482950,0.3356336447687,95.460115737728,0
540.67,502,407,412,2456245,1593204,2025-04-07,2025-08-15,505.28,5,-863041,112162086,-42661174,1.4204479042945,40.4023254346393,-0.541701502130298
559.11,325,68,68,1591948,1591948,2025-04-07,2025-12-19,505.28,0,0,850516954,-173881469,0.187174164196614,98.3949888434558,0
534.86,495,385,397,2355045,1582442,2025-04-07,2025-07-18,505.28,12,-772603,104857395,-33238059,1.50913724301467,80.3308789046304,-0.488234639879376
515.5,400,102,137,1518168,1582350,2025-04-07,2025-07-18,505.28,35,64182,104857395,-33238059,1.50904950480603,81.8399284094365,0.0405611906341833
570.69,560,1348,1479,2615120,1581051,2025-04-07,2025-08-15,505.28,131,-1034069,112162086,-42661174,1.40961269211773,41.811938126757,-0.654038990519597
524.46,515,18,1623,84168,1535358,2025-04-07,2025-04-11,505.28,1605,1451190,52569756,25897074,2.92061085465187,47.6722737689709,0.945180212041752
529,505,252,633,1182888,1519200,2025-04-07,2025-05-16,505.28,381,336312,191683614,-460736.000000003,0.792556008465074,68.7092351044675,0.221374407582938
519.12,380,111,109,1845597,1516408,2025-04-07,2025-06-20,505.28,-2,-329189,478977607,-137482950,0.316592671105812,95.7767084088338,-0.217084715986727
536,519,6,891,20358,1514700,2025-04-07,2025-05-16,505.28,885,1494342,191683614,-460736.000000003,0.790208389956588,69.4994434944241,0.986559714795009
549.15,355,77,77,1494955,1494955,2025-04-07,2025-12-19,505.28,0,0,850516954,-173881469,0.17577015872161,98.5707590021774,0
616.55,615,9626,9641,2464256,1494355,2025-04-07,2025-08-15,505.28,15,-969901,112162086,-42661174,1.33231741071577,43.1442555374728,-0.649043232699058
604,595,1634,1624,2400346,1461600,2025-04-07,2025-12-19,505.28,-10,-938746,850516954,-173881469,0.171848426198451,98.7426074283758,-0.642272851669403
588.59,585,3979,4034,2526665,1448206,2025-04-07,2025-07-18,505.28,55,-1078459,104857395,-33238059,1.38111956719886,83.2210479766353,-0.744686184147835
626.61,625,7789,8927,1939461,1437247,2025-04-07,2025-09-19,505.28,1138,-502214,264848567,-73847933,0.54266746325269,93.2750200608033,-0.349427760155353
513.63,180,42,42,1637874,1401246,2025-04-07,2025-06-20,505.28,0,-236628,478977607,-137482950,0.292549375904331,96.0692577847382,-0.168869705961694
546.98,511,373,374,2454340,1345652,2025-04-07,2025-08-15,505.28,1,-1108688,112162086,-42661174,1.19973874237681,44.3439942798496,-0.82390395139308
641,640,13173,13276,1791528,1327600,2025-04-07,2025-09-19,505.28,103,-463928,264848567,-73847933,0.501267579069061,93.7762876398723,-0.349448629105152
533.37,465,194,194,2104318,1326378,2025-04-07,2025-09-19,505.28,0,-777940,264848567,-73847933,0.500806183331171,94.2770938232035,-0.586514553166594
538.56,518,4,637,14032,1309672,2025-04-07,2025-05-16,505.28,633,1295640,191683614,-460736.000000003,0.683246717165923,70.18269021159,0.989285866995706
626.05,625,12230,12251,1871190,1286355,2025-04-07,2025-08-15,505.28,21,-584835,112162086,-42661174,1.14687150165877,45.4908657815084,-0.454645101857575
535.03,517,0,699,0,1260297,2025-04-07,2025-05-16,505.28,699,1260297,191683614,-460736.000000003,0.657488125197807,70.8401783367878,1
546.07,540,366,2074,554490,1258918,2025-04-07,2025-05-02,505.28,1708,704428,15637149,-467056,8.05081540119622,19.131415835457,0.559550344025584
540.44,493,265,265,1720115,1257160,2025-04-07,2025-08-15,505.28,0,-462955,112162086,-42661174,1.1208422068755,46.6117079883839,-0.368254637436762
555.88,540,675,785,1809675,1246580,2025-04-07,2025-07-18,505.28,110,-563095,104857395,-33238059,1.18883365355395,84.4098816301893,-0.451711883713841
558.19,545,1017,936,2435715,1234584,2025-04-07,2025-07-18,505.28,-81,-1201131,104857395,-33238059,1.17739335408819,85.5872749842775,-0.97290342333936
528.75,510,28,648,144256,1215000,2025-04-07,2025-05-02,505.28,620,1070744,15637149,-467056,7.76995857748749,26.9013744129445,0.881270781893004
550.86,550,4697,14122,2038498,1214492,2025-04-07,2025-04-11,505.28,9425,-824006,52569756,25897074,2.31024850105829,49.9825222700292,-0.678477915045962
592.92,590,2231,4122,1135579,1203624,2025-04-07,2025-07-18,505.28,1891,68045,104857395,-33238059,1.14786753952833,86.7351425238058,0.0565334356908802
534.7,516,2,641,7216,1198670,2025-04-07,2025-05-16,505.28,639,1191454,191683614,-460736.000000003,0.625337750570584,71.4655160873584,0.993979994493897
529.21,523,1,1914,2638,1188594,2025-04-07,2025-04-11,505.28,1913,1185956,52569756,25897074,2.26098443371128,52.2435067037405,0.997780570993964
533.05,512,1,560,4541,1178800,2025-04-07,2025-05-16,505.28,559,1174259,191683614,-460736.000000003,0.61497171062311,72.0804877979815,0.996147777400747
600.38,600,31118,30970,1587018,1176860,2025-04-07,2025-05-16,505.28,-148,-410158,191683614,-460736.000000003,0.613959626199452,72.694447424181,-0.348518940230784
587.93,574,843,843,1174299,1174299,2025-04-07,2025-08-15,505.28,0,0,112162086,-42661174,1.04696608442179,47.6586740728057,0
582.02,575,1654,1661,2089002,1166022,2025-04-07,2025-08-15,505.28,7,-922980,112162086,-42661174,1.03958658543494,48.6982606582406,-0.791563109443904
612.08,610,5723,5556,1797022,1155648,2025-04-07,2025-08-15,505.28,-167,-641374,112162086,-42661174,1.03033747072072,49.7285981289613,-0.554990793044249
562.82,560,799,4041,558501,1139562,2025-04-07,2025-05-09,505.28,3242,581061,21122544,7108655,5.3950035563898,58.3846008321725,0.509898539965355
531.7,485,229,241,1919020,1125470,2025-04-07,2025-07-18,505.28,12,-793550,104857395,-33238059,1.0733339312883,87.8084764550941,-0.705083209681289
552.84,546,1392,1642,2012832,1123128,2025-04-07,2025-05-16,505.28,250,-889704,191683614,-460736.000000003,0.585928017822118,73.2803754420031,-0.792166164497724
740.55,740,20038,20018,360684,1100990,2025-04-07,2025-12-19,505.28,-20,740306,850516954,-173881469,0.129449506540936,98.8720569349168,0.672400294280602
540.44,527,5,819,14240,1100736,2025-04-07,2025-05-16,505.28,814,1086496,191683614,-460736.000000003,0.574246268123889,73.854621710127,0.987063201348916
528,521,1,1567,3943,1096900,2025-04-07,2025-04-11,505.28,1566,1092957,52569756,25897074,2.0865609496076,54.3300676533481,0.996405324095177
524,514,0,1096,0,1096000,2025-04-07,2025-04-11,505.28,1096,1096000,52569756,25897074,2.08484893861786,56.4149165919659,1
620.54,620,20880,20255,1211040,1093770,2025-04-07,2025-06-20,505.28,-625,-117270,478977607,-137482950,0.228355143124676,96.2976129278628,-0.107216325187197
532.1,520,226,898,689978,1086580,2025-04-07,2025-04-25,505.28,672,396602,13056472,-3270620,8.32215624557691,8.32215624557691,0.365000276095639
559.04,541,598,599,1863368,1080596,2025-04-07,2025-08-15,505.28,1,-782772,112162086,-42661174,0.963423593958479,50.6920217229198,-0.724389133404158
625.44,625,24670,24387,1036140,1073028,2025-04-07,2025-06-20,505.28,-283,36888,478977607,-137482950,0.224024669278537,96.5216375971414,0.0343774812959215
562.44,543,556,551,1610732,1071144,2025-04-07,2025-08-15,505.28,-5,-539588,112162086,-42661174,0.954996503898831,51.6470182268187,-0.503749262470779
586.28,573,798,798,1059744,1059744,2025-04-07,2025-08-15,505.28,0,0,112162086,-42661174,0.944832641575514,52.5918508683942,0
563.95,410,68,68,1046860,1046860,2025-04-07,2025-08-15,505.28,0,0,112162086,-42661174,0.933345694016425,53.5251965624106,0
538.21,521,0,606,0,1042926,2025-04-07,2025-05-16,505.28,606,1042926,191683614,-460736.000000003,0.544087195684864,74.3987089058119,1
549.02,350,52,52,1034904,1034904,2025-04-07,2025-09-19,505.28,0,0,264848567,-73847933,0.390753105339626,94.6678469285431,0
527.2,510,88,598,332904,1028560,2025-04-07,2025-04-25,505.28,510,695656,13056472,-3270620,7.87777892833531,16.1999351739122,0.67633973710819
590.14,585,2046,1996,1816848,1025944,2025-04-07,2025-08-15,505.28,-50,-790904.000000001,112162086,-42661174,0.914697681353751,54.4398942437643,-0.770903675054389
550.48,400,68,68,1023264,1023264,2025-04-07,2025-08-15,505.28,0,0,112162086,-42661174,0.912308282140901,55.3522025259052,0
568.88,315,40,40,1015520,1015520,2025-04-07,2025-05-16,505.28,0,0,191683614,-460736.000000003,0.529789677275179,74.928498583087,0
566.2,552,696,708,1682232,1005360,2025-04-07,2025-08-15,505.28,12,-676872,112162086,-42661174,0.896345668892071,56.2485481947973,-0.673263308665553
520.74,425,106,105,1267548,1005270,2025-04-07,2025-06-20,505.28,-1,-262278,478977607,-137482950,0.209878287692059,96.7315158848334,-0.260903040974067
576.7,567,1046,1033,1768786,1002010,2025-04-07,2025-08-15,505.28,-13,-766776,112162086,-42661174,0.893358919876009,57.1419071146733,-0.765237871877526
553.97,548,1691,1675,2284541,999975,2025-04-07,2025-05-16,505.28,-16,-1284566,191683614,-460736.000000003,0.521679959560863,75.4501785426479,-1.28459811495287
575.17,565,953,983,1609617,999711,2025-04-07,2025-08-15,505.28,30,-609906,112162086,-42661174,0.891309207640807,58.0332163223141,-0.610082313788685
521,508,0,768,0,998400,2025-04-07,2025-04-11,505.28,768,998400,52569756,25897074,1.89919085795262,58.3141074499186,1
615.63,615,15788,15671,1247252,987273,2025-04-07,2025-06-20,505.28,-117,-259979,478977607,-137482950,0.206120909531372,96.9376367943648,-0.263330406078157
621.39,620,6922,7060,1405166,981340,2025-04-07,2025-08-15,505.28,138,-423826,112162086,-42661174,0.874930232663469,58.9081465549776,-0.431884973607516
562.1,544,545,542,1664975,981020,2025-04-07,2025-08-15,505.28,-3,-683955,112162086,-42661174,0.87464493126492,59.7827914862425,-0.697187621047481
583.42,576,1319,1320,1709424,979440,2025-04-07,2025-08-15,505.28,1,-729984,112162086,-42661174,0.873236255609583,60.6560277418521,-0.745307522666014
552.03,522,294,324,1777230,972972,2025-04-07,2025-08-15,505.28,30,-804258,112162086,-42661174,0.867469601091406,61.5234973429435,-0.826599326599326
533.68,520,42,704,118314,963072,2025-04-07,2025-05-02,505.28,662,844758,15637149,-467056,6.15887205525764,33.0602464682021,0.877149372009569
537.52,522,13,617,42978,957584,2025-04-07,2025-05-16,505.28,604,914606,191683614,-460736.000000003,0.499564871517917,75.9497434141658,0.955118297715918
569,566,3134,3170,1886668,951000,2025-04-07,2025-05-16,505.28,36,-935668,191683614,-460736.000000003,0.4961300447935,76.4458734589593,-0.983878023133544
576.55,150,22,22,938410,938410,2025-04-07,2025-09-19,505.28,0,0,264848567,-73847933,0.354319455313496,95.0221663838566,0
572.87,570,3051,3262,1977048,936194,2025-04-07,2025-05-30,505.28,211,-1040854,25903649,-10875774,3.61413945965682,3.61413945965682,-1.11179306853067
564.82,550,491,631,1213261,935142,2025-04-07,2025-08-15,505.28,140,-278119,112162086,-42661174,0.833741626381663,62.3572389693252,-0.297408308043057
670.93,670,10080,10022,1209600,932046,2025-04-07,2025-12-19,505.28,-58,-277554,850516954,-173881469,0.10958582255375,98.9816427574705,-0.297790023239196
549.78,365,50,50,923900,923900,2025-04-07,2025-12-19,505.28,0,0,850516954,-173881469,0.108628052110529,99.0902708095811,0
557.14,550,939,1291,1403805,921774,2025-04-07,2025-05-30,505.28,352,-482031,25903649,-10875774,3.55847162691249,7.17261108656931,-0.522938377519869
551.28,525,267,346,1416435,909288,2025-04-07,2025-08-15,505.28,79,-507147,112162086,-42661174,0.810691056512626,63.1679300258378,-0.557740781798506
551.02,544,1234,1291,1933678,906282,2025-04-07,2025-05-16,505.28,57,-1027396,191683614,-460736.000000003,0.472800977135166,76.9186744360945,-1.13363831566775
565.04,562,1867,2973,1400250,903792,2025-04-07,2025-05-16,505.28,1106,-496458,191683614,-460736.000000003,0.47150196156047,77.3901763976549,-0.549305592437198
580.03,572,1101,1100,1585440,883300,2025-04-07,2025-08-15,505.28,-1,-702140,112162086,-42661174,0.787521016682946,63.9554510425207,-0.794905468130873
531.97,475,139,155,1084756,883035,2025-04-07,2025-07-18,505.28,16,-201721,104857395,-33238059,0.842129446378102,88.6506059014722,-0.22844054878912
528.05,485,203,205,1630699,882525,2025-04-07,2025-05-16,505.28,2,-748174,191683614,-460736.000000003,0.460407116489363,77.8505835141443,-0.847765219115606
527.48,495,269,270,1398800,876960,2025-04-07,2025-05-16,505.28,1,-521840,191683614,-460736.000000003,0.457503894933867,78.3080874090782,-0.595055646779785
538.11,530,192,1080,376320,875880,2025-04-07,2025-04-25,505.28,888,499560,13056472,-3270620,6.70839718417042,22.9083323580826,0.570352103027812
532.55,511,0,406,0,874930,2025-04-07,2025-05-16,505.28,406,874930,191683614,-460736.000000003,0.456444858140039,78.7645322672182,1
526.8,400,64,69,1109952,874920,2025-04-07,2025-09-19,505.28,5,-235032,264848567,-73847933,0.330347265952925,95.3525136498096,-0.268632560691263
547.62,520,223,316,974510,872792,2025-04-07,2025-08-15,505.28,93,-101718,112162086,-42661174,0.778152432008085,64.7336034745288,-0.116543231377006
538.05,535,388,2853,448916,870165,2025-04-07,2025-04-11,505.28,2465,421249,52569756,25897074,1.65525782543103,59.9693652753496,0.484102440341774
561.72,558,2065,2327,1825460,865644,2025-04-07,2025-05-16,505.28,262,-959816,191683614,-460736.000000003,0.451600416924527,79.2161326841427,-1.10878837027693
637.77,635,3094,3083,1339702,853991,2025-04-07,2025-12-19,505.28,-11,-485711,850516954,-173881469,0.100408462874686,99.1906792724558,-0.568754237456835
538.8,520,113,443,383070,832840,2025-04-07,2025-05-30,505.28,330,449770,25903649,-10875774,3.21514548008275,10.3877565666521,0.540043705873877
700.42,700,19648,19783,943104,830886,2025-04-07,2025-12-19,505.28,135,-112218,850516954,-173881469,0.0976918797552859,99.2883711522111,-0.135058239036402
518.14,460,132,142,1104312,825588,2025-04-07,2025-05-16,505.28,10,-278724,191683614,-460736.000000003,0.430703482040984,79.6468361661837,-0.337606651259466
533.64,514,11,420,41503,824880,2025-04-07,2025-05-16,505.28,409,783377,191683614,-460736.000000003,0.430334123395649,80.0771702895794,0.949686014935506
537.94,475,127,131,1047496,824514,2025-04-07,2025-09-19,505.28,4,-222982,264848567,-73847933,0.311315258126354,95.6638289079359,-0.270440526176633
526.28,450,106,108,1070600,823824,2025-04-07,2025-08-15,505.28,2,-246776,112162086,-42661174,0.734494185495088,65.4680976600239,-0.29954941832236
572.11,215,23,23,821353,821353,2025-04-07,2025-12-19,505.28,0,0,850516954,-173881469,0.0965710320220142,99.3849421842331,0
636.29,635,6355,6359,1073995,820311,2025-04-07,2025-09-19,505.28,4,-253684,264848567,-73847933,0.309728313538506,95.9735572214744,-0.309253441682484
533.49,513,13,400,51012,819600,2025-04-07,2025-05-16,505.28,387,768588,191683614,-460736.000000003,0.427579584345692,80.5047498739251,0.937759882869693
554.05,430,66,66,818730,818730,2025-04-07,2025-08-15,505.28,0,0,112162086,-42661174,0.729952543856932,66.1980502038808,0
574.23,563,728,728,1379560,817544,2025-04-07,2025-08-15,505.28,0,-562016,112162086,-42661174,0.728895145548559,66.9269453494294,-0.687444345503117
564.75,547,447,458,1233273,812950,2025-04-07,2025-08-15,505.28,11,-420323,112162086,-42661174,0.724799287345637,67.651744636775,-0.517034257949443
607.35,605,3120,3432,1229280,806520,2025-04-07,2025-08-15,505.28,312,-422760,112162086,-42661174,0.719066512368538,68.3708111491436,-0.524177949709864
550.02,542,606,1002,1030200,803604,2025-04-07,2025-05-16,505.28,396,-226596,191683614,-460736.000000003,0.419234583087525,80.9239844570126,-0.281974703958666
528.61,522,2,1209,4206,799149,2025-04-07,2025-04-11,505.28,1207,794943,52569756,25897074,1.52016874493387,61.4895340202835,0.994736901378842
612.13,280,24,24,797112,797112,2025-04-07,2025-06-20,505.28,0,0,478977607,-137482950,0.166419471046378,97.1040562654112,0
553.12,530,281,344,1041105,795328,2025-04-07,2025-08-15,505.28,63,-245777,112162086,-42661174,0.709088095954278,69.0798992450979,-0.309025961615836
525,516,11,883,28270,794700,2025-04-07,2025-04-11,505.28,872,766430,52569756,25897074,1.51170570394125,63.0012397242247,0.964426827733736
560.88,555,1248,1334,1563744,784392,2025-04-07,2025-05-30,505.28,86,-779352,25903649,-10875774,3.02811391553368,13.4158704821857,-0.993574641250803
565.04,420,54,54,783216,783216,2025-04-07,2025-08-15,505.28,0,0,112162086,-42661174,0.698289438019189,69.778188683117,0
564.84,560,987,1617,1006740,782628,2025-04-07,2025-05-30,505.28,630,-224112,25903649,-10875774,3.02130406414942,16.4371745463352,-0.286358269829344
509.55,250,30,30,883680,778650,2025-04-07,2025-06-20,505.28,0,-105030,478977607,-137482950,0.162565011102909,97.2666212765141,-0.134887304950876
545.15,507,203,203,1414301,774445,2025-04-07,2025-08-15,505.28,0,-639856,112162086,-42661174,0.690469504998329,70.4686581881154,-0.826212319790301
553.7,550,1096,2090,1072984,773300,2025-04-07,2025-05-02,505.28,994,-299684,15637149,-467056,4.94527487075809,38.0055213389602,-0.387539118065434
535.7,532,57,2075,78774,767750,2025-04-07,2025-04-11,505.28,2018,688976,52569756,25897074,1.46044048597068,64.4616802101954,0.897396287854119
557.82,553,1298,1585,1420012,763970,2025-04-07,2025-05-16,505.28,287,-656042,191683614,-460736.000000003,0.398557802650779,81.3225422596634,-0.858727436941241
550.33,543,843,1023,1377462,749859,2025-04-07,2025-05-16,505.28,180,-627603,191683614,-460736.000000003,0.391196192701166,81.7137384523645,-0.836961348733562
567.51,440,58,58,739558,739558,2025-04-07,2025-08-15,505.28,0,0,112162086,-42661174,0.659365411588369,71.1280235997037,0
541.65,525,156,444,474552,739260,2025-04-07,2025-05-30,505.28,288,264708,25903649,-10875774,2.85388363623982,19.291058182575,0.358071585098612
534.56,510,17,299,80750,734344,2025-04-07,2025-05-30,505.28,282,653594,25903649,-10875774,2.83490561503516,22.1259637976101,0.890037911387579
601.73,195,18,18,732114,732114,2025-04-07,2025-06-20,505.28,0,0,478977607,-137482950,0.152849316815765,97.4194705933299,0
650.64,650,11153,11353,981464,726592,2025-04-07,2025-09-19,505.28,200,-254872,264848567,-73847933,0.274342432066095,96.2478996535405,-0.350777327578614
526.69,519,0,943,0,725167,2025-04-07,2025-04-11,505.28,943,725167,52569756,25897074,1.3794376371083,65.8411178473037,1
546.35,545,3077,5334,1907740,720090,2025-04-07,2025-04-11,505.28,2257,-1187650,52569756,25897074,1.36977999289173,67.2108978401954,-1.64930772542321
523.23,513,2,700,5632,716100,2025-04-07,2025-04-11,505.28,698,710468,52569756,25897074,1.36219007750388,68.5730879176993,0.992135176651306
545.1,535,197,706,416852,713060,2025-04-07,2025-05-16,505.28,509,296208,191683614,-460736.000000003,0.371998411924767,82.0857368642893,0.415404033321179
532.85,515,14,399,50428,712215,2025-04-07,2025-05-09,505.28,385,661787,21122544,7108655,3.37182396211365,61.7564247942862,0.929195537864268
585.14,578,832,992,943488,708288,2025-04-07,2025-08-15,505.28,160,-235200,112162086,-42661174,0.631486115548885,71.7595097152526,-0.332068311195446
566.77,564,2775,2549,1845375,706073,2025-04-07,2025-05-16,505.28,-226,-1139302,191683614,-460736.000000003,0.36835334292059,82.4540902072099,-1.613575366853
519.93,506,1,506,4310,704858,2025-04-07,2025-04-11,505.28,505,700548,52569756,25897074,1.34080515800758,69.9138930757069,0.993885293207994
577.5,569,819,827,1220310,702950,2025-04-07,2025-08-15,505.28,8,-517360,112162086,-42661174,0.626726931594336,72.386236646847,-0.735984067145601
557.26,535,277,314,930720,698964,2025-04-07,2025-08-15,505.28,37,-231756,112162086,-42661174,0.623173146048657,73.0094097928956,-0.331570724672515
536.69,515,15,320,59265,694080,2025-04-07,2025-05-30,505.28,305,634815,25903649,-10875774,2.67946805486748,24.8054318524776,0.914613589211618
563.85,325,29,29,692665,692665,2025-04-07,2025-06-20,505.28,0,0,478977607,-137482950,0.144613232409422,97.5640838257393,0
625.67,625,10268,10236,934388,685812,2025-04-07,2025-07-18,505.28,-32,-248576,104857395,-33238059,0.654042568957583,89.3046484704298,-0.362455016826769
603.07,350,27,27,683289,683289,2025-04-07,2025-08-15,505.28,0,0,112162086,-42661174,0.609197835354096,73.6186076282497,0
518.35,501,8,393,47176,681855,2025-04-07,2025-04-11,505.28,385,634679,52569756,25897074,1.29704805934424,71.2109411350511,0.930812269470782
530.47,508,10,302,54050,678594,2025-04-07,2025-05-16,505.28,292,624544,191683614,-460736.000000003,0.354017740921767,82.8081079481317,0.920350017830986
565.96,190,18,18,676728,676728,2025-04-07,2025-06-20,505.28,0,0,478977607,-137482950,0.141285936985359,97.7053697627246,0
548.93,541,575,853,1004525,676429,2025-04-07,2025-05-16,505.28,278,-328096,191683614,-460736.000000003,0.352888275572684,83.1609962237043,-0.485041297756306
547.25,539,320,817,589120,674025,2025-04-07,2025-05-16,505.28,497,84905,191683614,-460736.000000003,0.35163412559615,83.5126303493005,0.125967137717444
584.37,577,913,913,1146728,672881,2025-04-07,2025-08-15,505.28,0,-473847,112162086,-42661174,0.599918407366283,74.218526035616,-0.704206241519674
548.37,518,215,221,1255170,671177,2025-04-07,2025-08-15,505.28,6,-583993,112162086,-42661174,0.598399177419008,74.816925213035,-0.870102819375515
586.39,571,436,436,671004,671004,2025-04-07,2025-08-15,505.28,0,0,112162086,-42661174,0.598244936350417,75.4151701493854,0
612.15,170,15,15,663225,663225,2025-04-07,2025-09-19,505.28,0,0,264848567,-73847933,0.250416684338715,96.4983163378792,0
529.6,515,41,454,179539,662840,2025-04-07,2025-04-25,505.28,413,483301,13056472,-3270620,5.07671597656702,27.9850483346497,0.729136744915817
655.59,655,11199,11227,795129,662393,2025-04-07,2025-09-19,505.28,28,-132736,264848567,-73847933,0.250102542559726,96.748418880439,-0.20038859106301
523.42,500,186,281,851694,658102,2025-04-07,2025-04-25,505.28,95,-193592,13056472,-3270620,5.04042746003668,33.0254757946863,-0.294167165576157
585.5,175,16,16,656800,656800,2025-04-07,2025-06-20,505.28,0,0,478977607,-137482950,0.137125408453594,97.8424951711782,0
558.63,435,52,52,642876,642876,2025-04-07,2025-05-16,505.28,0,0,191683614,-460736.000000003,0.335383910280406,83.8480142595809,0
635.35,635,18071,18171,415633,635985,2025-04-07,2025-06-20,505.28,100,220352,478977607,-137482950,0.132779693811448,97.9752748649897,0.346473580351738
522.92,512,0,581,0,634452,2025-04-07,2025-04-11,505.28,581,634452,52569756,25897074,1.20687644051458,72.4178175755657,1
558.01,536,251,287,855408,631687,2025-04-07,2025-08-15,505.28,36,-223721,112162086,-42661174,0.563191201704291,75.9783613510897,-0.354164325053389
661.25,660,4686,4998,796620,624750,2025-04-07,2025-12-19,505.28,312,-171870,850516954,-173881469,0.0734553258535044,99.4583975100866,-0.275102040816327
587,225,17,17,615400,615400,2025-04-07,2025-06-20,505.28,0,0,478977607,-137482950,0.128481998115624,98.1037568631053,0
565.93,563,1591,2086,1086653,611198,2025-04-07,2025-05-16,505.28,495,-475455,191683614,-460736.000000003,0.318857719366664,84.1668719789476,-0.777906668542764
531.54,509,0,271,0,610834,2025-04-07,2025-05-16,505.28,271,610834,191683614,-460736.000000003,0.318667823113978,84.4855398020616,1
538.04,523,21,403,61971,606112,2025-04-07,2025-05-16,505.28,382,544141,191683614,-460736.000000003,0.316204388759073,84.8017441908206,0.897756520247083
567.23,455,54,54,606042,606042,2025-04-07,2025-08-15,505.28,0,0,112162086,-42661174,0.540326969311181,76.5186883204009,0
517.8,500,25,339,100450,603420,2025-04-07,2025-04-11,505.28,314,502970,52569756,25897074,1.14784630158831,73.565663877154,0.833532199794505
620.84,620,6988,7183,817596,603372,2025-04-07,2025-07-18,505.28,195,-214224,104857395,-33238059,0.575421504606327,89.8800699750361,-0.355044649072214
645.88,645,6810,6818,653760,599984,2025-04-07,2025-09-19,505.28,8,-53776,264848567,-73847933,0.226538510967288,96.9749573914062,-0.0896290567748473
530.49,500,211,196,1044450,597604,2025-04-07,2025-05-30,505.28,-15,-446846,25903649,-10875774,2.30702631895607,27.1124581714337,-0.747729265533698
606.51,605,4343,3955,1085750,597205,2025-04-07,2025-07-18,505.28,-388,-488545,104857395,-33238059,0.569540183598877,90.449610158635,-0.818052427558376
544.03,535,149,659,294126,595077,2025-04-07,2025-05-09,505.28,510,300951,21122544,7108655,2.81726008003581,64.573684874322,0.505734551999153
579.89,415,36,36,593604,593604,2025-04-07,2025-06-20,505.28,0,0,478977607,-137482950,0.123931472228513,98.2276883353338,0
552.73,550,1419,2144,1146552,585312,2025-04-07,2025-04-25,505.28,725,-561240,13056472,-3270620,4.48292616872307,37.5084019634094,-0.958873216335903
645.55,645,10625,10624,637500,584320,2025-04-07,2025-08-15,505.28,-1,-53179.9999999999,112162086,-42661174,0.52096035375091,77.0396486741518,-0.0910117743702079
635.75,635,7761,7784,760578,583800,2025-04-07,2025-08-15,505.28,23,-176778,112162086,-42661174,0.520496738978268,77.5601454131301,-0.302805755395683
592.16,230,16,16,579456,579456,2025-04-07,2025-06-20,505.28,0,0,478977607,-137482950,0.120977680695624,98.3486660160294,0
564.36,561,1619,1717,1269296,576912,2025-04-07,2025-05-16,505.28,98,-692384,191683614,-460736.000000003,0.300970953104004,85.1027151439246,-1.20015530964861
655.42,655,13714,13725,548560,576450,2025-04-07,2025-08-15,505.28,11,27890,112162086,-42661174,0.51394372248034,78.0740891356104,0.0483823401856189
569.41,567,2779,2361,1586809,569001,2025-04-07,2025-05-16,505.28,-418,-1017808,191683614,-460736.000000003,0.296843839766085,85.3995589836907,-1.78876311289435
545.5,515,90,186,444690,567300,2025-04-07,2025-08-15,505.28,96,122610,112162086,-42661174,0.505785885615573,78.579875021226,0.216129032258065
577.4,575,1959,2360,981459,566400,2025-04-07,2025-05-30,505.28,401,-415059,25903649,-10875774,2.1865645261021,29.2990226975358,-0.732801906779661
522.43,511,0,494,0,564642,2025-04-07,2025-04-11,505.28,494,564642,52569756,25897074,1.07408145474367,74.6397453318977,1
584.9,579,942,941,1078590,555190,2025-04-07,2025-08-15,505.28,-1,-523400,112162086,-42661174,0.494989010814225,79.0748640320402,-0.942740323132621
534.8,525,38,565,91998,553700,2025-04-07,2025-04-25,505.28,527,461702,13056472,-3270620,4.24080869625424,41.7492106596637,0.83384865450605
547.15,538,406,595,784798,544425,2025-04-07,2025-05-16,505.28,189,-240373,191683614,-460736.000000003,0.284022712551736,85.6835816962424,-0.441517197042752
562.44,315,22,22,544368,544368,2025-04-07,2025-06-20,505.28,0,0,478977607,-137482950,0.113652077267153,98.4623180932966,0
597.15,240,15,15,535725,535725,2025-04-07,2025-06-20,505.28,0,0,478977607,-137482950,0.111847608775581,98.5741657020722,0
566.42,553,401,399,997688,535458,2025-04-07,2025-08-15,505.28,-2,-462230,112162086,-42661174,0.477396613326182,79.5522606453664,-0.863242308453697
600.72,600,6287,7431,628700,535032,2025-04-07,2025-05-30,505.28,1144,-93668,25903649,-10875774,2.06546961781331,31.3644923153491,-0.17506990236098
630.34,630,15666,15693,485646,533562,2025-04-07,2025-06-20,505.28,27,47916.0000000001,478977607,-137482950,0.111396021902126,98.6855617239743,0.0898039965364852
539.5,530,247,561,529074,532950,2025-04-07,2025-05-02,505.28,314,3875.99999999988,15637149,-467056,3.40822997849544,41.4137513174556,0.00727272727272705
540.9,528,17,411,47192,530190,2025-04-07,2025-05-16,505.28,394,482998,191683614,-460736.000000003,0.276596412669891,85.9601781089123,0.910990399668044
570.87,557,383,381,796257,528447,2025-04-07,2025-08-15,505.28,-2,-267810,112162086,-42661174,0.471145837997343,80.0234064833637,-0.506786867935668
525.82,517,10,598,24840,527436,2025-04-07,2025-04-11,505.28,588,502596,52569756,25897074,1.00330692042778,75.6430522523255,0.952904238618524
570.09,360,25,25,525225,525225,2025-04-07,2025-07-18,505.28,0,0,104857395,-33238059,0.500894572099564,90.9505047307345,0
544.49,530,186,360,502758,521640,2025-04-07,2025-05-30,505.28,174,18881.9999999999,25903649,-10875774,2.01377033791648,33.3782626532656,0.0361973775017252
530.85,507,0,218,0,519930,2025-04-07,2025-05-16,505.28,218,519930,191683614,-460736.000000003,0.271243842470541,86.2314219513829,1
547.35,260,18,18,517230,517230,2025-04-07,2025-06-20,505.28,0,0,478977607,-137482950,0.107986259157205,98.7935479831315,0
548.52,514,149,149,749023,514348,2025-04-07,2025-08-15,505.28,0,-234675,112162086,-42661174,0.458575636690637,80.4819821200544,-0.456257242178447
560.9,557,960,1308,891840,510120,2025-04-07,2025-05-16,505.28,348,-381720,191683614,-460736.000000003,0.26612603412204,86.4975479855049,-0.748294518936721
630.88,630,5709,5760,719334,506880,2025-04-07,2025-08-15,505.28,51,-212454,112162086,-42661174,0.451917415301994,80.9338995353564,-0.419140625
566.06,355,24,24,506544,506544,2025-04-07,2025-09-19,505.28,0,0,264848567,-73847933,0.191257972711629,97.1662153641179,0
559.39,330,22,22,504658,504658,2025-04-07,2025-05-16,505.28,0,0,191683614,-460736.000000003,0.263276546945739,86.7608245324506,0
554.8,549,914,869,1190942,504020,2025-04-07,2025-05-16,505.28,-45,-686922,191683614,-460736.000000003,0.262943706810536,87.0237682392612,-1.36288639339709
562.38,546,307,306,873722,501228,2025-04-07,2025-08-15,505.28,-1,-372494,112162086,-42661174,0.446878279350118,81.3807778147065,-0.7431627921824
568.43,330,21,21,500703,500703,2025-04-07,2025-07-18,505.28,0,0,104857395,-33238059,0.477508524792171,91.4280132555267,0
529.66,504,0,195,0,500370,2025-04-07,2025-05-16,505.28,195,500370,191683614,-460736.000000003,0.261039527353653,87.2848077666148,1
647.11,645,2361,2370,703578,500070,2025-04-07,2025-12-19,505.28,9,-203508,850516954,-173881469,0.0587960060817318,99.5171935161683,-0.406959025736397
558.83,528,161,162,900956,499446,2025-04-07,2025-08-15,505.28,1,-401510,112162086,-42661174,0.445289507186947,81.8260673218934,-0.803910733092266
558.7,554,1113,1056,1161972,496320,2025-04-07,2025-05-16,505.28,-57,-665652,191683614,-460736.000000003,0.258926670696015,87.5437344373109,-1.3411750483559
560.33,560,6209,15038,993440,496254,2025-04-07,2025-04-11,505.28,8829,-497186,52569756,25897074,0.943991446336559,76.587043698662,-1.00187807050422
547.11,537,219,478,439314,483258,2025-04-07,2025-05-16,505.28,259,43944.0000000001,191683614,-460736.000000003,0.252112316705381,87.7958467540162,0.0909327936630124
562.71,559,1133,1298,989109,481558,2025-04-07,2025-05-16,505.28,165,-507551,191683614,-460736.000000003,0.251225438602175,88.0470721926184,-1.05397688336607
530.51,360,29,28,602707,477428,2025-04-07,2025-09-19,505.28,-1,-125279,264848567,-73847933,0.180264520744037,97.3464798848619,-0.262403964576858
534.64,520,68,326,207536,477264,2025-04-07,2025-05-09,505.28,258,269728,21122544,7108655,2.2595005601598,66.8331854344818,0.565154715210031
630.58,630,8164,8187,563316,474846,2025-04-07,2025-07-18,505.28,23,-88470,104857395,-33238059,0.452849319783311,91.88086257531,-0.186313036226482
544.91,503,110,113,799920,473583,2025-04-07,2025-08-15,505.28,3,-326337,112162086,-42661174,0.422230913216076,82.2482982351095,-0.689080900285694
576.06,566,468,469,820404,471814,2025-04-07,2025-08-15,505.28,1,-348590,112162086,-42661174,0.42065373142222,82.6689519665317,-0.738829284421403
569.67,554,300,301,729600,471667,2025-04-07,2025-08-15,505.28,1,-257933,112162086,-42661174,0.420522671092262,83.089474637624,-0.546854030491851
565,330,20,20,470000,470000,2025-04-07,2025-06-20,505.28,0,0,478977607,-137482950,0.0981256729189847,98.8916736560505,0
571.43,425,32,32,468576,468576,2025-04-07,2025-09-19,505.28,0,0,264848567,-73847933,0.176922233451239,97.5234021183132,0
541.46,490,49,91,337708,468286,2025-04-07,2025-08-15,505.28,42,130578,112162086,-42661174,0.417508283503215,83.5069829211272,0.278842416813657
563.6,330,20,20,467200,467200,2025-04-07,2025-09-19,505.28,0,0,264848567,-73847933,0.176402691278296,97.6998048095914,0
574.82,573,2529,2566,1016658,467012,2025-04-07,2025-05-16,505.28,37,-549646,191683614,-460736.000000003,0.243636892196743,88.2907090848152,-1.17694192012197
578.51,220,13,13,466063,466063,2025-04-07,2025-12-19,505.28,0,0,850516954,-173881469,0.0547976142989385,99.5719911304672,0
610.2,610,23412,23240,515064,464800,2025-04-07,2025-05-16,505.28,-172,-50264.0000000001,191683614,-460736.000000003,0.242482907276571,88.5331919920917,-0.108141135972461
595.54,595,8637,8576,699597,463104,2025-04-07,2025-05-16,505.28,-61,-236493,191683614,-460736.000000003,0.241598115945372,88.7747901080371,-0.510669309701493
569.25,556,279,348,646722,461100,2025-04-07,2025-08-15,505.28,69,-185622,112162086,-42661174,0.411101483972044,83.9180844050993,-0.4025634352635
550.3,540,333,447,682650,460410,2025-04-07,2025-05-30,505.28,114,-222240,25903649,-10875774,1.77739437405132,35.1556570273169,-0.482700201993875
552.36,455,47,47,457592,457592,2025-04-07,2025-07-18,505.28,0,0,104857395,-33238059,0.436394590958511,92.3172571662685,0
519.88,505,47,307,164970,456816,2025-04-07,2025-04-11,505.28,260,291846,52569756,25897074,0.868971124766111,77.4560148234281,0.638869916990648
650.15,650,31701,30422,380412,456330,2025-04-07,2025-06-20,505.28,-1279,75918,478977607,-137482950,0.0952716772832347,98.9869453333337,0.166366445335612
544.7,540,345,970,453330,455900,2025-04-07,2025-04-25,505.28,625,2570,13056472,-3270620,3.491754893665,45.2409655533287,0.00563720114060101
567.25,340,20,20,454500,454500,2025-04-07,2025-05-16,505.28,0,0,191683614,-460736.000000003,0.237109469357146,89.0118995773942,0
591.19,590,3952,3807,806208,453033,2025-04-07,2025-05-30,505.28,-145,-353175,25903649,-10875774,1.74891576086442,36.9045727881813,-0.779578971068333
565.41,340,20,20,450820,450820,2025-04-07,2025-08-15,505.28,0,0,112162086,-42661174,0.40193617654365,84.3200205816429,0
557.68,555,1393,1678,1032213,449704,2025-04-07,2025-05-02,505.28,285,-582509,15637149,-467056,2.87586950792629,44.2896208253819,-1.29531647483678
640.15,640,29961,29898,539298,448470,2025-04-07,2025-06-20,505.28,-63,-90828,478977607,-137482950,0.0936306819871853,99.0805760153209,-0.202528597230584
520.19,475,108,99,790884,447381,2025-04-07,2025-05-16,505.28,-9,-343503,191683614,-460736.000000003,0.23339553687672,89.245295114271,-0.767808646321592
547.15,535,209,368,496584,447120,2025-04-07,2025-05-30,505.28,159,-49464,25903649,-10875774,1.72608886107127,38.6306616492526,-0.110628019323672
581.87,580,2299,2390,852929,446930,2025-04-07,2025-05-30,505.28,91,-405999,25903649,-10875774,1.72535537367728,40.3560170229299,-0.908417425547625
557.12,552,657,864,747666,442368,2025-04-07,2025-05-16,505.28,207,-305298,191683614,-460736.000000003,0.230780289858266,89.4760754041292,-0.690144856770834
623.26,623,16881,16843,303858,437918,2025-04-07,2025-05-30,505.28,-38,134060,25903649,-10875774,1.69056490844205,42.0465819313719,0.306130371439402
583.13,582,3924,3855,859356,435615,2025-04-07,2025-05-16,505.28,-69,-423741,191683614,-460736.000000003,0.227257297016531,89.7033327011458,-0.97274198546882
584.95,584,4696,4574,878152,434530,2025-04-07,2025-05-16,505.28,-122,-443622,191683614,-460736.000000003,0.226691260109484,89.9300239612552,-1.02092375670264
666.15,665,3660,3734,523380,429410,2025-04-07,2025-12-19,505.28,74,-93970.0000000001,850516954,-173881469,0.050488117606648,99.6224792480739,-0.21883514589786
522.54,450,9,59,105444,427986,2025-04-07,2025-05-30,505.28,50,322542,25903649,-10875774,1.6522228200359,43.6988047514078,0.753627455103672
559.06,537,199,194,865650,427964,2025-04-07,2025-08-15,505.28,-5,-437686,112162086,-42661174,0.38155852415227,84.7015791057952,-1.02271686403529
519.38,504,0,275,0,422950,2025-04-07,2025-04-11,505.28,275,422950,52569756,25897074,0.804550053456592,78.2605648768847,1
511.2,400,38,38,547580,422560,2025-04-07,2025-05-16,505.28,0,-125020,191683614,-460736.000000003,0.22044659487691,90.1504705561321,-0.295863309352518
541.2,529,27,345,69093,420900,2025-04-07,2025-05-16,505.28,318,351807,191683614,-460736.000000003,0.219580584493779,90.3700511406259,0.835844618674269
695.54,695,7784,7787,404768,420498,2025-04-07,2025-12-19,505.28,3,15730.0000000001,850516954,-173881469,0.0494402842909114,99.6719195323648,0.0374080257218823
596.53,596,7955,7921,620490,419813,2025-04-07,2025-05-16,505.28,-34,-200677,191683614,-460736.000000003,0.219013504200729,90.5890646448267,-0.47801521153466
565.71,548,237,236,612645,417956,2025-04-07,2025-08-15,505.28,-1,-194689,112162086,-42661174,0.372635722912643,85.0742148287078,-0.465812190756922
531.5,526,0,752,0,413600,2025-04-07,2025-04-11,505.28,752,413600,52569756,25897074,0.786764161507617,79.0473290383924,1
562.07,375,22,22,411554,411554,2025-04-07,2025-05-16,505.28,0,0,191683614,-460736.000000003,0.214704841698154,90.8037694865248,0
584.05,583,4317,3918,863400,411390,2025-04-07,2025-05-16,505.28,-399,-452010,191683614,-460736.000000003,0.214619284045844,91.0183887705707,-1.09873842339386
675.8,675,5083,5110,523549,408800,2025-04-07,2025-12-19,505.28,27,-114749,850516954,-173881469,0.0480648854884555,99.7199844178532,-0.280697162426614
656.37,655,2985,2983,599985,408671,2025-04-07,2025-12-19,505.28,-2,-191314,850516954,-173881469,0.0480497182423009,99.7680341360955,-0.46813696102733
527.08,370,25,26,495000,408408,2025-04-07,2025-06-20,505.28,1,-86592,478977607,-137482950,0.085266616649993,99.1658426319709,-0.2120232708468
660.41,660,10130,9917,617930,406597,2025-04-07,2025-09-19,505.28,-213,-211333,264848567,-73847933,0.153520558787845,97.8533253683793,-0.519760352388237
541.28,535,122,646,238876,405688,2025-04-07,2025-04-25,505.28,524,166812,13056472,-3270620,3.10717933604116,48.3481448893698,0.411182978052099
557.93,345,19,19,404567,404567,2025-04-07,2025-09-19,505.28,0,0,264848567,-73847933,0.152754083053053,98.0060794514323,0
526.08,518,0,499,0,403192,2025-04-07,2025-04-11,505.28,499,403192,52569756,25897074,0.766965705528479,79.8142947439208,1
582.18,581,3471,3408,812214,402144,2025-04-07,2025-05-16,505.28,-63,-410070,191683614,-460736.000000003,0.209795710550407,91.2281844811211,-1.01970935784197
529.9,524,2,677,4672,399430,2025-04-07,2025-04-11,505.28,675,394758,52569756,25897074,0.759809499591362,80.5741042435122,0.988303332248454
542.67,531,52,341,125996,397947,2025-04-07,2025-05-16,505.28,289,271951,191683614,-460736.000000003,0.207606165021492,91.4357906461426,0.683384973375852
524.9,500,60,159,265380,395910,2025-04-07,2025-05-02,505.28,99,130530,15637149,-467056,2.53185539128648,46.8214762166684,0.329696143062817
640.67,640,6173,5890,487667,394630,2025-04-07,2025-08-15,505.28,-283,-93037,112162086,-42661174,0.351839034092144,85.4260538628,-0.235757545042191
577.62,568,414,410,679788,394420,2025-04-07,2025-08-15,505.28,-4,-285368,112162086,-42661174,0.351651805049346,85.7777056678493,-0.723513006439836
550.5,545,652,717,895196,394350,2025-04-07,2025-05-09,505.28,65,-500846,21122544,7108655,1.86696261586673,68.7001480503485,-1.27005452009636
570.48,430,28,28,393344,393344,2025-04-07,2025-07-18,505.28,0,0,104857395,-33238059,0.375122803689716,92.6923799699582,0
595.94,595,4141,4160,600445,391040,2025-04-07,2025-05-30,505.28,19,-209405,25903649,-10875774,1.50959426604337,45.2083990174512,-0.535507876432079
635.42,635,9656,9269,492456,389298,2025-04-07,2025-07-18,505.28,-387,-103158,104857395,-33238059,0.3712642298619,93.0636441998202,-0.26498466470416
563.84,335,17,17,389028,389028,2025-04-07,2025-09-19,505.28,0,0,264848567,-73847933,0.146886956726483,98.1529664081588,0
597.25,595,1792,1725,731136,388125,2025-04-07,2025-07-18,505.28,-67,-343011,104857395,-33238059,0.370145567701734,93.4337897675219,-0.88376425120773
572.1,562,370,382,680060,385820,2025-04-07,2025-08-15,505.28,12,-294240,112162086,-42661174,0.343984329963335,86.1216899978126,-0.76263542584625
534.8,531,61,1009,86010,383420,2025-04-07,2025-04-11,505.28,948,297410,52569756,25897074,0.729354726318304,81.3034589698305,0.775676803505295
521.35,445,56,50,563416,381750,2025-04-07,2025-05-16,505.28,-6,-181666,191683614,-460736.000000003,0.199156303469946,91.6349469496125,-0.475876882776687
538.11,525,12,291,34416,381501,2025-04-07,2025-05-09,505.28,279,347085,21122544,7108655,1.80613187502414,70.5062799253726,0.909787916676496
532.41,470,58,61,459824,380701,2025-04-07,2025-07-18,505.28,3,-79123,104857395,-33238059,0.363065475734925,93.7968552432568,-0.207835020133911
570.27,568,1964,1676,1040920,380452,2025-04-07,2025-05-16,505.28,-288,-660468,191683614,-460736.000000003,0.198479145953498,91.833426095566,-1.73600874748983
550.03,517,103,115,492958,379845,2025-04-07,2025-08-15,505.28,12,-113113,112162086,-42661174,0.338657217912299,86.4603472157249,-0.297787255327831
573.66,564,373,393,653496,379638,2025-04-07,2025-08-15,505.28,20,-273858,112162086,-42661174,0.338472663570112,86.798819879295,-0.721366143536738
557.22,534,161,163,549332,378486,2025-04-07,2025-08-15,505.28,2,-170846,112162086,-42661174,0.337445578535335,87.1362654578304,-0.451393182310575
526.02,305,20,17,609320,375734,2025-04-07,2025-06-20,505.28,-3,-233586,478977607,-137482950,0.0784450033798762,99.2442876353508,-0.621679166644488
527.37,497,1,123,5948,373551,2025-04-07,2025-05-16,505.28,122,367603,191683614,-460736.000000003,0.194878942547483,92.0283050381135,0.98407714073848
580.45,579,2574,2576,697554,373520,2025-04-07,2025-05-16,505.28,2,-324034,191683614,-460736.000000003,0.194862770064425,92.2231678081779,-0.867514457057186
544.15,534,115,366,250240,371490,2025-04-07,2025-05-16,505.28,251,121250,191683614,-460736.000000003,0.193803733270597,92.4169715414485,0.326388328084202
553.8,544,374,377,675070,369460,2025-04-07,2025-05-30,505.28,3,-305610,25903649,-10875774,1.42628553992528,46.6346845573765,-0.827180208953608
560.31,556,956,854,928276,368074,2025-04-07,2025-05-16,505.28,-102,-560202,191683614,-460736.000000003,0.192021629976154,92.6089931714247,-1.52198199275146
572.9,571,1755,1932,789750,367080,2025-04-07,2025-05-16,505.28,177,-422670,191683614,-460736.000000003,0.19150306713228,92.8004962385569,-1.15143837855508
543.31,532,41,324,101885,366444,2025-04-07,2025-05-16,505.28,283,264559,191683614,-460736.000000003,0.19117127038308,92.99166750894,0.721962973878683
536.52,525,31,318,80631,366336,2025-04-07,2025-05-02,505.28,287,285705,15637149,-467056,2.34272884398556,49.164205060654,0.779898781446541
570.04,559,321,331,643284,365424,2025-04-07,2025-08-15,505.28,10,-277860,112162086,-42661174,0.325799932073303,87.4620653899037,-0.76037698673322
553.89,545,295,411,520675,365379,2025-04-07,2025-05-30,505.28,116,-155296,25903649,-10875774,1.41053100279424,48.0452155601707,-0.425027163575356
619.46,315,12,12,365352,365352,2025-04-07,2025-09-19,505.28,0,0,264848567,-73847933,0.137947508698433,98.2909139168573,0
571.18,569,1763,1673,890315,364714,2025-04-07,2025-05-16,505.28,-90,-525601,191683614,-460736.000000003,0.190268741489818,93.1819362504298,-1.44113195545002
645.37,645,9529,9842,304928,364154,2025-04-07,2025-07-18,505.28,313,59226,104857395,-33238059,0.347284995970003,94.1441402392268,0.162639981985643
690.55,690,6477,6613,408051,363715,2025-04-07,2025-12-19,505.28,136,-44336,850516954,-173881469,0.0427639917451898,99.8107981278407,-0.121897639635429
575.66,574,2455,2189,905895,363374,2025-04-07,2025-05-16,505.28,-266,-542521,191683614,-460736.000000003,0.189569672867291,93.3715059232971,-1.49300995668375
524.5,445,14,45,177352,357750,2025-04-07,2025-07-18,505.28,31,180398,104857395,-33238059,0.341177653707686,94.4853178929345,0.504257162823201
640.35,640,10157,10220,426594,357700,2025-04-07,2025-07-18,505.28,63,-68894,104857395,-33238059,0.341129969898642,94.8264478628331,-0.192602739726027
607.39,310,12,12,356868,356868,2025-04-07,2025-06-20,505.28,0,0,478977607,-137482950,0.0745061971133026,99.3187938324641,0
592.62,320,13,13,354406,354406,2025-04-07,2025-06-20,505.28,0,0,478977607,-137482950,0.0739921856096291,99.3927860180737,0
575.04,185,9,9,351036,351036,2025-04-07,2025-06-20,505.28,0,0,478977607,-137482950,0.0732886036569973,99.4660746217307,0
543.74,542,1832,2015,1414304,350610,2025-04-07,2025-04-11,505.28,183,-1063694,52569756,25897074,0.666942414570081,81.9704013844006,-3.03383816776475
558.29,555,801,1065,700875,350385,2025-04-07,2025-05-09,505.28,264,-350490,21122544,7108655,1.65882007394564,72.1650999993183,-1.0002996703626
548.57,516,103,106,501816,345242,2025-04-07,2025-08-15,505.28,3,-156574,112162086,-42661174,0.307806329493551,87.7698717193972,-0.453519560192561
564.44,335,15,15,344160,344160,2025-04-07,2025-08-15,505.28,0,0,112162086,-42661174,0.306841654139706,88.0767133735369,0
571.75,568,891,917,643302,343875,2025-04-07,2025-05-30,505.28,26,-299427,25903649,-10875774,1.32751567163375,49.3727312318045,-0.87074372955289
538.7,536,372,1265,409572,341550,2025-04-07,2025-04-11,505.28,893,-68022,52569756,25897074,0.649708170606689,82.6201095550073,-0.199156785243742
543.96,365,19,19,340024,340024,2025-04-07,2025-06-20,505.28,0,0,478977607,-137482950,0.0709895400183082,99.537064161749,0
541.88,505,84,92,524244,339296,2025-04-07,2025-08-15,505.28,8,-184948,112162086,-42661174,0.302505072881758,88.3792184464187,-0.545093369801
526,500,71,130,344918,338000,2025-04-07,2025-05-09,505.28,59,-6918,21122544,7108655,1.60018603819691,73.7652860375152,-0.0204674556213018
525,485,31,82,233771,328000,2025-04-07,2025-05-09,505.28,51,94229,21122544,7108655,1.55284325600174,75.3181292935169,0.287283536585366
524.89,480,42,73,294126,327697,2025-04-07,2025-05-16,505.28,31,33571,191683614,-460736.000000003,0.170957231639007,93.5424631549361,0.102445246676045
575.51,572,915,931,530700,326781,2025-04-07,2025-05-30,505.28,16,-203919,25903649,-10875774,1.26152496893391,50.6342562007384,-0.624023428534707
559.9,553,466,472,685020,325680,2025-04-07,2025-05-30,505.28,6,-359340,25903649,-10875774,1.2572746025087,51.8915308032471,-1.10335298452469
530.12,506,0,134,0,323208,2025-04-07,2025-05-16,505.28,134,323208,191683614,-460736.000000003,0.168615351753541,93.7110785066897,1
537.9,520,0,179,0,320410,2025-04-07,2025-05-23,505.28,179,320410,3097569,2640978,10.3439180854405,10.3439180854405,1
527.59,498,4,108,19460,319572,2025-04-07,2025-05-16,505.28,104,300112,191683614,-460736.000000003,0.166718475998684,93.8777969826883,0.93910605434769
532.55,528,92,697,150972,317135,2025-04-07,2025-04-11,505.28,605,166163,52569756,25897074,0.603265116923883,83.2233746719311,0.523950368139751
555.56,532,177,134,813315,315704,2025-04-07,2025-08-15,505.28,-43,-497611,112162086,-42661174,0.281471227273715,88.6606896736924,-1.57619479005651
548.65,545,765,862,800190,314630,2025-04-07,2025-04-25,505.28,97,-485560,13056472,-3270620,2.40976275980219,50.757907649172,-1.54327305088517
547.15,536,183,282,373320,314430,2025-04-07,2025-05-16,505.28,99,-58890,191683614,-460736.000000003,0.164035930582987,94.0418329132713,-0.187291288999141
526.21,496,72,104,386784,314184,2025-04-07,2025-05-16,505.28,32,-72600,191683614,-460736.000000003,0.163907594104523,94.2057405073759,-0.231074784202887
539.5,537,131,1256,134537,314000,2025-04-07,2025-04-11,505.28,1125,179463,52569756,25897074,0.597301611976285,83.8206762839074,0.57153821656051
563.21,558,431,598,477117,311558,2025-04-07,2025-05-30,505.28,167,-165559,25903649,-10875774,1.20275718683495,53.094287990082,-0.531390623896674
565.26,549,188,190,495380,308940,2025-04-07,2025-08-15,505.28,2,-186440,112162086,-42661174,0.275440668961881,88.9361303426543,-0.603482876934033
574.34,499,41,41,308894,308894,2025-04-07,2025-08-15,505.28,0,0,112162086,-42661174,0.275399656885839,89.2115299995401,0
562.1,560,829,1462,475017,307020,2025-04-07,2025-05-02,505.28,633,-167997,15637149,-467056,1.96340138474091,51.1276064453949,-0.54718585108462
562.47,360,15,15,303705,303705,2025-04-07,2025-08-15,505.28,0,0,112162086,-42661174,0.270773316394989,89.4823033159351,0
555.9,548,317,384,510370,303360,2025-04-07,2025-05-30,505.28,67,-207010,25903649,-10875774,1.171109136014,54.265397126096,-0.68239055907173
561.4,560,1635,2160,703050,302400,2025-04-07,2025-04-25,505.28,525,-400650,13056472,-3270620,2.31609273929435,53.0740003884664,-1.32490079365079
571.65,498,41,41,301965,301965,2025-04-07,2025-08-15,505.28,0,0,112162086,-42661174,0.269221990040378,89.7515253059755,0
579.39,577,933,1263,416118,301857,2025-04-07,2025-05-30,505.28,330,-114261,25903649,-10875774,1.1653068646815,55.4307039907775,-0.378526918375257
564.06,559,590,595,702690,301070,2025-04-07,2025-05-30,505.28,5,-401620,25903649,-10875774,1.16226868268637,56.5929726734639,-1.33397548742817
542.54,535,161,397,291893,299338,2025-04-07,2025-05-02,505.28,236,7445,15637149,-467056,1.91427478244276,53.0418812278376,0.0248715498867501
519.13,420,27,30,401544,297390,2025-04-07,2025-05-16,505.28,3,-104154,191683614,-460736.000000003,0.155146281830851,94.3608867892067,-0.350226974679714
524.8,505,52,150,231972,297000,2025-04-07,2025-04-25,505.28,98,65028,13056472,-3270620,2.27473394037838,55.3487343288447,0.218949494949495
579.85,250,9,9,296865,296865,2025-04-07,2025-09-19,505.28,0,0,264848567,-73847933,0.112088580792661,98.4030024976499,0
570.5,200,8,8,296400,296400,2025-04-07,2025-09-19,505.28,0,0,264848567,-73847933,0.111913008764741,98.5149155064147,0
569.39,558,260,260,532480,296140,2025-04-07,2025-08-15,505.28,0,-236340,112162086,-42661174,0.264028613019911,90.0155539189954,-0.798068481123793
558.71,551,377,384,548535,296064,2025-04-07,2025-05-30,505.28,7,-252471,25903649,-10875774,1.14294322008455,57.7359158935484,-0.852758187418937
541.16,539,288,1365,267552,294840,2025-04-07,2025-04-11,505.28,1077,27288.0000000001,52569756,25897074,0.560854800239134,84.3815310841466,0.0925518925518928
555.23,529,99,112,396000,293776,2025-04-07,2025-08-15,505.28,13,-102224,112162086,-42661174,0.261920948938129,90.2774748679335,-0.347965797069876
558.57,556,1031,1136,720669,291952,2025-04-07,2025-05-02,505.28,105,-428717,15637149,-467056,1.8670411083248,54.9089223361624,-1.46845029319888
568.54,345,13,13,290602,290602,2025-04-07,2025-07-18,505.28,0,0,104857395,-33238059,0.277140205514356,95.1035880683475,0
545.19,504,68,70,517004,288330,2025-04-07,2025-08-15,505.28,2,-228674,112162086,-42661174,0.257065475761569,90.5345403436951,-0.793098186106198
527.12,505,13,129,59826,285348,2025-04-07,2025-05-02,505.28,116,225522,15637149,-467056,1.82480834581803,56.7337306819805,0.790340216157114
527.34,290,11,12,294756,284808,2025-04-07,2025-06-20,505.28,1,-9948,478977607,-137482950,0.0594616524525749,99.5965258142016,-0.0349287941349962
578.53,577,2107,1858,657384,284274,2025-04-07,2025-05-16,505.28,-249,-373110,191683614,-460736.000000003,0.148303756418115,94.5091905456248,-1.31250131914983
521.7,495,5,106,34340,283020,2025-04-07,2025-04-25,505.28,101,248680,13056472,-3270620,2.16766060540703,57.5163949342518,0.878665818670059
545.22,533,60,230,134820,281060,2025-04-07,2025-05-16,505.28,170,146240,191683614,-460736.000000003,0.146627035110054,94.6558175807349,0.520315946772931
519,320,9,14,258318,278600,2025-04-07,2025-09-19,505.28,5,20282,264848567,-73847933,0.105192187050799,98.6201076934655,0.0727997128499642
523.42,435,8,31,105728,274102,2025-04-07,2025-08-15,505.28,23,168374,112162086,-42661174,0.244380262328573,90.7789206060237,0.614274977927925
576.13,475,27,27,273051,273051,2025-04-07,2025-08-15,505.28,0,0,112162086,-42661174,0.243443225547713,91.0223638315714,0
527.53,490,80,72,635280,270216,2025-04-07,2025-05-30,505.28,-8,-365064,25903649,-10875774,1.04315805082133,58.7790739443698,-1.35100808242295
544.51,543,1309,1789,946407,270139,2025-04-07,2025-04-11,505.28,480,-676268,52569756,25897074,0.513867707508477,84.895398791655,-2.50340750502519
519.26,503,1,166,4113,269916,2025-04-07,2025-04-11,505.28,165,265803,52569756,25897074,0.513443509229908,85.4088423008849,0.984761925932512
571.09,570,1267,2465,368697,268685,2025-04-07,2025-05-02,505.28,1198,-100012,15637149,-467056,1.71824800032282,58.4519786823033,-0.372227701583639
579.55,578,1781,1730,507585,268150,2025-04-07,2025-05-16,505.28,-51,-239435,191683614,-460736.000000003,0.139891978455707,94.7957095591906,-0.892914413574492
528.03,501,2,99,11292,267597,2025-04-07,2025-05-16,505.28,97,256305,191683614,-460736.000000003,0.139603482225664,94.9353130414162,0.957802217513649
557.65,531,99,100,386892,266500,2025-04-07,2025-08-15,505.28,1,-120392,112162086,-42661174,0.237602570979288,91.2599664025507,-0.45175234521576
572.89,385,14,14,263046,263046,2025-04-07,2025-09-19,505.28,0,0,264848567,-73847933,0.099319397110425,98.7194270905759,0
587.92,587,3166,2858,493896,262936,2025-04-07,2025-05-16,505.28,-308,-230960,191683614,-460736.000000003,0.137171871143874,95.0724849125601,-0.878388657315849
555.02,546,266,291,460446,262482,2025-04-07,2025-05-30,505.28,25,-197964,25903649,-10875774,1.01330125342572,59.7923751977955,-0.75420028801975
567.47,551,150,159,388950,261873,2025-04-07,2025-08-15,505.28,9,-127077,112162086,-42661174,0.23347729106964,91.4934436936203,-0.48526193994799
549.48,460,29,29,259492,259492,2025-04-07,2025-05-02,505.28,0,0,15637149,-467056,1.65945851126698,60.1114371935703,0
562.75,562.5,690,10333,77970,258325,2025-04-07,2025-04-11,505.28,9643,180355,52569756,25897074,0.491394709916477,85.9002370108014,0.698170908738992
509.11,380,19,20,308142,258220,2025-04-07,2025-04-11,505.28,1,-49922,52569756,25897074,0.491194975301008,86.3914319861024,-0.193331267911083
569.21,335,11,11,257631,257631,2025-04-07,2025-07-18,505.28,0,0,104857395,-33238059,0.245696548154758,95.3492846165022,0
586.51,585,1180,1695,324500,255945,2025-04-07,2025-05-30,505.28,515,-68555,25903649,-10875774,0.988065426612289,60.7804406244078,-0.26785051475903
533.33,529,3,591,6081,255903,2025-04-07,2025-04-11,505.28,588,249822,52569756,25897074,0.486787498119641,86.8782194842221,0.97623708983482
605.3,605,8796,8514,299064,255420,2025-04-07,2025-05-16,505.28,-282,-43644.0000000001,191683614,-460736.000000003,0.133250826541699,95.2057357391018,-0.170871505755227
588.81,588,3230,3133,458660,253773,2025-04-07,2025-05-16,505.28,-97,-204887,191683614,-460736.000000003,0.132391598167593,95.3381273372694,-0.80736327347669
516.95,496,0,121,0,253495,2025-04-07,2025-04-11,505.28,121,253495,52569756,25897074,0.482206917604868,87.3604264018269,1
565.6,561,561,551,551463,253460,2025-04-07,2025-05-30,505.28,-10,-298003,25903649,-10875774,0.978472183590814,61.7589128079986,-1.1757397616981
523.78,355,15,15,320805,253170,2025-04-07,2025-06-20,505.28,0,-67635,478977607,-137482950,0.0528563332189348,99.6493821474205,-0.267152506221116
573.9,572,1543,1328,649603,252320,2025-04-07,2025-05-16,505.28,-215,-397283,191683614,-460736.000000003,0.131633578235853,95.4697609155053,-1.57452045022194
571.7,415,16,16,250720,250720,2025-04-07,2025-09-19,505.28,0,0,264848567,-73847933,0.094665416860647,98.8140925074365,0
571.14,405,15,15,249210,249210,2025-04-07,2025-09-19,505.28,0,0,264848567,-73847933,0.0940952797377227,98.9081877871742,0
531.39,505,0,94,0,248066,2025-04-07,2025-05-23,505.28,94,248066,3097569,2640978,8.00840917506599,18.3523272605065,1
536.95,460,10,32,111120,246240,2025-04-07,2025-08-15,505.28,22,135120,112162086,-42661174,0.219539426183639,91.712983119804,0.548732943469786
675.34,675,7236,7240,50652,246160,2025-04-07,2025-06-20,505.28,4,195508,478977607,-137482950,0.0513927992462495,99.7007749466668,0.794231394215145
521.5,490,32,78,173472,245700,2025-04-07,2025-04-25,505.28,46,72228,13056472,-3270620,1.88182535067666,59.3982202849284,0.293968253968254
710.41,710,5782,5911,213934,242351,2025-04-07,2025-12-19,505.28,129,28417,850516954,-173881469,0.0284945525024772,99.8392926803432,0.117255550833295
556.95,555,1123,1240,677169,241800,2025-04-07,2025-04-25,505.28,117,-435369,13056472,-3270620,1.85195510701513,61.2501753919436,-1.80053349875931
650.45,650,5349,5372,262101,241740,2025-04-07,2025-08-15,505.28,23,-20361,112162086,-42661174,0.215527375266541,91.9285104950705,-0.0842268552990815
567.96,468,24,24,239904,239904,2025-04-07,2025-08-15,505.28,0,0,112162086,-42661174,0.213890458492364,92.1424009535629,0
568.86,565,718,620,590914,239320,2025-04-07,2025-05-30,505.28,-98,-351594,25903649,-10875774,0.923885279637629,62.6827980876362,-1.46913755640983
586.9,586,2668,2650,440220,238500,2025-04-07,2025-05-16,505.28,-18,-201720,191683614,-460736.000000003,0.12442378094979,95.5941846964551,-0.845786163522013
514.35,450,32,37,298240,238095,2025-04-07,2025-04-11,505.28,5,-60145,52569756,25897074,0.452912507335967,87.8133389091629,-0.252609252609253
525.03,495,74,79,483886,237237,2025-04-07,2025-05-09,505.28,5,-246649,21122544,7108655,1.12314596196367,76.4412752554806,-1.03967340676201
515.42,300,6,11,154188,236962,2025-04-07,2025-07-18,505.28,5,82774,104857395,-33238059,0.225985015172273,95.5752696316745,0.349313392020662
535.4,515,0,116,0,236640,2025-04-07,2025-05-23,505.28,116,236640,3097569,2640978,7.63953926450065,25.9918665250072,1
576.76,574,810,855,421200,235980,2025-04-07,2025-05-30,505.28,45,-185220,25903649,-10875774,0.910991343343171,63.5937894309794,-0.784897025171625
578.3,576,1033,1025,503071,235750,2025-04-07,2025-05-30,505.28,-8,-267321,25903649,-10875774,0.910103437550439,64.5038928685298,-1.13391728525981
518.46,455,33,37,356202,234802,2025-04-07,2025-04-11,505.28,4,-121400,52569756,25897074,0.446648449347948,88.2599873585109,-0.517031371112682
531.91,527,1,477,2099,234207,2025-04-07,2025-04-11,505.28,476,232108,52569756,25897074,0.445516619860286,88.7055039783711,0.991037842592237
532.2,505,14,86,105112,233920,2025-04-07,2025-05-30,505.28,72,128808,25903649,-10875774,0.903038795808266,65.4069316643381,0.550649794801642
615.16,615,14539,14534,232624,232544,2025-04-07,2025-05-16,505.28,-5,-80.0000000000291,191683614,-460736.000000003,0.121316577430557,95.7155012738856,-0.000344020916471847
518.16,502,0,143,0,231088,2025-04-07,2025-04-11,505.28,143,231088,52569756,25897074,0.439583550663617,89.1450875290348,1
555.01,547,270,288,446580,230688,2025-04-07,2025-05-30,505.28,18,-215892,25903649,-10875774,0.890561789190396,66.2974934535285,-0.935861423220974
548.27,513,62,65,378882,229255,2025-04-07,2025-08-15,505.28,3,-149627,112162086,-42661174,0.204396162888768,92.3467971164516,-0.652666245011014
540.3,538,274,996,265506,229080,2025-04-07,2025-04-11,505.28,722,-36426,52569756,25897074,0.435763863922062,89.5808513929568,-0.159009952854898
559.66,552,293,299,416939,229034,2025-04-07,2025-05-30,505.28,6,-187905,25903649,-10875774,0.884176588402661,67.1816700419312,-0.820424041845316
685.63,685,3654,3625,244818,228375,2025-04-07,2025-12-19,505.28,-29,-16443,850516954,-173881469,0.0268513165935079,99.8661439969367,-0.0720000000000001
562.81,310,9,9,227529,227529,2025-04-07,2025-07-18,505.28,0,0,104857395,-33238059,0.216988987758088,95.7922586194326,0
569.56,395,13,13,226928,226928,2025-04-07,2025-09-19,505.28,0,0,264848567,-73847933,0.0856821702191804,98.9938699573934,0
578.49,205,6,6,224094,224094,2025-04-07,2025-12-19,505.28,0,0,850516954,-173881469,0.0263479756571672,99.8924919725939,0
522.04,470,19,43,155078,223772,2025-04-07,2025-05-30,505.28,24,68693.9999999999,25903649,-10875774,0.863862848048937,68.0455328899801,0.306982106787265
562.44,557,403,411,463853,223584,2025-04-07,2025-05-30,505.28,8,-240269,25903649,-10875774,0.863137081574878,68.908669971555,-1.07462519679405
556.86,549,274,282,455388,221652,2025-04-07,2025-05-30,505.28,8,-233736,25903649,-10875774,0.855678672915928,69.7643486444709,-1.05451789291322
517.28,497,0,109,0,221052,2025-04-07,2025-04-11,505.28,109,221052,52569756,25897074,0.420492725893573,90.0013441188504,1
536.44,533,58,642,74008,220848,2025-04-07,2025-04-11,505.28,584,146840,52569756,25897074,0.420104670069231,90.4214487889196,0.664891690212273
551.85,542,152,224,296856,220640,2025-04-07,2025-05-30,505.28,72,-76216.0000000001,25903649,-10875774,0.851771887427906,70.6161205318988,-0.345431472081219
545.27,506,60,56,421500,219912,2025-04-07,2025-08-15,505.28,-4,-201588,112162086,-42661174,0.196066253618001,92.5428633700697,-0.916675761213576
547.97,541,0,313,0,218161,2025-04-07,2025-05-09,505.28,313,218161,21122544,7108655,1.03283487064816,77.4741101261288,1
533.43,510,0,93,0,217899,2025-04-07,2025-05-23,505.28,93,217899,3097569,2640978,7.03451642239446,33.0263829474017,1
560.64,554,327,327,427716,217128,2025-04-07,2025-05-30,505.28,0,-210588,25903649,-10875774,0.838213952018883,71.4543344839177,-0.969879518072289
569.62,390,12,12,215544,215544,2025-04-07,2025-09-19,505.28,0,0,264848567,-73847933,0.0813838649162863,99.0752538223097,0
519.4,430,14,24,157010,214560,2025-04-07,2025-05-16,505.28,10,57550,191683614,-460736.000000003,0.111934450484641,95.8274357243703,0.268223340790455
514.8,490,3,86,16440,213280,2025-04-07,2025-04-11,505.28,83,196840,52569756,25897074,0.405708559879943,90.8271573487996,0.922918229557389
565.19,565,10349,11199,879665,212781,2025-04-07,2025-04-11,505.28,850,-666884,52569756,25897074,0.404759344897853,91.2319166936974,-3.13413321678157
557.06,345,10,10,212060,212060,2025-04-07,2025-05-16,505.28,0,0,191683614,-460736.000000003,0.110630217979926,95.9380659423502,0
552.26,543,225,228,421875,211128,2025-04-07,2025-05-30,505.28,3,-210747,25903649,-10875774,0.81505119220848,72.2693856761262,-0.998195407525293
572,569,634,699,426682,209700,2025-04-07,2025-05-30,505.28,65,-216982,25903649,-10875774,0.809538455373604,73.0789241314998,-1.03472579876013
549.02,548,1179,2037,582426,207774,2025-04-07,2025-04-11,505.28,858,-374652,52569756,25897074,0.395234857091595,91.627151550789,-1.80317075283722
522.11,350,2,12,46560,206532,2025-04-07,2025-05-16,505.28,10,159972,191683614,-460736.000000003,0.107746299065501,96.0458122414157,0.774562779617686
549.41,545,309,467,378834,205947,2025-04-07,2025-05-02,505.28,158,-172887,15637149,-467056,1.31703675650849,61.4284739500788,-0.83947326253842
700.21,700,9787,9785,88083,205485,2025-04-07,2025-08-15,505.28,-2,117402,112162086,-42661174,0.183203618377782,92.7260669884474,0.571340973793708
518.78,465,37,38,296370,204364,2025-04-07,2025-05-16,505.28,1,-92006,191683614,-460736.000000003,0.106615268637412,96.1524275100531,-0.450206494294494
550.73,541,190,210,378290,204330,2025-04-07,2025-05-30,505.28,20,-173960,25903649,-10875774,0.788807785343293,73.8677319168431,-0.85136788528361
547.55,542,287,367,403522,203685,2025-04-07,2025-05-02,505.28,80,-199837,15637149,-467056,1.30257120399633,62.7310451540751,-0.9811080835604
540.78,525,0,128,0,201984,2025-04-07,2025-05-23,505.28,128,201984,3097569,2640978,6.5207264148111,39.5471093622128,1
568.5,280,7,7,201950,201950,2025-04-07,2025-09-19,505.28,0,0,264848567,-73847933,0.0762511205129534,99.1515049428227,0
564.61,315,8,8,199688,199688,2025-04-07,2025-07-18,505.28,0,0,104857395,-33238059,0.190437689206374,95.982696308639,0
516.41,450,29,30,262421,199230,2025-04-07,2025-05-02,505.28,1,-63191,15637149,-467056,1.27408135587888,64.005126509954,-0.317176128093159
568.93,320,8,8,199144,199144,2025-04-07,2025-07-18,505.28,0,0,104857395,-33238059,0.189918889363979,96.172615198003,0
570.53,405,12,12,198636,198636,2025-04-07,2025-07-18,505.28,0,0,104857395,-33238059,0.189434421864095,96.3620496198671,0
548.11,547,1994,1786,1082742,198246,2025-04-07,2025-04-11,505.28,-208,-884496,52569756,25897074,0.377110367413537,92.0042619182026,-4.46160830483339
555.27,551,405,464,390825,198128,2025-04-07,2025-05-02,505.28,59,-192697,15637149,-467056,1.26703403542423,65.2721605453782,-0.972588427683114
567.13,320,8,8,197704,197704,2025-04-07,2025-05-16,505.28,0,0,191683614,-460736.000000003,0.103140793244852,96.255568303298,0
532.99,465,29,29,294437,197171,2025-04-07,2025-08-15,505.28,0,-97266,112162086,-42661174,0.175791131416725,92.9018581198642,-0.493307839388146
549.87,521,62,68,358918,196316,2025-04-07,2025-08-15,505.28,6,-162602,112162086,-42661174,0.175028841742476,93.0768869616066,-0.828266672100084
570.36,375,10,10,195360,195360,2025-04-07,2025-07-18,505.28,0,0,104857395,-33238059,0.186310178695551,96.5483597985626,0
660.35,660,5554,5562,172174,194670,2025-04-07,2025-08-15,505.28,8,22496,112162086,-42661174,0.173561322673688,93.2504482842803,0.115559665074228
528.91,460,5,28,46900,192948,2025-04-07,2025-07-18,505.28,23,146048,104857395,-33238059,0.184009911747283,96.7323697103099,0.756929328109128
573.72,571,614,708,374540,192576,2025-04-07,2025-05-30,505.28,94,-181964,25903649,-10875774,0.743431938874712,74.6111638557178,-0.944894483217015
518.76,305,9,9,229563,192384,2025-04-07,2025-07-18,505.28,0,-37179,104857395,-33238059,0.18347203838127,96.9158417486912,-0.193254116766467
555.55,555,2549,3496,703524,192280,2025-04-07,2025-04-11,505.28,947,-511244,52569756,25897074,0.365761636785988,92.3700235549885,-2.65885167464115
566.4,562,379,437,348680,192280,2025-04-07,2025-05-30,505.28,58,-156400,25903649,-10875774,0.742289242724066,75.3534530984419,-0.813397129186603
577.51,576,1463,1271,482790,191921,2025-04-07,2025-05-16,505.28,-192,-290869,191683614,-460736.000000003,0.100123842614946,96.3556921459129,-1.51556630071748
561.54,556,347,346,413277,191684,2025-04-07,2025-05-30,505.28,-1,-221593,25903649,-10875774,0.739988408582899,76.0934415070248,-1.15603284572526
570.12,570,10954,15937,438160,191244,2025-04-07,2025-04-11,505.28,4983,-246916,52569756,25897074,0.363790921913353,92.7338144769019,-1.2911045575286
526.35,465,0,31,0,190185,2025-04-07,2025-05-23,505.28,31,190185,3097569,2640978,6.13981480315693,45.6869241653697,1
528.13,505,2,82,8912,189666,2025-04-07,2025-05-09,505.28,80,180754,21122544,7108655,0.897931612783006,78.3720417389118,0.953012137125262
562.84,405,12,12,189408,189408,2025-04-07,2025-05-16,505.28,0,0,191683614,-460736.000000003,0.0988128281012064,96.4545049740141,0
554.73,345,9,9,188757,188757,2025-04-07,2025-06-20,505.28,0,0,478977607,-137482950,0.0394083141344017,99.7401832608012,0
570.79,195,5,5,187895,187895,2025-04-07,2025-12-19,505.28,0,0,850516954,-173881469,0.0220918582652968,99.9145838308592,0
563.9,330,8,8,187120,187120,2025-04-07,2025-08-15,505.28,0,0,112162086,-42661174,0.166829992801667,93.417278277082,0
553.23,524,52,64,279136,187072,2025-04-07,2025-08-15,505.28,12,-92064,112162086,-42661174,0.166787197591885,93.5840654746739,-0.492131371878207
516.16,310,8,9,242488,185544,2025-04-07,2025-05-16,505.28,1,-56944,191683614,-460736.000000003,0.0967970063419192,96.551301980356,-0.306902944854051
582.78,581,993,1040,353508,185120,2025-04-07,2025-05-30,505.28,47,-168388,25903649,-10875774,0.714648349350317,76.8080898563751,-0.909615384615385
524.88,475,19,37,177802,184556,2025-04-07,2025-05-30,505.28,18,6754.00000000003,25903649,-10875774,0.71247104992814,77.5205609063032,0.0365959383601727
557.31,295,7,7,183617,183617,2025-04-07,2025-07-18,505.28,0,0,104857395,-33238059,0.175111159303547,97.0909529079947,0
515,255,8,7,283024,182000,2025-04-07,2025-06-20,505.28,-1,-101024,478977607,-137482950,0.0379976010026707,99.7781808618038,-0.555076923076923
602.34,602,5332,5349,245272,181866,2025-04-07,2025-05-16,505.28,17,-63406,191683614,-460736.000000003,0.0948782194809829,96.646180199837,-0.348641307336171
566.46,340,8,8,181168,181168,2025-04-07,2025-07-18,505.28,0,0,104857395,-33238059,0.172775606336587,97.2637285143313,0
585.85,584,1003,979,293879,181115,2025-04-07,2025-05-30,505.28,-24,-112764,25903649,-10875774,0.699187207176873,78.2197481134801,-0.622609943958259
645.12,645,15106,15062,211484,180744,2025-04-07,2025-06-20,505.28,-44,-30740,478977607,-137482950,0.0377353758001467,99.815916237604,-0.170074801929801
576.13,573,667,576,391529,180288,2025-04-07,2025-05-30,505.28,-91,-211241,25903649,-10875774,0.695994606783006,78.9157427202631,-1.17168641285055
524.46,470,0,33,0,179718,2025-04-07,2025-05-09,505.28,33,179718,21122544,7108655,0.850835013055246,79.222876751967,1
569.4,420,12,12,179280,179280,2025-04-07,2025-07-18,505.28,0,0,104857395,-33238059,0.170975065707097,97.4347035800384,0
570.97,567,451,450,337799,178650,2025-04-07,2025-05-30,505.28,-1,-159149,25903649,-10875774,0.689671173354766,79.6054138936179,-0.890842429331094
559.96,538,81,81,270378,177876,2025-04-07,2025-08-15,505.28,0,-92502,112162086,-42661174,0.158588348651076,93.7426538233249,-0.520036429872496
546.59,541,314,318,395640,177762,2025-04-07,2025-04-25,505.28,4,-217878,13056472,-3270620,1.36148570609273,62.6116610980363,-1.2256725284369
566.57,345,8,8,177256,177256,2025-04-07,2025-08-15,505.28,0,0,112162086,-42661174,0.158035577191387,93.9006894005163,0
566.15,390,10,10,176150,176150,2025-04-07,2025-07-18,505.28,0,0,104857395,-33238059,0.167990059260961,97.6026936392994,0
542.78,541,546,987,442260,175686,2025-04-07,2025-04-11,505.28,441,-266574,52569756,25897074,0.334195958604031,93.0680104355059,-1.51733205833134
550.79,537,108,127,242244,175133,2025-04-07,2025-05-30,505.28,19,-67111,25903649,-10875774,0.676093935645901,80.2815078292638,-0.383200196422148
563.56,370,9,9,174204,174204,2025-04-07,2025-07-18,505.28,0,0,104857395,-33238059,0.16613420541298,97.7688278447123,0
620.23,620,7575,7533,174225,173259,2025-04-07,2025-05-30,505.28,-42,-966,25903649,-10875774,0.668859433665118,80.9503672629289,-0.00557546794105934
521.11,499,0,78,0,172458,2025-04-07,2025-04-11,505.28,78,172458,52569756,25897074,0.32805554585416,93.3960659813601,1
567.8,445,14,14,171920,171920,2025-04-07,2025-08-15,505.28,0,0,112162086,-42661174,0.153278176370579,94.0539675768869,0
515.1,425,8,19,111296,171190,2025-04-07,2025-05-16,505.28,11,59894,191683614,-460736.000000003,0.0893086249928489,96.7354888248299,0.349868567089199
570.13,448,14,14,170982,170982,2025-04-07,2025-08-15,505.28,0,0,112162086,-42661174,0.152441886646081,94.206409463533,0
549.08,538,79,154,177118,170632,2025-04-07,2025-05-30,505.28,75,-6486,25903649,-10875774,0.65871800532813,81.609085268257,-0.0380116273618079
520.33,507,0,128,0,170624,2025-04-07,2025-04-11,505.28,128,170624,52569756,25897074,0.324566847903955,93.720632829264,1
589.77,589,2522,2212,332904,170324,2025-04-07,2025-05-16,505.28,-310,-162580,191683614,-460736.000000003,0.0888568388532157,96.8243456636831,-0.954533712219065
587.35,586,1262,1260,326858,170100,2025-04-07,2025-05-30,505.28,-2,-156758,25903649,-10875774,0.656664240624941,82.2657495088819,-0.92156378600823
551.2,547,372,404,410688,169680,2025-04-07,2025-05-02,505.28,32,-241008,15637149,-467056,1.08510828924122,66.3572688346194,-1.42036775106082
527.53,490,15,45,87480,168885,2025-04-07,2025-05-09,505.28,30,81405,21122544,7108655,0.799548577103213,80.0224253290702,0.482014388489209
566.18,325,7,7,168826,168826,2025-04-07,2025-07-18,505.28,0,0,104857395,-33238059,0.16100533491224,97.9298331796246,0
571.5,570,986,1119,375666,167850,2025-04-07,2025-05-09,505.28,133,-207816,21122544,7108655,0.794648599146012,80.8170739282162,-1.2381054512958
522.23,355,2,10,49668,167230,2025-04-07,2025-05-16,505.28,8,117562,191683614,-460736.000000003,0.0872427207053807,96.9115883843885,0.702995873946062
516.57,494,0,74,0,167018,2025-04-07,2025-04-11,505.28,74,167018,52569756,25897074,0.317707390538392,94.0383402198024,1
537.24,527,0,163,0,166912,2025-04-07,2025-05-02,505.28,163,166912,15637149,-467056,1.06740685274534,67.4246756873648,1
598,265,5,5,166500,166500,2025-04-07,2025-06-20,505.28,0,0,478977607,-137482950,0.0347615415766191,99.8506777791806,0
550.23,547,315,515,296730,166345,2025-04-07,2025-04-25,505.28,200,-130385,13056472,-3270620,1.2740424825328,63.8857035805691,-0.783822777961466
517.13,420,13,17,156897,165121,2025-04-07,2025-04-25,505.28,4,8224,13056472,-3270620,1.26466782144518,65.1503714020143,0.0498058999158193
566.97,563,426,415,385104,164755,2025-04-07,2025-05-30,505.28,-11,-220349,25903649,-10875774,0.63603008209384,82.9017795909758,-1.3374343722497
705.43,705,3813,3830,156333,164690,2025-04-07,2025-12-19,505.28,17,8357,850516954,-173881469,0.0193635175907381,99.9339473484499,0.0507438217256664
700.15,700,10616,10979,169856,164685,2025-04-07,2025-09-19,505.28,363,-5171,264848567,-73847933,0.0621808159528384,99.2136857587755,-0.0313993381303701
578.51,577.5,1639,1628,381887,164428,2025-04-07,2025-05-09,505.28,-11,-217459,21122544,7108655,0.778447899078823,81.595521827295,-1.32251806261707
625.09,625,17876,17894,71504,161046,2025-04-07,2025-05-02,505.28,18,89542,15637149,-467056,1.02989362063379,68.4545693079986,0.556002632788148
567.04,300,6,6,160224,160224,2025-04-07,2025-09-19,505.28,0,0,264848567,-73847933,0.0604964572075635,99.2741822159831,0
605.53,605,3012,3016,207828,159848,2025-04-07,2025-05-30,505.28,4,-47980,25903649,-10875774,0.617086805028898,83.5188663960047,-0.300160152144537
527,300,6,7,158778,158900,2025-04-07,2025-08-15,505.28,1,122,112162086,-42661174,0.141669975717106,94.3480794392501,0.000767778477029578
541.59,315,7,7,158613,158613,2025-04-07,2025-08-15,505.28,0,0,112162086,-42661174,0.141414096025283,94.4894935352754,0
546.45,542,193,355,234495,157975,2025-04-07,2025-04-25,505.28,162,-76520,13056472,-3270620,1.20993634421305,66.3603077462273,-0.484380439943029
524.49,485,34,40,206244,157960,2025-04-07,2025-05-02,505.28,6,-48284,15637149,-467056,1.01015856534973,69.4647278733483,-0.305672322106863
545,370,9,9,157500,157500,2025-04-07,2025-08-15,505.28,0,0,112162086,-42661174,0.140421782098453,94.6299153173738,0
592.21,591,1298,1296,246620,156816,2025-04-07,2025-05-30,505.28,-2,-89804,25903649,-10875774,0.605381890404707,84.1242482864094,-0.572671156004489
567.79,564,404,411,355924,155769,2025-04-07,2025-05-30,505.28,7,-200155,25903649,-10875774,0.601339988817792,84.7255882752272,-1.28494758263839
593.62,593,2679,2505,254505,155310,2025-04-07,2025-05-16,505.28,-174,-99195,191683614,-460736.000000003,0.0810241401229006,96.9926125245114,-0.638690361213058
580.6,580,2219,2586,268499,155160,2025-04-07,2025-05-02,505.28,367,-113339,15637149,-467056,0.992252487969514,70.4569803613178,-0.730465326114978
529.22,485,33,35,215325,154770,2025-04-07,2025-05-30,505.28,2,-60555,25903649,-10875774,0.597483389309359,85.3230716645365,-0.391257995735608
539.05,528,0,140,0,154700,2025-04-07,2025-05-09,505.28,140,154700,21122544,7108655,0.732392840559357,82.3279146678544,1
567.95,458,14,14,153930,153930,2025-04-07,2025-08-15,505.28,0,0,112162086,-42661174,0.137238888370889,94.7671542057447,0
584.6,583,955,961,295095,153760,2025-04-07,2025-05-30,505.28,6,-141335,25903649,-10875774,0.593584324741275,85.9166559892778,-0.919192247658689
565.93,565,1536,1649,442368,153357,2025-04-07,2025-04-25,505.28,113,-289011,13056472,-3270620,1.17456691210306,67.5348746583304,-1.88456346955144
558.69,489,22,22,153318,153318,2025-04-07,2025-08-15,505.28,0,0,112162086,-42661174,0.136693249446163,94.9038474551909,0
532.48,503,0,52,0,153296,2025-04-07,2025-05-16,505.28,52,153296,191683614,-460736.000000003,0.0799734504171024,97.0725859749285,1
562.7,445,13,13,153010,153010,2025-04-07,2025-05-30,505.28,0,0,25903649,-10875774,0.590688979764975,86.5073449690428,0
526.21,400,12,12,175800,151452,2025-04-07,2025-05-30,505.28,0,-24348,25903649,-10875774,0.584674383134206,87.092019352177,-0.160763806354489
535.74,527,0,173,0,151202,2025-04-07,2025-04-25,505.28,173,151202,13056472,-3270620,1.15806168772085,68.6929363460512,1
556.43,550,90,234,125820,150462,2025-04-07,2025-05-23,505.28,144,24642,3097569,2640978,4.85742206226883,50.5443462276385,0.163775571240579
540.9,530,30,137,74280,149330,2025-04-07,2025-05-09,505.28,107,75050,21122544,7108655,0.706969766520548,83.034884434375,0.502578182548718
562.83,350,7,7,148981,148981,2025-04-07,2025-07-18,505.28,0,0,104857395,-33238059,0.142079631102794,98.0719128107274,0
550.66,365,8,8,148528,148528,2025-04-07,2025-07-18,505.28,0,0,104857395,-33238059,0.141647615792858,98.2135604265202,0
592.63,592,2414,2356,255884,148428,2025-04-07,2025-05-16,505.28,-58,-107456,191683614,-460736.000000003,0.0774338488839218,97.1500198238124,-0.723960438731237
523.85,495,49,51,399791,147135,2025-04-07,2025-05-02,505.28,2,-252656,15637149,-467056,0.940932391192282,71.3979127525101,-1.71717130526387
552.73,552,1016,2011,365760,146803,2025-04-07,2025-04-11,505.28,995,-218957,52569756,25897074,0.279253721474378,94.3175939412768,-1.49150221725714
547.78,512,30,41,198630,146698,2025-04-07,2025-08-15,505.28,11,-51932,112162086,-42661174,0.130791076763676,95.0346385319546,-0.35400618958677
520.49,435,11,17,123607,145333,2025-04-07,2025-07-18,505.28,6,21726,104857395,-33238059,0.138600620394966,98.3521610469152,0.149491168557726
569.9,390,8,8,143920,143920,2025-04-07,2025-08-15,505.28,0,0,112162086,-42661174,0.12831430399752,95.1629528359521,0
569.9,410,9,9,143910,143910,2025-04-07,2025-07-18,505.28,0,0,104857395,-33238059,0.137243539189582,98.4894045861048,0
675.32,675,4480,4493,143360,143776,2025-04-07,2025-09-19,505.28,13,416,264848567,-73847933,0.0542861158844783,99.3284683318675,0.00289338971733808
515.15,413,4,14,58212,143010,2025-04-07,2025-05-16,505.28,10,84798,191683614,-460736.000000003,0.074607316199704,97.2246271400121,0.59295154185022
545.11,538,23,201,37743,142911,2025-04-07,2025-05-02,505.28,178,105168,15637149,-467056,0.913919794458696,72.3118325469688,0.735898566240527
562.65,559,191,389,142677,141985,2025-04-07,2025-05-09,505.28,198,-692,21122544,7108655,0.672196492998192,83.7070809273732,-0.00487375426981723
566.98,425,10,10,141980,141980,2025-04-07,2025-07-18,505.28,0,0,104857395,-33238059,0.135402944160495,98.6248075302653,0
547.16,546,1020,1213,604860,140708,2025-04-07,2025-04-11,505.28,193,-464152,52569756,25897074,0.267659602604966,94.5852535438818,-3.29868948460642
572.74,571,439,804,157601,139896,2025-04-07,2025-05-09,505.28,365,-17705,21122544,7108655,0.66230658579762,84.3693875131708,-0.126558300451764
609.72,260,4,4,139888,139888,2025-04-07,2025-08-15,505.28,0,0,112162086,-42661174,0.1247195063758,95.2876723423279,0
517.11,390,3,11,51750,139821,2025-04-07,2025-05-16,505.28,8,88071,191683614,-460736.000000003,0.0729436372166898,97.2975707772288,0.629883923015856
507.39,400,2,13,35176,139607,2025-04-07,2025-04-11,505.28,11,104431,52569756,25897074,0.265565242494182,94.850818786376,0.748035556956313
568.4,395,8,8,138720,138720,2025-04-07,2025-08-15,505.28,0,0,112162086,-42661174,0.123678156271095,95.411350498599,0
564.01,465,14,14,138614,138614,2025-04-07,2025-05-30,505.28,0,0,25903649,-10875774,0.53511379805988,87.6271331502369,0
524.44,480,6,31,43800,137764,2025-04-07,2025-05-30,505.28,25,93964,25903649,-10875774,0.531832407086739,88.1589655573236,0.682064980691618
555.93,552,332,349,298136,137157,2025-04-07,2025-05-02,505.28,17,-160979,15637149,-467056,0.877122805442348,73.1889553524111,-1.17368417215308
650.24,650,5634,5704,140850,136896,2025-04-07,2025-07-18,505.28,70,-3954,104857395,-33238059,0.130554454456932,98.7553619847222,-0.0288832398316971
551.08,548,430,442,396030,136136,2025-04-07,2025-04-25,505.28,12,-259894,13056472,-3270620,1.04267063874529,69.7356069847965,-1.90907621789975
574.88,495,17,17,135796,135796,2025-04-07,2025-08-15,505.28,0,0,112162086,-42661174,0.121071214741851,95.5324217133408,0
570.66,570,2003,2046,380570,135036,2025-04-07,2025-04-25,505.28,43,-245534,13056472,-3270620,1.03424569822537,70.7698526830219,-1.81828549423857
529.9,500,0,45,0,134550,2025-04-07,2025-05-23,505.28,45,134550,3097569,2640978,4.34372890482827,54.8880751324668,1
609.6,275,4,4,133840,133840,2025-04-07,2025-08-15,505.28,0,0,112162086,-42661174,0.119327309943219,95.651749023284,0
514.21,180,0,4,0,133684,2025-04-07,2025-09-19,505.28,4,133684,264848567,-73847933,0.0504756365172253,99.3789439683848,1
528.4,495,20,40,136420,133600,2025-04-07,2025-05-30,505.28,20,-2819.99999999997,25903649,-10875774,0.515757451778319,88.6747230091019,-0.0211077844311375
556.62,487,19,19,132278,132278,2025-04-07,2025-08-15,505.28,0,0,112162086,-42661174,0.117934682491551,95.7696837057756,0
522.69,450,17,18,153068,130842,2025-04-07,2025-04-25,505.28,1,-22226,13056472,-3270620,1.00212369773397,71.7719763807559,-0.169869002308127
526.18,490,1,36,6200,130248,2025-04-07,2025-05-02,505.28,35,124048,15637149,-467056,0.83293955950666,74.0218949119178,0.952398501320558
670.3,670,4333,4334,103992,130020,2025-04-07,2025-08-15,505.28,1,26028,112162086,-42661174,0.115921524498038,95.8856052302736,0.200184586986617
545.39,544,610,930,411140,129270,2025-04-07,2025-04-11,505.28,320,-281870,52569756,25897074,0.245901845159791,95.0967206315357,-2.18047497485882
563.74,380,7,7,128618,128618,2025-04-07,2025-07-18,505.28,0,0,104857395,-33238059,0.122659923031656,98.8780219077539,0
575.46,575,2408,2755,279328,126730,2025-04-07,2025-04-25,505.28,347,-152598,13056472,-3270620,0.970629738263139,72.742606119019,-1.20411899313501
660.26,660,4863,4863,92397,126438,2025-04-07,2025-07-18,505.28,0,34041,104857395,-33238059,0.120580908957351,98.9986028167112,0.269230769230769
557.82,553,225,260,224775,125320,2025-04-07,2025-05-09,505.28,35,-99455,21122544,7108655,0.593299746469933,84.9626872596407,-0.793608362591765
559.4,558,452,892,235040,124880,2025-04-07,2025-04-25,505.28,440,-110160,13056472,-3270620,0.956460520116001,73.699066639135,-0.882126841768097
563.02,355,6,6,124812,124812,2025-04-07,2025-07-18,505.28,0,0,104857395,-33238059,0.11903023148725,99.1176330481985,0
555.99,554,545,626,350980,124574,2025-04-07,2025-04-25,505.28,81,-226406,13056472,-3270620,0.954116854844096,74.6531834939791,-1.81744184179684
513.24,485,4,44,31324,124256,2025-04-07,2025-04-11,505.28,40,92932,52569756,25897074,0.236364041712501,95.3330846732483,0.747907545712078
553,415,9,9,124200,124200,2025-04-07,2025-07-18,505.28,0,0,104857395,-33238059,0.118446581664555,99.236079629863,0
625.24,625,5168,5172,87856,124128,2025-04-07,2025-05-30,505.28,4,36272,25903649,-10875774,0.479191174957629,89.1539141840596,0.292214488270173
539.05,532,69,176,123717,124080,2025-04-07,2025-04-25,505.28,107,363,13056472,-3270620,0.950333290646968,75.6035167846261,0.00292553191489362
552.71,470,15,15,124065,124065,2025-04-07,2025-08-15,505.28,0,0,112162086,-42661174,0.11061224378441,95.996217474058,0
551.76,551,1341,1627,535059,123652,2025-04-07,2025-04-11,505.28,286,-411407,52569756,25897074,0.235215092114942,95.5682997653632,-3.32713583282114
575.81,575,1360,1526,265200,123606,2025-04-07,2025-05-02,505.28,166,-141594,15637149,-467056,0.790463785949728,74.8123586978675,-1.14552691616912
515.92,495,16,59,71392,123428,2025-04-07,2025-04-11,505.28,43,52036,52569756,25897074,0.234788991601939,95.8030887569651,0.421589914768124
580.36,578,543,523,228060,123428,2025-04-07,2025-05-30,505.28,-20,-104632,25903649,-10875774,0.476488852979748,89.6304030370393,-0.847716887578183
548.2,543,179,237,238428,123240,2025-04-07,2025-05-02,505.28,58,-115188,15637149,-467056,0.788123205835028,75.6004819037025,-0.934664070107108
670.39,670,3145,3144,122655,122616,2025-04-07,2025-09-19,505.28,-1,-38.9999999999855,264848567,-73847933,0.0462966446784664,99.4252406130632,-0.000318066157760696
567.66,365,6,6,121596,121596,2025-04-07,2025-09-19,505.28,0,0,264848567,-73847933,0.0459115189398023,99.4711521320031,0
568.17,395,7,7,121219,121219,2025-04-07,2025-07-18,505.28,0,0,104857395,-33238059,0.115603672969369,99.3516833028324,0
565.23,365,6,6,120138,120138,2025-04-07,2025-08-15,505.28,0,0,112162086,-42661174,0.107111060684089,96.1033285347421,0
542.82,532,5,111,20465,120102,2025-04-07,2025-05-02,505.28,106,99637,15637149,-467056,0.768055609113912,76.3685375128164,0.829603170638291
564.66,415,8,8,119728,119728,2025-04-07,2025-08-15,505.28,0,0,112162086,-42661174,0.106745518267198,96.2100740530093,0
515.29,416,2,12,29638,119148,2025-04-07,2025-05-16,505.28,10,89510,191683614,-460736.000000003,0.0621586777887024,97.3597294550175,0.751250545540001
573.39,494,15,15,119085,119085,2025-04-07,2025-08-15,505.28,0,0,112162086,-42661174,0.106172240769488,96.3162462937788,0
597.88,597,1323,1340,166698,117920,2025-04-07,2025-05-30,505.28,17,-48778,25903649,-10875774,0.455225439473798,90.0856284765131,-0.413653324287653
515.26,417,2,12,28280,117912,2025-04-07,2025-05-16,505.28,10,89632,191683614,-460736.000000003,0.0615138652383714,97.4212433202558,0.760160119411086
541.97,531,6,107,14448,117379,2025-04-07,2025-05-02,505.28,101,102931,15637149,-467056,0.75064194886165,77.1191794616781,0.876911542950613
600.16,600,6511,7328,110687,117248,2025-04-07,2025-05-02,505.28,817,6560.99999999999,15637149,-467056,0.749804200241361,77.8689836619195,0.0559583105895195
573.26,572,885,929,220365,117054,2025-04-07,2025-05-02,505.28,44,-103311,15637149,-467056,0.748563564880017,78.6175472267995,-0.882592649546363
562.06,395,7,7,116942,116942,2025-04-07,2025-05-16,505.28,0,0,191683614,-460736.000000003,0.0610078230265421,97.4822511432824,0
512.43,480,3,36,27525,116748,2025-04-07,2025-04-11,505.28,33,89223,52569756,25897074,0.222082065589195,96.0251708225543,0.764235789906465
566.78,451,10,10,115780,115780,2025-04-07,2025-08-15,505.28,0,0,112162086,-42661174,0.103225612262596,96.4194719060414,0
625.14,625,8292,8240,58044,115360,2025-04-07,2025-05-16,505.28,-52,57316,191683614,-460736.000000003,0.0601825046975586,97.54243364798,0.496844660194175
576.18,575,875,975,241500,115050,2025-04-07,2025-05-09,505.28,100,-126450,21122544,7108655,0.544678709155488,85.5073659687962,-1.09908735332464
558.69,557,694,680,365044,114920,2025-04-07,2025-04-25,505.28,-14,-250124,13056472,-3270620,0.880176513226544,76.4836932978526,-2.17650539505743
545.61,539,119,172,187306,113692,2025-04-07,2025-05-02,505.28,53,-73614,15637149,-467056,0.727063481968484,79.344610708768,-0.647486190761003
521.96,480,14,27,89110,113292,2025-04-07,2025-05-09,505.28,13,24182,21122544,7108655,0.536355848045576,86.0437218168418,0.213448434134802
527.21,499,1,40,6572,112840,2025-04-07,2025-05-16,505.28,39,106268,191683614,-460736.000000003,0.0588678383328061,97.6013014863128,0.941758241758242
564.81,562,392,399,245000,112119,2025-04-07,2025-05-09,505.28,7,-132881,21122544,7108655,0.530802539694082,86.5745243565359,-1.18517824811138
555.19,553,407,510,285307,111690,2025-04-07,2025-04-25,505.28,103,-173617,13056472,-3270620,0.855437824245324,77.3391311220979,-1.55445429313278
620.13,620,8627,8546,77643,111098,2025-04-07,2025-05-16,505.28,-81,33455,191683614,-460736.000000003,0.0579590491235208,97.6592605354363,0.301130533402942
514.8,414,1,11,15024,110880,2025-04-07,2025-05-16,505.28,10,95856,191683614,-460736.000000003,0.0578453200491097,97.7171058554854,0.864502164502165
537.02,534,104,367,130104,110834,2025-04-07,2025-04-11,505.28,263,-19270,52569756,25897074,0.210832251152164,96.2360030737065,-0.17386361585795
588.56,587,708,709,172752,110604,2025-04-07,2025-05-30,505.28,1,-62148,25903649,-10875774,0.426982314344979,90.5126107908581,-0.561896495605946
566.51,565,569,732,235566,110532,2025-04-07,2025-05-02,505.28,163,-125034,15637149,-467056,0.706855194639381,80.0514659034073,-1.1312018239062
570.52,569,731,722,230265,109744,2025-04-07,2025-05-02,505.28,-9,-120521,15637149,-467056,0.701815912862377,80.7532818162697,-1.09820126840647
560.33,558,426,471,278604,109743,2025-04-07,2025-05-02,505.28,45,-168861,15637149,-467056,0.701809517834741,81.4550913341045,-1.53869495093081
523.5,480,27,25,177930,108750,2025-04-07,2025-05-02,505.28,-2,-69180,15637149,-467056,0.695459255392399,82.1505505894969,-0.636137931034483
655.09,655,11967,12007,119670,108063,2025-04-07,2025-06-20,505.28,40,-11607,478977607,-137482950,0.0225611799843495,99.873238959165,-0.107409566641681
665.45,665,2427,2401,118923,108045,2025-04-07,2025-09-19,505.28,-26,-10878,264848567,-73847933,0.0407950102293738,99.5119471422324,-0.100680272108844
630.09,630,13258,11995,66290,107955,2025-04-07,2025-05-16,505.28,-1263,41665,191683614,-460736.000000003,0.0563193680185934,97.773425223504,0.385947848640637
685.29,685,3717,3717,81774,107793,2025-04-07,2025-09-19,505.28,0,26019,264848567,-73847933,0.0406998615174686,99.5526470037499,0.241379310344828
561.2,559,508,489,308864,107580,2025-04-07,2025-05-02,505.28,-19,-201284,15637149,-467056,0.687977073058522,82.8385276625554,-1.87101691764268
563.23,385,6,6,106938,106938,2025-04-07,2025-05-16,505.28,0,0,191683614,-460736.000000003,0.0557888062356754,97.8292140297397,0
563.12,385,6,6,106872,106872,2025-04-07,2025-08-15,505.28,0,0,112162086,-42661174,0.095283534580482,96.5147554406219,0
538.46,527,0,93,0,106578,2025-04-07,2025-05-09,505.28,93,106578,21122544,7108655,0.504569904079736,87.0790942606156,1
594.53,594,2293,1998,206370,105894,2025-04-07,2025-05-16,505.28,-295,-100476,191683614,-460736.000000003,0.0552441587417065,97.8844581884814,-0.948835628080911
558.58,488,15,15,105870,105870,2025-04-07,2025-08-15,505.28,0,0,112162086,-42661174,0.0943901845762747,96.6091456251982,0
540.45,534,43,164,84796,105780,2025-04-07,2025-04-25,505.28,121,20984,13056472,-3270620,0.810172916542846,78.1493040386408,0.198373983739838
572.51,572,1996,2071,303392,105621,2025-04-07,2025-04-25,505.28,75,-197771,13056472,-3270620,0.808955129685875,78.9582591683266,-1.87245907537327
550,519,34,34,199546,105400,2025-04-07,2025-08-15,505.28,0,-94146,112162086,-42661174,0.0939711481471555,96.7031167733453,-0.893225806451613
542.83,536,33,154,51249,105182,2025-04-07,2025-04-25,505.28,121,53933,13056472,-3270620,0.805592812514744,79.7638519808414,0.512758837063376
547.03,541,63,174,89775,104922,2025-04-07,2025-05-02,505.28,111,15147,15637149,-467056,0.670979089602587,83.509506752158,0.144364384971693
522.38,465,0,18,0,103284,2025-04-07,2025-05-09,505.28,18,103284,21122544,7108655,0.488975191624645,87.5680694522402,1
598.47,598,2386,2197,155090,103259,2025-04-07,2025-05-16,505.28,-189,-51831,191683614,-460736.000000003,0.0538694976817371,97.9383276861631,-0.501951403751731
552.81,549,284,270,241968,102870,2025-04-07,2025-04-25,505.28,-14,-139098,13056472,-3270620,0.787885119349239,80.5517371001906,-1.35217264508603
551.7,548,240,278,264240,102860,2025-04-07,2025-05-02,505.28,38,-161380,15637149,-467056,0.657792542617584,84.1672992947755,-1.56892864087109
515.25,422,1,11,13908,102575,2025-04-07,2025-05-16,505.28,10,88667,191683614,-460736.000000003,0.0535126596684472,97.9918403458316,0.864411406288082
604.32,604,3246,3187,120102,101984,2025-04-07,2025-05-16,505.28,-59,-18118,191683614,-460736.000000003,0.0532043391043326,98.0450446849359,-0.17765531848133
558.38,486,14,14,101332,101332,2025-04-07,2025-08-15,505.28,0,0,112162086,-42661174,0.0903442541180983,96.7934610274634,0
556.72,553,260,271,228800,100812,2025-04-07,2025-05-02,505.28,11,-127988,15637149,-467056,0.644695526019481,84.811994820795,-1.2695710828076
559.38,556,144,298,122400,100724,2025-04-07,2025-05-09,505.28,154,-21676,21122544,7108655,0.47685543938268,88.0449248916229,-0.215201937969104
524.68,475,0,20,0,99360,2025-04-07,2025-05-09,505.28,20,99360,21122544,7108655,0.470397883891259,88.5153227755142,1
549.98,549,408,1011,181152,99078,2025-04-07,2025-04-11,505.28,603,-82074,52569756,25897074,0.188469583157282,96.4244726568638,-0.82837764185793
554.51,527,23,36,105478,99036,2025-04-07,2025-08-15,505.28,13,-6442,112162086,-42661174,0.0882972165835076,96.8817582440469,-0.0650470535966719
565.6,456,9,9,98640,98640,2025-04-07,2025-08-15,505.28,0,0,112162086,-42661174,0.0879441561028029,96.9697024001497,0
591.64,591,1904,1540,211344,98560,2025-04-07,2025-05-16,505.28,-364,-112784,191683614,-460736.000000003,0.0514180622658753,98.0964627472018,-1.14431818181818
578.34,577,735,733,170520,98222,2025-04-07,2025-05-09,505.28,-2,-72298,21122544,7108655,0.465010275277448,88.9803330507916,-0.736067276170308
537.54,528,0,102,0,97308,2025-04-07,2025-04-25,505.28,102,97308,13056472,-3270620,0.74528555646579,81.2970226566564,1
593.04,592,917,933,162309,97032,2025-04-07,2025-05-30,505.28,16,-65277,25903649,-10875774,0.374588151653846,90.8871989425119,-0.672736829087311
566.91,565,468,506,244764,96646,2025-04-07,2025-05-09,505.28,38,-148118,21122544,7108655,0.457549052803488,89.4378821035951,-1.53258282805289
579.2,578,803,805,176660,96600,2025-04-07,2025-05-09,505.28,2,-80060,21122544,7108655,0.45733127600539,89.8952133796005,-0.828778467908903
550.75,539,83,82,175960,96350,2025-04-07,2025-05-30,505.28,-1,-79610,25903649,-10875774,0.371955317955397,91.2591542604673,-0.826258432797094
557.5,554,253,275,202400,96250,2025-04-07,2025-05-02,505.28,22,-106150,15637149,-467056,0.615521409944997,85.42751623074,-1.10285714285714
725.3,725,3097,3207,80522,96210,2025-04-07,2025-12-19,505.28,110,15688,850516954,-173881469,0.0113119438181123,99.945259292268,0.163059972975782
640.12,640,7870,7868,55090,94416,2025-04-07,2025-05-30,505.28,-2,39326,25903649,-10875774,0.36448918837651,91.6236434488438,0.416518386714116
535.37,480,16,17,155680,94129,2025-04-07,2025-08-15,505.28,1,-61551,112162086,-42661174,0.0839222979501291,97.0536246980999,-0.653900498252398
553.64,553,1390,1467,467040,93888,2025-04-07,2025-04-11,505.28,77,-373152,52569756,25897074,0.178596986449775,96.6030696433135,-3.97443762781186
544.3,440,9,9,93870,93870,2025-04-07,2025-05-02,505.28,0,0,15637149,-467056,0.600301244171812,86.0278174749118,0
556.49,552.5,179,234,158057,93366,2025-04-07,2025-05-02,505.28,55,-64691,15637149,-467056,0.597078150243372,86.6248956251552,-0.692875350770087
515.63,431,1,11,13104,93093,2025-04-07,2025-05-16,505.28,10,79989,191683614,-460736.000000003,0.048565966624565,98.1450287138263,0.859237536656891
580.85,580,1046,1094,193510,92990,2025-04-07,2025-05-09,505.28,48,-100520,21122544,7108655,0.440240531632932,90.3354539112334,-1.08097644908055
537,529,0,115,0,92000,2025-04-07,2025-04-25,505.28,115,92000,13056472,-3270620,0.704631388938758,82.0016540455952,1
583.69,582,359,544,120624,91936,2025-04-07,2025-05-30,505.28,185,-28688,25903649,-10875774,0.354915247654877,91.9785586964987,-0.31204316045945
599.43,599,2190,2137,129210,91891,2025-04-07,2025-05-16,505.28,-53,-37319,191683614,-460736.000000003,0.0479388916362981,98.1929676054626,-0.406122471188691
715.11,715,8303,8303,91333,91333,2025-04-07,2025-09-19,505.28,0,0,264848567,-73847933,0.0344849893033403,99.5871319930532,0
561.3,561,2690,3037,371220,91110,2025-04-07,2025-04-11,505.28,347,-280110,52569756,25897074,0.173312579194775,96.7763822225083,-3.07441554165295
524.55,434,2,10,25696,90550,2025-04-07,2025-05-16,505.28,8,64854,191683614,-460736.000000003,0.0472393013207691,98.2402069067834,0.716223081170624
597.49,597,1865,1846,119360,90454,2025-04-07,2025-05-16,505.28,-19,-28906,191683614,-460736.000000003,0.0471892187925881,98.287396125576,-0.319565746125102
525.41,425,9,9,126072,90369,2025-04-07,2025-08-15,505.28,0,-35703,112162086,-42661174,0.0805700065171755,97.134194704617,-0.39508017129768
569.35,469,9,9,90315,90315,2025-04-07,2025-08-15,505.28,0,0,112162086,-42661174,0.0805218619061703,97.2147165665232,0
615.33,615,2716,2721,84196,89793,2025-04-07,2025-05-30,505.28,5,5597,25903649,-10875774,0.346642281942594,92.3252009784413,0.0623322530709521
825.07,825,12765,12802,51060,89614,2025-04-07,2025-09-19,505.28,37,38554,264848567,-73847933,0.0338359391614152,99.6209679322146,0.430222956234517
655.31,655,2861,2863,62942,88753,2025-04-07,2025-07-18,505.28,2,25811,104857395,-33238059,0.0846416220811131,99.4363249249135,0.290818338535036
605.47,310,3,3,88641,88641,2025-04-07,2025-08-15,505.28,0,0,112162086,-42661174,0.0790293789650096,97.2937459454882,0
533.03,465,10,13,107630,88439,2025-04-07,2025-07-18,505.28,3,-19191,104857395,-33238059,0.0843421677603187,99.5206670926738,-0.216997026198849
559,265,3,3,88200,88200,2025-04-07,2025-09-19,505.28,0,0,264848567,-73847933,0.0333020491668358,99.6542699813815,0
690.14,690,6274,6274,87836,87836,2025-04-07,2025-08-15,505.28,0,0,112162086,-42661174,0.0783116676342842,97.3720576131225,0
527.57,440,23,10,244168,87570,2025-04-07,2025-05-16,505.28,-13,-156598,191683614,-460736.000000003,0.0456846561751491,98.3330807817511,-1.7882608199155
700.07,700,12755,12465,38265,87255,2025-04-07,2025-06-20,505.28,-290,48990,478977607,-137482950,0.0182169267883958,99.8914558859533,0.561457796114836
567.82,471,9,9,87138,87138,2025-04-07,2025-08-15,505.28,0,0,112162086,-42661174,0.0776893539586987,97.4497469670812,0
590.15,589,749,756,160286,86940,2025-04-07,2025-05-30,505.28,7,-73346,25903649,-10875774,0.335628389652747,92.660829368094,-0.843639291465378
556.8,533,35,36,164325,85680,2025-04-07,2025-08-15,505.28,1,-78645,112162086,-42661174,0.0763894494615587,97.5261364165428,-0.917892156862745
582.4,370,4,4,84960,84960,2025-04-07,2025-09-19,505.28,0,0,264848567,-73847933,0.0320787085851969,99.6863486899667,0
555.25,551,178,199,209150,84575,2025-04-07,2025-05-09,505.28,21,-124575,21122544,7108655,0.400401580415692,90.7358554916491,-1.4729530002956
610.42,610,1934,2009,90898,84378,2025-04-07,2025-05-30,505.28,75,-6519.99999999999,25903649,-10875774,0.325737891213705,92.9865672593077,-0.0772713266491264
557.43,557,1915,1962,409810,84366,2025-04-07,2025-04-11,505.28,47,-325444,52569756,25897074,0.160483910178316,96.9368661326866,-3.85752554346538
553.5,551,260,337,195260,84250,2025-04-07,2025-04-25,505.28,77,-111010,13056472,-3270620,0.645273853457504,82.6469278990527,-1.31762611275964
550.5,546,112,184,132720,82800,2025-04-07,2025-05-02,505.28,72,-49920,15637149,-467056,0.529508288243592,87.1544039133988,-0.602898550724638
569.98,566,207,208,168705,82784,2025-04-07,2025-05-30,505.28,1,-85921,25903649,-10875774,0.319584318024075,93.3061515773318,-1.03789379590259
563.39,460,8,8,82712,82712,2025-04-07,2025-05-30,505.28,0,0,25903649,-10875774,0.31930636490635,93.6254579422382,0
550.21,546,162,196,160380,82516,2025-04-07,2025-04-25,505.28,34,-77864,13056472,-3270620,0.631993083583375,83.278920982636,-0.943623054922682
525,450,9,11,108990,82500,2025-04-07,2025-07-18,505.28,2,-26490,104857395,-33238059,0.0786782849221078,99.5993453775959,-0.321090909090909
548.57,544,97,180,126973,82260,2025-04-07,2025-05-02,505.28,83,-44713,15637149,-467056,0.526054973320265,87.6804588867191,-0.543557014344761
569.09,478,9,9,81981,81981,2025-04-07,2025-08-15,505.28,0,0,112162086,-42661174,0.0730915436077036,97.5992279601505,0
568.69,405,5,5,81845,81845,2025-04-07,2025-08-15,505.28,0,0,112162086,-42661174,0.0729702905133202,97.6721982506638,0
585.39,585,2074,2097,155550,81783,2025-04-07,2025-05-02,505.28,23,-73767,15637149,-467056,0.523004545137992,88.2034634318571,-0.901984520010271
560.07,557,117,265,94185,81355,2025-04-07,2025-05-09,505.28,148,-12830,21122544,7108655,0.385157204548846,91.121012696198,-0.157703890357077
572.3,571,556,619,150676,80470,2025-04-07,2025-05-02,505.28,63,-70206,15637149,-467056,0.514607873852197,88.7180713057093,-0.872449360009942
525.12,475,0,16,0,80192,2025-04-07,2025-05-23,505.28,16,80192,3097569,2640978,2.58886888395384,57.4769440164206,1
551.48,523,23,28,129352,79744,2025-04-07,2025-08-15,505.28,5,-49608,112162086,-42661174,0.0710971085184703,97.7432953591823,-0.622090690208668
549.99,539,0,72,0,79128,2025-04-07,2025-05-23,505.28,72,79128,3097569,2640978,2.55451936663881,60.0314633830594,1
580.34,580,2304,2305,145152,78370,2025-04-07,2025-04-25,505.28,1,-66782,13056472,-3270620,0.600238716860114,83.8791596994962,-0.852137297435243
563.18,561,345,358,184920,78044,2025-04-07,2025-05-02,505.28,13,-106876,15637149,-467056,0.499093536807765,89.217164842517,-1.36943262774845
567.71,438,6,6,77826,77826,2025-04-07,2025-08-15,505.28,0,0,112162086,-42661174,0.0693870832609158,97.8126824424432,0
511.12,400,4,7,56028,77784,2025-04-07,2025-04-25,505.28,3,21756,13056472,-3270620,0.595750521274047,84.4749102207702,0.279697624190065
544.46,415,6,6,77676,77676,2025-04-07,2025-05-16,505.28,0,0,191683614,-460736.000000003,0.0405230256144899,98.3736038073656,0
544.37,530,0,54,0,77598,2025-04-07,2025-05-23,505.28,54,77598,3097569,2640978,2.50512579380798,62.5365891768674,1
522.7,265,4,3,133852,77310,2025-04-07,2025-08-15,505.28,-1,-56542,112162086,-42661174,0.0689270347557552,97.8816094771989,-0.731367222868969
680.25,680,3077,3083,95387,77075,2025-04-07,2025-09-19,505.28,6,-18312,264848567,-73847933,0.0291015355956221,99.7154502255623,-0.23758676613688
543.75,539,113,162,156166,76950,2025-04-07,2025-04-25,505.28,49,-79216,13056472,-3270620,0.589362884552581,85.0642731053228,-1.02944769330734
563.6,561,291,294,195261,76440,2025-04-07,2025-05-09,505.28,3,-118821,21122544,7108655,0.361888227099918,91.4829009232979,-1.55443485086342
562.27,562,2560,2803,314880,75681,2025-04-07,2025-04-11,505.28,243,-239199,52569756,25897074,0.143963004127316,97.0808291368139,-3.16062155626908
571.71,571,1077,1064,172320,75544,2025-04-07,2025-04-25,505.28,-13,-96776,13056472,-3270620,0.578594278760756,85.6428673840835,-1.28105474954993
525,375,2,5,33160,75000,2025-04-07,2025-05-02,505.28,3,41840,15637149,-467056,0.479627072684413,89.6967919152014,0.557866666666667
635.11,635,7324,6816,43944,74976,2025-04-07,2025-05-16,505.28,-508,31032,191683614,-460736.000000003,0.039114454509398,98.412718261875,0.413892445582586
574.99,574,750,757,156000,74943,2025-04-07,2025-05-02,505.28,7,-81057,15637149,-467056,0.479262556109173,90.1760544713106,-1.08158200232176
560.41,557.5,260,256,221000,74496,2025-04-07,2025-05-02,505.28,-4,-146504,15637149,-467056,0.476403978755974,90.6524584500666,-1.96660223367698
608.25,608,2955,2969,79785,74225,2025-04-07,2025-05-16,505.28,14,-5560,191683614,-460736.000000003,0.0387226630649817,98.45144092494,-0.0749073762209498
511.88,475,2,20,19322,73760,2025-04-07,2025-04-11,505.28,18,54438,52569756,25897074,0.140308811781436,97.2211379485954,0.738042299349241
581.17,579,336,337,133728,73129,2025-04-07,2025-05-30,505.28,1,-60599,25903649,-10875774,0.282311577029167,93.9077695192674,-0.828658945151718
554.39,552,353,305,253807,72895,2025-04-07,2025-04-25,505.28,-48,-180912,13056472,-3270620,0.558305490181421,86.201172874265,-2.48181631113245
603.35,603,2114,2075,88788,72625,2025-04-07,2025-05-16,505.28,-39,-16163,191683614,-460736.000000003,0.0378879542619642,98.489328879202,-0.22255421686747
558.61,552,50,109,73450,72049,2025-04-07,2025-05-23,505.28,59,-1401,3097569,2640978,2.32598531299868,64.8625744898661,-0.0194450998625935
569.54,427,5,5,71270,71270,2025-04-07,2025-08-15,505.28,0,0,112162086,-42661174,0.0635419708581383,97.9451514480571,0
571.02,492,9,9,71118,71118,2025-04-07,2025-08-15,505.28,0,0,112162086,-42661174,0.0634064526938274,98.0085579007509,0
549,540,0,79,0,71100,2025-04-07,2025-05-23,505.28,79,71100,3097569,2640978,2.29534838449119,67.1579228743573,1
554.63,554,940,1127,286700,71001,2025-04-07,2025-04-11,505.28,187,-215699,52569756,25897074,0.135060546980663,97.3561984955761,-3.03797129617893
528.16,440,5,8,66135,70528,2025-04-07,2025-07-18,505.28,3,4393,104857395,-33238059,0.0672608736846839,99.6666062512806,0.0622873185117967
600.28,600,2465,2515,78880,70420,2025-04-07,2025-05-09,505.28,50,-8460,21122544,7108655,0.333387872218422,91.8162887955163,-0.120136324907697
618.14,618,1993,4931,25909,69034,2025-04-07,2025-05-16,505.28,2938,43125,191683614,-460736.000000003,0.0360145546921919,98.5253434338942,0.6246921806646
518.06,465,1,13,10243,68978,2025-04-07,2025-04-11,505.28,12,58735,52569756,25897074,0.131212326722612,97.4874108222987,0.851503377888602
542.43,485,13,12,99736,68916,2025-04-07,2025-08-15,505.28,-1,-30820,112162086,-42661174,0.0614432224450604,98.0700011231959,-0.447211097568054
670.13,670,5291,5290,74074,68770,2025-04-07,2025-07-18,505.28,-1,-5304.00000000001,104857395,-33238059,0.0655843109587073,99.7321905622393,-0.0771266540642724
528.36,502,0,26,0,68536,2025-04-07,2025-05-16,505.28,26,68536,191683614,-460736.000000003,0.0357547515772527,98.5610981854714,1
576.54,576,1309,1267,137445,68418,2025-04-07,2025-04-25,505.28,-42,-69027,13056472,-3270620,0.524015982265347,86.7251888565303,-1.00890116635973
553.02,548,81,136,102870,68272,2025-04-07,2025-05-09,505.28,55,-34598,21122544,7108655,0.323218642602899,92.1395074381192,-0.506767049449262
553.53,542,0,59,0,68027,2025-04-07,2025-05-23,505.28,59,68027,3097569,2640978,2.19614155487739,69.3540644292347,1
645.07,645,9664,9665,38656,67655,2025-04-07,2025-05-16,505.28,1,28999,191683614,-460736.000000003,0.0352951400425912,98.596393325514,0.428630552065627
528.62,305,0,3,0,67086,2025-04-07,2025-09-19,505.28,3,67086,264848567,-73847933,0.0253299463764892,99.7407801719388,1
665.27,665,2437,2474,65799,66798,2025-04-07,2025-08-15,505.28,37,999,112162086,-42661174,0.0595548838134127,98.1295560070094,0.0149555375909458
573.71,572.5,521,551,122956,66671,2025-04-07,2025-05-02,505.28,30,-56285,15637149,-467056,0.4263628875059,91.0788213375725,-0.84422012569183
554.05,545,0,73,0,66065,2025-04-07,2025-05-23,505.28,73,66065,3097569,2640978,2.13280156148257,71.4868659907172,1
550.25,542,0,80,0,66000,2025-04-07,2025-05-09,505.28,80,66000,21122544,7108655,0.312462362488155,92.4519698006074,1
630.06,630,11010,10995,44040,65970,2025-04-07,2025-05-02,505.28,-15,21930,15637149,-467056,0.42187997313321,91.5007013107057,0.332423829013188
608.48,608,1369,1368,71188,65664,2025-04-07,2025-05-30,505.28,-1,-5524,25903649,-10875774,0.253493243365056,94.1612627626324,-0.0841252436647174
601.36,601,1815,1794,88935,64584,2025-04-07,2025-05-16,505.28,-21,-24351,191683614,-460736.000000003,0.0336930208337996,98.6300863463478,-0.377043849869937
630.19,630,3627,3388,43524,64372,2025-04-07,2025-05-30,505.28,-239,20848,25903649,-10875774,0.248505529085883,94.4097682917183,0.323867520039769
635.17,635,3610,3745,32490,63665,2025-04-07,2025-05-30,505.28,135,31175,25903649,-10875774,0.245776183888224,94.6555444756065,0.489672504515825
543.91,537,42,92,70140,63572,2025-04-07,2025-05-02,505.28,50,-6568,15637149,-467056,0.40654469686258,91.9072460075683,-0.10331592525011
547.9,544,147,161,161847,62790,2025-04-07,2025-04-25,505.28,14,-99057,13056472,-3270620,0.480910922950702,87.206099779481,-1.57759197324415
559.66,557,197,234,134354,62244,2025-04-07,2025-05-02,505.28,37,-72110,15637149,-467056,0.398052100162248,92.3052981077305,-1.15850523745261
559.36,559,1229,1721,207701,61956,2025-04-07,2025-04-11,505.28,492,-145745,52569756,25897074,0.117854836533767,97.6052656588324,-2.35239524824069
552.95,549,151,156,151453,61620,2025-04-07,2025-05-02,505.28,5,-89833,15637149,-467056,0.394061602917514,92.699359710648,-1.45785459266472
546.2,535,0,55,0,61600,2025-04-07,2025-05-23,505.28,55,61600,3097569,2640978,1.988656265607,73.4755222563242,1
546.49,444,6,6,61494,61494,2025-04-07,2025-05-16,505.28,0,0,191683614,-460736.000000003,0.0320809894579721,98.6621673358058,0
560.49,559,381,412,178308,61388,2025-04-07,2025-04-25,505.28,31,-116920,13056472,-3270620,0.470172953306222,87.6762727327873,-1.90460676353685
720.27,720,2277,2272,66033,61344,2025-04-07,2025-12-19,505.28,-5,-4688.99999999999,850516954,-173881469,0.0072125546365064,99.9524718469045,-0.0764377934272299
562.09,501,10,10,61090,61090,2025-04-07,2025-08-15,505.28,0,0,112162086,-42661174,0.0544658201167906,98.1840218271262,0
566.95,566,736,642,195776,60990,2025-04-07,2025-04-25,505.28,-94,-134786,13056472,-3270620,0.467124656645379,88.1433973894326,-2.20996884735203
540.44,473,10,9,102980,60696,2025-04-07,2025-08-15,505.28,-1,-42284,112162086,-42661174,0.0541145427698269,98.238136369896,-0.696652168182417
563.24,563,2284,2513,251240,60312,2025-04-07,2025-04-11,505.28,229,-190928,52569756,25897074,0.11472756312584,97.7199932219583,-3.16567183976655
550.63,543,0,79,0,60277,2025-04-07,2025-05-09,505.28,79,60277,21122544,7108655,0.285368088237856,92.7373378888452,1
571.82,497,8,8,59856,59856,2025-04-07,2025-08-15,505.28,0,0,112162086,-42661174,0.0533656265986351,98.2915019964946,0
571.17,472,6,6,59502,59502,2025-04-07,2025-08-15,505.28,0,0,112162086,-42661174,0.05305001192649,98.3445520084211,0
582.08,581,542,550,92140,59400,2025-04-07,2025-05-09,505.28,8,-32740,21122544,7108655,0.281216126239339,93.0185540150845,-0.551178451178451
606.45,310,2,2,59290,59290,2025-04-07,2025-09-19,505.28,0,0,264848567,-73847933,0.0223863774954841,99.7631665494343,0
564.13,563,510,524,173910,59212,2025-04-07,2025-04-25,505.28,14,-114698,13056472,-3270620,0.453506889150453,88.5969042785831,-1.93707356616902
690.22,690,2700,2690,59400,59180,2025-04-07,2025-09-19,505.28,-10,-220.000000000007,264848567,-73847933,0.0223448443275889,99.7855113937619,-0.00371747211895923
594.88,594,675,672,105300,59136,2025-04-07,2025-05-30,505.28,-3,-46164,25903649,-10875774,0.228292160691337,94.8838366362978,-0.780641233766234
680.2,680,2940,2942,38220,58840,2025-04-07,2025-08-15,505.28,2,20620,112162086,-42661174,0.0524597946582413,98.3970118030793,0.350441876274643
562.63,561,332,356,129812,58028,2025-04-07,2025-04-25,505.28,24,-71784,13056472,-3270620,0.444438589536285,89.0413428681194,-1.23705797201351
520.48,405,0,5,0,57740,2025-04-07,2025-05-23,505.28,5,57740,3097569,2640978,1.86404241519721,75.3395646715214,1
602.65,602,827,888,65333,57720,2025-04-07,2025-05-30,505.28,61,-7613,25903649,-10875774,0.222825749376082,95.1066623856739,-0.131895356895357
660.08,660,7201,7194,64809,57552,2025-04-07,2025-06-20,505.28,-7,-7257,478977607,-137482950,0.0120155930379434,99.9034714789913,-0.126094662218515
566.36,375,3,3,57408,57408,2025-04-07,2025-08-15,505.28,0,0,112162086,-42661174,0.0511830708997335,98.4481948739791,0
544.1,529,0,38,0,57380,2025-04-07,2025-05-23,505.28,38,57380,3097569,2640978,1.85242039806054,77.191985069582,1
558.39,558,1335,1467,268335,57213,2025-04-07,2025-04-11,505.28,132,-211122,52569756,25897074,0.108832538617832,97.8288257605761,-3.69010539562687
537.85,528,0,58,0,57130,2025-04-07,2025-05-02,505.28,58,57130,15637149,-467056,0.365347928832807,93.0647076394808,1
571.01,457,5,5,57005,57005,2025-04-07,2025-08-15,505.28,0,0,112162086,-42661174,0.0508237694509355,98.49901864343,0
579,295,2,2,56800,56800,2025-04-07,2025-08-15,505.28,0,0,112162086,-42661174,0.0506409982424899,98.5496596416725,0
559.1,370,3,3,56730,56730,2025-04-07,2025-05-30,505.28,0,0,25903649,-10875774,0.219003894007365,95.3256662796813,0
595.19,595,3019,2966,81513,56354,2025-04-07,2025-05-02,505.28,-53,-25159,15637149,-467056,0.360385387387432,93.4250930268683,-0.446445682648969
547.72,536,35,48,116620,56256,2025-04-07,2025-05-30,505.28,13,-60364,25903649,-10875774,0.217174035982344,95.5428403156636,-1.07302332195677
547.67,538,0,58,0,56086,2025-04-07,2025-05-09,505.28,58,56086,21122544,7108655,0.265526728219858,93.2840807433044,1
512,400,3,5,42594,56000,2025-04-07,2025-05-02,505.28,2,13406,15637149,-467056,0.358121547604362,93.7832145744726,0.239392857142857
546.95,537,0,56,0,55720,2025-04-07,2025-05-09,505.28,56,55720,21122544,7108655,0.263793982391515,93.5478747256959,1
555.68,547,0,64,0,55552,2025-04-07,2025-05-23,505.28,64,55552,3097569,2640978,1.79340637771104,78.985391447293,1
569.79,431,4,4,55516,55516,2025-04-07,2025-08-15,505.28,0,0,112162086,-42661174,0.0494962263808111,98.5991558680533,0
566.63,428,4,4,55452,55452,2025-04-07,2025-08-15,505.28,0,0,112162086,-42661174,0.0494391661011012,98.6485950341544,0
710.18,710,3080,3080,30800,55440,2025-04-07,2025-08-15,505.28,0,24640,112162086,-42661174,0.0494284672986556,98.6980235014531,0.444444444444444
585.2,585,2682,2759,99234,55180,2025-04-07,2025-04-25,505.28,77,-44054,13056472,-3270620,0.422625652626529,89.4639685207459,-0.798368974266038
543.4,538,59,102,85019,55080,2025-04-07,2025-04-25,505.28,43,-29939,13056472,-3270620,0.4218597489429,89.8858282696888,-0.543554829339143
568.45,477,6,6,54870,54870,2025-04-07,2025-08-15,505.28,0,0,112162086,-42661174,0.0489202741824898,98.7469437756356,0
543.42,531,0,44,0,54648,2025-04-07,2025-05-09,505.28,44,54648,21122544,7108655,0.258718836140192,93.8065935618361,1
569.58,568,303,345,102414,54510,2025-04-07,2025-05-02,505.28,42,-47904,15637149,-467056,0.348592956427032,94.1318075308997,-0.878811227297743
542.03,534,10,67,18900,53801,2025-04-07,2025-05-02,505.28,57,34901,15637149,-467056,0.344058881833255,94.4758664127329,0.648705414397502
605.22,605,2438,2442,53636,53724,2025-04-07,2025-05-09,505.28,4,88,21122544,7108655,0.254344363065358,94.0609379249015,0.00163800163800164
552.21,547.5,110,114,124190,53694,2025-04-07,2025-05-02,505.28,4,-70496,15637149,-467056,0.343374613876225,94.8192410266091,-1.31292136924051
577.29,576,429,416,111111,53664,2025-04-07,2025-05-09,505.28,-13,-57447,21122544,7108655,0.254060306372187,94.3149982312737,-1.07049418604651
609.26,609,2207,2060,55175,53560,2025-04-07,2025-05-16,505.28,-147,-1615,191683614,-460736.000000003,0.0279418771810093,98.6901092129868,-0.0301530993278566
570.06,568,259,257,109039,52942,2025-04-07,2025-05-09,505.28,-2,-56097,21122544,7108655,0.250642157497695,94.5656403887714,-1.05959351743417
518.75,491,0,19,0,52725,2025-04-07,2025-04-11,505.28,19,52725,52569756,25897074,0.100295310482324,97.9291210710584,1
568.81,567,274,291,125766,52671,2025-04-07,2025-05-09,505.28,17,-73095,21122544,7108655,0.249359168100206,94.8149995568716,-1.38776556359287
574.26,573,237,416,74418,52416,2025-04-07,2025-05-09,505.28,179,-22002,21122544,7108655,0.248151927154229,95.0631514840258,-0.419757326007326
566.18,305,2,2,52236,52236,2025-04-07,2025-08-15,505.28,0,0,112162086,-42661174,0.0465718870456814,98.7935156626813,0
515.53,385,4,4,74800,52212,2025-04-07,2025-05-30,505.28,0,-22588,25903649,-10875774,0.201562335870132,95.7444026515338,-0.432620853443653
576.84,576,515,619,92700,51996,2025-04-07,2025-05-02,505.28,104,-40704,15637149,-467056,0.33251585695065,95.1517568835598,-0.782829448419109
568.15,568,3415,3453,187825,51795,2025-04-07,2025-04-11,505.28,38,-136030,52569756,25897074,0.0985262324595914,98.027647303518,-2.62631528139782
730.21,730,2461,2461,59064,51681,2025-04-07,2025-12-19,505.28,0,-7383.00000000001,850516954,-173881469,0.00607642208152855,99.9585482689861,-0.142857142857143
670.11,670,4623,4698,23115,51678,2025-04-07,2025-06-20,505.28,75,28563,478977607,-137482950,0.0107892309044836,99.9142607098958,0.55271101822826
589.27,588,378,403,86562,51181,2025-04-07,2025-05-30,505.28,25,-35381,25903649,-10875774,0.197582201642711,95.9419848531765,-0.691291690275688
539.64,529,0,48,0,51072,2025-04-07,2025-05-09,505.28,48,51072,21122544,7108655,0.241789057227198,95.304940541253,1
553.42,452,5,5,50710,50710,2025-04-07,2025-08-15,505.28,0,0,112162086,-42661174,0.0452113560013497,98.8387270186826,0
564.72,562.5,193,228,94184,50616,2025-04-07,2025-05-02,505.28,35,-43568,15637149,-467056,0.323690718813257,95.475447602373,-0.86075549233444
564.77,560,30,106,27840,50562,2025-04-07,2025-05-23,505.28,76,22722,3097569,2640978,1.6323123068445,80.6177037541375,0.44938886911119
609.51,609,987,986,50337,50286,2025-04-07,2025-05-30,505.28,-1,-51,25903649,-10875774,0.194127089970992,96.1361119431475,-0.00101419878296146
517.61,455,9,8,102285,50088,2025-04-07,2025-05-16,505.28,-1,-52197,191683614,-460736.000000003,0.0261305590784614,98.7162397720653,-1.04210589362722
565.86,441,4,4,49944,49944,2025-04-07,2025-08-15,505.28,0,0,112162086,-42661174,0.0445284157785725,98.8832554344612,0
594.05,593,472,475,75992,49875,2025-04-07,2025-05-30,505.28,3,-26117,25903649,-10875774,0.192540440923979,96.3286523840715,-0.523649122807018
565.53,564,341,324,148676,49572,2025-04-07,2025-05-02,505.28,-17,-99104,15637149,-467056,0.31701430996149,95.7924619123345,-1.99919309287501
527,472,3,9,28923,49500,2025-04-07,2025-05-16,505.28,6,20577,191683614,-460736.000000003,0.0258238035933525,98.7420635756586,0.41569696969697
578.35,578,1438,1414,112164,49490,2025-04-07,2025-04-25,505.28,-24,-62674,13056472,-3270620,0.379045733028034,90.2648740027168,-1.2663972519701
611.4,611,1232,1233,51744,49320,2025-04-07,2025-05-30,505.28,1,-2423.99999999999,25903649,-10875774,0.190397885641517,96.519050269713,-0.0491484184914839
570.2,447,4,4,49280,49280,2025-04-07,2025-08-15,505.28,0,0,112162086,-42661174,0.0439364153765828,98.9271918498378,0
567.73,567,674,675,164456,49275,2025-04-07,2025-04-25,505.28,1,-115181,13056472,-3270620,0.377399040108231,90.642273042825,-2.33751395230847
542.26,481,7,8,61985,49008,2025-04-07,2025-08-15,505.28,1,-12977,112162086,-42661174,0.0436939091878159,98.9708857590256,-0.264793503101534
573.55,573,897,891,127374,49005,2025-04-07,2025-04-25,505.28,-6,-78369,13056472,-3270620,0.375331100162433,91.0176041429875,-1.59920416284053
546.78,543,122,129,141032,48762,2025-04-07,2025-04-25,505.28,7,-92270,13056472,-3270620,0.373469954211214,91.3910740971987,-1.89225216356999
564.9,564,567,538,179739,48420,2025-04-07,2025-04-25,505.28,-29,-131319,13056472,-3270620,0.370850563613203,91.7619246608119,-2.71208178438662
561.28,555,44,77,49500,48356,2025-04-07,2025-05-23,505.28,33,-1144,3097569,2640978,1.56109516850149,82.178798922639,-0.0236578707916288
525.04,285,3,2,81417,48008,2025-04-07,2025-09-19,505.28,-1,-33409,264848567,-73847933,0.0181265847664564,99.8036379785283,-0.695904849191801
590.31,590,1433,1547,67351,47957,2025-04-07,2025-05-02,505.28,114,-19394,15637149,-467056,0.306686340329685,96.0991482526642,-0.404403945200909
544.99,536,0,53,0,47647,2025-04-07,2025-05-09,505.28,53,47647,21122544,7108655,0.22557415432535,95.5305146955783,1
553.62,549,77,103,99099,47586,2025-04-07,2025-05-09,505.28,26,-51513,21122544,7108655,0.22528536335396,95.7558000589323,-1.08252427184466
527.71,370,2,3,41504,47313,2025-04-07,2025-05-16,505.28,1,5809,191683614,-460736.000000003,0.0246828609982281,98.7667464366568,0.122778094815378
573.95,573,541,497,123889,47215,2025-04-07,2025-05-02,505.28,-44,-76674,15637149,-467056,0.301941229823928,96.4010894824882,-1.62393307211691
580.05,580,9649,9404,86841,47020,2025-04-07,2025-04-11,505.28,-245,-39821,52569756,25897074,0.0894430630417992,98.1170903665598,-0.846894938324117
596.97,596,483,484,66654,46948,2025-04-07,2025-05-30,505.28,1,-19706,25903649,-10875774,0.181240874596471,96.7002911443094,-0.419740990031525
599.74,599,605,634,65945,46916,2025-04-07,2025-05-30,505.28,29,-19029,25903649,-10875774,0.181117339877482,96.8814084841869,-0.405597237616165
695.09,695,5163,5163,25815,46467,2025-04-07,2025-07-18,505.28,0,20652,104857395,-33238059,0.0443144710966737,99.776505033336,0.444444444444444
556.47,556,1061,986,259945,46342,2025-04-07,2025-04-11,505.28,-75,-213603,52569756,25897074,0.0881533480961943,98.205243714656,-4.60927452418972
607.55,607,821,842,50902,46310,2025-04-07,2025-05-30,505.28,21,-4592,25903649,-10875774,0.178777901136631,97.0601863853236,-0.0991578492766141
554.04,544,0,46,0,46184,2025-04-07,2025-05-23,505.28,46,46184,3097569,2640978,1.49097566511028,83.6697745877493,1
563.04,562,448,444,163520,46176,2025-04-07,2025-04-25,505.28,-4,-117344,13056472,-3270620,0.353663684952566,92.1155883457645,-2.54123354123354
557.81,556,272,255,153680,46155,2025-04-07,2025-04-25,505.28,-17,-107525,13056472,-3270620,0.353502845179004,92.4690911909435,-2.32965009208103
514.96,493,1,21,5008,46116,2025-04-07,2025-04-11,505.28,20,41108,52569756,25897074,0.087723443114326,98.2929671577703,0.891404284846908
563.1,411,3,3,45630,45630,2025-04-07,2025-05-16,505.28,0,0,191683614,-460736.000000003,0.0238048516760541,98.7905512883329,0
526,488,11,12,89485,45600,2025-04-07,2025-05-16,505.28,1,-43885,191683614,-460736.000000003,0.0237892008859975,98.8143404892189,-0.962390350877193
569.18,478,5,5,45590,45590,2025-04-07,2025-05-16,505.28,0,0,191683614,-460736.000000003,0.0237839839559786,98.8381244731749,0
606.27,606,1695,1688,57630,45576,2025-04-07,2025-05-16,505.28,-7,-12054,191683614,-460736.000000003,0.0237766802539522,98.8619011534288,-0.2644813059505
575.08,575,5094,5689,96786,45512,2025-04-07,2025-04-11,505.28,595,-51274,52569756,25897074,0.0865744935167666,98.3795416512871,-1.12660397257866
543.08,532,0,41,0,45428,2025-04-07,2025-05-09,505.28,41,45428,21122544,7108655,0.215068790956241,95.9708688498885,1
561.23,557.5,130,121,103610,45133,2025-04-07,2025-05-09,505.28,-9,-58477,21122544,7108655,0.213672178881483,96.18454102877,-1.29565949526954
715.35,715,1284,1284,39804,44940,2025-04-07,2025-12-19,505.28,0,5136,850516954,-173881469,0.00528384528828569,99.9638321142744,0.114285714285714
563.74,562,232,257,119480,44718,2025-04-07,2025-05-02,505.28,25,-74762,15637149,-467056,0.285972845817355,96.6870623283055,-1.67185473411154
640.07,640,6341,6325,31705,44275,2025-04-07,2025-05-16,505.28,-16,12570,191683614,-460736.000000003,0.0230979576584987,98.8849991110873,0.283907396950875
568.84,568,517,526,112706,44184,2025-04-07,2025-04-25,505.28,9,-68522,13056472,-3270620,0.338406883574675,92.8074980745181,-1.55083288068079
614.15,395,2,2,43830,43830,2025-04-07,2025-05-30,505.28,0,0,25903649,-10875774,0.169203960414998,97.2293903457386,0
650.05,650,8442,8707,33768,43535,2025-04-07,2025-05-16,505.28,265,9767,191683614,-460736.000000003,0.0227119048371031,98.9077110159244,0.224348225565637
607.25,607,1929,1738,59799,43450,2025-04-07,2025-05-16,505.28,-191,-16349,191683614,-460736.000000003,0.0226675609319428,98.9303785768563,-0.376271576524741
564.73,563,247,250,115596,43250,2025-04-07,2025-05-02,505.28,3,-72346,15637149,-467056,0.276584945248012,96.9636472735535,-1.67273988439306
575.25,574,146,345,43654,43125,2025-04-07,2025-05-09,505.28,199,-529,21122544,7108655,0.204165748216692,96.3887067769867,-0.0122666666666667
568.69,461,4,4,43076,43076,2025-04-07,2025-08-15,505.28,0,0,112162086,-42661174,0.0384051345122094,99.0092908935378,0
567.84,566,172,233,84796,42872,2025-04-07,2025-05-09,505.28,61,-41924,21122544,7108655,0.202967975827154,96.5916747528139,-0.977887665609255
568.7,462,4,4,42680,42680,2025-04-07,2025-08-15,505.28,0,0,112162086,-42661174,0.0380520740315047,99.0473429675693,0
561.02,558,175,141,133875,42582,2025-04-07,2025-05-09,505.28,-34,-91293,21122544,7108655,0.201595035143494,96.7932697879574,-2.14393405664365
577.34,577,1057,1243,96187,42262,2025-04-07,2025-04-25,505.28,186,-53925,13056472,-3270620,0.323686214775324,93.1311842892935,-1.27596895556292
695.08,695,5278,5278,15834,42224,2025-04-07,2025-06-20,505.28,0,26390,478977607,-137482950,0.0088154434326196,99.9230761533284,0.625
655.07,655,6021,6026,18063,42182,2025-04-07,2025-05-16,505.28,5,24119,191683614,-460736.000000003,0.0220060542055514,98.9523846310619,0.571784173344081
514.13,472,0,10,0,42130,2025-04-07,2025-04-11,505.28,10,42130,52569756,25897074,0.0801411366642067,98.4596827879513,1
600.09,600,3987,4675,31896,42075,2025-04-07,2025-04-25,505.28,688,10179,13056472,-3270620,0.322253974886937,93.4534382641804,0.24192513368984
569.21,429,3,3,42063,42063,2025-04-07,2025-08-15,505.28,0,0,112162086,-42661174,0.037501977272427,99.0848449448417,0
571,569,221,209,90831,41800,2025-04-07,2025-05-09,505.28,-12,-49031,21122544,7108655,0.197892829575831,96.9911626175332,-1.17299043062201
572.4,155,1,1,41740,41740,2025-04-07,2025-09-19,505.28,0,0,264848567,-73847933,0.0157599493449402,99.8193979278733,0
581.31,581,1338,1345,81618,41695,2025-04-07,2025-04-25,505.28,7,-39923,13056472,-3270620,0.319343540889147,93.7727818050695,-0.957500899388416
512.89,305,1,2,26500,41578,2025-04-07,2025-05-16,505.28,1,15078,191683614,-460736.000000003,0.0216909516324124,98.9740755826943,0.362643705805955
549.04,531,0,23,0,41492,2025-04-07,2025-05-23,505.28,23,41492,3097569,2640978,1.33950204176243,85.0092766295117,1
514.25,473,0,10,0,41250,2025-04-07,2025-04-11,505.28,10,41250,52569756,25897074,0.0784671703631267,98.5381499583144,1
563.56,562.5,374,389,149226,41234,2025-04-07,2025-04-25,505.28,15,-107992,13056472,-3270620,0.315812724907617,94.0885945299772,-2.61900373478198
561.94,155,1,1,40694,40694,2025-04-07,2025-06-20,505.28,0,0,478977607,-137482950,0.00849601305056418,99.931572166379,0
568.5,433,3,3,40650,40650,2025-04-07,2025-08-15,505.28,0,0,112162086,-42661174,0.036242193284458,99.1210871381262,0
840.05,840,7943,8100,39715,40500,2025-04-07,2025-12-19,505.28,157,785,850516954,-173881469,0.00476180983924278,99.9685939241136,0.0193827160493827
621.23,621,1756,1756,38632,40388,2025-04-07,2025-05-30,505.28,0,1756,25903649,-10875774,0.155916257203763,97.3853066029423,0.0434782608695652
563.41,429,3,3,40323,40323,2025-04-07,2025-05-16,505.28,0,0,191683614,-460736.000000003,0.0210362269150455,98.9951118096094,0
544.29,410,3,3,40287,40287,2025-04-07,2025-05-09,505.28,0,0,21122544,7108655,0.190729866629701,97.1818924841629,0
750.15,750,2686,2677,42976,40155,2025-04-07,2025-12-19,505.28,-9,-2821,850516954,-173881469,0.00472124627394553,99.9733151703875,-0.0702527705142573
568.47,435,3,3,40041,40041,2025-04-07,2025-05-30,505.28,0,0,25903649,-10875774,0.154576677594728,97.539883280537,0
543.78,537,26,59,38922,40002,2025-04-07,2025-04-25,505.28,33,1080.00000000001,13056472,-3270620,0.306376791525306,94.3949713215025,0.0269986500674968
538.4,531,15,54,43380,39960,2025-04-07,2025-04-25,505.28,39,-3420,13056472,-3270620,0.306055111978182,94.7010264334807,-0.0855855855855856
585.6,585,604,641,72480,38460,2025-04-07,2025-05-09,505.28,37,-34020,21122544,7108655,0.182080340322643,97.3639728244856,-0.884555382215289
539.74,533,11,57,18997,38418,2025-04-07,2025-04-25,505.28,46,19421,13056472,-3270620,0.294244877176622,94.9952713106573,0.505518246655214
695.2,695,1918,1918,26852,38360,2025-04-07,2025-08-15,505.28,0,11508,112162086,-42661174,0.03420050515109,99.1552876432772,0.3
613.48,230,1,1,38348,38348,2025-04-07,2025-09-19,505.28,0,0,264848567,-73847933,0.0144792174767553,99.83387714535,0
611.23,611,1768,1667,37128,38341,2025-04-07,2025-05-16,505.28,-101,1213,191683614,-460736.000000003,0.0200022313853077,99.0151140409947,0.0316371508307034
586.22,586,779,1734,24928,38148,2025-04-07,2025-04-25,505.28,955,13220,13056472,-3270620,0.292176937230823,95.2874482478881,0.34654503512635
551.58,541,0,36,0,38088,2025-04-07,2025-05-23,505.28,36,38088,3097569,2640978,1.22960941305908,86.2388860425708,1
564.22,564,1442,1731,139874,38082,2025-04-07,2025-04-11,505.28,289,-101792,52569756,25897074,0.0724408916792385,98.6105908499937,-2.6729688566777
567.42,566,246,268,94956,38056,2025-04-07,2025-05-02,505.28,22,-56900,15637149,-467056,0.243369171707707,97.2070164452612,-1.49516501997057
565.66,439,3,3,37998,37998,2025-04-07,2025-08-15,505.28,0,0,112162086,-42661174,0.0338777579439812,99.1891654012212,0
603.56,603,679,677,54320,37912,2025-04-07,2025-05-30,505.28,-2,-16408,25903649,-10875774,0.146357758322003,97.6862410388591,-0.432791728212703
567.74,442,3,3,37722,37722,2025-04-07,2025-08-15,505.28,0,0,112162086,-42661174,0.0336316854877325,99.222797086709,0
521.39,498,0,16,0,37424,2025-04-07,2025-04-11,505.28,16,37424,52569756,25897074,0.0711892214222946,98.681780071416,1
566.54,380,2,2,37308,37308,2025-04-07,2025-08-15,505.28,0,0,112162086,-42661174,0.0332625768033594,99.2560596635123,0
556.16,549,0,52,0,37232,2025-04-07,2025-05-23,505.28,52,37232,3097569,2640978,1.20197483897857,87.4408608815494,1
565.35,380,2,2,37070,37070,2025-04-07,2025-05-16,505.28,0,0,191683614,-460736.000000003,0.0193391595799107,99.0344532005746,0
529.76,477,3,7,27609,36932,2025-04-07,2025-05-16,505.28,4,9323,191683614,-460736.000000003,0.0192671659456504,99.0537203665202,0.252436911079822
522.09,430,0,4,0,36836,2025-04-07,2025-04-25,505.28,4,36836,13056472,-3270620,0.28212828090161,95.5695765287897,1
574.16,390,2,2,36832,36832,2025-04-07,2025-05-30,505.28,0,0,25903649,-10875774,0.142188461556131,97.8284295004152,0
700.1,700,3677,3677,22062,36770,2025-04-07,2025-07-18,505.28,0,14708,104857395,-33238059,0.0350666731707382,99.8115717065067,0.4
606.01,240,1,1,36601,36601,2025-04-07,2025-09-19,505.28,0,0,264848567,-73847933,0.0138195952557297,99.8476967406057,0
617.5,617,729,729,21870,36450,2025-04-07,2025-05-30,505.28,0,14580,25903649,-10875774,0.140713765848202,97.9691432662634,0.4
565.16,562.5,129,137,79206,36442,2025-04-07,2025-05-09,505.28,8,-42764,21122544,7108655,0.172526566875657,97.5364993913612,-1.17348114812579
815.1,815,3635,3636,32715,36360,2025-04-07,2025-12-19,505.28,1,3645,850516954,-173881469,0.00427504705567574,99.9775902174432,0.100247524752475
567.94,447,3,3,36282,36282,2025-04-07,2025-05-16,505.28,0,0,191683614,-460736.000000003,0.0189280654944246,99.0726484320147,0
750.04,750,9042,9066,18084,36264,2025-04-07,2025-06-20,505.28,24,18180,478977607,-137482950,0.00757112638879588,99.9391432927678,0.50132362673726
527.25,455,1,5,10458,36125,2025-04-07,2025-04-25,505.28,4,25667,13056472,-3270620,0.276682705711007,95.8462592345007,0.710505190311419
525.24,435,0,4,0,36096,2025-04-07,2025-04-25,505.28,4,36096,13056472,-3270620,0.276460593642754,96.1227198281435,1
573.69,572,210,209,70980,35321,2025-04-07,2025-05-09,505.28,-1,-35659,21122544,7108655,0.167219440991578,97.7037188323528,-1.00956937799043
568.46,452,3,3,34938,34938,2025-04-07,2025-05-16,505.28,0,0,191683614,-460736.000000003,0.0182269100998899,99.0908753421145,0
660.07,660,5102,4984,20408,34888,2025-04-07,2025-05-16,505.28,-118,14480,191683614,-460736.000000003,0.0182008254497956,99.1090761675643,0.415042421462967
544.63,536,4,40,7512,34520,2025-04-07,2025-05-02,505.28,36,27008,15637149,-467056,0.220756353987546,97.4277727992488,0.782387022016223
562.88,391,2,2,34376,34376,2025-04-07,2025-05-16,505.28,0,0,191683614,-460736.000000003,0.01793371863283,99.1270098861972,0
568.14,454,3,3,34242,34242,2025-04-07,2025-08-15,505.28,0,0,112162086,-42661174,0.0305290327785095,99.2865886962908,0
604.62,604,565,552,41245,34224,2025-04-07,2025-05-30,505.28,-13,-7021,25903649,-10875774,0.132120381958542,98.1012636482219,-0.205148433847592
548.24,539,0,37,0,34188,2025-04-07,2025-05-09,505.28,37,34188,21122544,7108655,0.161855503768864,97.8655743361217,1
512.15,470,2,8,20808,33720,2025-04-07,2025-04-11,505.28,6,12912,52569756,25897074,0.0641433450822941,98.7459234164983,0.382918149466192
598.85,598,396,396,46332,33660,2025-04-07,2025-05-30,505.28,0,-12672,25903649,-10875774,0.129943082536364,98.2312067307583,-0.376470588235294
568.25,567,269,266,96840,33250,2025-04-07,2025-05-02,505.28,-3,-63590,15637149,-467056,0.21263466889009,97.6404074681389,-1.91248120300752
540.82,430,3,3,33246,33246,2025-04-07,2025-05-02,505.28,0,0,15637149,-467056,0.212609088779547,97.8530165569184,0
576.91,245,1,1,33191,33191,2025-04-07,2025-06-20,505.28,0,0,478977607,-137482950,0.00692955151032771,99.9460728442781,0
544.71,508,9,9,59184,33039,2025-04-07,2025-08-15,505.28,0,-26145,112162086,-42661174,0.0294564778333384,99.3160451741242,-0.7913375102152
562.93,398,2,2,32986,32986,2025-04-07,2025-05-16,505.28,0,0,191683614,-460736.000000003,0.0172085653602086,99.1442184515574,0
690.06,690,5481,5475,49329,32850,2025-04-07,2025-07-18,505.28,-6,-16479,104857395,-33238059,0.031328262541712,99.8428999690485,-0.501643835616438
531.4,495,0,9,0,32760,2025-04-07,2025-05-23,505.28,9,32760,3097569,2640978,1.05760355943645,88.4984644409858,1
614.17,614,1979,1923,31664,32691,2025-04-07,2025-05-16,505.28,-56,1027,191683614,-460736.000000003,0.0170546659246523,99.161273117482,0.0314153742620294
750.1,750,3266,3266,19596,32660,2025-04-07,2025-09-19,505.28,0,13064,264848567,-73847933,0.0123315751223226,99.8600283157281,0.4
560.58,479,4,4,32632,32632,2025-04-07,2025-08-15,505.28,0,0,112162086,-42661174,0.0290936101170586,99.3451387842412,0
543.29,534,0,35,0,32515,2025-04-07,2025-05-09,505.28,35,32515,21122544,7108655,0.153935056307611,98.0195093924292,1
612.19,612,1723,1705,31014,32395,2025-04-07,2025-05-16,505.28,-18,1381,191683614,-460736.000000003,0.016900244796094,99.1781733622781,0.0426300354993055
568.12,462,3,3,31836,31836,2025-04-07,2025-05-16,505.28,0,0,191683614,-460736.000000003,0.0166086184080398,99.1947819806862,0
568.65,567.5,280,276,97440,31740,2025-04-07,2025-05-02,505.28,-4,-65700,15637149,-467056,0.202978177160044,98.0559947340785,-2.06994328922495
587.25,270,1,1,31725,31725,2025-04-07,2025-08-15,505.28,0,0,112162086,-42661174,0.0282849589655456,99.3734237432068,0
571.53,466,3,3,31659,31659,2025-04-07,2025-08-15,505.28,0,0,112162086,-42661174,0.0282261155520949,99.4016498587589,0
562.76,405,2,2,31552,31552,2025-04-07,2025-05-30,505.28,0,0,25903649,-10875774,0.121805232922975,98.3530119636813,0
606.52,606,589,606,38285,31512,2025-04-07,2025-05-30,505.28,17,-6773,25903649,-10875774,0.121650814524239,98.4746627782055,-0.21493399339934
675.12,675,2613,2613,31356,31356,2025-04-07,2025-07-18,505.28,0,0,104857395,-33238059,0.0299034703274862,99.8728034393759,0
562.61,406,2,2,31322,31322,2025-04-07,2025-05-16,505.28,0,0,191683614,-460736.000000003,0.0163404682050705,99.2111224488912,0
567.12,463,3,3,31236,31236,2025-04-07,2025-08-15,505.28,0,0,112162086,-42661174,0.0278489827658876,99.4294988415248,0
558.7,554,47,66,45073,31020,2025-04-07,2025-05-09,505.28,19,-14053,21122544,7108655,0.146857310369433,98.1663667027987,-0.453030303030303
519.25,475,6,7,55500,30975,2025-04-07,2025-04-25,505.28,1,-24525,13056472,-3270620,0.237238666004109,96.3599584941476,-0.791767554479419
517.38,440,4,4,41512,30952,2025-04-07,2025-04-11,505.28,0,-10560,52569756,25897074,0.0588779601716242,98.8048013766699,-0.341173429826829
569.13,569,2660,2364,125020,30732,2025-04-07,2025-04-11,505.28,-296,-94288,52569756,25897074,0.0584594685963542,98.8632608452662,-3.06807236756475
735.07,735,4346,4346,30422,30422,2025-04-07,2025-09-19,505.28,0,0,264848567,-73847933,0.0114865639427832,99.8715148796708,0
612.38,612,799,799,33558,30362,2025-04-07,2025-05-30,505.28,0,-3196,25903649,-10875774,0.117211285560579,98.5918740637661,-0.105263157894737
613.18,613,1785,1684,30345,30312,2025-04-07,2025-05-16,505.28,-101,-33.0000000000036,191683614,-460736.000000003,0.0158135582731657,99.2269360071644,-0.00108867775138571
665.08,665,3800,3789,7600,30312,2025-04-07,2025-05-16,505.28,-11,22712,191683614,-460736.000000003,0.0158135582731657,99.2427495654375,0.74927421483241
616.16,616,1886,1894,28290,30304,2025-04-07,2025-05-16,505.28,8,2014.00000000001,191683614,-460736.000000003,0.0158093847291506,99.2585589501667,0.0664598732840551
563.28,412,2,2,30256,30256,2025-04-07,2025-05-16,505.28,0,0,191683614,-460736.000000003,0.0157843434650601,99.2743432936318,0
592,290,1,1,30200,30200,2025-04-07,2025-08-15,505.28,0,0,112162086,-42661174,0.0269253194880844,99.4564241610128,0
559.67,410,2,2,29934,29934,2025-04-07,2025-05-30,505.28,0,0,25903649,-10875774,0.115559008694103,98.7074330724602,0
705.13,705,2301,2300,29913,29900,2025-04-07,2025-09-19,505.28,-1,-13,264848567,-73847933,0.011289470182408,99.8828043498533,-0.000434782608695652
542.3,533,0,32,0,29760,2025-04-07,2025-05-09,505.28,32,29760,21122544,7108655,0.140892119812841,98.3072588226115,1
725.1,725,2966,2966,23728,29660,2025-04-07,2025-09-19,505.28,0,5932,264848567,-73847933,0.0111988523615459,99.8940032022148,0.2
517.63,445,0,4,0,29052,2025-04-07,2025-04-25,505.28,4,29052,13056472,-3270620,0.222510338167922,96.5824688323155,1
735.16,735,1814,1813,34466,29008,2025-04-07,2025-12-19,505.28,-1,-5458,850516954,-173881469,0.00341063160041369,99.9810008490436,-0.18815499172642
620.07,620,4023,4088,20115,28616,2025-04-07,2025-05-02,505.28,65,8501,15637149,-467056,0.183000110825829,98.2389948449043,0.297071568353369
545.38,450,3,3,28614,28614,2025-04-07,2025-05-09,505.28,0,0,21122544,7108655,0.135466636973274,98.4427254595848,0
568.36,473,3,3,28608,28608,2025-04-07,2025-05-16,505.28,0,0,191683614,-460736.000000003,0.0149245933979521,99.2892678870297,0
582.6,582,291,475,29391,28500,2025-04-07,2025-05-02,505.28,184,-891.000000000004,15637149,-467056,0.182258287620077,98.4212531325244,-0.031263157894737
524.86,468,3,5,30222,28430,2025-04-07,2025-05-16,505.28,2,-1792,191683614,-460736.000000003,0.0148317320436164,99.3040996190733,-0.0630320084417867
680.09,680,3133,3133,34463,28197,2025-04-07,2025-07-18,505.28,0,-6266,104857395,-33238059,0.0268908072721051,99.899694246648,-0.222222222222222
515.44,375,1,2,16572,28088,2025-04-07,2025-05-09,505.28,1,11516,21122544,7108655,0.132976406629807,98.5757018662146,0.409997151808602
569.65,569,462,432,91476,28080,2025-04-07,2025-04-25,505.28,-30,-63396,13056472,-3270620,0.215065754363047,96.7975345866786,-2.25769230769231
590.47,590,603,596,47637,28012,2025-04-07,2025-05-09,505.28,-7,-19625,21122544,7108655,0.132616601485124,98.7083184676997,-0.70059260317007
558.76,551,23,36,30544,27936,2025-04-07,2025-05-23,505.28,13,-2608,3097569,2640978,0.901868529805147,89.400332970791,-0.0933562428407789
603.79,325,1,1,27879,27879,2025-04-07,2025-08-15,505.28,0,0,112162086,-42661174,0.024855992781732,99.4812801537946,0
563.13,424,2,2,27826,27826,2025-04-07,2025-05-16,505.28,0,0,191683614,-460736.000000003,0.0145166294704773,99.3186162485438,0
600.02,600,14529,13904,29058,27808,2025-04-07,2025-04-11,505.28,-625,-1250,52569756,25897074,0.0528973351141291,98.9161581803804,-0.0449510932105869
675.2,675,1343,1382,26860,27640,2025-04-07,2025-08-15,505.28,39,780,112162086,-42661174,0.0246429082996905,99.5059230620943,0.0282199710564399
527.96,460,0,4,0,27184,2025-04-07,2025-04-25,505.28,4,27184,13056472,-3270620,0.20820325735773,97.0057378440363,1
556.67,552,55,58,56540,27086,2025-04-07,2025-05-09,505.28,3,-29454,21122544,7108655,0.128232659853851,98.8365511275536,-1.0874252381304
514.78,488,0,10,0,26780,2025-04-07,2025-04-11,505.28,10,26780,52569756,25897074,0.0509418381169584,98.9671000184973,1
566.18,566,1279,1486,94646,26748,2025-04-07,2025-04-11,505.28,207,-67898,52569756,25897074,0.0508809666151009,99.0179809851124,-2.53843278002094
528.7,440,2,3,21262,26610,2025-04-07,2025-05-09,505.28,1,5348,21122544,7108655,0.125979143421361,98.9625302709749,0.20097707628711
720.1,720,2656,2656,23904,26560,2025-04-07,2025-09-19,505.28,0,2656,264848567,-73847933,0.01002837217541,99.9040315743902,0.1
516.96,385,0,2,0,26392,2025-04-07,2025-04-11,505.28,2,26392,52569756,25897074,0.0502037711569367,99.0681847562694,1
556.73,295,1,1,26173,26173,2025-04-07,2025-09-19,505.28,0,0,264848567,-73847933,0.00988225093926976,99.9139138253295,0
558.82,428,2,2,26164,26164,2025-04-07,2025-05-16,505.28,0,0,191683614,-460736.000000003,0.0136495757013429,99.3322658242452,0
557.66,427,2,2,26132,26132,2025-04-07,2025-05-16,505.28,0,0,191683614,-460736.000000003,0.0136328815252826,99.3458987057704,0
562.55,432,2,2,26110,26110,2025-04-07,2025-05-16,505.28,0,0,191683614,-460736.000000003,0.0136214042792411,99.3595201100497,0
567.25,437,2,2,26050,26050,2025-04-07,2025-08-15,505.28,0,0,112162086,-42661174,0.023225316975649,99.5291483790699,0
569.63,483,3,3,25989,25989,2025-04-07,2025-08-15,505.28,0,0,112162086,-42661174,0.0231709313965505,99.5523193104665,0
565.43,436,2,2,25886,25886,2025-04-07,2025-08-15,505.28,0,0,112162086,-42661174,0.0230791000088925,99.5753984104754,0
574.42,574,615,616,77490,25872,2025-04-07,2025-04-25,505.28,1,-51618,13056472,-3270620,0.198154601028517,97.2038924450648,-1.99512987012987
569.02,483,3,3,25806,25806,2025-04-07,2025-05-16,505.28,0,0,191683614,-460736.000000003,0.0134628096066678,99.3729829196564,0
539.01,496,6,6,46794,25806,2025-04-07,2025-08-15,505.28,0,-20988,112162086,-42661174,0.0230077746592552,99.5984061851346,-0.813299232736573
665.11,665,2347,2330,14082,25630,2025-04-07,2025-06-20,505.28,-17,11548,478977607,-137482950,0.00535098084449698,99.9514238251226,0.450565743269606
567.16,567,1488,1596,93744,25536,2025-04-07,2025-04-11,505.28,108,-68208,52569756,25897074,0.0485754584822498,99.1167602147516,-2.67105263157895
574.1,574,2632,2546,55272,25460,2025-04-07,2025-04-11,505.28,-86,-29812,52569756,25897074,0.0484308886653383,99.165191103417,-1.17093479968578
564.28,437,2,2,25456,25456,2025-04-07,2025-05-16,505.28,0,0,191683614,-460736.000000003,0.0132802170560077,99.3862631367124,0
565.74,563,96,92,57504,25208,2025-04-07,2025-05-09,505.28,-4,-32296,21122544,7108655,0.119341685357597,99.0818719563325,-1.28118057759441
520.35,470,2,5,19096,25175,2025-04-07,2025-05-02,505.28,3,6079,15637149,-467056,0.160994820731068,98.5822479532554,0.241469712015889
520.87,395,0,2,0,25174,2025-04-07,2025-04-11,505.28,2,25174,52569756,25897074,0.0478868496174873,99.2130779530344,1
568.45,443,2,2,25090,25090,2025-04-07,2025-08-15,505.28,0,0,112162086,-42661174,0.0223694127800013,99.6207755979146,0
805.06,805,4173,4173,33384,25038,2025-04-07,2025-12-19,505.28,0,-8346,850516954,-173881469,0.00294385666061632,99.9839447057042,-0.333333333333333
578.6,578,417,416,64218,24960,2025-04-07,2025-05-02,505.28,-1,-39258,15637149,-467056,0.159619889789373,98.7418678430448,-1.57283653846154
524.4,275,2,1,67294,24940,2025-04-07,2025-09-19,505.28,-1,-42354,264848567,-73847933,0.00941670188459053,99.9233305272141,-1.69823576583801
572.46,570,18,101,10764,24846,2025-04-07,2025-05-23,505.28,83,14082,3097569,2640978,0.802112882715445,90.2024458535064,0.566771311277469
577.69,577,360,360,57600,24840,2025-04-07,2025-05-02,505.28,0,-32760,15637149,-467056,0.158852486473078,98.9007203295179,-1.31884057971015
601.64,601,381,388,36195,24832,2025-04-07,2025-05-30,505.28,7,-11363,25903649,-10875774,0.0958629419353235,98.8032960143955,-0.457595038659794
568.31,565,9,75,7011,24825,2025-04-07,2025-05-23,505.28,66,17814,3097569,2640978,0.801434931715807,91.0038807852222,0.717583081570997
572.02,325,1,1,24702,24702,2025-04-07,2025-09-19,505.28,0,0,264848567,-73847933,0.00932683921223557,99.9326573664263,0
685.2,685,1229,1229,15977,24580,2025-04-07,2025-08-15,505.28,0,8603,112162086,-42661174,0.0219147136760634,99.6426903115907,0.35
566.41,444,2,2,24482,24482,2025-04-07,2025-08-15,505.28,0,0,112162086,-42661174,0.0218273401227577,99.6645176517134,0
527.88,493,1,7,6292,24416,2025-04-07,2025-05-16,505.28,6,18124,191683614,-460736.000000003,0.0127376563340464,99.3990007930464,0.742300131061599
563.15,320,1,1,24315,24315,2025-04-07,2025-08-15,505.28,0,0,112162086,-42661174,0.0216784484553898,99.6861961001688,0
576.96,575,31,124,13206,24304,2025-04-07,2025-05-23,505.28,93,11098,3097569,2640978,0.784615290248579,91.7884960754708,0.456632653061225
574.26,572.5,138,138,44850,24288,2025-04-07,2025-05-09,505.28,0,-20562,21122544,7108655,0.114986149395641,99.1968581057282,-0.846590909090909
710.13,710,1861,1861,24193,24193,2025-04-07,2025-09-19,505.28,0,0,264848567,-73847933,0.00913465391715712,99.9417920203435,0
568.44,448,2,2,24088,24088,2025-04-07,2025-05-16,505.28,0,0,191683614,-460736.000000003,0.0125665410294278,99.4115673340758,0
685.06,685,3989,3977,15956,23862,2025-04-07,2025-06-20,505.28,-12,7906,478977607,-137482950,0.0049818612918996,99.9564056864145,0.331321766825916
603.57,365,1,1,23857,23857,2025-04-07,2025-05-16,505.28,0,0,191683614,-460736.000000003,0.0124460299459922,99.4240133640218,0
564.24,559,1,45,1163,23580,2025-04-07,2025-05-23,505.28,44,22417,3097569,2640978,0.76124212245151,92.5497381979223,0.950678541136556
582.27,582,678,873,36612,23571,2025-04-07,2025-04-25,505.28,195,-13041,13056472,-3270620,0.180531157268212,97.384423602333,-0.553264604810997
665.21,665,1117,1120,16755,23520,2025-04-07,2025-07-18,505.28,3,6765,104857395,-33238059,0.0224304637741573,99.9221247104222,0.287627551020408
566.49,449,2,2,23498,23498,2025-04-07,2025-08-15,505.28,0,0,112162086,-42661174,0.0209500383222188,99.707146138491,0
518.5,460,1,4,10746,23400,2025-04-07,2025-04-11,505.28,3,12654,52569756,25897074,0.0445122857332646,99.2575902387677,0.540769230769231
690.05,690,4656,4656,23280,23280,2025-04-07,2025-06-20,505.28,0,0,478977607,-137482950,0.00486035247990205,99.9612660388944,0
571.11,340,1,1,23111,23111,2025-04-07,2025-09-19,505.28,0,0,264848567,-73847933,0.00872611857477031,99.9505181389182,0
568.07,453,2,2,23014,23014,2025-04-07,2025-08-15,505.28,0,0,112162086,-42661174,0.0205185199569131,99.727664658448,0
568.6,454,2,2,22920,22920,2025-04-07,2025-05-16,505.28,0,0,191683614,-460736.000000003,0.0119572036032251,99.4359705676251,0
521.1,295,1,1,0,22610,2025-04-07,2025-06-20,505.28,0,22610,478977607,-137482950,0.00472047120148563,99.9659865100959,1
568.73,456,2,2,22546,22546,2025-04-07,2025-05-16,505.28,0,0,191683614,-460736.000000003,0.0117620904205197,99.4477326580456,0
568.71,457,2,2,22342,22342,2025-04-07,2025-05-16,505.28,0,0,191683614,-460736.000000003,0.011655665048135,99.4593883230937,0
624.11,624,2065,2028,14455,22308,2025-04-07,2025-05-16,505.28,-37,7853,191683614,-460736.000000003,0.0116379274860709,99.4710262505798,0.352026178949256
567.47,564,6,64,5094,22208,2025-04-07,2025-05-23,505.28,58,17114,3097569,2640978,0.716949323808445,93.2666875217308,0.770623198847262
568.7,458,2,2,22140,22140,2025-04-07,2025-05-16,505.28,0,0,191683614,-460736.000000003,0.011550283061754,99.4825765336415,0
621.13,621,1689,1701,15201,22113,2025-04-07,2025-05-16,505.28,12,6912,191683614,-460736.000000003,0.0115361973507031,99.4941127309922,0.312576312576313
568.68,459,2,2,21936,21936,2025-04-07,2025-05-16,505.28,0,0,191683614,-460736.000000003,0.0114438576893693,99.5055565886816,0
546.32,438,2,2,21664,21664,2025-04-07,2025-05-16,505.28,0,0,191683614,-460736.000000003,0.0113019571928564,99.5168585458745,0
567.17,459,2,2,21634,21634,2025-04-07,2025-08-15,505.28,0,0,112162086,-42661174,0.0192881576756695,99.7469528161236,0
572.1,572,2129,2160,61741,21600,2025-04-07,2025-04-11,505.28,31,-40141,52569756,25897074,0.0410882637537827,99.2986785025215,-1.85837962962963
592.12,592,1767,1762,28272,21144,2025-04-07,2025-04-25,505.28,-5,-7128,13056472,-3270620,0.161942674866534,97.5463662771995,-0.337116912599319
618.25,618,845,844,22815,21100,2025-04-07,2025-05-30,505.28,-1,-1715,25903649,-10875774,0.0814557053332525,98.8847517197288,-0.0812796208530806
568.21,463,2,2,21042,21042,2025-04-07,2025-05-16,505.28,0,0,191683614,-460736.000000003,0.0109774641456833,99.5278360100201,0
569.17,464,2,2,21034,21034,2025-04-07,2025-08-15,505.28,0,0,112162086,-42661174,0.0187532175533897,99.765706033677,0
700.03,700,7009,7009,14018,21027,2025-04-07,2025-05-16,505.28,0,7009,191683614,-460736.000000003,0.010969638750655,99.5388056487708,0.333333333333333
564.77,355,1,1,20977,20977,2025-04-07,2025-08-15,505.28,0,0,112162086,-42661174,0.0187023982417731,99.7844084319188,0
546.44,442,2,2,20888,20888,2025-04-07,2025-05-16,505.28,0,0,191683614,-460736.000000003,0.0108971234233929,99.5497027721942,0
568.29,464,2,2,20858,20858,2025-04-07,2025-05-16,505.28,0,0,191683614,-460736.000000003,0.0108814726333363,99.5605842448275,0
571.11,571,1914,1896,65076,20856,2025-04-07,2025-04-11,505.28,-18,-44220,52569756,25897074,0.0396730013355968,99.3383515038571,-2.12025316455696
541.8,527,0,14,0,20720,2025-04-07,2025-05-23,505.28,14,20720,3097569,2640978,0.668911652976899,93.9355991747077,1
568.86,466,2,2,20572,20572,2025-04-07,2025-05-16,505.28,0,0,191683614,-460736.000000003,0.0107322684347969,99.5713165132623,0
613.34,613,608,603,24928,20502,2025-04-07,2025-05-30,505.28,-5,-4426,25903649,-10875774,0.0791471502721489,98.9638988700009,-0.215881377426592
520.9,480,1,5,8341,20450,2025-04-07,2025-04-25,505.28,4,12109,13056472,-3270620,0.156627303302148,97.7029935805017,0.592127139364303
522.19,420,1,2,19549,20438,2025-04-07,2025-05-30,505.28,1,889,25903649,-10875774,0.0789000808341713,99.0427989508351,0.0434974067912712
569.16,467,2,2,20432,20432,2025-04-07,2025-08-15,505.28,0,0,112162086,-42661174,0.0182164942973689,99.8026249262162,0
568.23,467,2,2,20246,20246,2025-04-07,2025-05-16,505.28,0,0,191683614,-460736.000000003,0.0105621965161821,99.5818787097785,0
765.12,765,1662,1662,19944,19944,2025-04-07,2025-12-19,505.28,0,0,850516954,-173881469,0.002344926800836,99.9862896325051,0
583.05,582.5,345,361,33810,19855,2025-04-07,2025-05-02,505.28,16,-13955,15637149,-467056,0.126973273708654,99.0276936032265,-0.70284563082347
566.68,564,79,74,44240,19832,2025-04-07,2025-05-09,505.28,-5,-24408,21122544,7108655,0.093890205649471,99.2907483113776,-1.23073820088745
628.1,628,1989,1977,13923,19770,2025-04-07,2025-05-16,505.28,-12,5847,191683614,-460736.000000003,0.0103138706472844,99.5921925804258,0.295751138088012
623.12,623,1633,1633,16330,19596,2025-04-07,2025-05-16,505.28,0,3265.99999999999,191683614,-460736.000000003,0.0102230960649563,99.6024156764907,0.166666666666666
680.06,680,3231,3234,16155,19404,2025-04-07,2025-06-20,505.28,3,3249,478977607,-137482950,0.00405112884536166,99.9700376389412,0.167439703153989
583.49,583,380,392,35720,19208,2025-04-07,2025-05-02,505.28,12,-16512,15637149,-467056,0.122835690828296,99.1505292940548,-0.859641815910038
595.42,595,569,454,28450,19068,2025-04-07,2025-05-09,505.28,-115,-9382,21122544,7108655,0.0902732170897596,99.3810215284674,-0.492028529473463
509.66,415,0,2,0,18932,2025-04-07,2025-04-11,505.28,2,18932,52569756,25897074,0.0360131022864173,99.3743646061435,1
568.45,474,2,2,18890,18890,2025-04-07,2025-05-16,505.28,0,0,191683614,-460736.000000003,0.00985478080562483,99.6122704572964,0
526.79,433,1,2,13145,18758,2025-04-07,2025-05-16,505.28,1,5613,191683614,-460736.000000003,0.0097859173293759,99.6220563746257,0.29923232754025
522.5,485,1,5,7696,18750,2025-04-07,2025-04-25,505.28,4,11054,13056472,-3270620,0.143606940680453,97.8466005211821,0.589546666666667
567,474,2,2,18600,18600,2025-04-07,2025-08-15,505.28,0,0,112162086,-42661174,0.0165831437906745,99.8192080700068,0
680.07,680,2590,2625,7770,18375,2025-04-07,2025-05-30,505.28,35,10605,25903649,-10875774,0.0709359519193609,99.1137349027544,0.577142857142857
613.1,430,1,1,18310,18310,2025-04-07,2025-05-30,505.28,0,0,25903649,-10875774,0.0706850220214148,99.1844199247759,0
567.45,476,2,2,18290,18290,2025-04-07,2025-08-15,505.28,0,0,112162086,-42661174,0.0163067580608299,99.8355148280677,0
584.32,584,323,564,13566,18048,2025-04-07,2025-04-25,505.28,241,4482,13056472,-3270620,0.138230296821377,97.9848308180035,0.248337765957447
568.95,479,2,2,17990,17990,2025-04-07,2025-05-16,505.28,0,0,191683614,-460736.000000003,0.00938525710392752,99.6314416317297,0
660.09,660,2179,1998,10895,17982,2025-04-07,2025-05-30,505.28,-181,7087,25903649,-10875774,0.0694187911517794,99.2538387159276,0.394116338560783
579.96,579,193,187,38021,17952,2025-04-07,2025-05-09,505.28,-6,-20069,21122544,7108655,0.0849897625967781,99.4660112910642,-1.11792557932264
670.06,670,2992,2992,8976,17952,2025-04-07,2025-05-16,505.28,0,8976,191683614,-460736.000000003,0.00936543276985585,99.6408070644995,0.5
569.07,481,2,2,17614,17614,2025-04-07,2025-05-16,505.28,0,0,191683614,-460736.000000003,0.00918910053521841,99.6499961650347,0
585.02,585,9142,8789,45710,17578,2025-04-07,2025-04-11,505.28,-353,-28132,52569756,25897074,0.0334374768640737,99.4078020830076,-1.60040960291273
569.36,482,2,2,17472,17472,2025-04-07,2025-08-15,505.28,0,0,112162086,-42661174,0.0155774563607884,99.8510922844284,0
578.06,578,2590,2909,28490,17454,2025-04-07,2025-04-11,505.28,319,-11036,52569756,25897074,0.0332015997943761,99.441003682802,-0.632290592414346
590.1,590,1672,1738,31768,17380,2025-04-07,2025-04-25,505.28,66,-14388,13056472,-3270620,0.133114060214735,98.1179448782183,-0.827848101265823
617.15,617,1174,1157,14088,17355,2025-04-07,2025-05-16,505.28,-17,3267,191683614,-460736.000000003,0.00905398204772996,99.6590501470825,0.188245462402766
685.1,685,1713,1713,17130,17130,2025-04-07,2025-07-18,505.28,0,0,104857395,-33238059,0.0163364729783722,99.9384611834006,0
595.12,595,1497,1427,16467,17124,2025-04-07,2025-04-25,505.28,-70,656.999999999996,13056472,-3270620,0.131153346784644,98.2490982250029,0.0383672039243165
563.46,393,1,1,17046,17046,2025-04-07,2025-05-16,505.28,0,0,191683614,-460736.000000003,0.00889277891014722,99.6679429259926,0
525.23,469,1,3,9629,16869,2025-04-07,2025-05-16,505.28,2,7240,191683614,-460736.000000003,0.00880043924881341,99.6767433652414,0.429189637797143
562.3,394,1,1,16830,16830,2025-04-07,2025-05-16,505.28,0,0,191683614,-460736.000000003,0.00878009322173986,99.6855234584632,0
775.09,775,1857,1858,5571,16722,2025-04-07,2025-09-19,505.28,1,11151,264848567,-73847933,0.00631379666856948,99.9568319355868,0.666846071044134
558.06,392,1,1,16606,16606,2025-04-07,2025-05-16,505.28,0,0,191683614,-460736.000000003,0.00866323398931742,99.6941866924525,0
562.6,397,1,1,16560,16560,2025-04-07,2025-05-16,505.28,0,0,191683614,-460736.000000003,0.00863923611123067,99.7028259285637,0
561.4,396,1,1,16540,16540,2025-04-07,2025-05-16,505.28,0,0,191683614,-460736.000000003,0.00862880225119295,99.7114547308149,0
525.58,443,2,2,24116,16516,2025-04-07,2025-05-16,505.28,0,-7600,191683614,-460736.000000003,0.00861628161914769,99.7200710124341,-0.460159844998789
562.06,399,1,1,16306,16306,2025-04-07,2025-05-16,505.28,0,0,191683614,-460736.000000003,0.00850672608875165,99.7285777385228,0
562.43,401,1,1,16143,16143,2025-04-07,2025-05-16,505.28,0,0,191683614,-460736.000000003,0.00842169012944424,99.7369994286523,0
581.5,581,181,322,20091,16100,2025-04-07,2025-05-02,505.28,141,-3991,15637149,-467056,0.102959944936254,99.2534892389911,-0.247888198757764
622.12,622,1421,1340,11368,16080,2025-04-07,2025-05-16,505.28,-81,4712,191683614,-460736.000000003,0.00838882347032543,99.7453882521226,0.293034825870647
562.69,402,1,1,16069,16069,2025-04-07,2025-05-16,505.28,0,0,191683614,-460736.000000003,0.00838308484730468,99.7537713369699,0
538.45,529,0,17,0,16065,2025-04-07,2025-05-02,505.28,17,16065,15637149,-467056,0.102736118969001,99.3562253579601,1
562.86,403,1,1,15986,15986,2025-04-07,2025-05-16,505.28,0,0,191683614,-460736.000000003,0.00833978432814816,99.762111121298,0
583.19,583,713,834,31372,15846,2025-04-07,2025-04-25,505.28,121,-15526,13056472,-3270620,0.121365097707865,98.3704633227108,-0.979805629180866
518.37,492,0,6,0,15822,2025-04-07,2025-04-11,505.28,6,15822,52569756,25897074,0.0300971531996458,99.4711008360016,1
561.5,404,1,1,15750,15750,2025-04-07,2025-05-16,505.28,0,0,191683614,-460736.000000003,0.00821666477970308,99.7703277860778,0
631.2,631,785,786,10205,15720,2025-04-07,2025-05-30,505.28,1,5515,25903649,-10875774,0.0606864307032573,99.3145251466309,0.350826972010178
564.12,407,1,1,15712,15712,2025-04-07,2025-05-16,505.28,0,0,191683614,-460736.000000003,0.00819684044563141,99.7785246265234,0
596.1,596,1595,1570,25520,15700,2025-04-07,2025-04-25,505.28,-25,-9820,13056472,-3270620,0.120246878329766,98.4907102010405,-0.625477707006369
564.13,408,1,1,15613,15613,2025-04-07,2025-05-16,505.28,0,0,191683614,-460736.000000003,0.00814519283844471,99.7866698193618,0
720.12,720,1302,1301,9114,15612,2025-04-07,2025-08-15,505.28,-1,6498,112162086,-42661174,0.013919141981721,99.8650114264102,0.416218293620292
513.18,482,0,5,0,15590,2025-04-07,2025-04-11,505.28,5,15590,52569756,25897074,0.0296558348111793,99.5007566708128,1
560.47,405,1,1,15547,15547,2025-04-07,2025-05-09,505.28,0,0,21122544,7108655,0.0736038234788385,99.539615114543,0
569.44,492,2,2,15488,15488,2025-04-07,2025-05-16,505.28,0,0,191683614,-460736.000000003,0.00807998121320897,99.794749800575,0
562.96,409,1,1,15396,15396,2025-04-07,2025-05-16,505.28,0,0,191683614,-460736.000000003,0.00803198545703547,99.8027817860321,0
785.02,785,7688,7672,7688,15344,2025-04-07,2025-06-20,505.28,-16,7656,478977607,-137482950,0.00320349005376362,99.973241128995,0.49895724713243
542.09,491,3,3,24258,15327,2025-04-07,2025-08-15,505.28,0,-8931,112162086,-42661174,0.0136650454236381,99.8786764718338,-0.582697201017812
715.05,715,3062,3062,15310,15310,2025-04-07,2025-07-18,505.28,0,0,104857395,-33238059,0.0146007823291815,99.9530619657298,0
562.55,410,1,1,15255,15255,2025-04-07,2025-05-16,505.28,0,0,191683614,-460736.000000003,0.00795842674376955,99.8107402127758,0
541.43,533,3,18,6360,15174,2025-04-07,2025-05-02,505.28,15,8814,15637149,-467056,0.0970381493455105,99.4532635073056,0.580862000790826
552.44,546,0,23,0,14812,2025-04-07,2025-05-09,505.28,23,14812,21122544,7108655,0.0701241289874932,99.6097392435305,1
562.86,415,1,1,14786,14786,2025-04-07,2025-05-02,505.28,0,0,15637149,-467056,0.0945568786228231,99.5478203859284,0
730.08,730,1831,1831,14648,14648,2025-04-07,2025-09-19,505.28,0,0,264848567,-73847933,0.00553070766661917,99.9623626432534,0
605.06,605,2521,2431,12605,14586,2025-04-07,2025-04-25,505.28,-90,1981,13056472,-3270620,0.111714711294138,98.6024249123347,0.13581516522693
564.16,419,1,1,14516,14516,2025-04-07,2025-05-16,505.28,0,0,191683614,-460736.000000003,0.00757289561537587,99.8183131083912,0
559.04,553,6,24,7518,14496,2025-04-07,2025-05-23,505.28,18,6978,3097569,2640978,0.467979890036348,94.403579064744,0.481374172185431
615.04,615,3745,3611,14980,14444,2025-04-07,2025-04-25,505.28,-134,-536.000000000002,13056472,-3270620,0.110627128063385,98.7130520403981,-0.037108834117973
619.13,619,1156,1110,10404,14430,2025-04-07,2025-05-16,505.28,-46,4026,191683614,-460736.000000003,0.00752803001721368,99.8258411384084,0.279002079002079
800.1,800,1340,1439,8040,14390,2025-04-07,2025-12-19,505.28,99,6350,850516954,-173881469,0.00169191218732602,99.9879815446924,0.441278665740097
800.08,800,1785,1797,5355,14376,2025-04-07,2025-08-15,505.28,12,9021,112162086,-42661174,0.0128171653298246,99.8914936371636,0.627504173622705
579.49,579,313,293,41942,14357,2025-04-07,2025-05-02,505.28,-20,-27585,15637149,-467056,0.0918134117670683,99.6396337976955,-1.92136240161594
521.36,486,0,4,0,14144,2025-04-07,2025-04-11,505.28,4,14144,52569756,25897074,0.0269052038209955,99.5276618746338,1
616.28,616,489,504,14670,14112,2025-04-07,2025-05-30,505.28,15,-557.999999999998,25903649,-10875774,0.0544788110740691,99.369003957705,-0.0395408163265305
695.18,695,780,781,13260,14058,2025-04-07,2025-09-19,505.28,1,797.999999999996,264848567,-73847933,0.00530793885699974,99.9676705821104,0.0567648314127185
558.53,418,1,1,14053,14053,2025-04-07,2025-05-16,505.28,0,0,191683614,-460736.000000003,0.00733135175550269,99.8331724901639,0
740.07,740,2000,1999,18000,13993,2025-04-07,2025-09-19,505.28,-1,-4007,264848567,-73847933,0.00528339653051625,99.9729539786409,-0.286357464446509
563.88,426,1,1,13788,13788,2025-04-07,2025-05-16,505.28,0,0,191683614,-460736.000000003,0.00719310311000292,99.8403655932739,0
558.32,421,1,1,13732,13732,2025-04-07,2025-05-16,505.28,0,0,191683614,-460736.000000003,0.00716388830189731,99.8475294815758,0
700.05,700,2756,2739,5512,13695,2025-04-07,2025-05-30,505.28,-17,8183,25903649,-10875774,0.0528689992672461,99.4218729569722,0.597517342095656
521.38,476,2,3,18598,13614,2025-04-07,2025-05-16,505.28,1,-4984,191683614,-460736.000000003,0.00710232852767478,99.8546318101035,-0.366093727045688
558.42,423,1,1,13542,13542,2025-04-07,2025-05-16,505.28,0,0,191683614,-460736.000000003,0.00706476663153899,99.861696576735,0
745.06,745,2251,2250,18008,13500,2025-04-07,2025-09-19,505.28,-1,-4508,264848567,-73847933,0.00509725242349527,99.9780512310644,-0.333925925925926
553.13,547,0,22,0,13486,2025-04-07,2025-05-09,505.28,22,13486,21122544,7108655,0.063846476068413,99.6735857195989,1
750.03,750,4462,4462,13386,13386,2025-04-07,2025-07-18,505.28,0,0,104857395,-33238059,0.0127659093571798,99.9658278750869,0
564.99,432,1,1,13299,13299,2025-04-07,2025-08-15,505.28,0,0,112162086,-42661174,0.0118569478103323,99.903350584974,0
815.05,815,2650,2652,5300,13260,2025-04-07,2025-08-15,505.28,2,7960,112162086,-42661174,0.0118221767023841,99.9151727616763,0.600301659125189
577.05,577,2662,2649,31944,13245,2025-04-07,2025-04-11,505.28,-13,-18699,52569756,25897074,0.0251950950656876,99.5528569696995,-1.41177802944507
604.09,604,1470,1469,8820,13221,2025-04-07,2025-04-25,505.28,-1,4401,13056472,-3270620,0.101260126012601,98.8143121664107,0.33287950987066
528.05,484,2,3,17040,13215,2025-04-07,2025-05-16,505.28,1,-3825,191683614,-460736.000000003,0.0068941730199223,99.868590749755,-0.2894438138479
565.87,561,15,27,13440,13149,2025-04-07,2025-05-23,505.28,12,-291,3097569,2640978,0.424494175916662,94.8280732406607,-0.0221309605293178
565.31,434,1,1,13131,13131,2025-04-07,2025-08-15,505.28,0,0,112162086,-42661174,0.0117071645760939,99.9268799262524,0
690.04,690,3227,3269,9681,13076,2025-04-07,2025-05-16,505.28,42,3395,191683614,-460736.000000003,0.00682165769266016,99.8754124074476,0.259635974304069
685.03,685,4335,4335,13005,13005,2025-04-07,2025-05-16,505.28,0,0,191683614,-460736.000000003,0.00678461748952626,99.8821970249372,0
610.19,610,615,679,7995,12901,2025-04-07,2025-05-09,505.28,64,4906,21122544,7108655,0.0610769233099952,99.7346626429089,0.380280598403225
760.19,760,673,674,8749,12806,2025-04-07,2025-12-19,505.28,1,4057,850516954,-173881469,0.00150567251361341,99.989487217206,0.316804622833047
805.07,805,1825,1826,5475,12782,2025-04-07,2025-09-19,505.28,1,7307,264848567,-73847933,0.00482615410941604,99.9828773851738,0.571663276482554
582.88,582,132,145,20856,12760,2025-04-07,2025-05-09,505.28,13,-8096,21122544,7108655,0.0604093900810433,99.79507203299,-0.63448275862069
795.12,795,962,1057,7696,12684,2025-04-07,2025-12-19,505.28,95,4988,850516954,-173881469,0.00149132829631989,99.9909785455024,0.393251340271208
562.72,436,1,1,12672,12672,2025-04-07,2025-05-16,505.28,0,0,191683614,-460736.000000003,0.00661089371989825,99.888807918657,0
516.59,390,0,1,0,12659,2025-04-07,2025-04-11,505.28,1,12659,52569756,25897074,0.0240803856879229,99.5769373553874,1
564.17,439,1,1,12517,12517,2025-04-07,2025-05-16,505.28,0,0,191683614,-460736.000000003,0.00653003130460593,99.8953379499616,0
526.54,485,0,3,0,12462,2025-04-07,2025-05-23,505.28,3,12462,3097569,2640978,0.402315493214195,95.2303887338748,1
579.27,579,507,456,38025,12312,2025-04-07,2025-04-25,505.28,-51,-25713,13056472,-3270620,0.0942980615284129,98.9086102279391,-2.08845029239766
562.91,441,1,1,12191,12191,2025-04-07,2025-05-16,505.28,0,0,191683614,-460736.000000003,0.00635995938599113,99.9016979093476,0
567.79,446,1,1,12179,12179,2025-04-07,2025-08-15,505.28,0,0,112162086,-42661174,0.0108583929154099,99.9377383191679,0
546.34,425,1,1,12134,12134,2025-04-07,2025-05-30,505.28,0,0,25903649,-10875774,0.0468428212565728,99.4687157782288,0
530.24,490,0,3,0,12072,2025-04-07,2025-05-23,505.28,3,12072,3097569,2640978,0.389724974649475,95.6201137085243,1
820.06,820,1997,1997,3994,11982,2025-04-07,2025-08-15,505.28,0,7988,112162086,-42661174,0.0106827542419281,99.9484210734098,0.666666666666667
597.12,597,986,969,8874,11628,2025-04-07,2025-04-25,505.28,-17,2754,13056472,-3270620,0.0890592803323899,98.9976695082715,0.236842105263158
610.11,610,1124,1052,8992,11572,2025-04-07,2025-05-02,505.28,-72,2580,15637149,-467056,0.0740032598013871,99.7136370574969,0.222951952989976
587.19,587,566,609,16414,11571,2025-04-07,2025-04-25,505.28,43,-4843,13056472,-3270620,0.0886227152327214,99.0862922235042,-0.418546365914787
561.44,446,1,1,11544,11544,2025-04-07,2025-05-16,505.28,0,0,191683614,-460736.000000003,0.00602242401377094,99.9077203333614,0
605.1,605,1115,1148,10035,11480,2025-04-07,2025-05-02,505.28,33,1445,15637149,-467056,0.0734149172588942,99.7870519747558,0.125871080139373
720.04,720,2831,2831,8493,11324,2025-04-07,2025-06-20,505.28,0,2831,478977607,-137482950,0.00236420238326507,99.9756053313783,0.25
563.8,451,1,1,11280,11280,2025-04-07,2025-05-16,505.28,0,0,191683614,-460736.000000003,0.00588469706127306,99.9136050304227,0
526.25,470,1,2,9427,11250,2025-04-07,2025-04-25,505.28,1,1823,13056472,-3270620,0.086164164408272,99.1724563879125,0.162044444444444
755.15,755,745,749,15645,11235,2025-04-07,2025-12-19,505.28,4,-4410,850516954,-173881469,0.00132096132207142,99.9922995068244,-0.392523364485981
564.42,453,1,1,11142,11142,2025-04-07,2025-05-16,505.28,0,0,191683614,-460736.000000003,0.00581270342701281,99.9194177338497,0
610.06,610,2081,1855,8324,11130,2025-04-07,2025-04-25,505.28,-226,2806,13056472,-3270620,0.0852450799879171,99.2577014679004,0.252111410601977
645.13,645,828,851,4968,11063,2025-04-07,2025-05-30,505.28,23,6095,25903649,-10875774,0.0427082686304157,99.5114240468592,0.550935550935551
619.28,619,403,395,10478,11060,2025-04-07,2025-05-30,505.28,-8,582,25903649,-10875774,0.0426966872505105,99.5541207341097,0.052622061482821
745.15,745,733,733,10995,10995,2025-04-07,2025-12-19,505.28,0,0,850516954,-173881469,0.00129274318969073,99.9935922500141,0
725.03,725,3640,3640,10920,10920,2025-04-07,2025-06-20,505.28,0,0,478977607,-137482950,0.00227985606016024,99.9778851874384,0
563.75,455,1,1,10875,10875,2025-04-07,2025-05-30,505.28,0,0,25903649,-10875774,0.0419825021563564,99.5961032362661,0
730.05,730,2171,2174,4342,10870,2025-04-07,2025-06-20,505.28,3,6528,478977607,-137482950,0.00226941715878588,99.9801546045972,0.600551977920883
581.05,581,1910,2170,13370,10850,2025-04-07,2025-04-11,505.28,260,-2520,52569756,25897074,0.0206392435985436,99.5975765989859,-0.232258064516129
594.12,594,902,898,12628,10776,2025-04-07,2025-04-25,505.28,-4,-1852,13056472,-3270620,0.0825337809478702,99.3402352488482,-0.171863400148478
523.65,470,0,2,0,10730,2025-04-07,2025-05-23,505.28,2,10730,3097569,2640978,0.346400677434466,95.9665143859588,1
518.54,465,0,2,0,10708,2025-04-07,2025-05-02,505.28,2,10708,15637149,-467056,0.0684779559240626,99.8555299306798,1
775.12,775,883,883,10596,10596,2025-04-07,2025-12-19,505.28,0,0,850516954,-173881469,0.00124583054460782,99.9948380805587,0
590.02,590,5236,5227,15708,10454,2025-04-07,2025-04-11,505.28,-9,-5254,52569756,25897074,0.0198859587630576,99.617462557749,-0.502582743447484
715.05,715,1670,2079,3340,10395,2025-04-07,2025-06-20,505.28,409,7055,478977607,-137482950,0.00217024759572946,99.9823248521929,0.678691678691679
561.44,556,11,19,12177,10336,2025-04-07,2025-05-23,505.28,8,-1841,3097569,2640978,0.333681025346005,96.3001954113048,-0.178115325077399
563.76,461,1,1,10276,10276,2025-04-07,2025-05-16,505.28,0,0,191683614,-460736.000000003,0.00536091728737961,99.9247786511371,0
562.05,460,1,1,10205,10205,2025-04-07,2025-05-09,505.28,0,0,21122544,7108655,0.0483133092301761,99.8433853422202,0
650.12,650,834,843,4170,10116,2025-04-07,2025-05-30,505.28,9,5946,25903649,-10875774,0.0390524130403404,99.6351556493064,0.587781731909846
755.03,755,3369,3369,6738,10107,2025-04-07,2025-06-20,505.28,0,3369,478977607,-137482950,0.00211011952381315,99.9844349717168,0.333333333333333
780.1,780,998,998,9980,9980,2025-04-07,2025-12-19,505.28,0,0,850516954,-173881469,0.00117340400483069,99.9960114845635,0
631.1,631,948,984,4740,9840,2025-04-07,2025-05-16,505.28,36,5100,191683614,-460736.000000003,0.00513345913855735,99.9299121102757,0.518292682926829
595.02,595,4905,4887,14715,9774,2025-04-07,2025-04-11,505.28,-18,-4941,52569756,25897074,0.0185924393485867,99.6360549970976,-0.505524861878453
627.11,627,914,885,9140,9735,2025-04-07,2025-05-16,505.28,-29,595,191683614,-460736.000000003,0.00507868137335933,99.934990791649,0.0611196712891628
571.16,475,1,1,9616,9616,2025-04-07,2025-05-02,505.28,0,0,15637149,-467056,0.0614945857457776,99.9170245164256,0
519.08,425,0,1,0,9408,2025-04-07,2025-04-25,505.28,1,9408,13056472,-3270620,0.0720562185558243,99.4122914674041,1
830.05,830,1832,1854,3664,9270,2025-04-07,2025-08-15,505.28,22,5606,112162086,-42661174,0.00826482488922326,99.956685898299,0.604746494066882
511.84,420,0,1,0,9184,2025-04-07,2025-04-11,505.28,1,9184,52569756,25897074,0.0174701210330898,99.6535251181307,1
820.05,820,1789,1789,5367,8945,2025-04-07,2025-09-19,505.28,0,3578,264848567,-73847933,0.00337740169838261,99.9862547868722,0.4
638.08,638,1109,1110,4436,8880,2025-04-07,2025-05-16,505.28,1,4444,191683614,-460736.000000003,0.00463263385674688,99.9396234255057,0.500450450450451
571.05,563,11,11,8855,8855,2025-04-07,2025-05-23,505.28,0,0,3097569,2640978,0.285869338181006,96.5860647494858,0
614.37,614,230,239,8050,8843,2025-04-07,2025-05-30,505.28,9,793,25903649,-10875774,0.0341380475005664,99.669293696807,0.0896754495080855
512.49,425,0,1,0,8749,2025-04-07,2025-04-11,505.28,1,8749,52569756,25897074,0.016642649054715,99.6701677671854,1
755.01,755,8712,8717,8712,8717,2025-04-07,2025-05-16,505.28,5,5,191683614,-460736.000000003,0.00454759789743948,99.9441710234032,0.000573591832052312
576.07,576,1242,1234,18630,8638,2025-04-07,2025-04-11,505.28,-8,-9992,52569756,25897074,0.016431501032647,99.686599268218,-1.156749247511
569.68,484,1,1,8568,8568,2025-04-07,2025-08-15,505.28,0,0,112162086,-42661174,0.00763894494615587,99.9643248432452,0
790.04,790,2132,2133,4264,8532,2025-04-07,2025-07-18,505.28,1,4268,104857395,-33238059,0.00813676517521726,99.9739646402621,0.500234411626817
570.27,567,16,26,10992,8502,2025-04-07,2025-05-23,505.28,10,-2490,3097569,2640978,0.274473304710888,96.8605380541967,-0.29287226534933
524.71,440,0,1,0,8471,2025-04-07,2025-04-25,505.28,1,8471,13056472,-3270620,0.0648797010402197,99.4771711684443,1
524.7,440,2,1,24542,8470,2025-04-07,2025-05-30,505.28,-1,-16072,25903649,-10875774,0.032698095932353,99.7019917927393,-1.89752066115702
830.04,830,2100,2099,6300,8396,2025-04-07,2025-09-19,505.28,-1,2096,264848567,-73847933,0.00317011343316047,99.9894249003054,0.249642686993807
599.1,599,739,838,5912,8380,2025-04-07,2025-04-25,505.28,99,2468,13056472,-3270620,0.0641827286881173,99.5413538971324,0.294510739856802
593.19,593,376,439,5640,8341,2025-04-07,2025-04-25,505.28,63,2701,13056472,-3270620,0.0638840262515019,99.6052379233839,0.323822083683012
513.05,430,0,1,0,8305,2025-04-07,2025-04-11,505.28,1,8305,52569756,25897074,0.0157980569664428,99.7023973251845,1
582.04,582,2081,2051,14567,8204,2025-04-07,2025-04-11,505.28,-30,-6363,52569756,25897074,0.0156059312887052,99.7180032564732,-0.775597269624574
569.82,567.5,34,35,15504,8120,2025-04-07,2025-05-09,505.28,1,-7384,21122544,7108655,0.0384423391424821,99.8818276813626,-0.90935960591133
529.72,449,1,1,11477,8072,2025-04-07,2025-05-16,505.28,0,-3405,191683614,-460736.000000003,0.00421110591122306,99.9483821293144,-0.421828543111992
526.69,487,1,2,8228,7938,2025-04-07,2025-05-16,505.28,1,-290,191683614,-460736.000000003,0.00414119904897035,99.9525233283634,-0.036533131771227
770.12,770,659,659,7908,7908,2025-04-07,2025-12-19,505.28,0,0,850516954,-173881469,0.000929787461943998,99.9969412720255,0
740.03,740,2565,2564,5130,7692,2025-04-07,2025-06-20,505.28,-1,2562,478977607,-137482950,0.00160592058743155,99.9860408923042,0.333073322932917
579.7,578,16,45,5680,7650,2025-04-07,2025-05-23,505.28,29,1970,3097569,2640978,0.246967864154116,97.1075059183508,0.257516339869281
637.1,637,576,753,2880,7530,2025-04-07,2025-05-16,505.28,177,4650,191683614,-460736.000000003,0.0039283483042009,99.9564516766676,0.617529880478088
549.51,537,0,6,0,7506,2025-04-07,2025-05-23,505.28,6,7506,3097569,2640978,0.24231905729945,97.3498249756503,1
745.04,745,1874,1874,3748,7496,2025-04-07,2025-06-20,505.28,0,3748,478977607,-137482950,0.00156500009404406,99.9876058923982,0.5
573.06,573,1231,1247,30775,7482,2025-04-07,2025-04-11,505.28,16,-23293,52569756,25897074,0.0142325180280464,99.7322357745012,-3.11320502539428
550.09,544,0,12,0,7308,2025-04-07,2025-05-09,505.28,12,7308,21122544,7108655,0.0345981052282339,99.9164257865909,1
790.09,790,802,802,7218,7218,2025-04-07,2025-12-19,505.28,0,0,850516954,-173881469,0.000848660331349491,99.9977899323568,0
529.57,494,1,2,6217,7114,2025-04-07,2025-05-16,505.28,1,897,191683614,-460736.000000003,0.00371132401541636,99.960163000683,0.12608940118077
765.12,765,580,590,2900,7080,2025-04-07,2025-09-19,505.28,10,4180,264848567,-73847933,0.00267322571543308,99.9920981260208,0.590395480225989
825.02,825,3537,3537,3537,7074,2025-04-07,2025-06-20,505.28,0,3537,478977607,-137482950,0.00147689576644446,99.9890827881647,0.5
815.02,815,3524,3524,3524,7048,2025-04-07,2025-06-20,505.28,0,3524,478977607,-137482950,0.0014714675377298,99.9905542557024,0.5
579.05,579,1394,1378,13940,6890,2025-04-07,2025-04-11,505.28,-16,-7050,52569756,25897074,0.0131063952436835,99.7453421697449,-1.02322206095791
629.17,629,420,404,5880,6868,2025-04-07,2025-05-30,505.28,-16,988.000000000001,25903649,-10875774,0.0265136390629753,99.7285054318023,0.143855562026791
622.21,622,322,322,7728,6762,2025-04-07,2025-05-30,505.28,0,-966,25903649,-10875774,0.0261044303063248,99.7546098621086,-0.142857142857143
626.2,626,242,337,4356,6740,2025-04-07,2025-05-30,505.28,95,2384,25903649,-10875774,0.02601950018702,99.7806293622956,0.353709198813057
592.54,592.5,1665,1665,6660,6660,2025-04-07,2025-04-11,505.28,0,0,52569756,25897074,0.012668881324083,99.758011051069,0
620.02,620,3304,3326,3304,6652,2025-04-07,2025-04-11,505.28,22,3348,52569756,25897074,0.0126536634486186,99.7706647145176,0.503307276007216
552.5,543,0,7,0,6650,2025-04-07,2025-05-23,505.28,7,6650,3097569,2640978,0.214684483218937,97.5645094588692,1
705.13,705,500,510,4000,6630,2025-04-07,2025-08-15,505.28,10,2630,112162086,-42661174,0.00591108835119204,99.9702359315964,0.396681749622926
634.16,634,398,411,4776,6576,2025-04-07,2025-05-30,505.28,13,1800,25903649,-10875774,0.0253863847522023,99.8060157470479,0.273722627737226
632.1,632,656,656,6560,6560,2025-04-07,2025-05-30,505.28,0,0,25903649,-10875774,0.0253246173927079,99.8313403644406,0
543.6,479,1,1,6460,6460,2025-04-07,2025-04-11,505.28,0,0,52569756,25897074,0.0122884344374739,99.7829531489551,0
735.02,735,3223,3223,6446,6446,2025-04-07,2025-06-20,505.28,0,0,478977607,-137482950,0.0013457831651825,99.9919000388676,0
588.02,588,3172,3164,12688,6328,2025-04-07,2025-04-11,505.28,-8,-6360,52569756,25897074,0.0120373394923119,99.7949904884474,-1.00505689001264
760.03,760,2083,2089,6249,6267,2025-04-07,2025-06-20,505.28,6,18,478977607,-137482950,0.00130841189826229,99.9932084507658,0.00287218764959311
582.54,582.5,1464,1561,10248,6244,2025-04-07,2025-04-11,505.28,97,-4004,52569756,25897074,0.0118775517999361,99.8068680402473,-0.641255605381166
624.23,624,271,269,4607,6187,2025-04-07,2025-05-30,505.28,-2,1580,25903649,-10875774,0.0238846658244945,99.8552250302651,0.255374171650234
690.05,690,1230,1231,3690,6155,2025-04-07,2025-05-30,505.28,1,2465,25903649,-10875774,0.0237611311055056,99.8789861613706,0.400487408610885
583.34,582.5,67,73,10653,6132,2025-04-07,2025-05-09,505.28,6,-4521,21122544,7108655,0.0290305940420813,99.945456380633,-0.737279843444227
720.08,720,753,753,4518,6024,2025-04-07,2025-07-18,505.28,0,1506,104857395,-33238059,0.00574494531358518,99.9797095855757,0.25
785.09,785,663,664,5304,5976,2025-04-07,2025-12-19,505.28,1,672,850516954,-173881469,0.000702631496279379,99.9984925638531,0.112449799196787
620.06,620,992,990,3968,5940,2025-04-07,2025-04-25,505.28,-2,1972,13056472,-3270620,0.0454946788075676,99.6507326021915,0.331986531986532
571.09,568,5,19,3295,5871,2025-04-07,2025-05-23,505.28,14,2576,3097569,2640978,0.189535729470433,97.7540451883396,0.438766819962528
625.02,625,2911,2935,5822,5870,2025-04-07,2025-04-11,505.28,24,48,52569756,25897074,0.0111661161219771,99.8180341563693,0.00817717206132879
785.03,785,1922,1922,5766,5766,2025-04-07,2025-07-18,505.28,0,0,104857395,-33238059,0.00549889685891968,99.9852084824347,0
633.12,633,475,476,5700,5712,2025-04-07,2025-05-30,505.28,1,12,25903649,-10875774,0.0220509473395042,99.9010371087101,0.00210084033613445
589.24,589,257,236,5911,5664,2025-04-07,2025-04-25,505.28,-21,-247,13056472,-3270620,0.0433807846407514,99.6941133868322,-0.0436087570621469
633.1,633,581,565,4067,5650,2025-04-07,2025-05-16,505.28,-16,1583,191683614,-460736.000000003,0.00294756546065539,99.9631105661437,0.280176991150443
675.03,675,1881,1871,1881,5613,2025-04-07,2025-05-16,505.28,-10,3732,191683614,-460736.000000003,0.00292826281958561,99.9660388289632,0.664885088188135
590.95,590,0,58,0,5510,2025-04-07,2025-05-23,505.28,58,5510,3097569,2640978,0.177881428952834,97.9319266172925,1
586.04,586,1367,1371,5468,5484,2025-04-07,2025-04-11,505.28,4,16,52569756,25897074,0.0104318536308215,99.8284660100001,0.00291757840991977
615.1,615,572,542,2288,5420,2025-04-07,2025-05-02,505.28,-30,3132,15637149,-467056,0.0346610497859936,99.9516855662116,0.577859778597786
588.15,588,600,356,16200,5340,2025-04-07,2025-04-25,505.28,-244,-10860,13056472,-3270620,0.0408992567057931,99.735012643538,-2.03370786516854
825.04,825,1316,1325,3948,5300,2025-04-07,2025-08-15,505.28,9,1352,112162086,-42661174,0.00472530441347177,99.9749612360098,0.255094339622642
517.55,465,0,1,0,5255,2025-04-07,2025-04-25,505.28,1,5255,13056472,-3270620,0.0402482385747084,99.7752608821127,1
655.1,655,525,524,2625,5240,2025-04-07,2025-05-30,505.28,-1,2615,25903649,-10875774,0.0202288102344191,99.9212659189445,0.499045801526718
574.7,572,7,19,3584,5130,2025-04-07,2025-05-23,505.28,12,1546,3097569,2640978,0.165613744197466,98.0975403614899,0.301364522417154
820.02,820,2530,2532,2530,5064,2025-04-07,2025-06-20,505.28,2,2534,478977607,-137482950,0.00105725193119519,99.994265702697,0.500394944707741
591.01,591,4983,4979,19932,4979,2025-04-07,2025-04-11,505.28,-4,-14953,52569756,25897074,0.00947122524213352,99.8379372352423,-3.00321349668608
600.57,600,0,87,0,4959,2025-04-07,2025-05-23,505.28,87,4959,3097569,2640978,0.16009328605755,98.2576336475475,1
601.11,601,447,445,3129,4895,2025-04-07,2025-04-25,505.28,-2,1766,13056472,-3270620,0.0374909853136437,99.8127518674264,0.360776302349336
530.75,482,1,1,8112,4875,2025-04-07,2025-05-16,505.28,0,-3237,191683614,-460736.000000003,0.00254325338419381,99.9685820823474,-0.664
705.06,705,805,810,1610,4860,2025-04-07,2025-06-20,505.28,5,3250,478977607,-137482950,0.0010146612135878,99.9952803639106,0.668724279835391
632.12,632,410,399,2460,4788,2025-04-07,2025-05-16,505.28,-11,2328,191683614,-460736.000000003,0.00249786609302974,99.9710799484405,0.486215538847118
559.95,554,18,8,21420,4760,2025-04-07,2025-05-23,505.28,-10,-16660,3097569,2640978,0.15366889325145,98.4113025407989,-3.5
603.09,603,522,518,4176,4662,2025-04-07,2025-04-25,505.28,-4,486,13056472,-3270620,0.0357064297307879,99.8484582971572,0.104247104247104
790.02,790,2208,2208,2208,4416,2025-04-07,2025-06-20,505.28,0,2208,478977607,-137482950,0.000921963769383482,99.99620232768,0.5
639.09,639,496,488,2480,4392,2025-04-07,2025-05-16,505.28,-8,1912,191683614,-460736.000000003,0.00229127566428292,99.9733712241047,0.435336976320583
512.84,469,0,1,0,4384,2025-04-07,2025-04-11,505.28,1,4384,52569756,25897074,0.00833939575447145,99.8462766309967,1
775.06,775,700,701,2100,4206,2025-04-07,2025-08-15,505.28,1,2106,112162086,-42661174,0.00374993025718156,99.978711166267,0.500713266761769
629.1,629,433,419,3897,4190,2025-04-07,2025-05-16,505.28,-14,293.000000000001,191683614,-460736.000000003,0.00218589367790196,99.9755571177826,0.0699284009546541
825.05,825,835,835,4175,4175,2025-04-07,2025-12-19,505.28,0,0,850516954,-173881469,0.000490877927872558,99.998983441781,0
589.02,589,2067,2074,6201,4148,2025-04-07,2025-04-11,505.28,7,-2053,52569756,25897074,0.00789046842827271,99.854167099425,-0.494937319189971
602.09,602,457,456,2742,4104,2025-04-07,2025-04-25,505.28,-1,1362,13056472,-3270620,0.0314326871761376,99.8798909843333,0.33187134502924
526.92,486,0,1,0,4092,2025-04-07,2025-05-16,505.28,1,4092,191683614,-460736.000000003,0.00213476776371714,99.9776918855463,1
670.05,670,823,816,2469,4080,2025-04-07,2025-05-30,505.28,-7,1611,25903649,-10875774,0.0157506766710744,99.9370165956156,0.394852941176471
775.01,775,4036,4036,4036,4036,2025-04-07,2025-05-16,505.28,0,0,191683614,-460736.000000003,0.00210555295561153,99.979797438502,0
626.14,626,293,287,1758,4018,2025-04-07,2025-05-16,505.28,-6,2260,191683614,-460736.000000003,0.00209616248157759,99.9818936009835,0.562468889995023
587.52,587.5,2000,2000,12000,4000,2025-04-07,2025-04-11,505.28,0,-8000,52569756,25897074,0.00760893773218198,99.8617760371572,-2
561.98,557,2,8,2526,3984,2025-04-07,2025-05-23,505.28,6,1458,3097569,2640978,0.128616989645751,98.5399195304447,0.365963855421687
800.05,800,776,786,2328,3930,2025-04-07,2025-09-19,505.28,10,1602,264848567,-73847933,0.00148386681661751,99.9935819928374,0.40763358778626
627.15,627,261,261,3915,3915,2025-04-07,2025-05-30,505.28,0,0,25903649,-10875774,0.0151137007762883,99.9521302963918,0
725.06,725,650,650,3900,3900,2025-04-07,2025-08-15,505.28,0,0,112162086,-42661174,0.00347711079481885,99.9821882770618,0
680.05,680,775,776,2325,3880,2025-04-07,2025-05-16,505.28,1,1555,191683614,-460736.000000003,0.00202416884731733,99.9839177698309,0.400773195876289
550.88,538,0,3,0,3864,2025-04-07,2025-05-23,505.28,3,3864,3097569,2640978,0.12474298393353,98.6646625143782,1
750.05,750,774,771,3096,3855,2025-04-07,2025-08-15,505.28,-3,759,112162086,-42661174,0.00343699028564786,99.9856252673475,0.196887159533074
760.04,760,961,961,3844,3844,2025-04-07,2025-09-19,505.28,0,0,264848567,-73847933,0.00145139543080858,99.9950333882683,0
555.49,548,0,5,0,3745,2025-04-07,2025-05-23,505.28,5,3745,3097569,2640978,0.120901261602244,98.7855637759804,1
569.74,566,6,10,4146,3740,2025-04-07,2025-05-23,505.28,4,-406,3097569,2640978,0.120739844697568,98.906303620678,-0.10855614973262
608.03,608,1311,1237,2622,3711,2025-04-07,2025-04-11,505.28,-74,1089,52569756,25897074,0.00705919198103183,99.8688352291382,0.293451899757478
593.02,593,1855,1853,7420,3706,2025-04-07,2025-04-11,505.28,-2,-3714,52569756,25897074,0.0070496808088666,99.8758849099471,-1.00215866162979
587.03,587,1216,1223,4864,3669,2025-04-07,2025-04-11,505.28,7,-1195,52569756,25897074,0.00697929813484392,99.8828642080819,-0.325701826110657
598.12,598,330,304,2970,3648,2025-04-07,2025-04-25,505.28,-26,678,13056472,-3270620,0.027940166378789,99.9078311507121,0.185855263157895
562.49,558,3,8,3060,3592,2025-04-07,2025-05-23,505.28,5,532,3097569,2640978,0.115961904319161,99.0222655249972,0.148106904231626
710.11,710,323,324,1615,3564,2025-04-07,2025-07-18,505.28,1,1949,104857395,-33238059,0.00339890190863506,99.9886073843433,0.54685746352413
567.09,562,2,7,1690,3563,2025-04-07,2025-05-23,505.28,5,1873,3097569,2640978,0.115025686272041,99.1372912112692,0.525680606230704
640.04,640,874,888,2622,3552,2025-04-07,2025-05-02,505.28,14,930,15637149,-467056,0.0227151381623338,99.9744007043739,0.261824324324324
584.03,584,1141,1153,5705,3459,2025-04-07,2025-04-11,505.28,12,-2246,52569756,25897074,0.00657982890390437,99.8894440369858,-0.6493206128939
685.05,685,705,690,2115,3450,2025-04-07,2025-05-30,505.28,-15,1335,25903649,-10875774,0.013318586890982,99.9654488832828,0.38695652173913
512.38,478,0,1,0,3438,2025-04-07,2025-04-11,505.28,1,3438,52569756,25897074,0.00653988198081041,99.8959839189666,1
720.02,720,1716,1716,3432,3432,2025-04-07,2025-05-16,505.28,0,0,191683614,-460736.000000003,0.00179045038247244,99.9857082202134,0
755.07,755,476,476,3332,3332,2025-04-07,2025-09-19,505.28,0,0,264848567,-73847933,0.00125807741296935,99.9962914656812,0
583.04,583,801,804,4005,3216,2025-04-07,2025-04-11,505.28,3,-789,52569756,25897074,0.00611758593667431,99.9021015049033,-0.245335820895522
760.01,760,3142,3142,3142,3142,2025-04-07,2025-05-16,505.28,0,0,191683614,-460736.000000003,0.00163915941192553,99.9873473796253,0
705.05,705,624,624,3120,3120,2025-04-07,2025-07-18,505.28,0,0,104857395,-33238059,0.00297546968432699,99.9915828540276,0
601.01,601,3109,3115,6218,3115,2025-04-07,2025-04-11,505.28,6,-3103,52569756,25897074,0.00592546025893672,99.9080269651623,-0.996147672552167
628.13,628,234,234,3510,3042,2025-04-07,2025-05-30,505.28,0,-468,25903649,-10875774,0.0117435192238746,99.9771924025067,-0.153846153846154
624.02,624,1453,1454,2906,2908,2025-04-07,2025-04-11,505.28,1,2,52569756,25897074,0.0055316977312963,99.9135586628936,0.000687757909215956
546.51,532,0,2,0,2902,2025-04-07,2025-05-23,505.28,2,2902,3097569,2640978,0.0936863714738881,99.2309775827431,1
586.25,585,0,23,0,2875,2025-04-07,2025-05-23,505.28,23,2875,3097569,2640978,0.0928147201886383,99.3237923029318,1
636.11,636,274,260,1370,2860,2025-04-07,2025-05-16,505.28,-14,1490,191683614,-460736.000000003,0.0014920419853937,99.9888394216106,0.520979020979021
583.75,583,39,38,5616,2850,2025-04-07,2025-05-09,505.28,-1,-2766,21122544,7108655,0.0134926929256249,99.9589490735586,-0.970526315789474
634.08,634,358,355,2148,2840,2025-04-07,2025-05-16,505.28,-3,692,191683614,-460736.000000003,0.00148160812535598,99.990321029736,0.243661971830986
830.01,830,2781,2835,2781,2835,2025-04-07,2025-06-20,505.28,54,54,478977607,-137482950,0.000591885707926216,99.9967942133879,0.0190476190476191
800.01,800,2758,2758,2758,2758,2025-04-07,2025-06-20,505.28,0,0,478977607,-137482950,0.000575809799809702,99.9973700231877,0
810.08,810,335,334,3015,2672,2025-04-07,2025-12-19,505.28,-1,-343,850516954,-173881469,0.000314161873838437,99.9992976036548,-0.128368263473054
554.82,546,0,3,0,2646,2025-04-07,2025-05-23,505.28,3,2646,3097569,2640978,0.0854218259544824,99.4092141288862,1
785.07,785,374,374,1122,2618,2025-04-07,2025-09-19,505.28,0,1496,264848567,-73847933,0.000988489395904491,99.9972799550771,0.571428571428572
830.05,830,523,523,2615,2615,2025-04-07,2025-12-19,505.28,0,0,850516954,-173881469,0.000307460067398022,99.9996050637222,0
611.02,611,1283,1281,2566,2562,2025-04-07,2025-04-11,505.28,-2,-4,52569756,25897074,0.00487352461746256,99.918432187511,-0.00156128024980484
596.02,596,1282,1269,2564,2538,2025-04-07,2025-04-11,505.28,-13,-26,52569756,25897074,0.00482787099106947,99.9232600585021,-0.0102442868400315
592.01,592,2529,2530,10116,2530,2025-04-07,2025-04-11,505.28,1,-7586,52569756,25897074,0.0048126531156051,99.9280727116177,-2.99841897233202
602.01,602,2221,2525,4442,2525,2025-04-07,2025-04-11,505.28,304,-1917,52569756,25897074,0.00480314194343987,99.9328758535611,-0.759207920792079
705.01,705,2515,2515,2515,2515,2025-04-07,2025-05-16,505.28,0,0,191683614,-460736.000000003,0.00131205789974306,99.9916330876358,0
605.01,605,2490,2500,4980,2500,2025-04-07,2025-04-11,505.28,10,-2480,52569756,25897074,0.00475558608261374,99.9376314396437,-0.992
730.06,730,401,401,2406,2406,2025-04-07,2025-08-15,505.28,0,0,112162086,-42661174,0.00214510989034209,99.9877703772378,0
575.36,573,5,10,2665,2360,2025-04-07,2025-05-23,505.28,5,-305,3097569,2640978,0.0761887790070213,99.4854029078932,-0.129237288135593
780.04,780,583,577,2332,2308,2025-04-07,2025-09-19,505.28,-6,-24,264848567,-73847933,0.000871441377290896,99.9981513964544,-0.0103986135181976
805.02,805,1137,1137,2274,2274,2025-04-07,2025-08-15,505.28,0,0,112162086,-42661174,0.00202742306344053,99.9897978003013,0
591.1,591,305,225,5185,2250,2025-04-07,2025-04-25,505.28,-80,-2935,13056472,-3270620,0.0172328328816544,99.9250639835937,-1.30444444444444
594.02,594,1105,1098,3315,2196,2025-04-07,2025-04-11,505.28,-7,-1119,52569756,25897074,0.00417730681496791,99.9418087464587,-0.509562841530055
800.04,800,613,546,1226,2184,2025-04-07,2025-07-18,505.28,-67,958,104857395,-33238059,0.00208282877902889,99.9936656828066,0.438644688644689
610.01,610,2080,2146,2080,2146,2025-04-07,2025-04-11,505.28,66,66,52569756,25897074,0.00408219509331563,99.945890941552,0.0307548928238583
598.02,598,1055,1072,2110,2144,2025-04-07,2025-04-11,505.28,17,34,52569756,25897074,0.00407839062444954,99.9499693321765,0.0158582089552239
615.18,615,129,118,1548,2124,2025-04-07,2025-05-09,505.28,-11,576,21122544,7108655,0.0100556069382552,99.9690046804968,0.271186440677966
620.19,620,114,110,684,2090,2025-04-07,2025-05-09,505.28,-4,1406,21122544,7108655,0.00989464147879157,99.9788993219756,0.672727272727273
695.03,695,692,692,1384,2076,2025-04-07,2025-05-16,505.28,0,692,191683614,-460736.000000003,0.00108303467191515,99.9927161223077,0.333333333333333
780.01,780,2074,2074,6222,2074,2025-04-07,2025-06-20,505.28,0,-4148,478977607,-137482950,0.000433005629008456,99.9978030288167,-2
660.02,660,1029,1029,2058,2058,2025-04-07,2025-04-25,505.28,0,0,13056472,-3270620,0.0157622978090866,99.9408262814028,0
795.01,795,2039,2039,2039,2039,2025-04-07,2025-06-20,505.28,0,0,478977607,-137482950,0.000425698398046404,99.9982287272148,0
810.02,810,1013,1013,2026,2026,2025-04-07,2025-09-19,505.28,0,0,264848567,-73847933,0.000764965437777883,99.9989163618922,0
655.01,655,2008,2017,2008,2017,2025-04-07,2025-04-11,505.28,9,9,52569756,25897074,0.00383680685145276,99.9538061390279,0.0044620723847298
770.01,770,2010,2010,2010,2010,2025-04-07,2025-05-16,505.28,0,0,191683614,-460736.000000003,0.00104860293379068,99.9937647252415,0
820.06,820,334,334,2004,2004,2025-04-07,2025-12-19,505.28,0,0,850516954,-173881469,0.000235621405378828,99.9998406851276,0
765.01,765,1965,1965,1965,1965,2025-04-07,2025-05-16,505.28,0,0,191683614,-460736.000000003,0.00102512674870581,99.9947898519902,0
635.02,635,977,975,2931,1950,2025-04-07,2025-05-02,505.28,-2,-981,15637149,-467056,0.0124703038897947,99.9868710082637,-0.503076923076923
710.02,710,954,954,1908,1908,2025-04-07,2025-06-20,505.28,0,0,478977607,-137482950,0.000398348476445581,99.9986270756913,0
805.01,805,1841,1841,1841,1841,2025-04-07,2025-06-20,505.28,0,0,478977607,-137482950,0.000384360348603938,99.9990114360399,0
572,569,3,6,1878,1800,2025-04-07,2025-05-23,505.28,3,-78,3097569,2640978,0.0581100856833213,99.5435129935766,-0.0433333333333333
715.07,715,254,254,1778,1778,2025-04-07,2025-08-15,505.28,0,0,112162086,-42661174,0.00158520589568921,99.9913830061969,0
605.42,605,0,42,0,1764,2025-04-07,2025-05-23,505.28,42,1764,3097569,2640978,0.0569478839696549,99.6004608775462,1
630.03,630,377,579,1131,1737,2025-04-07,2025-04-25,505.28,202,606,13056472,-3270620,0.0133037469846372,99.9541300283875,0.348877374784111
573.87,571,5,6,2700,1722,2025-04-07,2025-05-23,505.28,1,-978,3097569,2640978,0.0555919819703774,99.6560528595166,-0.56794425087108
579.1,577,7,8,2821,1680,2025-04-07,2025-05-23,505.28,1,-1141,3097569,2640978,0.0542360799710999,99.7102889394877,-0.679166666666667
578.01,576,3,8,1317,1608,2025-04-07,2025-05-23,505.28,5,291,3097569,2640978,0.0519116765437671,99.7622006160315,0.180970149253731
581.94,580,0,8,0,1552,2025-04-07,2025-05-23,505.28,8,1552,3097569,2640978,0.0501038072113971,99.8123044232429,1
597.52,597.5,803,756,2409,1512,2025-04-07,2025-04-11,505.28,-47,-897,52569756,25897074,0.00287617846276479,99.9566823174907,-0.593253968253968
725.05,725,292,292,1460,1460,2025-04-07,2025-07-18,505.28,0,0,104857395,-33238059,0.00139236722407609,99.9950580500307,0
710.02,710,730,730,1460,1460,2025-04-07,2025-05-16,505.28,0,0,191683614,-460736.000000003,0.000761671782753428,99.9955515237729,0
810.05,810,283,284,566,1420,2025-04-07,2025-08-15,505.28,1,854,112162086,-42661174,0.00126602495606225,99.992649031153,0.601408450704225
815.03,815,454,454,1362,1362,2025-04-07,2025-09-19,505.28,0,0,264848567,-73847933,0.000514256133392634,99.9994306180256,0
800.01,800,1355,1355,1355,1355,2025-04-07,2025-05-16,505.28,0,0,191683614,-460736.000000003,0.000706894017555408,99.9962584177905,0
835.05,835,271,271,1355,1355,2025-04-07,2025-12-19,505.28,0,0,850516954,-173881469,0.000159314872399357,100,0
685.01,685,1349,1349,1349,1349,2025-04-07,2025-04-11,505.28,0,0,52569756,25897074,0.00256611425017837,99.9592484317409,0
705.02,705,670,670,1340,1340,2025-04-07,2025-05-30,505.28,0,0,25903649,-10875774,0.00517301635765679,99.9823654188643,0
785.02,785,663,663,1326,1326,2025-04-07,2025-08-15,505.28,0,0,112162086,-42661174,0.00118221767023841,99.9938312488232,0
790.01,790,1316,1316,1316,1316,2025-04-07,2025-05-16,505.28,0,0,191683614,-460736.000000003,0.000686547990481857,99.996944965781,0
665.05,665,196,259,980,1295,2025-04-07,2025-05-30,505.28,63,315,25903649,-10875774,0.00499929565907877,99.9873647145234,0.243243243243243
810.02,810,635,636,635,1272,2025-04-07,2025-06-20,505.28,1,637,478977607,-137482950,0.00026556565096372,99.9992770016908,0.500786163522013
606.02,606,673,632,673,1264,2025-04-07,2025-04-11,505.28,-41,591,52569756,25897074,0.00240442432336951,99.9616528560642,0.467563291139241
615.01,615,1184,1264,1184,1264,2025-04-07,2025-04-11,505.28,80,80,52569756,25897074,0.00240442432336951,99.9640572803876,0.0632911392405063
607.01,607,1232,1236,2464,1236,2025-04-07,2025-04-11,505.28,4,-1228,52569756,25897074,0.00235116175924423,99.9664084421469,-0.993527508090615
625.14,625,90,87,540,1218,2025-04-07,2025-05-09,505.28,-3,678,21122544,7108655,0.00576635087137231,99.984665672847,0.556650246305419
725.02,725,605,605,1210,1210,2025-04-07,2025-05-16,505.28,0,0,191683614,-460736.000000003,0.000631248532281951,99.9975762143132,0
576.37,574,2,5,870,1185,2025-04-07,2025-05-23,505.28,3,315,3097569,2640978,0.0382558064081866,99.8505602296511,0.265822784810127
675.04,675,273,296,546,1184,2025-04-07,2025-05-30,505.28,23,638,25903649,-10875774,0.0045707846025863,99.991935499126,0.538851351351351
765.01,765,1171,1171,1171,1171,2025-04-07,2025-06-20,505.28,0,0,478977607,-137482950,0.000244479070187513,99.999521480761,0
645.07,645,162,167,486,1169,2025-04-07,2025-05-02,505.28,5,683,15637149,-467056,0.00747578730624106,99.99434679557,0.58426005132592
770.02,770,574,574,1148,1148,2025-04-07,2025-06-20,505.28,0,0,478977607,-137482950,0.000239677175555307,99.9997611579366,0
775.01,775,1144,1144,1144,1144,2025-04-07,2025-06-20,505.28,0,0,478977607,-137482950,0.000238842063445359,100,0
790.03,790,379,379,1137,1137,2025-04-07,2025-08-15,505.28,0,0,112162086,-42661174,0.00101371153172026,99.994844960355,0
735.04,735,282,282,1128,1128,2025-04-07,2025-08-15,505.28,0,0,112162086,-42661174,0.00100568742988607,99.9958506477849,0
629.01,629,1121,1121,1121,1121,2025-04-07,2025-04-11,505.28,0,0,52569756,25897074,0.002132404799444,99.9685408469463,0
780.01,780,1094,1094,1094,1094,2025-04-07,2025-05-16,505.28,0,0,191683614,-460736.000000003,0.000570732144063185,99.9981469464573,0
595.71,595,0,15,0,1065,2025-04-07,2025-05-23,505.28,15,1065,3097569,2640978,0.0343818006959651,99.884942030347,1
628.01,628,1042,1042,1042,1042,2025-04-07,2025-04-11,505.28,0,0,52569756,25897074,0.00198212827923341,99.9705229752255,0
567.88,557.5,1,1,1038,1038,2025-04-07,2025-05-23,505.28,0,0,3097569,2640978,0.0335101494107153,99.9184521797577,0
735.04,735,257,257,1028,1028,2025-04-07,2025-07-18,505.28,0,0,104857395,-33238059,0.000980379113938507,99.9960384291447,0
603.01,603,982,1018,1964,1018,2025-04-07,2025-04-11,505.28,36,-946,52569756,25897074,0.00193647465284031,99.9724594498784,-0.929273084479371
795.03,795,333,333,666,999,2025-04-07,2025-07-18,505.28,0,333,104857395,-33238059,0.00095272250469316,99.9969911516494,0.333333333333333
610.36,610,0,27,0,972,2025-04-07,2025-05-23,505.28,27,972,3097569,2640978,0.0313794462689935,99.9498316260267,1
635.01,635,961,961,961,961,2025-04-07,2025-04-11,505.28,0,0,52569756,25897074,0.00182804729015672,99.9742874971685,0
599.01,599,951,949,2853,949,2025-04-07,2025-04-11,505.28,-2,-1904,52569756,25897074,0.00180522047696017,99.9760927176455,-2.00632244467861
755.04,755,228,228,912,912,2025-04-07,2025-07-18,505.28,0,0,104857395,-33238059,0.000869752676957119,99.9978609043263,0
635.08,635,113,113,565,904,2025-04-07,2025-05-09,505.28,0,339,21122544,7108655,0.00427978751044382,99.9889454603574,0.375
770.04,770,225,225,900,900,2025-04-07,2025-09-19,505.28,0,0,264848567,-73847933,0.000339816828233018,99.9997704348538,0
650.04,650,208,221,624,884,2025-04-07,2025-05-02,505.28,13,260,15637149,-467056,0.00565320443004029,100,0.294117647058824
715.01,715,1073,873,2146,873,2025-04-07,2025-05-16,505.28,-200,-1273,191683614,-460736.000000003,0.000455437990646399,99.998602384448,-1.4581901489118
623.02,623,427,427,854,854,2025-04-07,2025-04-11,505.28,0,0,52569756,25897074,0.00162450820582085,99.9777172258513,0
597.01,597,850,851,1700,851,2025-04-07,2025-04-11,505.28,1,-849,52569756,25897074,0.00161880150252172,99.9793360273538,-0.99764982373678
690.01,690,837,837,837,837,2025-04-07,2025-04-11,505.28,0,0,52569756,25897074,0.00159217022045908,99.9809281975743,0
795.03,795,276,276,828,828,2025-04-07,2025-08-15,505.28,0,0,112162086,-42661174,0.000738217368746155,99.9965888651536,0
780.03,780,265,265,795,795,2025-04-07,2025-08-15,505.28,0,0,112162086,-42661174,0.000708795662020765,99.9972976608156,0
770.03,770,264,264,792,792,2025-04-07,2025-08-15,505.28,0,0,112162086,-42661174,0.000706120961409366,99.998003781777,0
621.03,621,261,262,522,786,2025-04-07,2025-04-11,505.28,1,264,52569756,25897074,0.00149515626437376,99.9824233538387,0.33587786259542
750.01,750,725,776,725,776,2025-04-07,2025-05-16,505.28,51,51,191683614,-460736.000000003,0.000404833769463466,99.9990072182174,0.0657216494845361
613.02,613,384,384,768,768,2025-04-07,2025-04-11,505.28,0,0,52569756,25897074,0.00146091604457894,99.9838842698833,0
645.09,645,81,85,243,765,2025-04-07,2025-05-09,505.28,4,522,21122544,7108655,0.00362172283793089,99.9925671831954,0.682352941176471
720.03,720,253,253,506,759,2025-04-07,2025-05-30,505.28,0,253,25903649,-10875774,0.00293008911601605,99.994865588242,0.333333333333333
745.03,745,248,248,744,744,2025-04-07,2025-07-18,505.28,0,0,104857395,-33238059,0.000709535078570281,99.9985704394049,0
655.02,655,421,371,842,742,2025-04-07,2025-04-25,505.28,-50,-100,13056472,-3270620,0.00568300533252781,99.95981303372,-0.134770889487871
612.01,612,724,738,1448,738,2025-04-07,2025-04-11,505.28,14,-710,52569756,25897074,0.00140384901158758,99.9852881188948,-0.962059620596206
670.01,670,730,730,730,730,2025-04-07,2025-04-11,505.28,0,0,52569756,25897074,0.00138863113612321,99.986676750031,0
635.03,635,254,241,254,723,2025-04-07,2025-04-25,505.28,-13,469,13056472,-3270620,0.00553748363263828,99.9653505173526,0.648686030428769
695.02,695,360,360,720,720,2025-04-07,2025-05-30,505.28,0,0,25903649,-10875774,0.00277953117724843,99.9976451194193,0
650.07,650,88,101,264,707,2025-04-07,2025-05-09,505.28,13,443,21122544,7108655,0.00334713470119887,99.9959143178966,0.626591230551627
625.05,625,133,140,266,700,2025-04-07,2025-04-25,505.28,7,434,13056472,-3270620,0.00536132578540359,99.970711843138,0.62
645.04,645,164,174,328,696,2025-04-07,2025-04-25,505.28,10,368,13056472,-3270620,0.00533068963805843,99.9760425327761,0.528735632183908
745.04,745,167,167,668,668,2025-04-07,2025-08-15,505.28,0,0,112162086,-42661174,0.000595566669471536,99.9985993484465,0
617.01,617,670,666,670,666,2025-04-07,2025-04-11,505.28,-4,-4,52569756,25897074,0.0012668881324083,99.9879436381634,-0.00600600600600601
630.11,630,45,58,270,638,2025-04-07,2025-05-09,505.28,13,368,21122544,7108655,0.00302046950405216,99.9989347874006,0.576802507836991
604.01,604,522,591,522,591,2025-04-07,2025-04-11,505.28,69,69,52569756,25897074,0.00112422054992989,99.9890678587133,0.116751269035533
700.01,700,573,574,573,574,2025-04-07,2025-04-25,505.28,1,1,13056472,-3270620,0.00439628714403094,99.9804388199201,0.00174216027874564
755.04,755,140,140,560,560,2025-04-07,2025-08-15,505.28,0,0,112162086,-42661174,0.000499277447461168,99.999098625894,0
616.03,616,186,186,558,558,2025-04-07,2025-04-11,505.28,0,0,52569756,25897074,0.00106144681363939,99.9901293055269,0
645.02,645,281,278,281,556,2025-04-07,2025-04-11,505.28,-3,275,52569756,25897074,0.0010576423447733,99.9911869478717,0.494604316546763
650.02,650,269,269,538,538,2025-04-07,2025-04-25,505.28,0,0,13056472,-3270620,0.00412056181792447,99.9845593817381,0
575.18,572.5,1,2,527,536,2025-04-07,2025-05-23,505.28,1,9,3097569,2640978,0.0173038921812557,99.967135518208,0.0167910447761194
785.01,785,530,530,530,530,2025-04-07,2025-05-16,505.28,0,0,191683614,-460736.000000003,0.000276497290999532,99.9992837155084,0
626.01,626,528,528,528,528,2025-04-07,2025-04-11,505.28,0,0,52569756,25897074,0.00100437978064802,99.9921913276524,0
795.03,795,176,176,528,528,2025-04-07,2025-09-19,505.28,0,0,264848567,-73847933,0.000199359205896704,99.9999697940597,0
602.51,602.5,422,509,844,509,2025-04-07,2025-04-11,505.28,87,-335,52569756,25897074,0.000968237326420157,99.9931595649788,-0.658153241650295
625.22,625,0,23,0,506,2025-04-07,2025-05-23,505.28,23,506,3097569,2640978,0.0163353907532003,99.9834709089612,1
622.02,622,251,251,502,502,2025-04-07,2025-04-11,505.28,0,0,52569756,25897074,0.000954921685388839,99.9941144866642,0
630.01,630,392,476,784,476,2025-04-07,2025-04-11,505.28,84,-308,52569756,25897074,0.000905463590129655,99.9950199502543,-0.647058823529412
730.04,730,113,113,452,452,2025-04-07,2025-07-18,505.28,0,0,104857395,-33238059,0.000431061633755063,99.9990015010386,0
680.01,680,447,450,447,450,2025-04-07,2025-04-25,505.28,3,3,13056472,-3270620,0.00344656657633088,99.9880059483144,0.00666666666666667
665.01,665,444,449,888,449,2025-04-07,2025-04-25,505.28,5,-439,13056472,-3270620,0.00343890753949459,99.9914448558539,-0.977728285077951
760.03,760,142,142,426,426,2025-04-07,2025-08-15,505.28,0,0,112162086,-42661174,0.000379807486818674,99.9994784333808,0
760.05,760,38,85,76,425,2025-04-07,2025-07-18,505.28,47,349,104857395,-33238059,0.000405312376871464,99.9994068134155,0.821176470588235
566.7,562.5,0,1,0,420,2025-04-07,2025-05-23,505.28,1,420,3097569,2640978,0.013559019992775,99.997029928954,1
740.06,740,69,70,207,420,2025-04-07,2025-07-18,505.28,1,213,104857395,-33238059,0.000400543995967094,99.9998073574115,0.507142857142857
640.01,640,457,415,457,415,2025-04-07,2025-04-11,505.28,-42,-42,52569756,25897074,0.000789427289713881,99.995809377544,-0.101204819277108
735.01,735,399,399,399,399,2025-04-07,2025-05-16,505.28,0,0,191683614,-460736.000000003,0.000208155507752478,99.9994918710162,0
650.01,650,338,398,338,398,2025-04-07,2025-04-11,505.28,60,60,52569756,25897074,0.000757089304352107,99.9965664668484,0.150753768844221
618.01,618,394,394,394,394,2025-04-07,2025-04-11,505.28,0,0,52569756,25897074,0.000749480366619925,99.997315947215,0
765.03,765,129,129,387,387,2025-04-07,2025-08-15,505.28,0,0,112162086,-42661174,0.000345036378870486,99.9998234697597,0
795.01,795,363,363,363,363,2025-04-07,2025-05-16,505.28,0,0,191683614,-460736.000000003,0.000189374559684585,99.9996812455758,0
680.02,680,178,178,356,356,2025-04-07,2025-04-11,505.28,0,0,52569756,25897074,0.000677195458164196,99.9979931426731,0
695.01,695,348,348,348,348,2025-04-07,2025-04-25,505.28,0,0,13056472,-3270620,0.00266534481902921,99.9941102006729,0
640.03,640,110,110,220,330,2025-04-07,2025-04-25,505.28,0,110,13056472,-3270620,0.00252748215597598,99.9966376828289,0.333333333333333
715.02,715,161,161,322,322,2025-04-07,2025-05-30,505.28,0,0,25903649,-10875774,0.00124306810982499,99.9988881875291,0
614.01,614,307,306,921,306,2025-04-07,2025-04-11,505.28,-1,-615,52569756,25897074,0.000582083736511921,99.9985752264097,-2.00980392156863
710.02,710,144,144,288,288,2025-04-07,2025-05-30,505.28,0,0,25903649,-10875774,0.00111181247089937,100,0
730.01,730,273,273,273,273,2025-04-07,2025-05-16,505.28,0,0,191683614,-460736.000000003,0.000142422189514853,99.9998236677654,0
640.09,640,26,25,78,225,2025-04-07,2025-05-09,505.28,-1,147,21122544,7108655,0.00106521259939144,100,0.653333333333333
745.02,745,109,109,218,218,2025-04-07,2025-05-16,505.28,0,0,191683614,-460736.000000003,0.000113729074411128,99.9999373968398,0
675.01,675,212,214,212,214,2025-04-07,2025-04-11,505.28,2,2,52569756,25897074,0.000407078168671736,99.9989823045783,0.00934579439252336
740.06,740,33,33,132,198,2025-04-07,2025-08-15,505.28,0,66,112162086,-42661174,0.000176530240352342,100,0.333333333333333
685.01,685,195,195,195,195,2025-04-07,2025-04-25,505.28,0,0,13056472,-3270620,0.00149351218307671,99.998131195012,0
675.01,675,182,182,182,182,2025-04-07,2025-04-25,505.28,0,0,13056472,-3270620,0.00139394470420493,99.9995251397162,0
609.01,609,198,179,396,179,2025-04-07,2025-04-11,505.28,-19,-217,52569756,25897074,0.000340499963515144,99.9993228045418,-1.2122905027933
619.01,619,272,172,272,172,2025-04-07,2025-04-11,505.28,-100,-100,52569756,25897074,0.000327184322483825,99.9996499888643,-0.581395348837209
740.01,740,120,120,120,120,2025-04-07,2025-05-16,505.28,0,0,191683614,-460736.000000003,6.26031602263092e-05,100,0
700.01,700,83,83,83,83,2025-04-07,2025-04-11,505.28,0,0,52569756,25897074,0.000157885457942776,99.9998078743223,0
790.04,790,20,20,80,80,2025-04-07,2025-09-19,505.28,0,0,264848567,-73847933,3.02059402873794e-05,100,0
780.02,780,33,33,66,66,2025-04-07,2025-07-18,505.28,0,0,104857395,-33238059,6.29426279376862e-05,99.9998703000394,0
627.01,627,64,64,64,64,2025-04-07,2025-04-11,505.28,0,0,52569756,25897074,0.000121743003714912,99.999929617326,0
765.03,765,18,18,54,54,2025-04-07,2025-07-18,505.28,0,0,104857395,-33238059,5.14985137671978e-05,99.9999217985532,0
670.01,670,53,53,53,53,2025-04-07,2025-04-25,505.28,0,0,13056472,-3270620,0.000405928952323415,99.9999310686685,0
770.01,770,48,48,48,48,2025-04-07,2025-07-18,505.28,0,0,104857395,-33238059,4.57764566819536e-05,99.9999675750099,0
615.22,615,0,2,0,44,2025-04-07,2025-05-23,505.28,2,44,3097569,2640978,0.00142046876114786,99.9984503977151,1
775.02,775,17,17,34,34,2025-04-07,2025-07-18,505.28,0,0,104857395,-33238059,3.24249901497171e-05,100,0
630.14,630,0,2,0,28,2025-04-07,2025-05-23,505.28,2,28,3097569,2640978,0.000903934666184999,99.9993543323813,1
660.01,660,25,26,25,26,2025-04-07,2025-04-11,505.28,1,1,52569756,25897074,4.94580952591829e-05,99.9999790754212,0.0384615384615385
650.1,650,0,2,0,20,2025-04-07,2025-05-23,505.28,2,20,3097569,2640978,0.00064566761870357,100,1
665.01,665,11,11,11,11,2025-04-07,2025-04-11,505.28,0,0,52569756,25897074,2.09245787635004e-05,100,0
690.01,690,9,9,9,9,2025-04-07,2025-04-25,505.28,0,0,13056472,-3270620,6.89313315266176e-05,100,0
405,405,0,0,0,0,2025-04-07,2025-04-11,505.28,0,0,52569756,25897074,0,100,
552.58,410,0,0,0,0,2025-04-07,2025-04-11,505.28,0,0,52569756,25897074,0,100,
435,435,0,0,0,0,2025-04-07,2025-04-11,505.28,0,0,52569756,25897074,0,100,
560.93,445,0,0,0,0,2025-04-07,2025-04-11,505.28,0,0,52569756,25897074,0,100,
471,471,0,0,0,0,2025-04-07,2025-04-11,505.28,0,0,52569756,25897074,0,100,
474,474,0,0,0,0,2025-04-07,2025-04-11,505.28,0,0,52569756,25897074,0,100,
476,476,0,0,0,0,2025-04-07,2025-04-11,505.28,0,0,52569756,25897074,0,100,
477,477,0,0,0,0,2025-04-07,2025-04-11,505.28,0,0,52569756,25897074,0,100,
481,481,0,0,0,0,2025-04-07,2025-04-11,505.28,0,0,52569756,25897074,0,100,
483,483,0,0,0,0,2025-04-07,2025-04-11,505.28,0,0,52569756,25897074,0,100,
484,484,0,0,0,0,2025-04-07,2025-04-11,505.28,0,0,52569756,25897074,0,100,
514.34,487,0,0,0,0,2025-04-07,2025-04-11,505.28,0,0,52569756,25897074,0,100,
489,489,0,0,0,0,2025-04-07,2025-04-11,505.28,0,0,52569756,25897074,0,100,
695,695,0,0,0,0,2025-04-07,2025-04-11,505.28,0,0,52569756,25897074,0,100,
405,405,0,0,0,0,2025-04-07,2025-04-25,505.28,0,0,13056472,-3270620,0,100,
410,410,0,0,0,0,2025-04-07,2025-04-25,505.28,0,0,13056472,-3270620,0,100,
415,415,0,0,0,0,2025-04-07,2025-04-25,505.28,0,0,13056472,-3270620,0,100,
380,380,0,0,0,0,2025-04-07,2025-05-02,505.28,0,0,15637149,-467056,0,100,
385,385,0,0,0,0,2025-04-07,2025-05-02,505.28,0,0,15637149,-467056,0,100,
390,390,0,0,0,0,2025-04-07,2025-05-02,505.28,0,0,15637149,-467056,0,100,
395,395,0,0,0,0,2025-04-07,2025-05-02,505.28,0,0,15637149,-467056,0,100,
405,405,0,0,0,0,2025-04-07,2025-05-02,505.28,0,0,15637149,-467056,0,100,
410,410,0,0,0,0,2025-04-07,2025-05-02,505.28,0,0,15637149,-467056,0,100,
420,420,0,0,0,0,2025-04-07,2025-05-02,505.28,0,0,15637149,-467056,0,100,
425,425,0,0,0,0,2025-04-07,2025-05-02,505.28,0,0,15637149,-467056,0,100,
435,435,0,0,0,0,2025-04-07,2025-05-02,505.28,0,0,15637149,-467056,0,100,
445,445,0,0,0,0,2025-04-07,2025-05-02,505.28,0,0,15637149,-467056,0,100,
455,455,0,0,0,0,2025-04-07,2025-05-02,505.28,0,0,15637149,-467056,0,100,
380,380,0,0,0,0,2025-04-07,2025-05-09,505.28,0,0,21122544,7108655,0,100,
385,385,0,0,0,0,2025-04-07,2025-05-09,505.28,0,0,21122544,7108655,0,100,
390,390,0,0,0,0,2025-04-07,2025-05-09,505.28,0,0,21122544,7108655,0,100,
395,395,0,0,0,0,2025-04-07,2025-05-09,505.28,0,0,21122544,7108655,0,100,
400,400,0,0,0,0,2025-04-07,2025-05-09,505.28,0,0,21122544,7108655,0,100,
415,415,0,0,0,0,2025-04-07,2025-05-09,505.28,0,0,21122544,7108655,0,100,
420,420,0,0,0,0,2025-04-07,2025-05-09,505.28,0,0,21122544,7108655,0,100,
425,425,0,0,0,0,2025-04-07,2025-05-09,505.28,0,0,21122544,7108655,0,100,
430,430,0,0,0,0,2025-04-07,2025-05-09,505.28,0,0,21122544,7108655,0,100,
435,435,0,0,0,0,2025-04-07,2025-05-09,505.28,0,0,21122544,7108655,0,100,
445,445,0,0,0,0,2025-04-07,2025-05-09,505.28,0,0,21122544,7108655,0,100,
455,455,0,0,0,0,2025-04-07,2025-05-09,505.28,0,0,21122544,7108655,0,100,
325,325,0,0,0,0,2025-04-07,2025-05-16,505.28,0,0,191683614,-460736.000000003,0,100,
335,335,0,0,0,0,2025-04-07,2025-05-16,505.28,0,0,191683614,-460736.000000003,0,100,
560.69,360,0,0,0,0,2025-04-07,2025-05-16,505.28,0,0,191683614,-460736.000000003,0,100,
529.23,471,1,0,9329,0,2025-04-07,2025-05-16,505.28,-1,-9329,191683614,-460736.000000003,0,100,-Inf
489,489,0,0,0,0,2025-04-07,2025-05-16,505.28,0,0,191683614,-460736.000000003,0,100,
527.28,491,2,0,14122,0,2025-04-07,2025-05-16,505.28,-2,-14122,191683614,-460736.000000003,0,100,-Inf
400,400,0,0,0,0,2025-04-07,2025-05-23,505.28,0,0,3097569,2640978,0,100,
410,410,0,0,0,0,2025-04-07,2025-05-23,505.28,0,0,3097569,2640978,0,100,
415,415,0,0,0,0,2025-04-07,2025-05-23,505.28,0,0,3097569,2640978,0,100,
420,420,0,0,0,0,2025-04-07,2025-05-23,505.28,0,0,3097569,2640978,0,100,
425,425,0,0,0,0,2025-04-07,2025-05-23,505.28,0,0,3097569,2640978,0,100,
430,430,0,0,0,0,2025-04-07,2025-05-23,505.28,0,0,3097569,2640978,0,100,
435,435,0,0,0,0,2025-04-07,2025-05-23,505.28,0,0,3097569,2640978,0,100,
440,440,0,0,0,0,2025-04-07,2025-05-23,505.28,0,0,3097569,2640978,0,100,
445,445,0,0,0,0,2025-04-07,2025-05-23,505.28,0,0,3097569,2640978,0,100,
450,450,0,0,0,0,2025-04-07,2025-05-23,505.28,0,0,3097569,2640978,0,100,
455,455,0,0,0,0,2025-04-07,2025-05-23,505.28,0,0,3097569,2640978,0,100,
460,460,0,0,0,0,2025-04-07,2025-05-23,505.28,0,0,3097569,2640978,0,100,
480,480,0,0,0,0,2025-04-07,2025-05-23,505.28,0,0,3097569,2640978,0,100,
528,528,0,0,0,0,2025-04-07,2025-05-23,505.28,0,0,3097569,2640978,0,100,
533,533,0,0,0,0,2025-04-07,2025-05-23,505.28,0,0,3097569,2640978,0,100,
534,534,0,0,0,0,2025-04-07,2025-05-23,505.28,0,0,3097569,2640978,0,100,
536,536,0,0,0,0,2025-04-07,2025-05-23,505.28,0,0,3097569,2640978,0,100,
552.5,552.5,0,0,0,0,2025-04-07,2025-05-23,505.28,0,0,3097569,2640978,0,100,
567.5,567.5,0,0,0,0,2025-04-07,2025-05-23,505.28,0,0,3097569,2640978,0,100,
620,620,0,0,0,0,2025-04-07,2025-05-23,505.28,0,0,3097569,2640978,0,100,
635,635,0,0,0,0,2025-04-07,2025-05-23,505.28,0,0,3097569,2640978,0,100,
640,640,0,0,0,0,2025-04-07,2025-05-23,505.28,0,0,3097569,2640978,0,100,
645,645,0,0,0,0,2025-04-07,2025-05-23,505.28,0,0,3097569,2640978,0,100,
375,375,0,0,0,0,2025-04-07,2025-05-30,505.28,0,0,25903649,-10875774,0,100,
380,380,0,0,0,0,2025-04-07,2025-05-30,505.28,0,0,25903649,-10875774,0,100,
567.96,415,0,0,0,0,2025-04-07,2025-05-30,505.28,0,0,25903649,-10875774,0,100,
215,215,46,46,0,0,2025-04-07,2025-06-20,505.28,0,0,478977607,-137482950,0,100,
220,220,79,79,0,0,2025-04-07,2025-06-20,505.28,0,0,478977607,-137482950,0,100,
235,235,2,2,0,0,2025-04-07,2025-06-20,505.28,0,0,478977607,-137482950,0,100,
270,270,15,15,0,0,2025-04-07,2025-06-20,505.28,0,0,478977607,-137482950,0,100,
275,275,4,4,0,0,2025-04-07,2025-06-20,505.28,0,0,478977607,-137482950,0,100,
285,285,4,4,0,0,2025-04-07,2025-06-20,505.28,0,0,478977607,-137482950,0,100,
280,280,0,0,0,0,2025-04-07,2025-08-15,505.28,0,0,112162086,-42661174,0,100,
285,285,0,0,0,0,2025-04-07,2025-08-15,505.28,0,0,112162086,-42661174,0,100,
160,160,0,0,0,0,2025-04-07,2025-09-19,505.28,0,0,264848567,-73847933,0,100,
165,165,0,0,0,0,2025-04-07,2025-09-19,505.28,0,0,264848567,-73847933,0,100,
175,175,0,0,0,0,2025-04-07,2025-09-19,505.28,0,0,264848567,-73847933,0,100,
185,185,0,0,0,0,2025-04-07,2025-09-19,505.28,0,0,264848567,-73847933,0,100,
190,190,0,0,0,0,2025-04-07,2025-09-19,505.28,0,0,264848567,-73847933,0,100,
195,195,0,0,0,0,2025-04-07,2025-09-19,505.28,0,0,264848567,-73847933,0,100,
205,205,0,0,0,0,2025-04-07,2025-09-19,505.28,0,0,264848567,-73847933,0,100,
210,210,0,0,0,0,2025-04-07,2025-09-19,505.28,0,0,264848567,-73847933,0,100,
215,215,0,0,0,0,2025-04-07,2025-09-19,505.28,0,0,264848567,-73847933,0,100,
571.87,220,0,0,0,0,2025-04-07,2025-09-19,505.28,0,0,264848567,-73847933,0,100,
561.35,225,0,0,0,0,2025-04-07,2025-09-19,505.28,0,0,264848567,-73847933,0,100,
235,235,0,0,0,0,2025-04-07,2025-09-19,505.28,0,0,264848567,-73847933,0,100,
245,245,0,0,0,0,2025-04-07,2025-09-19,505.28,0,0,264848567,-73847933,0,100,
255,255,0,0,0,0,2025-04-07,2025-09-19,505.28,0,0,264848567,-73847933,0,100,
260,260,0,0,0,0,2025-04-07,2025-09-19,505.28,0,0,264848567,-73847933,0,100,
613.75,270,0,0,0,0,2025-04-07,2025-09-19,505.28,0,0,264848567,-73847933,0,100,
290,290,0,0,0,0,2025-04-07,2025-09-19,505.28,0,0,264848567,-73847933,0,100,
