Watch,strike,open_interest.yt,open_interest.td,OI_Dollar.yt,OI_Dollar.td,Date.td,expiry,stkClose,diff_oi,diff_oi_d,totalOI,totalOIdiff,OI_pct,cum_sep_OI,pct
431.75,400,47618,47612,117664078,151168100,2023-11-03,2023-11-17,430.76,-6,33504022,672805518,235832752,22.4683204812836,22.4683204812836,0.221634207216999
432.5,415,32111,31980,35932209,55965000,2023-11-03,2023-11-17,430.76,-131,20032791,672805518,235832752,8.31815413261816,30.7864746139017,0.357952130796033
432.12,410,22572,23821,34535160,52692052,2023-11-03,2023-11-17,430.76,1249,18156892,672805518,235832752,7.83169141606238,38.6181660299641,0.34458502394251
434.74,400,13589,13435,37872543,46673190,2023-11-03,2023-12-15,430.76,-154,8800647,878851435,217070587,5.31070305415158,5.31070305415158,0.188558935011727
434.06,425,51238,48934,24286812,44334204,2023-11-03,2023-11-17,430.76,-2304,20047392,672805518,235832752,6.58945309066267,45.2076191206268,0.45218793146709
437.2,420,24977,24391,30072308,41952520,2023-11-03,2023-12-15,430.76,-586,11880212,878851435,217070587,4.77356221191128,10.0842652660629,0.283182321348038
435.63,430,72646,69316,18670022,39024908,2023-11-03,2023-11-17,430.76,-3330,20354886,672805518,235832752,5.80032519887865,51.0079443195054,0.521587033594032
433.85,385,7440,7452,31002480,36403020,2023-11-03,2023-12-15,430.76,12,5400540,878851435,217070587,4.14211305236135,14.2263783184242,0.148354175010755
440,430,35806,35517,22342944,35517000,2023-11-03,2023-12-15,430.76,-289,13174056,878851435,217070587,4.0412973780944,18.2676756965186,0.370922544133795
432.6,414,16685,16642,20138795,30954120,2023-11-03,2023-11-17,430.76,-43,10815325,672805518,235832752,4.60075299204071,55.6086973115461,0.349398561483899
435.57,410,12156,12089,23971632,30911573,2023-11-03,2023-12-15,430.76,-67,6939941,878851435,217070587,3.5172694461152,21.7849451426338,0.224509474170079
436.35,415,14687,14349,22985155,30635115,2023-11-03,2023-12-15,430.76,-338,7649960,878851435,217070587,3.4858127073548,25.2707578499886,0.249712135893729
432.59,355,3322,3322,22509872,25775398,2023-11-03,2023-12-15,430.76,0,3265526,878851435,217070587,2.93285041970717,28.2036082696958,0.126691583967006
433.06,420,27332,16935,21072972,22117110,2023-11-03,2023-11-17,430.76,-10397,1044138,672805518,235832752,3.28729616631949,58.8959934778656,0.0472095133586621
433.74,380,3925,3923,17556525,21082202,2023-11-03,2023-12-15,430.76,-2,3525677,878851435,217070587,2.39883570310151,30.6024439727973,0.167234760391728
434.6,405,6966,6971,16676604,20634160,2023-11-03,2023-12-15,430.76,5,3957556,878851435,217070587,2.34785530048091,32.9502992732782,0.1917963222152
434.08,390,4631,4601,17116176,20281208,2023-11-03,2023-12-15,430.76,-30,3165032,878851435,217070587,2.30769470155101,35.2579939748292,0.156057370941613
444.72,440,43392,42920,11325312,20258240,2023-11-03,2023-12-15,430.76,-472,8932928,878851435,217070587,2.30508129055965,37.5630752653889,0.440952817224004
431.62,370,3275,3274,17308375,20174388,2023-11-03,2023-12-15,430.76,-1,2866013,878851435,217070587,2.29554020128556,39.8586154666744,0.142061954989663
438.43,425,15063,14651,13436196,19676293,2023-11-03,2023-12-15,430.76,-412,6240097,878851435,217070587,2.23886452435502,42.0974799910294,0.31713783688828
432.3,400,6052,6048,15735200,19535040,2023-11-03,2023-11-24,430.76,-4,3799840,100730326,33682043,19.3934049215725,19.3934049215725,0.194514062935116
442.11,435,26014,26559,10951894,18883449,2023-11-03,2023-12-15,430.76,545,7931555,878851435,217070587,2.1486508695295,44.2461308605589,0.420026818194071
434.08,395,4339,4328,14062699,16913824,2023-11-03,2023-12-15,430.76,-11,2851125,878851435,217070587,1.92453733662049,46.1706681971794,0.16856773488952
434.05,409,6475,6473,13066550,16214865,2023-11-03,2023-12-15,430.76,-2,3148315,878851435,217070587,1.84500637471224,48.0156745718917,0.194162270237834
437.7,422,10627,9771,11540922,15340470,2023-11-03,2023-12-15,430.76,-856,3799548,878851435,217070587,1.74551344960824,49.7611880214999,0.247681329190044
438.17,423,9822,9836,9871110,14921212,2023-11-03,2023-12-15,430.76,14,5050102,878851435,217070587,1.69780823080752,51.4589962523074,0.338451192838759
436.7,416,7185,7154,10734390,14808780,2023-11-03,2023-12-15,430.76,-31,4074390,878851435,217070587,1.68501516982788,53.1440114221353,0.275133400590731
438.08,424,10373,10292,9823231,14491136,2023-11-03,2023-12-15,430.76,-81,4667905,878851435,217070587,1.64887208723736,54.7928835093727,0.32212139890206
430.7,415,9358,9216,7654844,14469120,2023-11-03,2023-11-03,430.76,-142,6814276,185125137,98861537,7.8158591720583,7.8158591720583,0.47095303653574
430.6,420,14459,13606,5855895,14422360,2023-11-03,2023-11-03,430.76,-853,8566465,185125137,98861537,7.79060058170274,15.606459753761,0.593971097656694
432.31,412,6707,6655,9269074,13516305,2023-11-03,2023-11-17,430.76,-52,4247231,672805518,235832752,2.00894681128344,60.9049402891491,0.314230183471
432.85,418,8896,8799,8122048,13066515,2023-11-03,2023-11-17,430.76,-97,4944467,672805518,235832752,1.94209391130469,62.8470342004538,0.37840747896436
436.84,418,6979,6880,9456545,12961920,2023-11-03,2023-12-15,430.76,-99,3505375,878851435,217070587,1.47487043700395,56.2677539463766,0.270436401397324
433,300,936,940,10504728,12502000,2023-11-03,2023-12-15,430.76,4,1997272,878851435,217070587,1.42253849764722,57.6902924440238,0.159756199008159
441.14,430,10380,11180,7660440,12454520,2023-11-03,2023-12-29,430.76,800,4794080,181777115,62642449,6.85153353875157,6.85153353875157,0.384926918098811
432.5,320,1114,1107,10989610,12453750,2023-11-03,2023-12-15,430.76,-7,1464140,878851435,217070587,1.41704837746553,59.1073408214894,0.117566194921208
437.06,419,6748,6728,8691424,12150768,2023-11-03,2023-12-15,430.76,-20,3459344,878851435,217070587,1.382573608701,60.4899144301904,0.284701674824176
431.49,415,7372,7351,7231932,12121799,2023-11-03,2023-11-10,430.76,-21,4889867,127761173,59416338,9.4878582556533,9.4878582556533,0.403394496146983
433.46,422,11550,10572,7368900,12115512,2023-11-03,2023-11-17,430.76,-978,4746612,672805518,235832752,1.80074504085741,64.6477792413112,0.391779728335047
438.02,435,39765,39930,4652505,12058860,2023-11-03,2023-11-17,430.76,165,7406355,672805518,235832752,1.79232477697961,66.4401040182908,0.614183679054239
436.32,410,4448,4449,9096160,11709768,2023-11-03,2023-12-29,430.76,1,2613608,181777115,62642449,6.44182739945015,13.2933609382017,0.223198956631762
441.21,433,14297,14074,7191391,11554754,2023-11-03,2023-12-15,430.76,-223,4363363,878851435,217070587,1.31475623067055,61.8046706608609,0.377624915251333
430.66,414,7299,6870,6955947,11445420,2023-11-03,2023-11-03,430.76,-429,4489473,185125137,98861537,6.18253154891656,21.7889913026776,0.392250612035207
431.21,408,4863,4846,7192377,11247566,2023-11-03,2023-11-17,430.76,-17,4055189,672805518,235832752,1.67174104538185,68.1118450636726,0.360539249113986
436.1,414,5048,5040,8238336,11138400,2023-11-03,2023-12-15,430.76,-8,2900064,878851435,217070587,1.2673814431446,63.0720521040055,0.2603663003663
433.82,424,12026,11265,6349728,11062230,2023-11-03,2023-11-17,430.76,-761,4712502,672805518,235832752,1.64419430341236,69.756039367085,0.425999278626461
436.62,417,5481,5452,7783020,10696824,2023-11-03,2023-12-15,430.76,-29,2913804,878851435,217070587,1.21713677352077,64.2891888775263,0.272398984969744
439.66,429,10417,9973,7104394,10631218,2023-11-03,2023-12-15,430.76,-444,3526824,878851435,217070587,1.20967180306191,65.4988606805882,0.331742233110073
433.41,350,1258,1258,9082760,10492978,2023-11-03,2023-12-15,430.76,0,1410218,878851435,217070587,1.1939421820481,66.6928028626363,0.134396355353075
439.55,425,5742,7178,5742000,10443990,2023-11-03,2023-12-29,430.76,1436,4701990,181777115,62642449,5.74549221996399,19.0388531581657,0.45021012084462
432.7,416,6216,6190,6638688,10337300,2023-11-03,2023-11-17,430.76,-26,3698612,672805518,235832752,1.536446970698,71.292486337783,0.357792847261858
434.7,427,14045,13338,5421370,10270260,2023-11-03,2023-11-17,430.76,-707,4848890,672805518,235832752,1.52648272423949,72.8189690620225,0.47212923528713
441.35,440,86565,75682,3808860,10217070,2023-11-03,2023-11-17,430.76,-10883,6408210,672805518,235832752,1.51857702213435,74.3375460841568,0.627206234272644
432.61,425,17534,13250,5610880,10083250,2023-11-03,2023-11-10,430.76,-4284,4472370,127761173,59416338,7.89226473366834,17.3801229893216,0.443544492103241
447.94,445,32485,34024,4872750,10003056,2023-11-03,2023-12-15,430.76,1539,5130306,878851435,217070587,1.13819646889465,67.8309993315309,0.512873865746628
443.68,438,17467,17531,5571973,9957608,2023-11-03,2023-12-15,430.76,64,4385635,878851435,217070587,1.13302517393056,68.9640245054615,0.440430573286275
430.63,419,8964,8497,4284792,9882011,2023-11-03,2023-11-03,430.76,-467,5597219,185125137,98861537,5.33801684641022,27.1270081490878,0.566404854234629
433,417,6231,6174,6050301,9878400,2023-11-03,2023-11-17,430.76,-57,3828099,672805518,235832752,1.46824003901823,75.8057861231751,0.387522169582119
433.59,375,1657,1657,8454014,9708363,2023-11-03,2023-12-15,430.76,0,1254349,878851435,217070587,1.10466486295263,70.0686893684141,0.129202935654549
430.62,422,12956,10974,3601768,9459588,2023-11-03,2023-11-03,430.76,-1982,5857820,185125137,98861537,5.10983443593616,32.236842585024,0.619246842462906
421.9,330,1022,1022,9392180,9392180,2023-11-03,2023-12-15,430.76,0,0,878851435,217070587,1.06868802006337,71.1373773884775,0
434.94,428,13722,13166,4747812,9137204,2023-11-03,2023-11-17,430.76,-556,4389392,672805518,235832752,1.35807506858171,77.1638611917568,0.480386779150383
430.63,416,6345,6227,4619160,9110101,2023-11-03,2023-11-03,430.76,-118,4490941,185125137,98861537,4.92105024073527,37.1578928257593,0.49296281127948
433.17,419,6447,6408,5351010,9080136,2023-11-03,2023-11-17,430.76,-39,3729126,672805518,235832752,1.34959297405762,78.5134541658144,0.410690544723119
433.72,403,2942,2942,7181422,9037824,2023-11-03,2023-12-15,430.76,0,1856402,878851435,217070587,1.02836766717005,72.1657450556476,0.205403645833333
440.78,432,10183,10262,5570101,9010036,2023-11-03,2023-12-15,430.76,79,3439935,878851435,217070587,1.02520581308489,73.1909508687325,0.381789262551226
435.2,415,4445,4457,6609715,9003140,2023-11-03,2023-12-08,430.76,12,2393425,83002856,24707321,10.84678339261,10.84678339261,0.265843361316163
431.7,420,7976,7624,4809528,8920080,2023-11-03,2023-11-10,430.76,-352,4110552,127761173,59416338,6.98183946698736,24.361962456309,0.4608200823311
419.17,365,1635,1635,8856795,8856795,2023-11-03,2023-12-15,430.76,0,0,878851435,217070587,1.00776930517272,74.1987201739052,0
430.5,400,2770,2886,6393160,8802300,2023-11-03,2023-11-03,430.76,116,2409140,185125137,98861537,4.75478378714178,41.912676612901,0.27369437533372
414.76,250,531,531,8748756,8748756,2023-11-03,2023-12-15,430.76,0,0,878851435,217070587,0.995476101145582,75.1941962750508,0
435.73,405,2791,2818,6823995,8659714,2023-11-03,2023-12-29,430.76,27,1835719,181777115,62642449,4.76391871441023,23.8027718725759,0.211983790688699
434.37,402,2662,2662,6655000,8616894,2023-11-03,2023-12-15,430.76,0,1961894,878851435,217070587,0.980472200059615,76.1746684751104,0.227679950571517
434.38,426,11122,10188,4693484,8537544,2023-11-03,2023-11-17,430.76,-934,3844060,672805518,235832752,1.26894678649172,79.7824009523061,0.450253609234693
435.09,407,3017,3013,6055119,8463517,2023-11-03,2023-12-15,430.76,-4,2408398,878851435,217070587,0.963020217404549,77.1376886925149,0.284562316115156
430.64,421,11357,8707,3861380,8393548,2023-11-03,2023-11-03,430.76,-2650,4532168,185125137,98861537,4.53398611124323,46.4466627241443,0.539958549114153
431.55,409,3722,3720,6011030,8388600,2023-11-03,2023-11-17,430.76,-2,2377570,672805518,235832752,1.24680903702101,81.0292099893271,0.283428700855924
430.68,423,13972,10912,3101784,8380416,2023-11-03,2023-11-03,430.76,-3060,5278632,185125137,98861537,4.52689253107751,50.9735552552218,0.629877084860704
434.25,408,3174,3174,6703488,8331750,2023-11-03,2023-12-15,430.76,0,1628262,878851435,217070587,0.948027125881634,78.0857158183965,0.195428571428571
440.38,431,8921,8743,5209864,8200934,2023-11-03,2023-12-15,430.76,-178,2991070,878851435,217070587,0.933142243774114,79.0188580621707,0.364723091296674
432.28,413,4347,4251,5611977,8195928,2023-11-03,2023-11-17,430.76,-96,2583951,672805518,235832752,1.21817193538535,82.2473819247125,0.31527253533706
433.6,423,8721,7718,5032017,8181080,2023-11-03,2023-11-17,430.76,-1003,3149063,672805518,235832752,1.21596505693344,83.4633469816459,0.384920206134153
430.68,418,6741,6384,3754737,8094912,2023-11-03,2023-11-03,430.76,-357,4340175,185125137,98861537,4.37267036296643,55.3462256181882,0.53616086252698
445.93,442,18825,20573,3934425,8085189,2023-11-03,2023-12-15,430.76,1748,4150764,878851435,217070587,0.919972213506143,79.9388302756768,0.513378722501107
432.09,411,3813,3797,5528850,8007873,2023-11-03,2023-11-17,430.76,-16,2479023,672805518,235832752,1.1902210647446,84.6535680463905,0.30957321625855
436.04,431,14935,15780,3270765,7953120,2023-11-03,2023-11-17,430.76,845,4682355,672805518,235832752,1.18208305182182,85.8356510982123,0.588744417285292
437.29,415,3595,3480,6010840,7756920,2023-11-03,2023-12-29,430.76,-115,1746080,181777115,62642449,4.26726983757004,28.070041710146,0.225099652955039
432.44,405,2777,2786,5145781,7644784,2023-11-03,2023-11-24,430.76,9,2499003,100730326,33682043,7.58935695293987,26.9827618745124,0.326889942214195
435.29,420,5239,4965,5307107,7591485,2023-11-03,2023-12-01,430.76,-274,2284378,77639531,28317502,9.77786045616375,9.77786045616375,0.300913194190596
430.75,425,14720,13037,1987200,7496275,2023-11-03,2023-11-03,430.76,-1683,5509075,185125137,98861537,4.04930152732311,59.3955271455113,0.734908337807778
451.73,450,45456,43140,3772848,7463220,2023-11-03,2023-12-15,430.76,-2316,3690372,878851435,217070587,0.849201549065002,80.7880318247418,0.494474502962528
433.48,412.5,3539,3541,5616393,7429018,2023-11-03,2023-12-08,430.76,2,1812625,83002856,24707321,8.95031611924294,19.7970995118529,0.243992543832846
430.62,413,4230,4190,4331520,7382780,2023-11-03,2023-11-03,430.76,-40,3051260,185125137,98861537,3.98799434784483,63.3835214933562,0.413294179157445
439.33,428,7301,6511,5424643,7376963,2023-11-03,2023-12-15,430.76,-790,1952320,878851435,217070587,0.839386807168381,81.6274186319102,0.26465091393301
441.61,434,9720,9307,4383720,7082627,2023-11-03,2023-12-15,430.76,-413,2698907,878851435,217070587,0.805895822426461,82.4333144543367,0.381060163128737
434.51,415,3606,3590,4904160,7004090,2023-11-03,2023-12-01,430.76,-16,2099930,77639531,28317502,9.02129354696901,18.7991540031328,0.299814822482293
433.97,430,12809,17565,1716406,6973305,2023-11-03,2023-11-10,430.76,4756,5256899,127761173,59416338,5.45807841009725,29.8200408664063,0.753860472186431
433.3,421,5792,5606,4077568,6895380,2023-11-03,2023-11-17,430.76,-186,2817812,672805518,235832752,1.02486971576829,86.8605208139806,0.408652170003684
437.48,434,19283,19426,2699620,6760248,2023-11-03,2023-11-17,430.76,143,4060628,672805518,235832752,1.00478486265923,87.8653056766398,0.600662579242655
438.65,426,6203,5327,5179505,6738655,2023-11-03,2023-12-15,430.76,-876,1559150,878851435,217070587,0.766757011667165,83.2000714660038,0.231374065002586
443.3,435,8185,8109,4248015,6730470,2023-11-03,2023-12-29,430.76,-76,2482455,181777115,62642449,3.70259479583005,31.772636505976,0.368838283210534
423.48,360,1051,1051,6671748,6671748,2023-11-03,2023-12-15,430.76,0,0,878851435,217070587,0.759144007086932,83.9592154730907,0
434.8,411,2713,2721,4321809,6475980,2023-11-03,2023-12-15,430.76,8,2154171,878851435,217070587,0.736868569828301,84.696084042919,0.332640156393318
436.59,432,13024,14051,2552704,6449409,2023-11-03,2023-11-17,430.76,1027,3896705,672805518,235832752,0.958584438958184,88.823890115598,0.604195671262282
442.61,436,9891,9713,3719016,6420293,2023-11-03,2023-12-15,430.76,-178,2701277,878851435,217070587,0.730532231536949,85.426616274456,0.420740455303208
434.1,420,4639,4542,4059125,6404220,2023-11-03,2023-11-24,430.76,-97,2345095,100730326,33682043,6.35778742540752,33.3405492999199,0.366179644047206
431.25,410,3019,3009,4317170,6394125,2023-11-03,2023-11-10,430.76,-10,2076955,127761173,59416338,5.00474819529091,34.8247890616972,0.324822395558423
431.52,405,2340,2338,4633200,6200376,2023-11-03,2023-11-17,430.76,-2,1567176,672805518,235832752,0.921570325170847,89.7454604407689,0.252754994213254
430.62,412,3434,3324,3863250,6189288,2023-11-03,2023-11-03,430.76,-110,2326038,185125137,98861537,3.34329961900312,66.7268211123593,0.375816733685684
431.37,414,3495,3491,3799065,6063867,2023-11-03,2023-11-10,430.76,-4,2264802,127761173,59416338,4.74625182096598,39.5710408826632,0.373491371100323
435.02,410,2399,2396,4126280,5994792,2023-11-03,2023-12-08,430.76,-3,1868512,83002856,24707321,7.22239244394193,27.0194919557949,0.311689212903467
430.55,410,2918,2917,3746712,5994435,2023-11-03,2023-11-03,430.76,-1,2247723,185125137,98861537,3.23804486907686,69.9648659814361,0.374968283082559
427.78,405,2589,2585,4880265,5888630,2023-11-03,2023-11-10,430.76,-4,1008365,127761173,59416338,4.60909199698722,44.1801328796504,0.171239320521072
441.52,431,3545,5597,2474410,5888044,2023-11-03,2023-12-29,430.76,2052,3413634,181777115,62642449,3.23915582002718,35.0117923260032,0.579756876816817
430.56,417,4595,4297,2931610,5826732,2023-11-03,2023-11-03,430.76,-298,2895122,185125137,98861537,3.14745587467141,73.1123218561075,0.496868913826824
428.73,150,207,206,5617566,5741838,2023-11-03,2023-12-15,430.76,-1,124272,878851435,217070587,0.653334314689945,86.079950589146,0.0216432438532749
430.38,411,3033,2824,3739689,5472912,2023-11-03,2023-11-03,430.76,-209,1733223,185125137,98861537,2.95633110051392,76.0686529566215,0.316691187433673
443.1,437,8143,8927,2817478,5445470,2023-11-03,2023-12-15,430.76,784,2627992,878851435,217070587,0.619612119083586,86.6995627082295,0.482601501798743
431.51,350,640,657,4758400,5355207,2023-11-03,2023-12-29,430.76,17,596807.000000001,181777115,62642449,2.9460292622644,37.9578215882676,0.111444244825644
435.86,413,2318,2304,3984642,5266944,2023-11-03,2023-12-15,430.76,-14,1282302,878851435,217070587,0.599298560626461,87.298861268856,0.243462243000875
435,400,1479,1480,4206276,5180000,2023-11-03,2023-12-29,430.76,1,973724,181777115,62642449,2.84964364188528,40.8074652301529,0.187977606177606
437.97,430,6773,6484,3054623,5167748,2023-11-03,2023-12-01,430.76,-289,2113125,77639531,28317502,6.65607833205484,25.4552323351876,0.408906355340856
435.25,429,8439,8161,2464188,5100625,2023-11-03,2023-11-17,430.76,-278,2636437,672805518,235832752,0.758112836999651,90.5035732777685,0.516885087611812
420.71,391,1702,1702,5056642,5056642,2023-11-03,2023-12-15,430.76,0,0,878851435,217070587,0.575369374005744,87.8742306428617,0
430.84,426,13891,10281,1402991,4976004,2023-11-03,2023-11-03,430.76,-3610,3573013,185125137,98861537,2.68791374344803,78.7565667000695,0.718048659124872
438.14,420,2784,2738,3708288,4966732,2023-11-03,2023-12-29,430.76,-46,1258444,181777115,62642449,2.73231974222938,43.5397849723823,0.253374653595161
435.95,417,2597,2598,3272220,4923210,2023-11-03,2023-12-08,430.76,1,1650990,83002856,24707321,5.93137421681008,32.950866172605,0.335348278866837
436.96,433,13045,12421,2100245,4918716,2023-11-03,2023-11-17,430.76,-624,2818471,672805518,235832752,0.731075454705174,91.2346487324737,0.573009500853475
436.5,425,4150,4269,2867650,4909350,2023-11-03,2023-12-01,430.76,119,2041700,77639531,28317502,6.32326076261331,31.7784930978009,0.415879902634768
437.55,421,3024,2961,3510864,4900455,2023-11-03,2023-12-15,430.76,-63,1389591,878851435,217070587,0.557597655854087,88.4318282987158,0.28356366908787
430.47,406,1998,1997,3376620,4886659,2023-11-03,2023-11-17,430.76,-1,1510039,672805518,235832752,0.726310779157433,91.9609595116311,0.309012558478093
430.97,427,14119,12132,1016568,4816404,2023-11-03,2023-11-03,430.76,-1987,3799836,185125137,98861537,2.60170178834223,81.3582684884117,0.788936310160028
430.7,424,9495,7135,1671120,4780450,2023-11-03,2023-11-03,430.76,-2360,3109330,185125137,98861537,2.5822803307365,83.9405488191482,0.650426215105273
433.43,415,2640,2587,3276240,4767841,2023-11-03,2023-11-24,430.76,-53,1491601,100730326,33682043,4.73327267897455,38.0738219788944,0.312846212782683
420.26,394,1762,1762,4627012,4627012,2023-11-03,2023-12-15,430.76,0,0,878851435,217070587,0.526483978489493,88.9583122772053,0
431.47,416,3085,2925,2838200,4524975,2023-11-03,2023-11-10,430.76,-160,1686775,127761173,59416338,3.54174503391574,47.7218779135661,0.372770015303952
439.02,427,4419,3677,3446820,4419754,2023-11-03,2023-12-15,430.76,-742,972934.000000001,878851435,217070587,0.502901153025938,89.4612134302312,0.220133066229478
448.75,445,12949,11663,2693392,4373625,2023-11-03,2023-12-29,430.76,-1286,1680233,181777115,62642449,2.40603719560628,45.9458221679885,0.384173997542085
440.16,427,3152,3264,2846256,4295424,2023-11-03,2023-12-29,430.76,112,1449168,181777115,62642449,2.36301692872615,48.3088390967147,0.337374843554443
438.76,423,821,2711,917878,4272536,2023-11-03,2023-12-29,430.76,1890,3354658,181777115,62642449,2.35042568477336,50.659264781488,0.785167872195811
444.16,439,7919,8276,2256915,4270416,2023-11-03,2023-12-15,430.76,357,2013501,878851435,217070587,0.485908747477894,89.9471221777091,0.471499966279632
440.48,428,3375,3377,2902500,4214496,2023-11-03,2023-12-29,430.76,2,1311996,181777115,62642449,2.31849647300212,52.9777612544902,0.311305551126398
445.73,440,7340,7338,2480920,4204674,2023-11-03,2023-12-29,430.76,-2,1723754,181777115,62642449,2.31309315256764,55.2908544070578,0.40996139058581
446.64,443,10847,11511,2039236,4190004,2023-11-03,2023-12-15,430.76,664,2150768,878851435,217070587,0.476759078171159,90.4238812558803,0.513309295170124
431.79,430,26222,23229,524440,4157991,2023-11-03,2023-11-03,430.76,-2993,3633551,185125137,98861537,2.24604344249587,86.1865922616441,0.873871780867251
429.97,399,1340,1340,3087360,4149980,2023-11-03,2023-11-17,430.76,0,1062620,672805518,235832752,0.616817176579696,92.5777766882108,0.256054246044559
416.55,200,190,190,4114450,4114450,2023-11-03,2023-12-15,430.76,0,0,878851435,217070587,0.468162175783442,90.8920434316637,0
433,410,1722,1724,2839578,3965200,2023-11-03,2023-11-24,430.76,2,1125622,100730326,33682043,3.93645107432691,42.0102730532213,0.283875214364975
438.62,422,1382,2340,1652872,3889080,2023-11-03,2023-12-29,430.76,958,2236208,181777115,62642449,2.13947723837514,57.4303316454329,0.574996657307127
431.97,422.5,4147,4083,1886885,3866601,2023-11-03,2023-11-10,430.76,-64,1979716,127761173,59416338,3.02642885096241,50.7483067645285,0.512004212485333
435.88,413,1653,1657,2991930,3791216,2023-11-03,2023-12-29,430.76,4,799285.999999999,181777115,62642449,2.0856398782652,59.5159715236981,0.210825761444349
434.49,416,2059,2048,2643756,3786752,2023-11-03,2023-12-01,430.76,-11,1142996,77639531,28317502,4.87735043118692,36.6558435289878,0.301840733166576
429.06,413,2343,2343,3762858,3762858,2023-11-03,2023-12-08,430.76,0,0,83002856,24707321,4.53340786249572,37.4842740351007,0
419.04,335,444,444,3731376,3731376,2023-11-03,2023-12-15,430.76,0,0,878851435,217070587,0.424574148871931,91.3166175805357,0
436.75,414,1654,1630,2912694,3708250,2023-11-03,2023-12-29,430.76,-24,795556,181777115,62642449,2.03999826930909,61.5559697930072,0.214536776107328
430.18,350,452,457,3043316,3664226,2023-11-03,2023-11-17,430.76,5,620910,672805518,235832752,0.544618898324791,93.1223955865356,0.169451884245131
441.33,435,7702,5700,2711104,3608100,2023-11-03,2023-12-08,430.76,-2002,896996,83002856,24707321,4.34695885645188,41.8312328915526,0.248606191624401
438.62,436,14802,13766,1435794,3606692,2023-11-03,2023-11-17,430.76,-1036,2170898,672805518,235832752,0.536067541586364,93.658463128122,0.601908341494089
445.33,441,7592,8174,1791712,3539342,2023-11-03,2023-12-15,430.76,582,1747630,878851435,217070587,0.402723584333682,91.7193411648694,0.493772571285849
435.16,425,3485,3458,2087515,3513328,2023-11-03,2023-11-24,430.76,-27,1425813,100730326,33682043,3.48785528600394,45.4981283392253,0.405829743195056
433.65,406,1252,1253,2670516,3464545,2023-11-03,2023-12-15,430.76,1,794029,878851435,217070587,0.394212817095759,92.1135539819651,0.229187093831946
431.38,411,1633,1650,2202917,3362700,2023-11-03,2023-11-10,430.76,17,1159783,127761173,59416338,2.632020293051,53.3803270575795,0.344896363041604
436.02,417.5,1811,1815,2044619,3361380,2023-11-03,2023-12-08,430.76,4,1316761,83002856,24707321,4.04971607242045,45.880948963973,0.391732264724607
435.14,412,1449,1442,2645874,3336788,2023-11-03,2023-12-15,430.76,-7,690914,878851435,217070587,0.379676002918514,92.4932299848836,0.207059603427008
439.27,424,526,2182,561768,3331914,2023-11-03,2023-12-29,430.76,1656,2770146,181777115,62642449,1.83296670760783,63.3889365006151,0.831397809187152
431.95,422,3590,3346,1719610,3329270,2023-11-03,2023-11-10,430.76,-244,1609660,127761173,59416338,2.60585428407111,55.9861813416507,0.483487371105377
431.31,413,1945,1813,2244530,3319603,2023-11-03,2023-11-10,430.76,-132,1075073,127761173,59416338,2.59828782254527,58.5844691641959,0.323855894816338
434.56,412,1453,1453,2493348,3277968,2023-11-03,2023-12-08,430.76,0,784620,83002856,24707321,3.9492231448036,49.8301721087766,0.23936170212766
431.3,412,1698,1696,2144574,3273280,2023-11-03,2023-11-10,430.76,-2,1128706,127761173,59416338,2.56203032825943,61.1464994924554,0.344824151921009
439.26,437,13397,14456,1098554,3267056,2023-11-03,2023-11-17,430.76,1059,2168502,672805518,235832752,0.485586980575269,94.1440501086973,0.663748034928082
452.39,450,13630,13637,1717380,3259243,2023-11-03,2023-12-29,430.76,7,1541863,181777115,62642449,1.7929886278589,65.181925128474,0.473073962266698
423.42,392,1033,1033,3245686,3245686,2023-11-03,2023-12-15,430.76,0,0,878851435,217070587,0.369309973306239,92.8625399581899,0
441.94,432,1955,3237,1077205,3217578,2023-11-03,2023-12-29,430.76,1282,2140373,181777115,62642449,1.7700677007664,66.9519928292404,0.665212467265751
432.3,310,259,259,2891735,3167570,2023-11-03,2023-12-15,430.76,0,275835,878851435,217070587,0.36042155407074,93.2229615122606,0.0870809484873263
442.4,433,3351,3368,2044110,3165920,2023-11-03,2023-12-29,430.76,17,1121810,181777115,62642449,1.74164938199179,68.6936422112322,0.354339338959923
430.02,408,1449,1437,1822842,3164274,2023-11-03,2023-11-03,430.76,-12,1341432,185125137,98861537,1.70926220570467,87.8958544673488,0.42393041816227
432.22,423,3357,3411,1426725,3144942,2023-11-03,2023-11-10,430.76,54,1718217,127761173,59416338,2.46157883976222,63.6080783322176,0.546342985021663
431.81,421,2861,2891,1536357,3125171,2023-11-03,2023-11-10,430.76,30,1588814,127761173,59416338,2.44610387226172,66.0541822044793,0.508392660753604
434.93,414,1484,1482,2033080,3101826,2023-11-03,2023-12-08,430.76,-2,1068746,83002856,24707321,3.73701116983252,53.5671832786091,0.344553820878412
431.14,428,9197,9703,450653,3046742,2023-11-03,2023-11-03,430.76,506,2596089,185125137,98861537,1.64577433911636,89.5416288064651,0.852086917763303
431.41,429,8063,12387,266079,2985267,2023-11-03,2023-11-03,430.76,4324,2719188,185125137,98861537,1.61256707132106,91.1541958777862,0.910869279029313
422.92,280,208,208,2972736,2972736,2023-11-03,2023-12-15,430.76,0,0,878851435,217070587,0.338252391884642,93.5612139041453,0
434.7,404,975,966,2232750,2965620,2023-11-03,2023-12-15,430.76,-9,732870,878851435,217070587,0.337442698719608,93.8986566028649,0.247122018330063
436.15,419,1730,1728,2041400,2963520,2023-11-03,2023-12-08,430.76,-2,922120,83002856,24707321,3.57038316850206,57.1375664471112,0.311157002483533
432.68,426,3973,4309,1092575,2878412,2023-11-03,2023-11-10,430.76,336,1785837,127761173,59416338,2.25296303439543,68.3071452388747,0.620424386779933
436.73,430,4946,4226,1716262,2844098,2023-11-03,2023-11-24,430.76,-720,1127836,100730326,33682043,2.82347741036796,48.3216057495932,0.39655314268355
432.53,340,306,303,2235024,2803659,2023-11-03,2023-12-15,430.76,-3,568635,878851435,217070587,0.319013986704135,94.217670589569,0.202818887746334
431.36,390,671,672,2290123,2779392,2023-11-03,2023-11-17,430.76,1,489269,672805518,235832752,0.413104816420367,94.5571549251176,0.176034542806484
434.65,417,1590,1567,1920720,2765755,2023-11-03,2023-12-01,430.76,-23,845035,77639531,28317502,3.56230255950413,40.218146088492,0.305535016659104
432.98,413,1404,1384,1974024,2765232,2023-11-03,2023-11-24,430.76,-20,791208,100730326,33682043,2.74518321324603,51.0667889628393,0.286127167630058
428.93,411,1527,1527,2737911,2737911,2023-11-03,2023-12-08,430.76,0,0,83002856,24707321,3.29857444905269,60.4361408961639,0
430,370,448,451,2414272,2706000,2023-11-03,2023-11-17,430.76,3,291728,672805518,235832752,0.402196463555164,94.9593513886728,0.107807834441981
423.04,407,1674,1674,2685096,2685096,2023-11-03,2023-11-17,430.76,0,0,672805518,235832752,0.399089473579496,95.3584408622523,0
439.91,438,20617,13922,1360722,2659102,2023-11-03,2023-11-17,430.76,-6695,1298380,672805518,235832752,0.395225949975042,95.7536668122273,0.488277621542912
434.93,418,1581,1519,1829217,2571667,2023-11-03,2023-12-01,430.76,-62,742450,77639531,28317502,3.31231650536374,43.5304625938557,0.288703786298926
432.25,424,3445,3067,1281540,2530275,2023-11-03,2023-11-10,430.76,-378,1248735,127761173,59416338,1.98047258066424,70.287617819539,0.493517503038207
450.19,448,12073,11523,1291811,2523537,2023-11-03,2023-12-15,430.76,-550,1231726,878851435,217070587,0.287140340164547,94.5048109297335,0.488095082418051
443.65,436,3299,3295,1586819,2520675,2023-11-03,2023-12-29,430.76,-4,933856,181777115,62642449,1.38668445695158,70.0803266681837,0.370478542453906
434.02,410,1073,1046,1884188,2512492,2023-11-03,2023-12-01,430.76,-27,628304,77639531,28317502,3.23609888885084,46.7665614827065,0.250072040030376
449.39,447,10058,10371,1217018,2478669,2023-11-03,2023-12-15,430.76,313,1261651,878851435,217070587,0.28203504042751,94.786845970161,0.509003420787527
424.3,225,123,123,2451390,2451390,2023-11-03,2023-12-15,430.76,0,0,878851435,217070587,0.278931102843338,95.0657770730044,0
447.28,444,7058,7235,1171628,2373080,2023-11-03,2023-12-15,430.76,177,1201452,878851435,217070587,0.270020609342238,95.3357976823466,0.506283816811907
435.8,418,1336,1332,1663320,2370960,2023-11-03,2023-12-08,430.76,-4,707640,83002856,24707321,2.85648002280789,63.2926209189718,0.298461382731046
430.2,409,1139,1114,1618519,2361680,2023-11-03,2023-11-03,430.76,-25,743161,185125137,98861537,1.27572086550299,92.4299167432892,0.314674723078487
433.38,414,1266,1214,1677450,2352732,2023-11-03,2023-11-24,430.76,-52,675282,100730326,33682043,2.33567396575288,53.4024629285921,0.287020366110547
448.11,444,2659,5647,627524,2320917,2023-11-03,2023-12-29,430.76,2988,1693393,181777115,62642449,1.27679273598329,71.357119404167,0.729622386324026
434.69,409,900,899,1800000,2309531,2023-11-03,2023-12-29,430.76,-1,509531,181777115,62642449,1.2705290212137,72.6276484253807,0.220620983221269
430.28,395,635,642,1579245,2264976,2023-11-03,2023-11-03,430.76,7,685731,185125137,98861537,1.22348376709101,93.6534005103802,0.302754201369021
434.63,422,1828,1706,1392936,2154678,2023-11-03,2023-11-24,430.76,-122,761742.000000001,100730326,33682043,2.13905591847285,55.541518847065,0.353529390470409
436.98,427,1887,2146,1111443,2141708,2023-11-03,2023-12-01,430.76,259,1030265,77639531,28317502,2.75852774020492,49.5250892229115,0.481048303503559
435.46,421,1510,1466,1419400,2119836,2023-11-03,2023-12-01,430.76,-44,700436,77639531,28317502,2.73035652417839,52.2554457470899,0.33041990040739
434.31,413,998,992,1532928,2113952,2023-11-03,2023-12-01,430.76,-6,581024,77639531,28317502,2.72277791064967,54.9782236577395,0.2748520306989
435.29,416,1103,1095,1580599,2112255,2023-11-03,2023-12-08,430.76,-8,531656,83002856,24707321,2.54479797659011,65.8374188955619,0.251700670610319
448.68,446,7754,7719,1054544,2068692,2023-11-03,2023-12-15,430.76,-35,1014148,878851435,217070587,0.235385859044538,95.5711835413912,0.490236342577822
433.01,427,3875,3440,906750,2067440,2023-11-03,2023-11-10,430.76,-435,1160690,127761173,59416338,1.61820680841745,71.9058246279564,0.561414116008203
432.26,431,8610,16372,111930,2062872,2023-11-03,2023-11-03,430.76,7762,1950942,185125137,98861537,1.11431220709914,94.7677127174793,0.945740695496376
440.76,429,1767,1752,1459542,2060352,2023-11-03,2023-12-29,430.76,-15,600810,181777115,62642449,1.13344960942966,73.7610980348104,0.291605512067841
419.9,325,217,217,2059330,2059330,2023-11-03,2023-12-15,430.76,0,0,878851435,217070587,0.234320605051979,95.8055041464431,0
431.53,417,1433,1414,1197988,2054542,2023-11-03,2023-11-10,430.76,-19,856554,127761173,59416338,1.60811140955946,73.5139360375159,0.416907515154229
433.58,429,3201,4402,518562,2016116,2023-11-03,2023-11-10,430.76,1201,1497554,127761173,59416338,1.57803497937515,75.091971016891,0.742791585404808
433.25,428,4639,3814,913883,2002350,2023-11-03,2023-11-10,430.76,-825,1088467,127761173,59416338,1.56726018788196,76.659231204773,0.543594776138038
431.86,419,1600,1557,1084800,2002302,2023-11-03,2023-11-10,430.76,-43,917502,127761173,59416338,1.56722261778232,78.2264538225553,0.458223584654063
429,300,159,155,1806240,1999500,2023-11-03,2023-12-29,430.76,-4,193260,181777115,62642449,1.09997344825282,74.8610714830632,0.0966541635408853
435.63,426,1825,2058,952650,1981854,2023-11-03,2023-11-24,430.76,233,1029204,100730326,33682043,1.96748494589405,57.509003792959,0.519313733504083
424.64,395,662,662,1962168,1962168,2023-11-03,2023-11-17,430.76,0,0,672805518,235832752,0.291639700850373,96.0453065130777,0
433,412,932,932,1474424,1957200,2023-11-03,2023-12-01,430.76,0,482776,77639531,28317502,2.5208807611164,57.4991044188559,0.246666666666667
433.15,427.5,2820,3448,589380,1948120,2023-11-03,2023-11-10,430.76,628,1358740,127761173,59416338,1.5248138023905,79.7512676249458,0.697462168654908
433.4,416,1126,1114,1342192,1938360,2023-11-03,2023-11-24,430.76,-12,596168,100730326,33682043,1.92430629083837,59.4333100837974,0.307563094574795
435.98,434,4207,9771,222971,1934658,2023-11-03,2023-11-10,430.76,5564,1711687,127761173,59416338,1.51427695486171,81.2655445798075,0.884749139124331
437.39,416,907,885,1450293,1893015,2023-11-03,2023-12-29,430.76,-22,442722,181777115,62642449,1.04139346693889,75.9024649500021,0.23387136393531
433.75,419,1311,1271,1250694,1874725,2023-11-03,2023-11-24,430.76,-40,624031,100730326,33682043,1.86113266425843,61.2944427480558,0.332865353585193
433.97,380,369,341,1650906,1840377,2023-11-03,2023-12-29,430.76,-28,189471,181777115,62642449,1.01243602639419,76.9149009763963,0.102952275539196
434.4,431,2738,5394,284752,1833960,2023-11-03,2023-11-10,430.76,2656,1549208,127761173,59416338,1.43545958207506,82.7010041618826,0.844733800082881
430.07,407,789,789,1820223,1820223,2023-11-03,2023-12-29,430.76,0,0,181777115,62642449,1.00134882215509,77.9162497985514,0
439.02,435,4197,4423,747066,1778046,2023-11-03,2023-11-24,430.76,226,1030980,100730326,33682043,1.76515461689263,63.0595973649485,0.579838766826055
432.79,412,868,855,1282036,1777545,2023-11-03,2023-11-24,430.76,-13,495509,100730326,33682043,1.7646572492975,64.824254614246,0.278760312678442
439.08,430,1452,1954,789888,1774232,2023-11-03,2023-12-08,430.76,502,984344,83002856,24707321,2.13755536315522,67.9749742587171,0.554800048697126
436.95,422,1190,1180,1165010,1764100,2023-11-03,2023-12-08,430.76,-10,599090,83002856,24707321,2.12534855427143,70.1003228129885,0.339600929652514
433.47,417,1107,1071,1216593,1763937,2023-11-03,2023-11-24,430.76,-36,547344,100730326,33682043,1.75114791150383,66.5754025257498,0.310296796314154
436.49,420,1046,1055,1164198,1739695,2023-11-03,2023-12-08,430.76,9,575497,83002856,24707321,2.09594595154653,72.196268764535,0.330803387950186
424.2,403,820,820,1738400,1738400,2023-11-03,2023-12-29,430.76,0,0,181777115,62642449,0.95633600522266,78.8725858037741,0
431.35,409,775,771,1044700,1723185,2023-11-03,2023-11-10,430.76,-4,678485,127761173,59416338,1.34875483649481,84.0497589983774,0.393738919500808
455.96,455,18641,17940,876127,1722240,2023-11-03,2023-12-15,430.76,-701,846113,878851435,217070587,0.195964861797148,96.0014690082403,0.491286348011892
430.45,405,670,667,1216720,1697515,2023-11-03,2023-11-03,430.76,-3,480795,185125137,98861537,0.91695543215182,95.6846681496311,0.283234610592543
434.02,418,1083,1045,1112241,1674090,2023-11-03,2023-11-24,430.76,-38,561849,100730326,33682043,1.66195233002621,68.237354855776,0.335614572693224
434.25,421,1335,1259,1125405,1668175,2023-11-03,2023-11-24,430.76,-76,542770,100730326,33682043,1.65608021560458,69.8934350713806,0.325367542374151
430.15,290,119,119,1558543,1667785,2023-11-03,2023-12-15,430.76,0,109242,878851435,217070587,0.18976870647085,96.1912377147111,0.0655012486621478
450.93,449,8785,8547,834575,1649571,2023-11-03,2023-12-15,430.76,-238,814996,878851435,217070587,0.18769622877159,96.3789339434827,0.494065426707914
437.82,426,1264,1391,989712,1644162,2023-11-03,2023-12-08,430.76,127,654450,83002856,24707321,1.98084991195966,74.1771186764947,0.398044718221197
425.23,260,99,99,1635777,1635777,2023-11-03,2023-12-15,430.76,0,0,878851435,217070587,0.186126680216435,96.5650606236992,0
443.95,440,4235,4137,851235,1634115,2023-11-03,2023-12-08,430.76,-98,782880,83002856,24707321,1.96874550919067,76.1458641856854,0.47908500931697
435.3,419,1010,997,1089790,1625110,2023-11-03,2023-12-01,430.76,-13,535320,77639531,28317502,2.09314762604632,59.5922520449022,0.3294053940964
436.6,435,10606,10114,413634,1618240,2023-11-03,2023-11-10,430.76,-492,1204606,127761173,59416338,1.26661329260025,85.3163722909777,0.744392673521851
456.43,455,11184,11104,805248,1587872,2023-11-03,2023-12-29,430.76,-80,782624,181777115,62642449,0.873526901337388,79.7461127051114,0.492876000080611
431.48,418,1339,1171,1005589,1578508,2023-11-03,2023-11-10,430.76,-168,572919,127761173,59416338,1.23551464262151,86.5518869335992,0.362949696802297
442.93,442,21281,16855,617149,1567515,2023-11-03,2023-11-17,430.76,-4426,950366,672805518,235832752,0.23298188823713,96.2782884013148,0.606288297081687
447.47,443,3515,3489,910385,1559583,2023-11-03,2023-12-29,430.76,-26,649198,181777115,62642449,0.857964436282312,80.6040771413937,0.41626383462759
442.75,434,1760,1779,983840,1556625,2023-11-03,2023-12-29,430.76,19,572785,181777115,62642449,0.85633716873546,81.4604143101292,0.367965951979443
435.67,427,1652,1749,791308,1516383,2023-11-03,2023-11-24,430.76,97,725075,100730326,33682043,1.50538875452463,71.3988238259052,0.478160860415871
443.01,440,5184,5000,725760,1505000,2023-11-03,2023-12-01,430.76,-184,779240,77639531,28317502,1.93844550658092,61.5306975514832,0.517767441860465
434.54,414,816,727,1175040,1493258,2023-11-03,2023-12-01,430.76,-89,318218,77639531,28317502,1.92332176761861,63.4540193191018,0.213103161007676
429.88,370,236,247,1100940,1479036,2023-11-03,2023-12-29,430.76,11,378096,181777115,62642449,0.813653577899506,82.2740678880287,0.255636779632139
429.75,412.5,860,855,1068980,1474875,2023-11-03,2023-11-10,430.76,-5,405895,127761173,59416338,1.15440001478383,87.706286948383,0.275206373421476
437.66,429,1756,1696,870976,1468736,2023-11-03,2023-12-01,430.76,-60,597760,77639531,28317502,1.8917373418961,65.3457566609979,0.406989411303325
440.65,439,8608,8811,464832,1453815,2023-11-03,2023-11-17,430.76,203,988983,672805518,235832752,0.216082502462472,96.4943709037773,0.680267434302164
431.85,402,484,484,978164,1444740,2023-11-03,2023-11-17,430.76,0,466576,672805518,235832752,0.214733672859086,96.7091045766364,0.322948073701843
436.64,426,1296,1350,826848,1436400,2023-11-03,2023-12-01,430.76,54,609552,77639531,28317502,1.85008845558328,67.1958451165811,0.424360902255639
438.39,431,1489,1933,625380,1428487,2023-11-03,2023-12-01,430.76,444,803107,77639531,28317502,1.83989648263074,69.0357415992119,0.562208126500276
446.37,441,2671,2653,817326,1424661,2023-11-03,2023-12-29,430.76,-18,607335,181777115,62642449,0.783740571523539,83.0578084595522,0.426301414862904
423.49,407,859,859,1416491,1416491,2023-11-03,2023-12-08,430.76,0,0,83002856,24707321,1.7065569406431,77.8524211263285,0
430.7,400,461,460,1103634,1412200,2023-11-03,2023-11-10,430.76,-1,308566,127761173,59416338,1.10534363988659,88.8116305882696,0.218500212434499
440.14,435,2440,2747,649040,1411958,2023-11-03,2023-12-01,430.76,307,762918,77639531,28317502,1.81860707015348,70.8543486693654,0.540326270328154
430.48,395,399,396,1019445,1405008,2023-11-03,2023-11-10,430.76,-3,385563,127761173,59416338,1.09971438662355,89.9113449748931,0.274420501520276
415.8,170,57,57,1401060,1401060,2023-11-03,2023-12-15,430.76,0,0,878851435,217070587,0.159419435891346,96.7244800595905,0
434.89,424,1397,1285,909447,1399365,2023-11-03,2023-11-24,430.76,-112,489918,100730326,33682043,1.38921917119577,72.788042997101,0.350100224030185
432.85,432,8168,16434,57176,1396890,2023-11-03,2023-11-03,430.76,8266,1339714,185125137,98861537,0.754565275487143,96.4392334251183,0.959069074873469
437.11,431,2161,2273,656944,1388803,2023-11-03,2023-11-24,430.76,112,731859,100730326,33682043,1.37873374896057,74.1667767460616,0.526971067890838
437.15,427.5,1620,1402,981720,1352930,2023-11-03,2023-12-01,430.76,-218,371210,77639531,28317502,1.74257879017842,72.5969274595438,0.274374875270709
424.82,240,73,73,1349186,1349186,2023-11-03,2023-12-15,430.76,0,0,878851435,217070587,0.15351695932544,96.877997018916,0
434.87,432,3107,4675,270309,1341725,2023-11-03,2023-11-10,430.76,1568,1071416,127761173,59416338,1.0501821237975,90.9615270986906,0.798536212711249
438.48,421,466,756,590888,1321488,2023-11-03,2023-12-29,430.76,290,730600,181777115,62642449,0.726982601742799,83.784791061295,0.552861622655673
437.3,428,1343,1420,742679,1320600,2023-11-03,2023-12-01,430.76,77,577921,77639531,28317502,1.70093763188755,74.2978650914313,0.437620021202484
438.54,434,2783,2906,587213,1319324,2023-11-03,2023-11-24,430.76,123,732111,100730326,33682043,1.30975849318705,75.4765352392486,0.554913728545831
450.88,448,4516,4522,699980,1302336,2023-11-03,2023-12-29,430.76,6,602356,181777115,62642449,0.716446622007396,84.5012376833024,0.462519656985601
431.2,380,255,254,980985,1300480,2023-11-03,2023-11-17,430.76,-1,319495,672805518,235832752,0.193292112684486,96.9023966893209,0.245674673966535
457.79,457,16276,16342,602212,1291018,2023-11-03,2023-12-15,430.76,66,688806,878851435,217070587,0.146898320761119,97.0248953396771,0.533537100179858
438.8,429,1269,1310,775359,1283800,2023-11-03,2023-12-08,430.76,41,508441,83002856,24707321,1.54669376677834,79.3991148931068,0.396043776289142
438.17,427.5,1057,1201,731444,1281467,2023-11-03,2023-12-08,430.76,144,550023,83002856,24707321,1.54388302012162,80.9429979132284,0.429213549783178
453.35,452,8341,9444,550506,1274940,2023-11-03,2023-12-15,430.76,1103,724434,878851435,217070587,0.145068887553219,97.1699642272303,0.568210268718528
424.5,407,722,722,1263500,1263500,2023-11-03,2023-11-10,430.76,0,0,127761173,59416338,0.988954602037037,91.9504817007276,0
427.8,325,0,120,0,1233600,2023-11-03,2023-11-10,430.76,120,1233600,127761173,59416338,0.965551560801653,92.9160332615293,1
427.89,397,396,396,1223244,1223244,2023-11-03,2023-12-29,430.76,0,0,181777115,62642449,0.672936194415892,85.1741738777183,0
432.85,411,549,556,839970,1214860,2023-11-03,2023-11-24,430.76,7,374890,100730326,33682043,1.20605188947765,76.6825871287263,0.308586997678745
433.95,395,312,311,843960,1211345,2023-11-03,2023-12-29,430.76,-1,367385,181777115,62642449,0.666390265903384,85.8405641436217,0.303286842311645
450.19,447,3795,3794,641355,1210286,2023-11-03,2023-12-29,430.76,-1,568931,181777115,62642449,0.665807684317138,86.5063718279389,0.470079799320161
436.75,421,803,763,848771,1201725,2023-11-03,2023-12-08,430.76,-40,352954,83002856,24707321,1.44781162710835,82.3908095403368,0.293706130770351
432.71,417.5,794,790,859902,1201590,2023-11-03,2023-11-24,430.76,-4,341688,100730326,33682043,1.19287810107951,77.8754652298058,0.284363218735176
436.03,423,875,913,707000,1189639,2023-11-03,2023-12-01,430.76,38,482639,77639531,28317502,1.53225938471988,75.8301244761512,0.405702065920838
434.8,423,1056,991,726528,1169380,2023-11-03,2023-11-24,430.76,-65,442852,100730326,33682043,1.16090163353586,79.0363668633416,0.378706665070379
418.64,210,56,56,1168384,1168384,2023-11-03,2023-11-17,430.76,0,0,672805518,235832752,0.173658504388188,97.076055193709,0
445.52,445,21574,22295,345184,1159340,2023-11-03,2023-11-17,430.76,721,814156,672805518,235832752,0.172314282357001,97.248369476066,0.702258181379061
460.54,460,20805,21217,582540,1145718,2023-11-03,2023-12-15,430.76,412,563178,878851435,217070587,0.130365378535224,97.3003296057655,0.491550276769676
438.61,428,906,1069,611550,1134209,2023-11-03,2023-12-08,430.76,163,522659,83002856,24707321,1.36646984773632,83.7572793880731,0.460813659563625
439.49,431,1339,1335,665483,1133415,2023-11-03,2023-12-08,430.76,-4,467932,83002856,24707321,1.36551325414634,85.1227926422194,0.412851426882475
417.2,315,110,110,1124200,1124200,2023-11-03,2023-12-15,430.76,0,0,878851435,217070587,0.127916955611502,97.428246561377,0
426.16,412.5,813,813,1110558,1110558,2023-11-03,2023-11-24,430.76,0,0,100730326,33682043,1.10250611121818,80.1388729745598,0
460.82,460,14098,13513,592116,1108066,2023-11-03,2023-12-29,430.76,-585,515950,181777115,62642449,0.609573982951594,87.1159458108905,0.465631108616274
438.77,432,1412,1635,530912,1106895,2023-11-03,2023-12-01,430.76,223,575983,77639531,28317502,1.42568480997135,77.2558092861226,0.520359202995767
454.22,453,9095,8992,545700,1097024,2023-11-03,2023-12-15,430.76,-103,551324,878851435,217070587,0.124824737869376,97.5530712992464,0.502563298524007
437.5,425,775,866,632400,1082500,2023-11-03,2023-12-08,430.76,91,450100,83002856,24707321,1.30417199138304,86.4269646336025,0.415796766743649
454.75,453,6267,6165,551496,1078875,2023-11-03,2023-12-29,430.76,-102,527379,181777115,62642449,0.593515305818337,87.7094611167088,0.488823079596802
431.24,409,480,481,772800,1069744,2023-11-03,2023-11-24,430.76,1,296944,100730326,33682043,1.0619880253341,81.2008609998939,0.2775841696705
434.84,408,405,392,888975,1052128,2023-11-03,2023-12-29,430.76,-13,163153,181777115,62642449,0.578801132364764,88.2882622490735,0.155069535265671
431.41,360,145,145,820845,1035445,2023-11-03,2023-11-17,430.76,0,214600,672805518,235832752,0.153899599854352,97.4022690759204,0.207253886010363
439.33,433,1212,1611,407232,1019763,2023-11-03,2023-12-01,430.76,399,612531,77639531,28317502,1.31345847516776,78.5692677612903,0.600660153388582
455.09,454,9726,9331,505752,1017079,2023-11-03,2023-12-15,430.76,-395,511327,878851435,217070587,0.115728206098907,97.6687995053453,0.502740691726011
438.14,427,772,903,534996,1005942,2023-11-03,2023-12-08,430.76,131,470946,83002856,24707321,1.21193661095228,87.6389012445548,0.468164168510709
439.99,426,711,716,684693,1001684,2023-11-03,2023-12-29,430.76,5,316991,181777115,62642449,0.551050664435949,88.8393129135095,0.316458084585558
430.22,403,365,365,659920,993530,2023-11-03,2023-11-17,430.76,0,333610,672805518,235832752,0.147669716347362,97.5499387922678,0.335782512858192
438.05,433,1773,1966,434385,992830,2023-11-03,2023-11-24,430.76,193,558445,100730326,33682043,0.985631675608793,82.1864926755027,0.562477967023559
438.96,432.5,1390,1524,486500,984504,2023-11-03,2023-12-01,430.76,134,498004,77639531,28317502,1.26804475416009,79.8373125154504,0.505842535936878
437.54,432,1829,1771,492001,981134,2023-11-03,2023-11-24,430.76,-58,489133,100730326,33682043,0.974020475224115,83.1605131507268,0.498538425943857
436.01,428,1337,1215,577584,973215,2023-11-03,2023-11-24,430.76,-122,395631,100730326,33682043,0.966158890421937,84.1266720411488,0.406519628242475
429.15,402,358,358,833066,971970,2023-11-03,2023-11-24,430.76,0,138904,100730326,33682043,0.964922917056776,85.0915949582055,0.142909760589319
452.54,451,6292,6296,471900,969584,2023-11-03,2023-12-15,430.76,4,497684,878851435,217070587,0.110323993497263,97.7791234988426,0.5132964240334
423.65,407.5,595,595,960925,960925,2023-11-03,2023-12-08,430.76,0,0,83002856,24707321,1.15770112777806,88.7966023723328,0
436.92,422.5,670,666,635160,960372,2023-11-03,2023-12-08,430.76,-4,325212,83002856,24707321,1.15703488564297,89.9536372579758,0.338631280378853
465.31,465,30613,30839,489808,956009,2023-11-03,2023-12-15,430.76,226,466201,878851435,217070587,0.108779363829565,97.8879028626721,0.487653358911893
441.26,437,1372,2239,289492,953814,2023-11-03,2023-12-01,430.76,867,664322,77639531,28317502,1.22851592186975,81.0658284373202,0.696490091359531
420,383,257,257,950900,950900,2023-11-03,2023-12-15,430.76,0,0,878851435,217070587,0.108198036907114,97.9961008995792,0
427.79,320,88,88,839080,948552,2023-11-03,2023-11-17,430.76,0,109472,672805518,235832752,0.140984574980849,97.6909233672486,0.115409592726598
446.88,442,1920,1937,543360,945256,2023-11-03,2023-12-29,430.76,17,401896,181777115,62642449,0.520008252964076,89.3593211664736,0.42517159372699
419.41,384,266,266,941906,941906,2023-11-03,2023-12-15,430.76,0,0,878851435,217070587,0.107174655748272,98.1032755553275,0
431.41,408,402,400,651240,936400,2023-11-03,2023-11-10,430.76,-2,285160,127761173,59416338,0.732930027184394,93.6489632887137,0.304527979495942
434.54,401,260,277,567840,929058,2023-11-03,2023-12-15,430.76,17,361218,878851435,217070587,0.105712747684141,98.2089883030117,0.388800268659223
431.48,417.5,703,663,559588,926874,2023-11-03,2023-11-10,430.76,-40,367286,127761173,59416338,0.725473927826258,94.37443721654,0.396263138247486
442.21,437,1792,1768,507136,921128,2023-11-03,2023-12-08,430.76,-24,413992,83002856,24707321,1.10975458483019,91.063391842806,0.449440251517704
432.95,397,255,255,779025,916725,2023-11-03,2023-12-15,430.76,0,137700,878851435,217070587,0.104309438830239,98.3132977418419,0.150208623087622
436.95,423,657,654,604440,912330,2023-11-03,2023-12-08,430.76,-3,307890,83002856,24707321,1.09915494955981,92.1625467923658,0.337476570977607
432.33,395,271,244,733326,910852,2023-11-03,2023-11-24,430.76,-27,177526,100730326,33682043,0.904248041448809,85.9958429996543,0.194901037709749
453.95,452,4753,4667,470547,910065,2023-11-03,2023-12-29,430.76,-86,439518,181777115,62642449,0.500648830299678,89.8599699967732,0.482952316592771
437.4,417,462,446,713328,909840,2023-11-03,2023-12-29,430.76,-16,196512,181777115,62642449,0.50052505234226,90.3604950491155,0.215985228171986
444.11,437,1293,1277,566334,907947,2023-11-03,2023-12-29,430.76,-16,341613,181777115,62642449,0.499483667127185,90.8599787162427,0.376247732521832
441.61,437.5,2211,2206,426723,906666,2023-11-03,2023-12-01,430.76,-5,479943,77639531,28317502,1.16778912536192,82.2336175626821,0.52934928628624
417.38,235,49,49,893662,893662,2023-11-03,2023-12-15,430.76,0,0,878851435,217070587,0.101685218275828,98.4149829601177,0
470.19,470,46787,46555,514657,884545,2023-11-03,2023-12-15,430.76,-232,369888,878851435,217070587,0.100647841577456,98.5156308016952,0.418167532460191
451.6,449,3409,3394,487487,882440,2023-11-03,2023-12-29,430.76,-15,394953,181777115,62642449,0.485451647750048,91.3454303639928,0.447569239835003
436.34,429,884,1199,338572,880066,2023-11-03,2023-11-24,430.76,315,541494,100730326,33682043,0.873685249464992,86.8695282491193,0.615287944313267
437.78,432.5,1697,1658,453099,875424,2023-11-03,2023-11-24,430.76,-39,422325,100730326,33682043,0.869076905399869,87.7386051545192,0.482423374273495
430.01,385,197,194,657586,873194,2023-11-03,2023-11-17,430.76,-3,215608,672805518,235832752,0.129784012859419,97.820707380108,0.246918783225721
433.74,409,352,352,658944,870848,2023-11-03,2023-12-01,430.76,0,211904,77639531,28317502,1.12165541030896,83.3552729729911,0.243330638641876
434.45,398,237,237,591789,863865,2023-11-03,2023-12-15,430.76,0,272076,878851435,217070587,0.0982947703783405,98.6139255720735,0.314951989026063
442.08,440,5312,4123,435584,857584,2023-11-03,2023-11-24,430.76,-1189,422000,100730326,33682043,0.851366250914347,88.5899714054336,0.492080076120823
439.59,436,2424,2377,373296,853343,2023-11-03,2023-11-24,430.76,-47,480047,100730326,33682043,0.847155999475272,89.4371274049088,0.562548705502945
442.13,441,10995,7522,395820,849986,2023-11-03,2023-11-17,430.76,-3473,454166,672805518,235832752,0.12633457622742,97.9470419563354,0.534321741769864
429.82,300,67,65,789126,843830,2023-11-03,2023-11-17,430.76,-2,54703.9999999999,672805518,235832752,0.125419601567536,98.072461557903,0.0648282236943459
434.62,422.5,725,692,519825,838704,2023-11-03,2023-11-24,430.76,-33,318879,100730326,33682043,0.832623136750297,90.2697505416591,0.380204458307102
437.28,436,5888,6543,176640,837504,2023-11-03,2023-11-10,430.76,655,660864,127761173,59416338,0.655523098555146,95.0299603150951,0.789087574507107
417.68,377,203,203,825804,825804,2023-11-03,2023-12-15,430.76,0,0,878851435,217070587,0.0939640042802001,98.7078895763537,0
430.17,406,347,335,506273,809695,2023-11-03,2023-11-03,430.76,-12,303422,185125137,98861537,0.437377123993702,96.876610549112,0.374736166087231
435.74,427.5,849,981,401577,808344,2023-11-03,2023-11-24,430.76,132,406767,100730326,33682043,0.802483256134801,91.0722337977939,0.503210266916065
439.66,434,1264,1421,381728,804286,2023-11-03,2023-12-01,430.76,157,422558,77639531,28317502,1.03592331076807,84.3911962837591,0.525382761853371
449.55,446,2357,2250,447830,798750,2023-11-03,2023-12-29,430.76,-107,350920,181777115,62642449,0.43941174883318,91.7848421128259,0.439336463223787
444.65,438,1195,1199,485170,797335,2023-11-03,2023-12-29,430.76,4,312165,181777115,62642449,0.438633323012085,92.223475435838,0.391510469250691
422.62,348,106,106,790972,790972,2023-11-03,2023-12-29,430.76,0,0,181777115,62642449,0.43513288237631,92.6586083182143,0
436.09,424,723,650,555264,785850,2023-11-03,2023-12-01,430.76,-73,230586,77639531,28317502,1.01217767531337,85.4033739590725,0.293422408856652
436.34,411,321,310,641679,785540,2023-11-03,2023-12-29,430.76,-11,143861,181777115,62642449,0.432144607422117,93.0907529256364,0.183136441174224
441.71,436,778,1346,251294,768566,2023-11-03,2023-12-08,430.76,568,517272,83002856,24707321,0.925951270881571,93.0884980632474,0.67303523705186
453.13,451,3599,3598,406687,766374,2023-11-03,2023-12-29,430.76,-1,359687,181777115,62642449,0.421600925947141,93.5123538515836,0.469336120484255
429.93,404,295,295,550175,764935,2023-11-03,2023-11-17,430.76,0,214760,672805518,235832752,0.113693330321349,98.1861548882243,0.280755881218666
434.33,434,6235,22860,12470,754380,2023-11-03,2023-11-03,430.76,16625,741910,185125137,98861537,0.407497335167401,97.2841078842794,0.983469869296641
421.5,362,126,126,749700,749700,2023-11-03,2023-12-15,430.76,0,0,878851435,217070587,0.0853045202116556,98.7931940965654,0
446.6,445,4519,4672,307292,747520,2023-11-03,2023-12-01,430.76,153,440228,77639531,28317502,0.962808495069348,86.3661824541418,0.588918022260274
432.18,408,301,300,620361,725400,2023-11-03,2023-12-08,430.76,-1,105039,83002856,24707321,0.873945831454282,93.9624438947017,0.144801488833747
456.89,456,8078,8091,347354,720099,2023-11-03,2023-12-15,430.76,13,372745,878851435,217070587,0.0819363741495171,98.8751304707149,0.517630214734363
425.61,390,201,201,715761,715761,2023-11-03,2023-12-29,430.76,0,0,181777115,62642449,0.393757487019199,93.9061113386028,0
419.41,379,176,176,711216,711216,2023-11-03,2023-12-29,430.76,0,0,181777115,62642449,0.39125717227936,94.2973685108821,0
435.69,422,705,515,627450,705035,2023-11-03,2023-12-01,430.76,-190,77585,77639531,28317502,0.908087659622776,87.2742701137646,0.11004418220372
416.24,376,174,174,700176,700176,2023-11-03,2023-12-15,430.76,0,0,878851435,217070587,0.079669438100195,98.9547999088151,0
450.18,450,39877,38815,279139,698670,2023-11-03,2023-11-17,430.76,-1062,419531,672805518,235832752,0.103844273167807,98.2899991613921,0.60047089469993
430.37,408,311,312,515949,697944,2023-11-03,2023-11-24,430.76,1,181995,100730326,33682043,0.69288369026027,91.7651174880542,0.260758742821774
462.43,462,15072,16089,331584,691827,2023-11-03,2023-12-15,430.76,1017,360243,878851435,217070587,0.0787194481852328,99.0335193570003,0.520712548079216
429.27,406,299,297,500227,691119,2023-11-03,2023-11-10,430.76,-2,190892,127761173,59416338,0.540946035302916,95.570906350398,0.276207136542332
465.47,465,14560,14390,378560,676330,2023-11-03,2023-12-29,430.76,-170,297770,181777115,62642449,0.372065537512794,94.6694340483949,0.44027323939497
431.21,300,51,51,592620,669171,2023-11-03,2023-12-01,430.76,0,76551,77639531,28317502,0.861894696401502,88.1361648101661,0.114396768538983
443.76,443,6549,8749,157176,664924,2023-11-03,2023-11-17,430.76,2200,507748,672805518,235832752,0.0988285592509067,98.388827720643,0.763618097707407
423.85,250,38,38,660630,660630,2023-11-03,2023-11-17,430.76,0,0,672805518,235832752,0.0981903361856791,98.4870180568287,0
442.82,441,3599,3615,244732,657930,2023-11-03,2023-11-24,430.76,16,413198,100730326,33682043,0.653159804128898,92.4182772921831,0.628027297736841
419.42,300,55,55,656810,656810,2023-11-03,2023-11-10,430.76,0,0,127761173,59416338,0.514092023873325,96.0849983742713,0
431.31,365,96,98,521472,649838,2023-11-03,2023-11-17,430.76,2,128366,672805518,235832752,0.0965863065350186,98.5836043633638,0.197535385742293
423.22,394,220,220,642840,642840,2023-11-03,2023-11-17,430.76,0,0,672805518,235832752,0.0955461842689584,98.6791505476327,0
437.18,424,486,487,416016,641866,2023-11-03,2023-12-08,430.76,1,225850,83002856,24707321,0.77330592094325,94.7357498156449,0.351864719427419
445.2,439,1068,1034,393024,641080,2023-11-03,2023-12-29,430.76,-34,248056,181777115,62642449,0.352673657517339,95.0221077059123,0.386934547950334
444.63,444,11893,10069,237860,634347,2023-11-03,2023-11-17,430.76,-1824,396487,672805518,235832752,0.0942838581178224,98.7734344057505,0.625031725538231
430.07,407,277,274,452895,632118,2023-11-03,2023-11-03,430.76,-3,179223,185125137,98861537,0.341454440085033,97.6255623243644,0.283527759057644
442.76,438,1277,1327,325635,631652,2023-11-03,2023-12-08,430.76,50,306017,83002856,24707321,0.761000320278136,95.496750135923,0.484470879534934
440.12,437,2216,2008,296944,626496,2023-11-03,2023-11-24,430.76,-208,329552,100730326,33682043,0.621953710345383,93.0402310025285,0.526024108693432
415.47,398,355,355,620185,620185,2023-11-03,2023-11-17,430.76,0,0,672805518,235832752,0.0921789407797336,98.8656133465303,0
440.75,438,2332,2205,277508,606375,2023-11-03,2023-11-24,430.76,-127,328867,100730326,33682043,0.601978593814935,93.6422095963434,0.542349206349206
459.59,459,9753,10162,292590,599558,2023-11-03,2023-12-15,430.76,409,306968,878851435,217070587,0.0682206316247296,99.101739988625,0.511990499668089
432.8,385,127,125,538226,597500,2023-11-03,2023-12-29,430.76,-2,59274,181777115,62642449,0.32869924247615,95.3508069483884,0.0992033472803347
445.16,443,3112,2758,298752,595728,2023-11-03,2023-12-01,430.76,-354,296976,77639531,28317502,0.767299843684012,88.9034646538501,0.49850938683426
433.85,411,262,260,394310,594100,2023-11-03,2023-12-01,430.76,-2,199790,77639531,28317502,0.765202973727392,89.6686676275775,0.336290186837233
445.97,445,6033,6086,211155,590342,2023-11-03,2023-11-24,430.76,53,379187,100730326,33682043,0.586061838020856,94.2282714343643,0.642317504090849
420.99,392,200,200,579800,579800,2023-11-03,2023-11-17,430.76,0,0,672805518,235832752,0.0861764632554634,98.9517898097857,0
435.4,433,3198,2370,214266,568800,2023-11-03,2023-11-10,430.76,-828,354534,127761173,59416338,0.445205680758739,96.5302040550301,0.623301687763713
424.12,375,115,115,564880,564880,2023-11-03,2023-11-17,430.76,0,0,672805518,235832752,0.0839588833455435,99.0357486931313,0
470.28,470,20154,20126,322464,563528,2023-11-03,2023-12-29,430.76,-28,241064,181777115,62642449,0.310010421278828,95.6608173696672,0.427776437018214
446.41,446,12950,13688,181300,561208,2023-11-03,2023-11-17,430.76,738,379908,672805518,235832752,0.0834131089870164,99.1191618021183,0.676946871748086
427.5,342,64,64,547200,547200,2023-11-03,2023-12-29,430.76,0,0,181777115,62642449,0.301027992440083,95.9618453621073,0
430.79,405,211,210,404276,541590,2023-11-03,2023-12-01,430.76,-1,137314,77639531,28317502,0.697569901600771,90.3662375291783,0.253538654701896
433.6,409,208,218,346528,536280,2023-11-03,2023-12-08,430.76,10,189752,83002856,24707321,0.646098249920461,96.1428483858435,0.353830088759603
427.26,375,100,100,522600,522600,2023-11-03,2023-12-29,430.76,0,0,181777115,62642449,0.287494935762403,96.2493402978697,0
428.21,404,215,215,365285,520515,2023-11-03,2023-11-10,430.76,0,155230,127761173,59416338,0.407412508650026,96.9376165636801,0.298223874432053
427.43,325,120,50,1086840,512150,2023-11-03,2023-11-03,430.76,-70,-574690,185125137,98861537,0.276650706813522,97.9022130311779,-1.12211266230597
441.8,438,2007,1343,373302,510340,2023-11-03,2023-12-01,430.76,-664,137038,77639531,28317502,0.657319787261466,91.0235573164397,0.268522945487322
429.63,325,49,48,0,502224,2023-11-03,2023-12-29,430.76,-1,502224,181777115,62642449,0.276285603938648,96.5256259018084,1
416.69,340,65,65,498485,498485,2023-11-03,2023-11-17,430.76,0,0,672805518,235832752,0.0740905041150391,99.1932523062333,0
435.13,432.5,1972,1895,157760,498385,2023-11-03,2023-11-10,430.76,-77,340625,127761173,59416338,0.390091127294205,97.3277076909743,0.683457567944461
438,419,265,262,375505,497800,2023-11-03,2023-12-29,430.76,-3,122295,181777115,62642449,0.273851854233686,96.7994777560421,0.245670952189634
458.69,458,7181,7192,244154,496248,2023-11-03,2023-12-15,430.76,11,252094,878851435,217070587,0.056465516267832,99.1582055048929,0.508000032241943
433.54,433,5379,9177,16137,495558,2023-11-03,2023-11-03,430.76,3798,479421,185125137,98861537,0.267688120603525,98.1699011517815,0.967436707711307
430.66,385,109,108,384661,493128,2023-11-03,2023-11-24,430.76,-1,108467,100730326,33682043,0.489552669570433,94.7178241039347,0.219957090248374
443.62,442,3529,3043,222327,492966,2023-11-03,2023-11-24,430.76,-486,270639,100730326,33682043,0.489391844120509,95.2072159480552,0.549001351005952
440.66,436,1061,1034,249335,481844,2023-11-03,2023-12-01,430.76,-27,232509,77639531,28317502,0.620616834998656,91.6441741514384,0.482539992196645
426.71,394,147,147,480837,480837,2023-11-03,2023-12-29,430.76,0,0,181777115,62642449,0.264520096492895,97.063997852535,0
471.18,471,26670,26665,293370,479970,2023-11-03,2023-12-15,430.76,-5,186600,878851435,217070587,0.0546133260850851,99.212818830978,0.38877429839365
461.49,461,9769,9753,244225,477897,2023-11-03,2023-12-15,430.76,-16,233672,878851435,217070587,0.0543774500408024,99.2671962810188,0.488958917925829
442.42,439,1127,1394,176939,476748,2023-11-03,2023-12-01,430.76,267,299809,77639531,28317502,0.614053168353116,92.2582273197915,0.628862627635564
433.18,432.5,4447,6999,22235,475932,2023-11-03,2023-11-03,430.76,2552,453697,185125137,98861537,0.257086642966266,98.4269877947477,0.953281141003337
438.02,437,4433,4622,101959,471444,2023-11-03,2023-11-10,430.76,189,369485,127761173,59416338,0.369004126159675,97.696711817134,0.783730411247147
445.2,444,3900,3920,159900,470400,2023-11-03,2023-11-24,430.76,20,310500,100730326,33682043,0.466989454595829,95.674205402651,0.660076530612245
445.84,444,1988,2517,157052,463128,2023-11-03,2023-12-01,430.76,529,306076,77639531,28317502,0.596510558519474,92.854737878311,0.660888566443834
440.78,434,708,679,275412,460362,2023-11-03,2023-12-08,430.76,-29,184950,83002856,24707321,0.554633927295225,96.6974823131387,0.401749058349733
440.45,440,10466,10062,104660,452790,2023-11-03,2023-11-10,430.76,-404,348130,127761173,59416338,0.354403446186268,98.0511152633203,0.768855319242916
480.08,480,56340,56318,281700,450544,2023-11-03,2023-12-15,430.76,-22,168844,878851435,217070587,0.0512650923759372,99.3184613733947,0.374755850704926
419.39,368,87,87,447093,447093,2023-11-03,2023-12-15,430.76,0,0,878851435,217070587,0.050872420774963,99.3693337941697,0
430.76,402,155,155,244125,445780,2023-11-03,2023-11-10,430.76,0,201655,127761173,59416338,0.348916646217705,98.400031909538,0.452364394993046
423.01,401,202,202,444602,444602,2023-11-03,2023-11-17,430.76,0,0,672805518,235832752,0.0660818004765532,99.2593341067099,0
444.76,442.5,2071,1943,205029,439118,2023-11-03,2023-12-01,430.76,-128,234089,77639531,28317502,0.565585590670299,93.4203234689813,0.533089055789105
434.18,396,115,115,311765,439070,2023-11-03,2023-12-15,430.76,0,127305,878851435,217070587,0.0499595247290004,99.4192933188987,0.289942378208486
450.42,450,11132,10347,166980,434574,2023-11-03,2023-11-24,430.76,-785,267594,100730326,33682043,0.431423204169914,96.1056286068209,0.615761642436041
448.28,448,15420,15331,154200,429268,2023-11-03,2023-11-17,430.76,-89,275068,672805518,235832752,0.0638026871830739,99.323136793893,0.640783845988986
422.18,335,49,49,427182,427182,2023-11-03,2023-12-29,430.76,0,0,181777115,62642449,0.235003179580664,97.2990010321156,0
431.53,349,51,51,393873,420903,2023-11-03,2023-12-29,430.76,0,27030,181777115,62642449,0.231548949382325,97.530549981498,0.0642190718526596
441.54,439,1697,1651,169700,419354,2023-11-03,2023-11-24,430.76,-46,249654,100730326,33682043,0.41631355387453,96.5219421606955,0.595329959890689
431.61,355,54,54,0,413694,2023-11-03,2023-12-29,430.76,0,413694,181777115,62642449,0.227583103626658,97.7581330851246,1
439.05,425,0,294,0,413070,2023-11-03,2023-12-22,430.76,294,413070,2338637,2338637,17.6628523366388,17.6628523366388,1
440.58,430,0,387,0,409446,2023-11-03,2023-12-22,430.76,387,409446,2338637,2338637,17.50789027968,35.1707426163188,1
431.21,380,79,79,300990,404559,2023-11-03,2023-11-24,430.76,0,103569,100730326,33682043,0.401625822197776,96.9235679828933,0.256004686584651
455.08,455,50832,50484,152496,403872,2023-11-03,2023-11-17,430.76,-348,251376,672805518,235832752,0.0600280451326501,99.3831648390256,0.622415022581412
435.2,435,13340,20124,26680,402480,2023-11-03,2023-11-03,430.76,6784,375800,185125137,98861537,0.217409697311932,98.6443974920597,0.933710991850527
444.41,442,1354,1664,147586,401024,2023-11-03,2023-12-01,430.76,310,253438,77639531,28317502,0.516520379289772,93.9368438482711,0.631977138525375
432.71,348,47,46,374731,389666,2023-11-03,2023-12-15,430.76,-1,14934.9999999999,878851435,217070587,0.0443380968024476,99.4636314157011,0.0383276960268536
421.73,390,122,122,387106,387106,2023-11-03,2023-11-24,430.76,0,0,100730326,33682043,0.384299361842629,97.3078673447359,0
427.5,280,26,26,372970,383500,2023-11-03,2023-11-17,430.76,0,10530,672805518,235832752,0.0570001270411697,99.4401649660668,0.0274576271186441
419,220,19,19,378100,378100,2023-11-03,2023-12-15,430.76,0,0,878851435,217070587,0.0430220609470815,99.5066534766482,0
431.45,406,147,148,264306,376660,2023-11-03,2023-11-24,430.76,1,112354,100730326,33682043,0.373929098571566,97.6817964433075,0.298290235225402
440.35,433,499,511,212075,375585,2023-11-03,2023-12-08,430.76,12,163510,83002856,24707321,0.452496477952518,97.1499787910913,0.435347524528402
435.79,422.5,277,280,236835,372120,2023-11-03,2023-12-01,430.76,3,135285,77639531,28317502,0.479291921534147,94.4161357698052,0.363552079974202
443.73,441,1290,1357,157380,370461,2023-11-03,2023-12-01,430.76,67,213081,77639531,28317502,0.477155123464102,94.8932908932693,0.575177953954667
432.81,380,83,70,336731,369670,2023-11-03,2023-12-01,430.76,-13,32939,77639531,28317502,0.476136312569946,95.3694272058392,0.0891037952768686
419.78,391,128,128,368384,368384,2023-11-03,2023-11-17,430.76,0,0,672805518,235832752,0.054753415384444,99.4949183814512,0
447.3,445,472,1553,51920,357190,2023-11-03,2023-12-08,430.76,1081,305270,83002856,24707321,0.430334589932664,97.5803133810239,0.854643187099303
426.6,404,155,155,350300,350300,2023-11-03,2023-12-29,430.76,0,0,181777115,62642449,0.19270852659313,97.9508416117177,0
426.5,408,184,184,340400,340400,2023-11-03,2023-12-01,430.76,0,0,77639531,28317502,0.438436445475179,95.8078636513144,0
455.58,454,2488,2147,196552,339226,2023-11-03,2023-12-29,430.76,-341,142674,181777115,62642449,0.186616450591154,98.1374580623089,0.420586865393572
424,403,160,160,336000,336000,2023-11-03,2023-11-24,430.76,0,0,100730326,33682043,0.333563896139877,98.0153603394473,0
417.49,365,64,64,335936,335936,2023-11-03,2023-11-24,430.76,0,0,100730326,33682043,0.33350036015966,98.348860699607,0
450.77,450,4216,4358,134912,335566,2023-11-03,2023-12-01,430.76,142,200654,77639531,28317502,0.432210235788261,96.2400738871027,0.597956884785705
438.79,438,2792,4129,47464,326191,2023-11-03,2023-11-10,430.76,1337,278727,127761173,59416338,0.255313091090671,98.6553450006286,0.854490160672735
424.86,407,179,179,319694,319694,2023-11-03,2023-12-01,430.76,0,0,77639531,28317502,0.411767041714871,96.6518409288176,0
439.82,428,0,264,0,312048,2023-11-03,2023-12-22,430.76,264,312048,2338637,2338637,13.3431567190633,48.5138993353821,1
445.18,440,0,597,0,309246,2023-11-03,2023-12-22,430.76,597,309246,2338637,2338637,13.2233433405868,61.737242675969,1
464.35,464,8731,8720,157158,305200,2023-11-03,2023-12-15,430.76,-11,148042,878851435,217070587,0.0347271436155759,99.5413806202638,0.485065530799476
432.68,365,70,44,0,297792,2023-11-03,2023-12-29,430.76,-26,297792,181777115,62642449,0.163822602201603,98.3012806645105,1
420.11,340,37,37,296407,296407,2023-11-03,2023-11-03,430.76,0,0,185125137,98861537,0.160111697851168,98.8045091899108,0
447.34,447,9225,8436,101475,286824,2023-11-03,2023-11-17,430.76,-789,185349,672805518,235832752,0.0426310415605123,99.5375494230117,0.646211614090871
466.27,466,10597,10599,169552,286173,2023-11-03,2023-12-15,430.76,2,116621,878851435,217070587,0.0325621588135656,99.5739427790773,0.407519227879639
439.59,439,4563,4802,59319,283318,2023-11-03,2023-11-10,430.76,239,223999,127761173,59416338,0.221755947716604,98.8771009483452,0.790627492781962
458.15,457,2707,2425,162420,278875,2023-11-03,2023-12-29,430.76,-282,116455,181777115,62642449,0.15341590166617,98.4546965661767,0.417588525324966
475.11,475,25100,25085,175700,275935,2023-11-03,2023-12-15,430.76,-15,100235,878851435,217070587,0.0313972292711794,99.6053400083485,0.363255839237501
434.65,405,88,89,175384,263885,2023-11-03,2023-12-08,430.76,1,88501,83002856,24707321,0.317922795331284,97.8982361763552,0.335377152926464
446.82,446,3242,3179,100502,260678,2023-11-03,2023-11-24,430.76,-63,160176,100730326,33682043,0.258788003922473,98.6076487035295,0.614459217885667
439.91,432,332,322,154380,254702,2023-11-03,2023-12-08,430.76,-10,100322,83002856,24707321,0.306859320599763,98.205095496955,0.393879906714513
448.65,447.5,1803,2184,86544,251160,2023-11-03,2023-12-01,430.76,381,164616,77639531,28317502,0.323494998958713,96.9753359277763,0.655422838031534
475.2,475,11619,12018,127809,240360,2023-11-03,2023-12-29,430.76,399,112551,181777115,62642449,0.132227865977519,98.5869244321542,0.468260109835247
433.79,412,109,109,205465,237511,2023-11-03,2023-12-29,430.76,0,32046,181777115,62642449,0.130660561974482,98.7175849941287,0.134924277191372
430.06,404,93,90,144708,234540,2023-11-03,2023-11-03,430.76,-3,89832,185125137,98861537,0.126692681394207,98.931201871305,0.383013558454848
430.33,402,79,79,125294,223807,2023-11-03,2023-11-03,430.76,0,98513,185125137,98861537,0.120894981430858,99.0520968527359,0.440169431697847
429.01,403,90,86,178290,223686,2023-11-03,2023-11-03,430.76,-4,45396,185125137,98861537,0.120829620236824,99.1729264729727,0.202945199967812
414.75,355,37,37,221075,221075,2023-11-03,2023-11-17,430.76,0,0,672805518,235832752,0.0328586781893784,99.5704081012011,0
447.41,446,1542,1559,90978,219819,2023-11-03,2023-12-01,430.76,17,128841,77639531,28317502,0.283127676286453,97.2584636040627,0.586123128573963
463.4,463,5384,5385,107680,215400,2023-11-03,2023-12-15,430.76,1,107720,878851435,217070587,0.0245092619095513,99.6298492702581,0.500092850510678
452.13,452,16784,16298,83920,211874,2023-11-03,2023-11-17,430.76,-486,127954,672805518,235832752,0.031491121034474,99.6018992222356,0.603915534704589
416.5,386,69,69,210450,210450,2023-11-03,2023-12-15,430.76,0,0,878851435,217070587,0.0239460267821034,99.6537952970402,0
439.18,426,0,158,0,208244,2023-11-03,2023-12-22,430.76,158,208244,2338637,2338637,8.90450292200115,70.6417455979701,1
430.1,396,62,61,118172,208010,2023-11-03,2023-11-17,430.76,-1,89838,672805518,235832752,0.030916809454586,99.6328160316902,0.431892697466468
444.4,443,1751,1442,91052,201880,2023-11-03,2023-11-24,430.76,-309,110828,100730326,33682043,0.200416307597376,98.8080650111269,0.548979591836735
428.76,355,27,27,158733,199152,2023-11-03,2023-11-03,430.76,0,40419,185125137,98861537,0.107576962927514,99.2805034359002,0.202955531453362
469.22,469,9060,9040,117780,198880,2023-11-03,2023-12-15,430.76,-20,81100,878851435,217070587,0.0226295357872403,99.6764248328274,0.407783588093323
421.04,403,106,106,191224,191224,2023-11-03,2023-11-10,430.76,0,0,127761173,59416338,0.149673015290804,99.0267739636361,0
415.67,393,84,84,190428,190428,2023-11-03,2023-11-17,430.76,0,0,672805518,235832752,0.0283035728610062,99.6611196045512,0
431.92,400,58,59,150974,188328,2023-11-03,2023-12-01,430.76,1,37354,77639531,28317502,0.242567153065363,97.5010307571281,0.198345439870864
432.24,340,20,20,146640,184480,2023-11-03,2023-12-08,430.76,0,37840,83002856,24707321,0.222257412443736,98.4273529093987,0.205117085862966
442.8,435,0,231,0,180180,2023-11-03,2023-12-22,430.76,231,180180,2338637,2338637,7.70448769945913,78.3462332974292,1
426.76,406,86,86,178536,178536,2023-11-03,2023-12-01,430.76,0,0,77639531,28317502,0.229955021237828,97.7309857783659,0
413.04,325,20,20,176080,176080,2023-11-03,2023-12-08,430.76,0,0,83002856,24707321,0.212137278746168,98.6394901881449,0
472.15,472,11541,11716,103869,175740,2023-11-03,2023-12-15,430.76,175,71871,878851435,217070587,0.0199965537975141,99.6964213866249,0.408962103106862
467.24,467,7248,7208,101472,172992,2023-11-03,2023-12-15,430.76,-40,71520,878851435,217070587,0.0196838729631249,99.7161052595881,0.413429522752497
437.34,418,101,87,147763,168258,2023-11-03,2023-12-29,430.76,-14,20495,181777115,62642449,0.0925628069297942,98.8101478010585,0.121806986889182
414.37,397,94,94,163278,163278,2023-11-03,2023-11-17,430.76,0,0,672805518,235832752,0.0242682314029416,99.6853878359541,0
430.63,360,30,23,190020,162449,2023-11-03,2023-12-29,430.76,-7,-27571,181777115,62642449,0.0893671351313943,98.8995149361899,-0.169720958577769
449.23,449,7002,7001,63018,161023,2023-11-03,2023-11-17,430.76,-1,98005,672805518,235832752,0.0239330676833123,99.7093209036374,0.608639759537457
423.06,375,33,33,158598,158598,2023-11-03,2023-11-24,430.76,0,0,100730326,33682043,0.157448115476168,98.965513126603,0
432.52,390,32,37,114400,157324,2023-11-03,2023-12-01,430.76,5,42924,77639531,28317502,0.202633887626137,97.9336196659921,0.272838219216394
419.59,389,51,51,156009,156009,2023-11-03,2023-12-15,430.76,0,0,878851435,217070587,0.0177514644440445,99.7338567240321,0
436.11,436,5621,13971,11242,153681,2023-11-03,2023-11-03,430.76,8350,142439,185125137,98861537,0.0830146583497194,99.3635180942499,0.926848471834514
430.89,401,50,51,72700,152439,2023-11-03,2023-11-10,430.76,1,79739,127761173,59416338,0.119315592069588,99.1460895557056,0.523087923694068
426.8,356,21,21,148680,148680,2023-11-03,2023-12-29,430.76,0,0,181777115,62642449,0.0817924742616803,98.9813074104515,0
442.14,434,0,182,0,148148,2023-11-03,2023-12-22,430.76,182,148148,2338637,2338637,6.33480099733306,84.6810342947623,1
480.13,480,11283,11393,90264,148109,2023-11-03,2023-12-29,430.76,110,57845,181777115,62642449,0.0814783533119667,99.0627857637635,0.390556954675273
411.41,330,18,18,146538,146538,2023-11-03,2023-11-17,430.76,0,0,672805518,235832752,0.0217801424155383,99.731101046053,0
422.62,388,42,42,145404,145404,2023-11-03,2023-12-15,430.76,0,0,878851435,217070587,0.0165447758528152,99.7504014998849,0
430.72,300,1,11,11519,143792,2023-11-03,2023-11-03,430.76,10,132273,185125137,98861537,0.0776728662191348,99.4411909604691,0.919891231779237
454.1,454,13958,14307,69790,143070,2023-11-03,2023-11-17,430.76,349,73280,672805518,235832752,0.021264688854707,99.7523657349077,0.512196826728175
473.16,473,8605,8605,68840,137680,2023-11-03,2023-12-15,430.76,0,68840,878851435,217070587,0.015665901484248,99.7660674013692,0.5
419.3,387,42,42,135660,135660,2023-11-03,2023-12-15,430.76,0,0,878851435,217070587,0.0154360560382996,99.7815034574075,0
459.04,458,1463,1302,73150,135408,2023-11-03,2023-12-29,430.76,-161,62258,181777115,62642449,0.0744912251467959,99.1372769889103,0.459780810587262
429.43,398,43,43,135149,135149,2023-11-03,2023-12-29,430.76,0,0,181777115,62642449,0.0743487429647016,99.211625731875,0
431.95,371,22,22,101200,134090,2023-11-03,2023-12-15,430.76,0,32890,878851435,217070587,0.0152574137857555,99.7967608711932,0.245283018867925
448.21,447,1029,1095,50421,132495,2023-11-03,2023-12-01,430.76,66,82074,77639531,28317502,0.170654044780358,98.1042737107724,0.619449790558134
428.49,310,11,11,117227,130339,2023-11-03,2023-11-17,430.76,0,13112,672805518,235832752,0.0193724629945737,99.7717381979022,0.100599206684108
415.2,285,10,10,130200,130200,2023-11-03,2023-11-17,430.76,0,0,672805518,235832752,0.0193518032353593,99.7910900011376,0
434.65,399,37,35,88578,124775,2023-11-03,2023-12-15,430.76,-2,36197,878851435,217070587,0.0141975076822853,99.8109583788755,0.290098176718093
459.96,459,1613,1299,74198,124704,2023-11-03,2023-12-29,430.76,-314,50506,181777115,62642449,0.0686026951192399,99.2802284269943,0.40500705671029
423.53,406,71,71,124463,124463,2023-11-03,2023-12-08,430.76,0,0,83002856,24707321,0.149950261952432,98.7894404500973,0
428.51,406,55,55,123805,123805,2023-11-03,2023-12-29,430.76,0,0,181777115,62642449,0.0681081334138239,99.3483365604081,0
418.21,350,18,18,122778,122778,2023-11-03,2023-11-03,430.76,0,0,185125137,98861537,0.0663216254635371,99.5075125859326,0
428.44,335,14,13,112910,121472,2023-11-03,2023-11-17,430.76,-1,8561.99999999999,672805518,235832752,0.0180545487143285,99.8091445498519,0.0704853793466806
432.19,382,25,24,0,120456,2023-11-03,2023-12-15,430.76,-1,120456,878851435,217070587,0.0137060708104778,99.824664449686,1
426.4,407.5,63,63,119070,119070,2023-11-03,2023-12-01,430.76,0,0,77639531,28317502,0.153362595660193,98.2576363064326,0
430.61,390,30,29,95400,117769,2023-11-03,2023-11-03,430.76,-1,22369,185125137,98861537,0.0636158881005987,99.5711284740332,0.189939627576017
460.03,460,39125,38833,78250,116499,2023-11-03,2023-11-17,430.76,-292,38249,672805518,235832752,0.0173154049548089,99.8264599548067,0.328320414767509
422.9,340,14,14,116060,116060,2023-11-03,2023-12-29,430.76,0,0,181777115,62642449,0.0638474210573757,99.4121839814654,0
424.63,400,47,47,115761,115761,2023-11-03,2023-12-08,430.76,0,0,83002856,24707321,0.13946628535288,98.9289067354502,0
448.14,447.5,1801,1803,39622,115392,2023-11-03,2023-11-24,430.76,2,75770,100730326,33682043,0.114555372331467,99.0800684989345,0.656631308929562
455.18,455,6317,6298,50536,113364,2023-11-03,2023-11-24,430.76,-19,62828,100730326,33682043,0.112542075958337,99.1926105748928,0.55421474189337
415.34,375,27,27,108918,108918,2023-11-03,2023-11-03,430.76,0,0,185125137,98861537,0.0588347977832962,99.6299632718165,0
426.91,404,47,47,107677,107677,2023-11-03,2023-12-01,430.76,0,0,77639531,28317502,0.138688369974826,98.3963246764074,0
430.62,395,20,30,48400,106860,2023-11-03,2023-12-08,430.76,10,58460,83002856,24707321,0.128742557966921,99.0576492934171,0.547070933932248
431,390,25,26,76325,106600,2023-11-03,2023-11-10,430.76,1,30275,127761173,59416338,0.083436929621803,99.2295264853274,0.284005628517824
415.23,345,15,15,105345,105345,2023-11-03,2023-11-17,430.76,0,0,672805518,235832752,0.0156575707513742,99.8421175255581,0
432.37,407,42,41,79254,104017,2023-11-03,2023-11-24,430.76,-1,24763,100730326,33682043,0.103262844597564,99.2958734194904,0.238066854456483
429.95,385,32,23,118400,103385,2023-11-03,2023-12-01,430.76,-9,-15015,77639531,28317502,0.133160258271009,98.5294849346784,-0.145233834695555
417.17,386,33,33,102861,102861,2023-11-03,2023-11-17,430.76,0,0,672805518,235832752,0.0152883704500176,99.8574058960081,0
449.08,448,901,948,40545,102384,2023-11-03,2023-12-01,430.76,47,61839,77639531,28317502,0.131870966608492,98.6613559012869,0.603990857946554
441.34,441,2882,3010,20174,102340,2023-11-03,2023-11-10,430.76,128,82166,127761173,59416338,0.0801025832785678,99.309629068606,0.802872777017784
447.71,447,1548,1438,38700,102098,2023-11-03,2023-11-24,430.76,-110,63398,100730326,33682043,0.101357757940742,99.3972311774311,0.620952418264804
423.6,220,5,5,101800,101800,2023-11-03,2023-11-17,430.76,0,0,672805518,235832752,0.0151306725757264,99.8725365685839,0
476.11,476,9245,9245,64715,101695,2023-11-03,2023-12-15,430.76,0,36980,878851435,217070587,0.0115713527850131,99.836235802471,0.363636363636364
457.25,456,1291,813,83915,101625,2023-11-03,2023-12-29,430.76,-478,17710,181777115,62642449,0.055906377433705,99.4680903588992,0.174268142681427
482.07,482,13653,13653,68265,95571,2023-11-03,2023-12-15,430.76,0,27306,878851435,217070587,0.0108745342152169,99.8471103366862,0.285714285714286
455.38,455,2521,2396,42857,91048,2023-11-03,2023-12-01,430.76,-125,48191,77639531,28317502,0.117270157131681,98.7786260584186,0.529292241455057
418.12,403,60,60,90720,90720,2023-11-03,2023-12-01,430.76,0,0,77639531,28317502,0.116847691931575,98.8954737503502,0
437.07,437,4823,12706,9646,88942,2023-11-03,2023-11-03,430.76,7883,79296,185125137,98861537,0.0480442588409806,99.6780075306575,0.891547300487959
452.59,452,1326,1505,31824,88795,2023-11-03,2023-12-01,430.76,179,56971,77639531,28317502,0.114368284888274,99.0098420352385,0.641601441522608
451.16,451,5280,5413,26400,86608,2023-11-03,2023-11-17,430.76,133,60208,672805518,235832752,0.0128726649355453,99.8854092335194,0.695178274524293
425.48,340,10,10,85480,85480,2023-11-03,2023-12-01,430.76,0,0,77639531,28317502,0.110098552759161,99.1199405879976,0
431.88,310,0,7,0,85316,2023-11-03,2023-12-08,430.76,7,85316,83002856,24707321,0.102786824588301,99.1604361180054,1
419.43,381,22,22,84546,84546,2023-11-03,2023-12-15,430.76,0,0,878851435,217070587,0.00962005597681023,99.856730392663,0
445.26,442,154,259,24640,84434,2023-11-03,2023-12-08,430.76,105,59794,83002856,24707321,0.101724210550056,99.2621603285554,0.708174432100813
424.34,350,11,11,81774,81774,2023-11-03,2023-11-24,430.76,0,0,100730326,33682043,0.0811811132230427,99.4784122906542,0
451.26,450,412,641,23484,80766,2023-11-03,2023-12-08,430.76,229,57282,83002856,24707321,0.0973050855021181,99.3594654140576,0.70923408364906
425.6,345,10,10,80600,80600,2023-11-03,2023-12-01,430.76,0,0,77639531,28317502,0.103813094903935,99.2237536829016,0
431.83,402,27,27,54432,80541,2023-11-03,2023-12-01,430.76,0,26109,77639531,28317502,0.103737102688062,99.3274907855896,0.324170298357358
477.11,477,7049,7244,42294,79684,2023-11-03,2023-12-15,430.76,195,37390,878851435,217070587,0.00906683391829474,99.8657972265813,0.469228452386928
423.65,225,4,4,79460,79460,2023-11-03,2023-11-17,430.76,0,0,672805518,235832752,0.0118102479652969,99.8972194814847,0
474.13,474,5826,6043,46608,78559,2023-11-03,2023-12-15,430.76,217,31951,878851435,217070587,0.00893882593478385,99.8747360525161,0.406713425578228
424.39,175,3,3,74817,74817,2023-11-03,2023-12-15,430.76,0,0,878851435,217070587,0.00851304293540808,99.8832490954515,0
424.42,392,23,23,74566,74566,2023-11-03,2023-12-29,430.76,0,0,181777115,62642449,0.0410205652125132,99.5091109241117,0
453.11,453,6299,6710,31495,73810,2023-11-03,2023-11-17,430.76,411,42315,672805518,235832752,0.0109704807742079,99.9081899622589,0.573296301314185
429.21,398,21,23,33537,71783,2023-11-03,2023-11-03,430.76,2,38246,185125137,98861537,0.038775393316792,99.7167829239743,0.5328002451834
418.34,404,49,49,70266,70266,2023-11-03,2023-11-24,430.76,0,0,100730326,33682043,0.0697565497802519,99.5481688404344,0
500.02,500,34650,34650,103950,69300,2023-11-03,2023-12-15,430.76,0,-34650,878851435,217070587,0.00788529178427068,99.8911343872358,-0.5
460.18,460,3817,3766,34353,67788,2023-11-03,2023-12-01,430.76,-51,33435,77639531,28317502,0.0873111920266494,99.4148019776163,0.493228890069039
478.15,478,4500,4497,40500,67455,2023-11-03,2023-12-29,430.76,-3,26955,181777115,62642449,0.0371086316338556,99.5462195557455,0.399599733155437
416.8,380,18,18,66240,66240,2023-11-03,2023-11-03,430.76,0,0,185125137,98861537,0.0357812024198529,99.7525641263941,0
490.04,490,16592,16423,49776,65692,2023-11-03,2023-12-15,430.76,-169,15916,878851435,217070587,0.00747475595804199,99.8986091431938,0.242282165256043
481.05,481,12559,12559,62795,62795,2023-11-03,2023-12-15,430.76,0,0,878851435,217070587,0.00714512117739217,99.9057542643712,0
468.24,468,2448,2557,29376,61368,2023-11-03,2023-12-15,430.76,109,31992,878851435,217070587,0.00698275016186325,99.9127370145331,0.521314039890497
458.05,458,11952,11840,35856,59200,2023-11-03,2023-11-17,430.76,-112,23344,672805518,235832752,0.00879897658627705,99.9169889388452,0.394324324324324
456.06,456,9874,9674,29622,58044,2023-11-03,2023-11-17,430.76,-200,28422,672805518,235832752,0.00862715873266664,99.9256160975779,0.48966301426504
432.94,385,11,12,40623,57528,2023-11-03,2023-12-08,430.76,1,16905,83002856,24707321,0.0693084584944884,99.428773872552,0.293856904463913
441.02,431,0,57,0,57114,2023-11-03,2023-12-22,430.76,57,57114,2338637,2338637,2.4421917552831,87.1232260500454,1
442.25,442,2170,2278,13020,56950,2023-11-03,2023-11-10,430.76,108,43930,127761173,59416338,0.0445753578045186,99.3542044264105,0.771378402107112
432.52,370,9,9,48555,56268,2023-11-03,2023-12-01,430.76,0,7713.00000000001,77639531,28317502,0.0724733898766081,99.4872753674929,0.137076135636596
460.08,460,3773,6990,18865,55920,2023-11-03,2023-11-24,430.76,3217,37055,100730326,33682043,0.0555145627147082,99.6036834031491,0.662643061516452
441.47,432,0,59,0,55873,2023-11-03,2023-12-22,430.76,59,55873,2338637,2338637,2.38912665796359,89.512352708009,1
424.53,395,18,18,53154,53154,2023-11-03,2023-12-01,430.76,0,0,77639531,28317502,0.068462546482925,99.5557379139758,0
454.42,454,1239,1263,23541,53046,2023-11-03,2023-12-01,430.76,24,29505,77639531,28317502,0.0683234420877684,99.6240613560636,0.556215360253365
445.1,445,4981,5276,14943,52760,2023-11-03,2023-11-10,430.76,295,37817,127761173,59416338,0.041295801189928,99.3955002276005,0.716774071266111
429.7,386,2,12,5130,52440,2023-11-03,2023-11-10,430.76,10,47310,127761173,59416338,0.0410453338589808,99.4365455614594,0.902173913043478
430.57,398,16,16,43680,52112,2023-11-03,2023-11-24,430.76,0,8432,100730326,33682043,0.0517341718917896,99.6554175750409,0.161805342339576
462.65,462,913,797,31955,51805,2023-11-03,2023-12-29,430.76,-116,19850,181777115,62642449,0.0284991870401288,99.5747187427856,0.383167647910434
424.46,382,12,12,50952,50952,2023-11-03,2023-11-17,430.76,0,0,672805518,235832752,0.00757306511864845,99.9331891626965,0
452.02,450,0,252,0,50904,2023-11-03,2023-12-22,430.76,252,50904,2338637,2338637,2.1766524689381,91.6890051769471,1
444.15,444,3341,3333,13364,49995,2023-11-03,2023-11-10,430.76,-8,36631,127761173,59416338,0.0391316069084619,99.4756771683679,0.732693269326933
419.53,378,12,12,49836,49836,2023-11-03,2023-12-15,430.76,0,0,878851435,217070587,0.00567058299222098,99.9184075975253,0
414.9,392,21,21,48090,48090,2023-11-03,2023-11-10,430.76,0,0,127761173,59416338,0.0376405435789166,99.5133177119468,0
490.07,490,6281,6809,31405,47663,2023-11-03,2023-12-29,430.76,528,16258,181777115,62642449,0.0262205723751309,99.6009393151608,0.341103161781676
448.06,448,7623,7713,15246,46278,2023-11-03,2023-11-10,430.76,90,31032,127761173,59416338,0.0362222723174278,99.5495399842642,0.670556203811746
457.05,457,9220,9225,27660,46125,2023-11-03,2023-11-17,430.76,5,18465,672805518,235832752,0.00685562153787211,99.9400447842344,0.400325203252033
423.41,393,15,15,45615,45615,2023-11-03,2023-12-15,430.76,0,0,878851435,217070587,0.00519029703808813,99.9235978945634,0
416.31,394,20,20,44620,44620,2023-11-03,2023-11-10,430.76,0,0,127761173,59416338,0.0349245384589573,99.5844645227232,0
505.02,505,21664,21665,43328,43330,2023-11-03,2023-12-15,430.76,1,2,878851435,217070587,0.00493029860046824,99.9285281931638,4.61573967228248e-05
464.52,464,927,820,25029,42640,2023-11-03,2023-12-29,430.76,-107,17611,181777115,62642449,0.0234572982413105,99.6243966134021,0.413015947467167
422.7,384,11,11,42570,42570,2023-11-03,2023-11-17,430.76,0,0,672805518,235832752,0.00632723704861172,99.946372021283,0
462.04,462,10637,10623,21274,42492,2023-11-03,2023-11-17,430.76,-14,21218,672805518,235832752,0.00631564380243386,99.9526876650854,0.499341052433399
477.15,477,2875,2822,25875,42330,2023-11-03,2023-12-29,430.76,-53,16455,181777115,62642449,0.0232867597222016,99.6476833731243,0.388731396172927
429.6,360,2,6,11028,41760,2023-11-03,2023-11-10,430.76,4,30732,127761173,59416338,0.0326859866886163,99.6171505094118,0.735919540229885
465.02,465,20785,20742,41570,41484,2023-11-03,2023-11-17,430.76,-43,-86,672805518,235832752,0.00616582339028914,99.9588534884757,-0.00207308841963167
430.51,396,11,12,18667,41412,2023-11-03,2023-11-10,430.76,1,22745,127761173,59416338,0.0324136034662111,99.649564112878,0.549236936153772
500.03,500,13641,13694,40923,41082,2023-11-03,2023-12-29,430.76,53,159.000000000007,181777115,62642449,0.0226002046517242,99.670283577776,0.00387030816415966
520.02,520,20119,20118,20119,40236,2023-11-03,2023-12-15,430.76,-1,20117,878851435,217070587,0.00457824819959474,99.9331064413634,0.499975146634854
466.43,466,1034,916,23782,39388,2023-11-03,2023-12-29,430.76,-118,15606,181777115,62642449,0.021668294163432,99.6919518719394,0.396212044277445
438.9,427,0,33,0,39270,2023-11-03,2023-12-22,430.76,33,39270,2338637,2338637,1.67918321654878,93.3681883934959,1
485.05,485,7619,7606,30476,38030,2023-11-03,2023-12-15,430.76,-13,7554,878851435,217070587,0.00432723876703916,99.9374336801305,0.198632658427557
430.41,396,11,11,20988,37851,2023-11-03,2023-11-24,430.76,0,16863,100730326,33682043,0.0375765685499717,99.6929941435909,0.445510026155187
479.09,479,4155,4153,20775,37377,2023-11-03,2023-12-15,430.76,-2,16602,878851435,217070587,0.00425293724416573,99.9416866173746,0.444176900232764
429.18,355,4,5,23760,37090,2023-11-03,2023-11-10,430.76,1,13330,127761173,59416338,0.0290307290776048,99.6785948419556,0.359396063629011
438.38,423,0,24,0,36912,2023-11-03,2023-12-22,430.76,24,36912,2338637,2338637,1.57835525564677,94.9465436491426,1
419.43,379,9,9,36387,36387,2023-11-03,2023-12-15,430.76,0,0,878851435,217070587,0.00414029021867615,99.9458269075933,0
427.38,391,10,10,36380,36380,2023-11-03,2023-12-29,430.76,0,0,181777115,62642449,0.0200135204038198,99.7119653923433,0
429.75,378,5,7,20465,36225,2023-11-03,2023-11-24,430.76,2,15760,100730326,33682043,0.0359623575525805,99.7289565011435,0.435058661145618
485.09,485,4043,4005,24258,36045,2023-11-03,2023-12-29,430.76,-38,11787,181777115,62642449,0.0198292287783311,99.7317946211216,0.327007906783188
493.04,493,7549,8831,22647,35324,2023-11-03,2023-12-15,430.76,1282,12677,878851435,217070587,0.00401933689736764,99.9498462444907,0.358877816781791
430.59,360,4,5,23096,35295,2023-11-03,2023-12-01,430.76,1,12199,77639531,28317502,0.0454600891393844,99.669521445203,0.345629692591019
465.11,465,2872,3194,17232,35134,2023-11-03,2023-12-01,430.76,322,17902,77639531,28317502,0.0452527205503083,99.7147741657533,0.509534923435988
430.23,360,6,5,32796,35115,2023-11-03,2023-11-03,430.76,-1,2319,185125137,98861537,0.018968250648749,99.7715323770429,0.0660401537804357
427.7,396,11,11,23243,34870,2023-11-03,2023-11-03,430.76,0,11627,185125137,98861537,0.0188359077352094,99.7903682847781,0.333438485804416
430.63,396,0,10,0,34630,2023-11-03,2023-12-08,430.76,10,34630,83002856,24707321,0.041721455946046,99.4704953284981,1
455.65,455,183,529,5673,34385,2023-11-03,2023-12-08,430.76,346,28712,83002856,24707321,0.0414262853798669,99.511921613878,0.83501526828559
428.85,315,0,3,0,34155,2023-11-03,2023-11-24,430.76,3,34155,100730326,33682043,0.0339073656924331,99.7628638668359,1
424.58,387,9,9,33822,33822,2023-11-03,2023-12-29,430.76,0,0,181777115,62642449,0.0186063025590433,99.7504009236806,0
416.98,305,3,3,33594,33594,2023-11-03,2023-11-24,430.76,0,0,100730326,33682043,0.0333504331158424,99.7962142999517,0
510.02,510,16458,16458,16458,32916,2023-11-03,2023-12-15,430.76,0,16458,878851435,217070587,0.00374534292021723,99.9535915874109,0.5
472.22,472,1487,1487,20818,32714,2023-11-03,2023-12-29,430.76,0,11896,181777115,62642449,0.0179967648842925,99.7683976885649,0.363636363636364
448.43,445,0,95,0,32585,2023-11-03,2023-12-22,430.76,95,32585,2338637,2338637,1.39333295419511,96.3398766033378,1
443.18,443,1551,1809,7755,32562,2023-11-03,2023-11-10,430.76,258,24807,127761173,59416338,0.0254866163447012,99.7040814583003,0.761838953381242
515.02,515,16278,16279,16278,32558,2023-11-03,2023-12-15,430.76,1,16280,878851435,217070587,0.00370460793524221,99.9572961953461,0.500030714417347
420.68,399,15,15,32520,32520,2023-11-03,2023-11-10,430.76,0,0,127761173,59416338,0.0254537425075144,99.7295352008078,0
461.73,461,630,445,22680,32485,2023-11-03,2023-12-29,430.76,-185,9805,181777115,62642449,0.0178707864298539,99.7862684749948,0.30183161459135
430.36,401,11,11,21175,32296,2023-11-03,2023-11-03,430.76,0,11121,185125137,98861537,0.0174454968803075,99.8078137816584,0.344346049046321
425.52,320,3,3,31656,31656,2023-11-03,2023-11-24,430.76,0,0,100730326,33682043,0.0314264842148928,99.8276407841666,0
448.61,448,318,516,6360,31476,2023-11-03,2023-11-24,430.76,198,25116,100730326,33682043,0.0312477892705321,99.8588885734372,0.797941288600839
414.59,310,3,3,31377,31377,2023-11-03,2023-11-24,430.76,0,0,100730326,33682043,0.0311495070511337,99.8900380804883,0
414.42,386,11,11,31262,31262,2023-11-03,2023-11-24,430.76,0,0,100730326,33682043,0.0310353408366811,99.921073421325,0
432.49,370,4,5,19924,31245,2023-11-03,2023-12-08,430.76,1,11321,83002856,24707321,0.0376432830214903,99.5495648968995,0.362329972795647
449.63,448,5,189,290,30807,2023-11-03,2023-12-08,430.76,184,30517,83002856,24707321,0.0371155903358313,99.5866804872353,0.990586555003733
417.43,375,7,7,29701,29701,2023-11-03,2023-12-01,430.76,0,0,77639531,28317502,0.0382549966717341,99.753029162425,0
417.2,375,7,7,29540,29540,2023-11-03,2023-11-10,430.76,0,0,127761173,59416338,0.0231212654880681,99.7526564662959,0
438.04,438,4812,7336,4812,29344,2023-11-03,2023-11-03,430.76,2524,24532,185125137,98861537,0.0158508998159445,99.8236646814743,0.836014176663032
416.33,398,16,16,29328,29328,2023-11-03,2023-11-10,430.76,0,0,127761173,59416338,0.0229553308813156,99.7756117971772,0
422.19,404,16,16,29104,29104,2023-11-03,2023-12-08,430.76,0,0,83002856,24707321,0.0350638537064315,99.6217443409417,0
483.1,483,2906,2904,29060,29040,2023-11-03,2023-12-29,430.76,-2,-20,181777115,62642449,0.0159756083707237,99.8022440833655,-0.00068870523415978
459.04,459,7084,7041,14168,28164,2023-11-03,2023-11-17,430.76,-43,13996,672805518,235832752,0.0041860536583768,99.9630395421341,0.496946456469252
450.04,450,6520,6868,13040,27472,2023-11-03,2023-11-10,430.76,348,14432,127761173,59416338,0.0215026203618215,99.797114417539,0.52533488642982
433.63,388,0,6,0,27378,2023-11-03,2023-12-08,430.76,6,27378,83002856,24707321,0.0329844071871455,99.6547287481289,1
495.05,495,5417,5434,21668,27170,2023-11-03,2023-12-29,430.76,17,5502,181777115,62642449,0.014946876013518,99.817190959379,0.202502760397497
446.09,446,2807,3014,8421,27126,2023-11-03,2023-11-10,430.76,207,18705,127761173,59416338,0.0212318025602348,99.8183462200993,0.689559831895598
505.03,505,8509,8777,25527,26331,2023-11-03,2023-12-29,430.76,268,804,181777115,62642449,0.0144853217634134,99.8316762811424,0.0305343511450382
446.58,444,91,102,11193,26316,2023-11-03,2023-12-08,430.76,11,15123,83002856,24707321,0.0317049331410958,99.68643368127,0.574669402644779
422.9,359,4,4,25560,25560,2023-11-03,2023-12-29,430.76,0,0,181777115,62642449,0.0140611759626617,99.8457374571051,0
456.34,456,737,746,11055,25364,2023-11-03,2023-12-01,430.76,9,14309,77639531,28317502,0.0326689248032681,99.7856980872283,0.56414603374862
447.08,447,3158,3159,6316,25272,2023-11-03,2023-11-10,430.76,1,18956,127761173,59416338,0.0197806574615592,99.8381268775609,0.750079138968028
452.28,452,927,902,10197,25256,2023-11-03,2023-11-24,430.76,-25,15059,100730326,33682043,0.0250728861931808,99.9461463075182,0.596254355400697
464.03,464,8318,8310,16636,24930,2023-11-03,2023-11-17,430.76,-8,8294,672805518,235832752,0.00370537983607917,99.9667449219702,0.332691536301645
414.55,392,11,11,24805,24805,2023-11-03,2023-11-03,430.76,0,0,185125137,98861537,0.0133990447769392,99.8370637262513,0
448.07,446,57,119,5472,24633,2023-11-03,2023-12-08,430.76,62,19161,83002856,24707321,0.0296772920681187,99.7161109733381,0.777858969674827
487.06,487,4056,4055,16224,24330,2023-11-03,2023-12-15,430.76,-1,8106,878851435,217070587,0.00276838599006213,99.9600645813362,0.333168927250308
430.8,350,5,3,33150,24240,2023-11-03,2023-11-10,430.76,-2,-8910,127761173,59416338,0.0189729003192543,99.8570997778801,-0.367574257425743
455.02,455,12137,12119,12137,24238,2023-11-03,2023-11-10,430.76,-18,12101,127761173,59416338,0.0189713348984359,99.8760711127785,0.499257364469016
422.7,375,5,5,23850,23850,2023-11-03,2023-12-08,430.76,0,0,83002856,24707321,0.0287339510341668,99.7448449243723,0
437.55,437.5,3044,4560,6088,22800,2023-11-03,2023-11-03,430.76,1516,16712,185125137,98861537,0.0123159935865436,99.8493797198378,0.732982456140351
422.75,310,2,2,22550,22550,2023-11-03,2023-12-01,430.76,0,0,77639531,28317502,0.0290444825072423,99.8147425697355,0
496.03,496,7515,7515,30060,22545,2023-11-03,2023-12-15,430.76,0,-7515,878851435,217070587,0.00256527998955819,99.9626298613258,-0.333333333333334
431.45,394,6,6,19410,22470,2023-11-03,2023-12-08,430.76,0,3060,83002856,24707321,0.0270713576409949,99.7719162820133,0.136181575433912
424.77,350,3,3,22431,22431,2023-11-03,2023-12-01,430.76,0,0,77639531,28317502,0.0288912100718383,99.8436337798073,0
469.33,469,756,673,13608,22209,2023-11-03,2023-12-29,430.76,-83,8601,181777115,62642449,0.0122177095835194,99.8579551666886,0.387275428880184
456.02,456,10965,10952,21930,21904,2023-11-03,2023-11-10,430.76,-13,-26,127761173,59416338,0.0171444888033393,99.8932156015819,-0.00118699780861943
421.1,390,7,7,21770,21770,2023-11-03,2023-12-08,430.76,0,0,83002856,24707321,0.0262280131661976,99.7981442951794,0
432.44,360,0,3,0,21732,2023-11-03,2023-12-08,430.76,3,21732,83002856,24707321,0.0261822316089943,99.8243265267884,1
415.1,345,3,3,21030,21030,2023-11-03,2023-11-10,430.76,0,0,127761173,59416338,0.0164603999056897,99.9096760014876,0
483.06,483,3369,3466,16845,20796,2023-11-03,2023-12-15,430.76,97,3951,878851435,217070587,0.0023662702445266,99.9649961315703,0.1899884593191
431.85,330,0,2,0,20370,2023-11-03,2023-12-01,430.76,2,20370,77639531,28317502,0.0262366345309324,99.8698704143383,1
430.1,380,4,4,15976,20040,2023-11-03,2023-11-10,430.76,0,4064,127761173,59416338,0.0156855166005716,99.9253615180881,0.202794411177645
478.1,478,2008,1999,14056,19990,2023-11-03,2023-12-15,430.76,-9,5934,878851435,217070587,0.00227455963589568,99.9672706912062,0.296848424212106
480.01,480,19844,19854,19844,19854,2023-11-03,2023-11-17,430.76,10,10,672805518,235832752,0.00295092704635041,99.9696958490165,0.000503676840938854
430.59,365,3,3,13803,19677,2023-11-03,2023-11-03,430.76,0,5874,185125137,98861537,0.0106290265702815,99.8600087464081,0.298521116023784
494.04,494,4882,4882,19528,19528,2023-11-03,2023-12-29,430.76,0,0,181777115,62642449,0.0107428264553544,99.868697993144,0
433.85,402,3,6,7140,19110,2023-11-03,2023-12-08,430.76,3,11970,83002856,24707321,0.0230233041619676,99.8473498309504,0.626373626373627
550.01,550,19062,19062,19062,19062,2023-11-03,2023-12-15,430.76,0,0,878851435,217070587,0.00216896727260848,99.9694396584788,0
484.06,484,3109,3157,12436,18942,2023-11-03,2023-12-15,430.76,48,6506,878851435,217070587,0.00215531308770065,99.9715949715665,0.34346953859149
471.26,471,725,727,10875,18902,2023-11-03,2023-12-29,430.76,2,8027,181777115,62642449,0.0103984486716053,99.8790964418156,0.424664056713575
458.24,458,515,778,6695,18672,2023-11-03,2023-12-01,430.76,263,11977,77639531,28317502,0.024049604318192,99.8939200186565,0.641441730934019
419.45,235,1,1,18445,18445,2023-11-03,2023-11-17,430.76,0,0,672805518,235832752,0.00274150545834257,99.9724373544749,0
413.53,230,1,1,18353,18353,2023-11-03,2023-11-17,430.76,0,0,672805518,235832752,0.00272783137310714,99.975165185848,0
420.41,240,1,1,18041,18041,2023-11-03,2023-11-17,430.76,0,0,672805518,235832752,0.00268145838839568,99.9778466442364,0
414.75,385,6,6,17850,17850,2023-11-03,2023-11-03,430.76,0,0,185125137,98861537,0.00964212655788609,99.869650872966,0
418.34,330,2,2,17668,17668,2023-11-03,2023-11-03,430.76,0,0,185125137,98861537,0.00954381467925666,99.8791946876453,0
540.01,540,17577,17577,17577,17577,2023-11-03,2023-12-15,430.76,0,0,878851435,217070587,0.00199999673437411,99.9735949683009,0
432.32,345,0,2,0,17464,2023-11-03,2023-12-08,430.76,2,17464,83002856,24707321,0.0210402398683727,99.8683900708188,1
468.38,468,559,458,11180,17404,2023-11-03,2023-12-29,430.76,-101,6224,181777115,62642449,0.0095743625373304,99.8886708043529,0.357618938175132
470.01,470,17105,17320,17105,17320,2023-11-03,2023-11-17,430.76,215,215,672805518,235832752,0.00257429517693106,99.9804209394133,0.0124133949191686
489.05,489,3414,3414,13656,17070,2023-11-03,2023-12-15,430.76,0,3414,878851435,217070587,0.00194230780313854,99.975537276104,0.2
438.06,421,0,10,0,17060,2023-11-03,2023-12-22,430.76,10,17060,2338637,2338637,0.729484738332627,97.0693613416704,1
493.04,493,4242,4242,16968,16968,2023-11-03,2023-12-29,430.76,0,0,181777115,62642449,0.00933450836206747,99.898005312715,0
422.04,398,7,7,16828,16828,2023-11-03,2023-12-08,430.76,0,0,83002856,24707321,0.0202740011741283,99.8886640719929,0
488.04,488,2053,4139,6159,16556,2023-11-03,2023-12-15,430.76,2086,10397,878851435,217070587,0.00188382237778334,99.9774210984818,0.627989852621406
456.18,455,0,140,0,16520,2023-11-03,2023-12-22,430.76,140,16520,2338637,2338637,0.706394365606975,97.7757557072774,1
501.03,501,5460,5460,16380,16380,2023-11-03,2023-12-15,430.76,0,0,878851435,217070587,0.00186379623991852,99.9792848947217,0
452.02,452,8029,8031,8029,16062,2023-11-03,2023-11-10,430.76,2,8033,127761173,59416338,0.0125718945927336,99.9379334126809,0.500124517494708
495.02,495,7708,7918,15416,15836,2023-11-03,2023-12-15,430.76,210,420.000000000002,878851435,217070587,0.00180189726833637,99.9810867919901,0.0265218489517556
475.01,475,15845,15819,31690,15819,2023-11-03,2023-11-17,430.76,-26,-15871,672805518,235832752,0.00235119950368778,99.982772138917,-1.00328718629496
454.21,454,756,751,6804,15771,2023-11-03,2023-11-24,430.76,-5,8967,100730326,33682043,0.0156566553750655,99.9618029628932,0.568575233022636
440.23,429,0,14,0,15722,2023-11-03,2023-12-22,430.76,14,15722,2338637,2338637,0.672271925912401,98.4480276331898,1
486.06,486,2500,2599,10000,15594,2023-11-03,2023-12-15,430.76,99,5594,878851435,217070587,0.00177436132877225,99.9828611533188,0.358727715788124
600.01,600,15518,15518,15518,15518,2023-11-03,2023-12-15,430.76,0,0,878851435,217070587,0.00176571367833063,99.9846268669972,0
473.25,473,617,620,6787,15500,2023-11-03,2023-12-29,430.76,3,8713,181777115,62642449,0.00852692595544824,99.9065322386704,0.562129032258065
416.36,397,8,8,15488,15488,2023-11-03,2023-11-03,430.76,0,0,185125137,98861537,0.00836623283633276,99.8875609204816,0
432.24,355,1,2,6687,15448,2023-11-03,2023-12-08,430.76,1,8761,83002856,24707321,0.0186114077809564,99.9072754797739,0.567128430864837
700.01,700,14944,14944,14944,14944,2023-11-03,2023-12-15,430.76,0,0,878851435,217070587,0.00170040116052152,99.9863272681577,0
417.62,388,5,5,14810,14810,2023-11-03,2023-11-03,430.76,0,0,185125137,98861537,0.00799999407968028,99.8955609145613,0
429.04,285,0,1,0,14404,2023-11-03,2023-12-01,430.76,1,14404,77639531,28317502,0.0185524047021871,99.9124724233587,1
440.01,440,11708,14253,11708,14253,2023-11-03,2023-11-03,430.76,2545,2545,185125137,98861537,0.00769911651706165,99.9032600310783,0.178558899880727
454.03,454,4644,4653,9288,13959,2023-11-03,2023-11-10,430.76,9,4671,127761173,59416338,0.0109258546021646,99.948859267283,0.334622823984526
468.02,468,6927,6920,13854,13840,2023-11-03,2023-11-17,430.76,-7,-14,672805518,235832752,0.00205705803976477,99.9848291969568,-0.00101156069364162
439.02,439,5034,6750,5034,13500,2023-11-03,2023-11-03,430.76,1716,8466,185125137,98861537,0.00729236462361133,99.9105523957019,0.627111111111111
432.44,365,0,2,0,13488,2023-11-03,2023-12-08,430.76,2,13488,83002856,24707321,0.0162500432515238,99.9235255230254,1
481.11,481,1187,1190,8309,13090,2023-11-03,2023-12-29,430.76,3,4781,181777115,62642449,0.00720112650043984,99.9137333651709,0.36524064171123
423.79,402,6,6,13074,13074,2023-11-03,2023-12-29,430.76,0,0,181777115,62642449,0.0071923245123568,99.9209256896832,0
491.03,491,4326,4326,12978,12978,2023-11-03,2023-12-15,430.76,0,0,878851435,217070587,0.0014767000977816,99.9878039682554,0
474.21,474,614,616,6754,12936,2023-11-03,2023-12-29,430.76,2,6182,181777115,62642449,0.00711640736514054,99.9280420970484,0.477891156462585
463.6,463,223,215,6690,12900,2023-11-03,2023-12-29,430.76,-8,6210,181777115,62642449,0.0070966028919537,99.9351386999403,0.481395348837209
441.75,433,0,14,0,12250,2023-11-03,2023-12-22,430.76,14,12250,2338637,2338637,0.523809381276359,98.9718370144661,1
505.01,505,12190,12190,12190,12190,2023-11-03,2023-11-10,430.76,0,0,127761173,59416338,0.00954123988827184,99.9584005071713,0
430.49,370,3,2,13224,12098,2023-11-03,2023-11-03,430.76,-1,-1126,185125137,98861537,0.00653503905307036,99.917087434755,-0.0930732352454951
429.94,370,0,2,0,11988,2023-11-03,2023-11-10,430.76,2,11988,127761173,59416338,0.00938313238561139,99.9677836395569,1
460.33,460,155,360,2170,11880,2023-11-03,2023-12-08,430.76,205,9710,83002856,24707321,0.0143127605151322,99.9378382835405,0.817340067340067
520.02,520,5860,5860,11720,11720,2023-11-03,2023-12-29,430.76,0,0,181777115,62642449,0.00644745627082925,99.9415861562112,0
545.01,545,11424,11424,11424,11424,2023-11-03,2023-12-15,430.76,0,0,878851435,217070587,0.00129987840322523,99.9891038466587,0
535.01,535,10954,10955,10954,10955,2023-11-03,2023-12-15,430.76,1,1,878851435,217070587,0.00124651329721047,99.9903503599559,9.12825193975354e-05
441.02,441,4655,5451,4655,10902,2023-11-03,2023-11-03,430.76,796,6247,185125137,98861537,0.00588898956493412,99.9229764243199,0.573014125848468
430.25,394,2,3,0,10875,2023-11-03,2023-11-03,430.76,1,10875,185125137,98861537,0.0058744048356869,99.9288508291556,1
565.01,565,10673,10673,10673,10673,2023-11-03,2023-12-15,430.76,0,0,878851435,217070587,0.00121442596267707,99.9915647859186,0
466.02,466,5308,5299,10616,10598,2023-11-03,2023-11-17,430.76,-9,-18,672805518,235832752,0.0015751951665771,99.9864043921233,-0.00169843366672957
494.03,494,3516,3516,10548,10548,2023-11-03,2023-12-15,430.76,0,0,878851435,217070587,0.00120020285339808,99.992764988772,0
499.03,499,3170,3468,9510,10404,2023-11-03,2023-12-15,430.76,298,894,878851435,217070587,0.00118381783150869,99.9939488066035,0.0859284890426759
458.44,458,3,235,63,10340,2023-11-03,2023-12-08,430.76,232,10277,83002856,24707321,0.012457402670578,99.9502956862111,0.993907156673114
423.67,398,4,4,10268,10268,2023-11-03,2023-12-01,430.76,0,0,77639531,28317502,0.0132252215691514,99.9256976449278,0
472.02,472,5122,5121,10244,10242,2023-11-03,2023-11-17,430.76,-1,-2,672805518,235832752,0.00152228240197043,99.9879266745253,-0.000195274360476469
449.06,449,1819,1676,5457,10056,2023-11-03,2023-11-10,430.76,-143,4599,127761173,59416338,0.00787093587501737,99.9756545754319,0.457338902147971
560.01,560,9923,9923,9923,9923,2023-11-03,2023-12-15,430.76,0,0,878851435,217070587,0.00112908730700315,99.9950778939105,0
515.02,515,4949,4953,4949,9906,2023-11-03,2023-12-29,430.76,4,4957,181777115,62642449,0.00544953087191421,99.9470356870831,0.500403795679386
462.16,462,430,608,3440,9728,2023-11-03,2023-12-01,430.76,178,6288,77639531,28317502,0.0125296995933682,99.9382273445212,0.646381578947369
417.65,386,3,3,9495,9495,2023-11-03,2023-12-29,430.76,0,0,181777115,62642449,0.00522342980303104,99.9522591168861,0
446.01,446,9403,9406,9403,9406,2023-11-03,2023-11-03,430.76,3,3,185125137,98861537,0.00508088752960653,99.9339317166852,0.000318945354029343
530.01,530,9353,9353,9353,9353,2023-11-03,2023-12-15,430.76,0,0,878851435,217070587,0.00106422992869096,99.9961421238392,0
412.8,320,1,1,9280,9280,2023-11-03,2023-11-03,430.76,0,0,185125137,98861537,0.00501282545978616,99.938944542145,0
421.59,330,1,1,9159,9159,2023-11-03,2023-12-08,430.76,0,0,83002856,24707321,0.0110345600638127,99.9613302462749,0
500.01,500,9138,9135,9138,9135,2023-11-03,2023-11-17,430.76,-3,-3,672805518,235832752,0.0013577474850615,99.9892844220103,-0.000328407224958949
485.01,485,8947,8926,8947,8926,2023-11-03,2023-11-17,430.76,-21,-21,672805518,235832752,0.00132668353055927,99.9906111055409,-0.00235267757114049
443.02,443,3995,4440,3995,8880,2023-11-03,2023-11-03,430.76,445,4885,185125137,98861537,0.00479675539686434,99.9437412975419,0.550112612612613
498.02,498,4320,4320,8640,8640,2023-11-03,2023-12-15,430.76,0,0,878851435,217070587,0.000983101313363618,99.9971252251525,0
496.03,496,2842,2842,8526,8526,2023-11-03,2023-12-29,430.76,0,0,181777115,62642449,0.00469035939975172,99.9569494762859,0
482.1,482,844,844,6752,8440,2023-11-03,2023-12-29,430.76,0,1688,181777115,62642449,0.00464304871380537,99.9615925249996,0.2
467.42,467,190,197,3990,8274,2023-11-03,2023-12-29,430.76,7,4284,181777115,62642449,0.00455172808744379,99.9661442530871,0.517766497461929
432.34,350,0,1,0,8234,2023-11-03,2023-12-08,430.76,1,8234,83002856,24707321,0.0099201405792591,99.9712503868542,1
484.09,484,910,910,5460,8190,2023-11-03,2023-12-29,430.76,0,2730,181777115,62642449,0.00450551765000781,99.9706497707371,0.333333333333333
464.11,464,879,731,3516,8041,2023-11-03,2023-12-01,430.76,-148,4525,77639531,28317502,0.0103568374208752,99.9485841819421,0.562740952617834
452.96,452,56,83,2464,7968,2023-11-03,2023-12-08,430.76,27,5504,83002856,24707321,0.00959966967883611,99.980850056533,0.690763052208835
479.14,479,568,566,4544,7924,2023-11-03,2023-12-29,430.76,-2,3380,181777115,62642449,0.00435918459812722,99.9750089553352,0.426552246340232
495.01,495,7895,7895,7895,7895,2023-11-03,2023-11-17,430.76,0,0,672805518,235832752,0.0011734445971057,99.991784550138,0
555.01,555,7791,7791,7791,7791,2023-11-03,2023-12-15,430.76,0,0,878851435,217070587,0.000886497955140735,99.9980117231077,0
417.53,392,3,3,7659,7659,2023-11-03,2023-12-01,430.76,0,0,77639531,28317502,0.00986482002319154,99.9584490019653,0
470.06,470,908,1259,3632,7554,2023-11-03,2023-12-01,430.76,351,3922,77639531,28317502,0.00972957963901147,99.9681785816043,0.51919512840879
451.04,451,1813,1840,3626,7360,2023-11-03,2023-11-10,430.76,27,3734,127761173,59416338,0.00576074861178678,99.9814153240437,0.507336956521739
437.62,420,0,4,0,7048,2023-11-03,2023-12-22,430.76,4,7048,2338637,2338637,0.301372124019247,99.2732091384854,1
459.01,459,7015,7017,7015,7017,2023-11-03,2023-11-03,430.76,2,1.99999999999909,185125137,98861537,0.00379040907880598,99.9475317066207,0.000285022089211784
460.02,460,3510,3506,3510,7012,2023-11-03,2023-11-10,430.76,-4,3502,127761173,59416338,0.00548836538938164,99.9869036894331,0.499429549343982
460.68,460,0,103,0,7004,2023-11-03,2023-12-22,430.76,103,7004,2338637,2338637,0.299490686241601,99.572699824727,1
460.01,460,6911,6910,6911,6910,2023-11-03,2023-11-03,430.76,-1,-0.999999999999091,185125137,98861537,0.00373261033697439,99.9512643169577,-0.000144717800289304
450.01,450,6788,6867,6788,6867,2023-11-03,2023-11-03,430.76,79,79,185125137,98861537,0.00370938280521029,99.9549736997629,0.0115042959079656
491.05,491,1371,1371,6855,6855,2023-11-03,2023-12-29,430.76,0,0,181777115,62642449,0.00377110176932888,99.9787800571046,0
416.21,382,2,2,6842,6842,2023-11-03,2023-11-24,430.76,0,0,100730326,33682043,0.00679239338508643,99.9685953562783,0
421.65,388,2,2,6730,6730,2023-11-03,2023-11-24,430.76,0,0,100730326,33682043,0.00668120541970647,99.975276561698,0
458.12,458,517,511,2585,6132,2023-11-03,2023-11-24,430.76,-6,3547,100730326,33682043,0.00608754110455277,99.9813641028026,0.578440965427267
414.76,385,2,2,5952,5952,2023-11-03,2023-11-10,430.76,0,0,127761173,59416338,0.00465869235561887,99.9915623817887,0
488.01,488,4702,5872,4702,5872,2023-11-03,2023-11-17,430.76,1170,1170,672805518,235832752,0.00087276335328748,99.9926573134913,0.19925068119891
497.02,497,2912,2912,8736,5824,2023-11-03,2023-12-15,430.76,0,-2912,878851435,217070587,0.000662683107526587,99.9986744062152,-0.5
412.9,356,1,1,5690,5690,2023-11-03,2023-11-03,430.76,0,0,185125137,98861537,0.00307359664506285,99.958047296408,0
421.41,365,1,1,5641,5641,2023-11-03,2023-12-01,430.76,0,0,77639531,28317502,0.00726562863961659,99.9754442102439,0
492.03,492,1490,1872,4470,5616,2023-11-03,2023-12-15,430.76,382,1146,878851435,217070587,0.000639015853686352,99.9993134220689,0.204059829059829
494.01,494,5543,5603,5543,5603,2023-11-03,2023-11-17,430.76,60,60,672805518,235832752,0.000832781517109971,99.9934900950084,0.0107085489916116
454.8,454,57,70,1881,5600,2023-11-03,2023-12-08,430.76,13,3719,83002856,24707321,0.00674675579837879,99.9875968123314,0.664107142857143
432.81,405,0,2,0,5562,2023-11-03,2023-12-22,430.76,2,5562,2338637,2338637,0.237830839074213,99.8105306638012,1
520.01,520,5544,5544,5544,5544,2023-11-03,2023-11-17,430.76,0,0,672805518,235832752,0.000824012266795945,99.9943141072752,0
515.01,515,5405,5405,5405,5405,2023-11-03,2023-11-17,430.76,0,0,672805518,235832752,0.000803352507581545,99.9951174597828,0
530.01,530,5355,5355,5355,5355,2023-11-03,2023-12-29,430.76,0,0,181777115,62642449,0.00294591538654357,99.9817259724911,0
490.01,490,5297,5297,5297,5297,2023-11-03,2023-11-17,430.76,0,0,672805518,235832752,0.000787300320566039,99.9959047601034,0
422.39,396,2,2,5278,5278,2023-11-03,2023-12-01,430.76,0,0,77639531,28317502,0.00679808331145122,99.9822422935553,0
466.1,466,36,521,144,5210,2023-11-03,2023-12-01,430.76,485,5066,77639531,28317502,0.0067104990626489,99.988952792618,0.97236084452975
510.02,510,2585,2585,7755,5170,2023-11-03,2023-12-29,430.76,0,-2585,181777115,62642449,0.00284414239933338,99.9845701148904,-0.5
415.49,364,1,1,5149,5149,2023-11-03,2023-11-03,430.76,0,0,185125137,98861537,0.00278136188496109,99.9608286582929,0
455.01,455,4822,4821,4822,4821,2023-11-03,2023-11-03,430.76,-1,-1,185125137,98861537,0.0026041844333652,99.9634328427263,-0.000207425845260319
468.01,468,4754,4754,4754,4754,2023-11-03,2023-11-03,430.76,0,0,185125137,98861537,0.0025679926978258,99.9660008354241,0
445.01,445,4566,4594,4566,4594,2023-11-03,2023-11-03,430.76,28,28,185125137,98861537,0.00248156467265707,99.9684824000968,0.00609490639965172
489.07,489,648,648,2592,4536,2023-11-03,2023-12-29,430.76,0,1944,181777115,62642449,0.00249536362154279,99.987065478512,0.428571428571429
474.01,474,4510,4499,9020,4499,2023-11-03,2023-11-17,430.76,-11,-4521,672805518,235832752,0.000668692494284805,99.9965734525976,-1.00488997555012
487.08,487,534,537,2670,4296,2023-11-03,2023-12-29,430.76,3,1626,181777115,62642449,0.00236333380029714,99.9894288123123,0.378491620111732
505.01,505,4287,4277,4287,4277,2023-11-03,2023-11-17,430.76,-10,-10,672805518,235832752,0.000635696332086266,99.9972091489297,-0.00233808744447042
424.15,403,2,2,4230,4230,2023-11-03,2023-12-08,430.76,0,0,83002856,24707321,0.00509621018341827,99.9926930225148,0
449.01,449,4210,4208,4210,4208,2023-11-03,2023-11-03,430.76,-2,-2,185125137,98861537,0.00227305706193752,99.9707554571587,-0.000475285171102662
465.01,465,4126,4124,4126,4124,2023-11-03,2023-11-03,430.76,-2,-2,185125137,98861537,0.00222768234872393,99.9729831395074,-0.000484966052376334
465.04,465,988,973,3952,3892,2023-11-03,2023-11-24,430.76,-15,-60.0000000000005,100730326,33682043,0.00386378179695358,99.9852278845995,-0.0154162384378213
442.51,442.5,2920,3699,2920,3699,2023-11-03,2023-11-03,430.76,779,779,185125137,98861537,0.0019981079068695,99.9749812474143,0.210597458772641
560.01,560,3650,3650,3650,3650,2023-11-03,2023-11-17,430.76,0,0,672805518,235832752,0.000542504468579582,99.9977516533983,0
461.01,461,3630,3630,3630,3630,2023-11-03,2023-11-03,430.76,0,0,185125137,98861537,0.00196083582101549,99.9769420832353,0
462.08,462,142,442,568,3536,2023-11-03,2023-11-24,430.76,300,2968,100730326,33682043,0.00351036290699585,99.9887382475065,0.839366515837104
416.56,399,2,2,3512,3512,2023-11-03,2023-11-03,430.76,0,0,185125137,98861537,0.00189709515245355,99.9788391783878,0
496.01,496,3473,3473,3473,3473,2023-11-03,2023-11-17,430.76,0,0,672805518,235832752,0.000516196717637503,99.9982678501159,0
448.01,448,3396,3391,3396,3391,2023-11-03,2023-11-03,430.76,-5,-4.99999999999955,185125137,98861537,0.0018317339584197,99.9806709123462,-0.00147449130050119
411.1,378,1,1,3310,3310,2023-11-03,2023-11-03,430.76,0,0,185125137,98861537,0.00178797977067804,99.9824588921169,0
442.01,442,2353,3310,2353,3310,2023-11-03,2023-11-03,430.76,957,957,185125137,98861537,0.00178797977067804,99.9842468718875,0.289123867069486
605.01,605,3282,3282,3282,3282,2023-11-03,2023-12-15,430.76,0,0,878851435,217070587,0.000373441957229096,99.9996868640261,0
476.01,476,3079,3079,3079,3079,2023-11-03,2023-11-17,430.76,0,0,672805518,235832752,0.000457635961303159,99.9987254860773,0
499.04,499,760,760,3040,3040,2023-11-03,2023-12-29,430.76,0,0,181777115,62642449,0.00167237773577824,99.991101190048,0
418.26,388,1,1,3026,3026,2023-11-03,2023-11-10,430.76,0,0,127761173,59416338,0.00236848169826994,99.993930863487,0
444.01,444,2559,2880,2559,2880,2023-11-03,2023-11-03,430.76,321,321,185125137,98861537,0.00155570445303708,99.9858025763406,0.111458333333333
550.01,550,2852,2852,2852,2852,2023-11-03,2023-12-29,430.76,0,0,181777115,62642449,0.00156895437580248,99.9926701444239,0
590.01,590,2752,2752,2752,2752,2023-11-03,2023-12-15,430.76,0,0,878851435,217070587,0.000313135973886189,100,0
468.08,468,115,322,575,2576,2023-11-03,2023-12-01,430.76,207,2001,77639531,28317502,0.00331789742521757,99.9922706900432,0.776785714285714
418.88,394,1,1,2488,2488,2023-11-03,2023-12-01,430.76,0,0,77639531,28317502,0.00320455310323809,99.9954752431464,0
476.17,476,147,146,1470,2482,2023-11-03,2023-12-29,430.76,-1,1012,181777115,62642449,0.0013654084013821,99.9940355528252,0.407735697018533
478.01,478,2479,2475,2479,2475,2023-11-03,2023-11-17,430.76,-4,-4,672805518,235832752,0.000367862619105333,99.9990933486963,-0.00161616161616162
422.93,399,1,1,2393,2393,2023-11-03,2023-12-29,430.76,0,0,181777115,62642449,0.00131644734267017,99.9953520001679,0
465.39,465,0,61,0,2379,2023-11-03,2023-12-22,430.76,61,2379,2338637,2338637,0.101725919841343,99.9122565836425,1
488.05,488,471,471,2355,2355,2023-11-03,2023-12-29,430.76,0,0,181777115,62642449,0.00129554262097294,99.9966475427889,0
465.2,465,96,111,1056,2220,2023-11-03,2023-12-08,430.76,15,1164,83002856,24707321,0.00267460676292874,99.9953676292777,0.524324324324324
486.01,486,2101,2101,2101,2101,2023-11-03,2023-11-17,430.76,0,0,672805518,235832752,0.000312274489996082,99.9994056231863,0
470.03,470,703,699,1406,2097,2023-11-03,2023-11-24,430.76,-4,691,100730326,33682043,0.00208179610180156,99.9908200436083,0.329518359561278
484.01,484,2076,2076,2076,2076,2023-11-03,2023-11-17,430.76,0,0,672805518,235832752,0.000308558705964715,99.9997141818923,0
435.52,415,0,1,0,2052,2023-11-03,2023-12-22,430.76,1,2052,2338637,2338637,0.0877434163574766,100,1
452.01,452,1947,1945,3894,1945,2023-11-03,2023-11-03,430.76,-2,-1949,185125137,98861537,0.00105064068095734,99.9868532170215,-1.00205655526992
475.02,475,904,945,904,1890,2023-11-03,2023-11-24,430.76,41,986,100730326,33682043,0.00187629691578681,99.9926963405241,0.521693121693122
411.87,393,1,1,1887,1887,2023-11-03,2023-11-03,430.76,0,0,185125137,98861537,0.00101931052183367,99.9878725275434,0
451.01,451,1880,1879,3760,1879,2023-11-03,2023-11-03,430.76,-1,-1881,185125137,98861537,0.00101498912057524,99.9888875166639,-1.0010643959553
470.01,470,1837,1834,1837,1834,2023-11-03,2023-11-03,430.76,-3,-3,185125137,98861537,0.000990681238496531,99.9898781979024,-0.00163576881134133
492.05,492,357,359,2499,1795,2023-11-03,2023-12-29,430.76,2,-704,181777115,62642449,0.000987473038066426,99.997635015827,-0.392200557103064
447.01,447,1744,1787,1744,1787,2023-11-03,2023-11-03,430.76,43,42.9999999999998,185125137,98861537,0.000965293006103218,99.9908434909085,0.0240626748740905
466.01,466,1654,1654,1654,1654,2023-11-03,2023-11-03,430.76,0,0,185125137,98861537,0.000893449710181714,99.9917369406187,0
480.01,480,1635,1635,1635,1635,2023-11-03,2023-11-03,430.76,0,0,185125137,98861537,0.000883186382192927,99.9926201270009,0
456.15,456,156,108,1092,1620,2023-11-03,2023-11-24,430.76,-48,528,100730326,33682043,0.00160825449924584,99.9943045950234,0.325925925925926
540.02,540,803,803,1606,1606,2023-11-03,2023-12-29,430.76,0,0,181777115,62642449,0.000883499553835476,99.9985185153808,0
454.01,454,1594,1594,1594,1594,2023-11-03,2023-11-03,430.76,0,0,185125137,98861537,0.000861039200743441,99.9934811662017,0
500.01,500,1520,1525,1520,1525,2023-11-03,2023-11-24,430.76,5,5,100730326,33682043,0.00151394327861105,99.995818538302,0.00327868852459016
470.11,470,124,138,868,1518,2023-11-03,2023-12-08,430.76,14,650,83002856,24707321,0.00182885273248911,99.9971964820102,0.428194993412385
482.01,482,1489,1487,1489,1487,2023-11-03,2023-11-17,430.76,-2,-2,672805518,235832752,0.000221014834185709,99.9999351967265,-0.00134498991257566
447.51,447.5,1454,1453,1454,1453,2023-11-03,2023-11-03,430.76,-1,-1,185125137,98861537,0.0007848745035635,99.9942660407052,-0.000688231245698555
453.01,453,1445,1439,1445,1439,2023-11-03,2023-11-03,430.76,-6,-6,185125137,98861537,0.000777312051361237,99.9950433527566,-0.00416956219596942
490.01,490,1380,1380,1380,1380,2023-11-03,2023-11-03,430.76,0,0,185125137,98861537,0.000745441717080269,99.9957887944737,0
462.02,462,664,657,664,1314,2023-11-03,2023-11-10,430.76,-7,650,127761173,59416338,0.00102848147770215,99.9949593449647,0.494672754946728
480.02,480,593,604,593,1208,2023-11-03,2023-11-24,430.76,11,615,100730326,33682043,0.00119924162659813,99.9970177799286,0.509105960264901
475.04,475,291,285,873,1140,2023-11-03,2023-12-01,430.76,-6,267,77639531,28317502,0.00146832417109784,99.9969435673175,0.234210526315789
456.61,456,0,18,0,1098,2023-11-03,2023-12-08,430.76,18,1098,83002856,24707321,0.0013228460476107,99.9985193280578,1
470.01,470,1089,1080,1089,1080,2023-11-03,2023-11-10,430.76,-9,-9,127761173,59416338,0.000845327241946973,99.9958046722066,-0.00833333333333333
486.05,486,215,215,1075,1075,2023-11-03,2023-12-29,430.76,0,0,181777115,62642449,0.000591383574329475,99.9991098989551,0
457.01,457,1067,1065,1067,1065,2023-11-03,2023-11-03,430.76,-2,-2,185125137,98861537,0.000575286542529338,99.9963640810162,-0.00187793427230047
525.01,525,1038,1038,1038,1038,2023-11-03,2023-12-29,430.76,0,0,181777115,62642449,0.000571028976887437,99.999680927932,0
480.02,480,511,511,1022,1022,2023-11-03,2023-11-10,430.76,0,0,127761173,59416338,0.000799930038212783,99.9966046022448,0
466.03,466,335,335,1005,1005,2023-11-03,2023-11-24,430.76,0,0,100730326,33682043,0.000997713439346955,99.9980154933679,0
458.01,458,929,926,929,926,2023-11-03,2023-11-10,430.76,-3,-3.00000000000011,127761173,59416338,0.000724789838928608,99.9973293920838,-0.00323974082073446
458.01,458,838,845,838,845,2023-11-03,2023-11-03,430.76,7,6.99999999999977,185125137,98861537,0.000456448007922338,99.9968205290241,0.00828402366863879
482.01,482,804,804,804,804,2023-11-03,2023-11-03,430.76,0,0,185125137,98861537,0.000434300826472852,99.9972548298506,0
465.01,465,777,797,777,797,2023-11-03,2023-11-10,430.76,20,20,127761173,59416338,0.000623820196140497,99.9979532122799,0.0250941028858218
466.01,466,728,732,728,732,2023-11-03,2023-11-10,430.76,4,4,127761173,59416338,0.000572944019541837,99.9985261562995,0.00546448087431694
456.01,456,698,697,698,697,2023-11-03,2023-11-03,430.76,-1,-1,185125137,98861537,0.000376502084641266,99.9976313319352,-0.00143472022955524
475.01,475,650,650,650,650,2023-11-03,2023-11-03,430.76,0,0,185125137,98861537,0.000351113852247953,99.9979824457875,0
474.01,474,597,597,597,597,2023-11-03,2023-11-03,430.76,0,0,185125137,98861537,0.000322484568910812,99.9983049303564,0
475.01,475,595,595,595,595,2023-11-03,2023-11-10,430.76,0,0,127761173,59416338,0.000465712693480045,99.9989918689929,0
462.26,462,3,22,42,572,2023-11-03,2023-12-08,430.76,19,530,83002856,24707321,0.000689132913691548,99.9992084609715,0.926573426573426
500.01,500,572,572,572,572,2023-11-03,2023-12-01,430.76,0,0,77639531,28317502,0.000736738092866635,99.9976803054104,0
464.01,464,540,538,540,538,2023-11-03,2023-11-10,430.76,-2,-2,127761173,59416338,0.000421098200155066,99.9994129671931,-0.00371747211895911
452.51,452.5,504,504,504,504,2023-11-03,2023-11-03,430.76,0,0,185125137,98861537,0.00027224827928149,99.9985771786357,0
475.08,475,1,60,4,480,2023-11-03,2023-12-08,430.76,59,476,83002856,24707321,0.000578293354146754,99.9997867543257,0.991666666666667
462.01,462,473,471,473,471,2023-11-03,2023-11-03,430.76,-2,-2.00000000000006,185125137,98861537,0.00025442249909044,99.9988316011348,-0.00424628450106169
472.03,472,44,152,88,456,2023-11-03,2023-11-24,430.76,108,368,100730326,33682043,0.000452693859046977,99.9984681872269,0.807017543859649
464.01,464,445,444,445,444,2023-11-03,2023-11-03,430.76,-1,-0.999999999999943,185125137,98861537,0.000239837769843217,99.9990714389046,-0.00225225225225212
480.02,480,198,221,396,442,2023-11-03,2023-12-01,430.76,23,46,77639531,28317502,0.000569297617215127,99.9982496030276,0.104072398190045
492.01,492,436,436,436,436,2023-11-03,2023-11-17,430.76,0,0,672805518,235832752,6.48032735070404e-05,100,0
464.06,464,63,70,189,420,2023-11-03,2023-11-24,430.76,7,231,100730326,33682043,0.000416954870174847,99.9988851420971,0.55
485.01,485,410,410,410,410,2023-11-03,2023-11-03,430.76,0,0,185125137,98861537,0.000221471814494862,99.9992929107191,0
472.01,472,395,395,395,395,2023-11-03,2023-11-03,430.76,0,0,185125137,98861537,0.000213369187135294,99.9995062799062,0
472.06,472,48,59,192,354,2023-11-03,2023-12-01,430.76,11,162,77639531,28317502,0.000455953295235645,99.9987055563228,0.457627118644068
535.01,535,336,336,336,336,2023-11-03,2023-12-29,430.76,0,0,181777115,62642449,0.00018484174974391,99.9998657696817,0
520.01,520,301,304,301,304,2023-11-03,2023-12-01,430.76,3,3,77639531,28317502,0.000391553112292757,99.9990971094351,0.00986842105263158
505.01,505,303,303,303,303,2023-11-03,2023-12-01,430.76,0,0,77639531,28317502,0.000390265108633899,99.9994873745438,0
490.02,490,139,138,139,276,2023-11-03,2023-11-24,430.76,-1,137,100730326,33682043,0.000273998914686328,99.9991591410118,0.496376811594203
481.01,481,253,253,253,253,2023-11-03,2023-11-03,430.76,0,0,185125137,98861537,0.000136664314798049,99.999642944221,0
495.01,495,176,238,352,238,2023-11-03,2023-11-24,430.76,62,-114,100730326,33682043,0.000236274426432413,99.9993954154382,-0.478991596638655
485.03,485,73,74,146,222,2023-11-03,2023-12-01,430.76,1,76,77639531,28317502,0.000285936812266421,99.999773311356,0.342342342342342
490.03,490,70,70,210,210,2023-11-03,2023-11-10,430.76,0,0,127761173,59416338,0.000164369185934134,99.999577336379,0
485.01,485,196,196,196,196,2023-11-03,2023-11-10,430.76,0,0,127761173,59416338,0.000153411240205191,99.9997307476192,0
500.01,500,186,186,186,186,2023-11-03,2023-11-10,430.76,0,0,127761173,59416338,0.00014558413611309,99.9998763317554,0
467.01,467,185,185,185,185,2023-11-03,2023-11-03,430.76,0,0,185125137,98861537,9.99324041013404e-05,99.9997428766251,0
495.01,495,176,176,176,176,2023-11-03,2023-11-03,430.76,0,0,185125137,98861537,9.50708276855995e-05,99.9998379474528,0
485.01,485,167,167,167,167,2023-11-03,2023-11-24,430.76,0,0,100730326,33682043,0.000165789198379046,99.9995612046366,0
480.05,480,27,33,108,165,2023-11-03,2023-12-08,430.76,6,57,83002856,24707321,0.000198788340487947,99.9999855426662,0.345454545454545
530.01,530,148,148,148,148,2023-11-03,2023-11-24,430.76,0,0,100730326,33682043,0.000146926954252089,99.9997081315909,0
453.03,453,0,49,0,147,2023-11-03,2023-11-10,430.76,49,147,127761173,59416338,0.000115058430153893,99.9999913901855,1
468.03,468,49,49,147,147,2023-11-03,2023-11-24,430.76,0,0,100730326,33682043,0.000145934204561196,99.9998540657954,0
498.04,498,33,33,132,132,2023-11-03,2023-12-29,430.76,0,0,181777115,62642449,7.26164016851076e-05,99.9999383860834,0
500.01,500,129,129,129,129,2023-11-03,2023-11-03,430.76,0,0,185125137,98861537,6.9682595292286e-05,99.9999076300481,0
476.01,476,118,118,118,118,2023-11-03,2023-11-03,430.76,0,0,185125137,98861537,6.3740668561936e-05,99.9999713707167,0
497.04,497,28,28,112,112,2023-11-03,2023-12-29,430.76,0,0,181777115,62642449,6.16139165813034e-05,100,0
490.01,490,78,78,156,78,2023-11-03,2023-12-01,430.76,0,-78,77639531,28317502,0.000100464285390905,99.9998737756414,-1
540.01,540,78,78,78,78,2023-11-03,2023-12-01,430.76,0,0,77639531,28317502,0.000100464285390905,99.9999742399268,0
510.01,510,62,62,62,62,2023-11-03,2023-11-24,430.76,0,0,100730326,33682043,6.15504808353345e-05,99.9999156162763,0
469.01,469,50,50,50,50,2023-11-03,2023-11-03,430.76,0,0,185125137,98861537,2.70087578652271e-05,99.9999983794745,0
505.01,505,33,43,33,43,2023-11-03,2023-11-24,430.76,10,10,100730326,33682043,4.26882367083772e-05,99.999958304513,0.232558139534884
515.01,515,40,40,40,40,2023-11-03,2023-11-24,430.76,0,0,100730326,33682043,3.97099876356997e-05,99.9999980145006,0
495.02,495,3,6,3,12,2023-11-03,2023-12-01,430.76,3,9,77639531,28317502,1.5456043906293e-05,99.9999896959707,0.75
510.01,510,5,5,5,5,2023-11-03,2023-12-01,430.76,0,0,77639531,28317502,6.44001829428877e-06,99.999996135989,0
468.02,468,2,2,4,4,2023-11-03,2023-11-10,430.76,0,0,127761173,59416338,3.13084163684064e-06,99.9999945210271,0
485.04,485,0,1,0,4,2023-11-03,2023-12-08,430.76,1,4,83002856,24707321,4.81911128455628e-06,99.9999903617774,1
495.02,495,2,2,4,4,2023-11-03,2023-12-08,430.76,0,0,83002856,24707321,4.81911128455628e-06,99.9999951808887,0
463.01,463,3,3,3,3,2023-11-03,2023-11-03,430.76,0,0,185125137,98861537,1.62052547191363e-06,100,0
525.01,525,3,3,3,3,2023-11-03,2023-12-01,430.76,0,0,77639531,28317502,3.86401097657326e-06,100,0
463.01,463,0,2,0,2,2023-11-03,2023-11-10,430.76,2,2,127761173,59416338,1.56542081842032e-06,99.999996086448,1
525.01,525,2,2,2,2,2023-11-03,2023-11-10,430.76,0,0,127761173,59416338,1.56542081842032e-06,99.9999976518688,0
520.01,520,2,2,2,2,2023-11-03,2023-11-24,430.76,0,0,100730326,33682043,1.98549938178498e-06,100,0
505.02,505,1,1,2,2,2023-11-03,2023-12-08,430.76,0,0,83002856,24707321,2.40955564227814e-06,99.9999975904444,0
515.02,515,1,1,2,2,2023-11-03,2023-12-08,430.76,0,0,83002856,24707321,2.40955564227814e-06,100,0
457.01,457,0,1,0,1,2023-11-03,2023-11-10,430.76,1,1,127761173,59416338,7.8271040921016e-07,99.9999984345792,1
469.01,469,1,1,1,1,2023-11-03,2023-11-10,430.76,0,0,127761173,59416338,7.8271040921016e-07,99.9999992172896,0
473.01,473,1,1,1,1,2023-11-03,2023-11-10,430.76,0,0,127761173,59416338,7.8271040921016e-07,100,0
305,305,1,1,0,0,2023-11-03,2023-11-03,430.76,0,0,185125137,98861537,0,100,
310,310,0,0,0,0,2023-11-03,2023-11-03,430.76,0,0,185125137,98861537,0,100,
315,315,0,0,0,0,2023-11-03,2023-11-03,430.76,0,0,185125137,98861537,0,100,
335,335,27,27,0,0,2023-11-03,2023-11-03,430.76,0,0,185125137,98861537,0,100,
345,345,1,1,0,0,2023-11-03,2023-11-03,430.76,0,0,185125137,98861537,0,100,
354,354,0,0,0,0,2023-11-03,2023-11-03,430.76,0,0,185125137,98861537,0,100,
357,357,0,0,0,0,2023-11-03,2023-11-03,430.76,0,0,185125137,98861537,0,100,
358,358,0,0,0,0,2023-11-03,2023-11-03,430.76,0,0,185125137,98861537,0,100,
359,359,0,0,0,0,2023-11-03,2023-11-03,430.76,0,0,185125137,98861537,0,100,
361,361,0,0,0,0,2023-11-03,2023-11-03,430.76,0,0,185125137,98861537,0,100,
362,362,0,0,0,0,2023-11-03,2023-11-03,430.76,0,0,185125137,98861537,0,100,
363,363,0,0,0,0,2023-11-03,2023-11-03,430.76,0,0,185125137,98861537,0,100,
366,366,0,0,0,0,2023-11-03,2023-11-03,430.76,0,0,185125137,98861537,0,100,
367,367,0,0,0,0,2023-11-03,2023-11-03,430.76,0,0,185125137,98861537,0,100,
368,368,0,0,0,0,2023-11-03,2023-11-03,430.76,0,0,185125137,98861537,0,100,
369,369,0,0,0,0,2023-11-03,2023-11-03,430.76,0,0,185125137,98861537,0,100,
371,371,0,0,0,0,2023-11-03,2023-11-03,430.76,0,0,185125137,98861537,0,100,
372,372,0,0,0,0,2023-11-03,2023-11-03,430.76,0,0,185125137,98861537,0,100,
373,373,0,0,0,0,2023-11-03,2023-11-03,430.76,0,0,185125137,98861537,0,100,
374,374,0,0,0,0,2023-11-03,2023-11-03,430.76,0,0,185125137,98861537,0,100,
376,376,0,0,0,0,2023-11-03,2023-11-03,430.76,0,0,185125137,98861537,0,100,
377,377,0,0,0,0,2023-11-03,2023-11-03,430.76,0,0,185125137,98861537,0,100,
379,379,0,0,0,0,2023-11-03,2023-11-03,430.76,0,0,185125137,98861537,0,100,
381,381,0,0,0,0,2023-11-03,2023-11-03,430.76,0,0,185125137,98861537,0,100,
382,382,0,0,0,0,2023-11-03,2023-11-03,430.76,0,0,185125137,98861537,0,100,
383,383,0,0,0,0,2023-11-03,2023-11-03,430.76,0,0,185125137,98861537,0,100,
384,384,0,0,0,0,2023-11-03,2023-11-03,430.76,0,0,185125137,98861537,0,100,
386,386,1,1,0,0,2023-11-03,2023-11-03,430.76,0,0,185125137,98861537,0,100,
387,387,0,0,0,0,2023-11-03,2023-11-03,430.76,0,0,185125137,98861537,0,100,
389,389,0,0,0,0,2023-11-03,2023-11-03,430.76,0,0,185125137,98861537,0,100,
391,391,0,0,0,0,2023-11-03,2023-11-03,430.76,0,0,185125137,98861537,0,100,
471,471,0,0,0,0,2023-11-03,2023-11-03,430.76,0,0,185125137,98861537,0,100,
473,473,0,0,0,0,2023-11-03,2023-11-03,430.76,0,0,185125137,98861537,0,100,
477,477,0,0,0,0,2023-11-03,2023-11-03,430.76,0,0,185125137,98861537,0,100,
478,478,0,0,0,0,2023-11-03,2023-11-03,430.76,0,0,185125137,98861537,0,100,
479,479,0,0,0,0,2023-11-03,2023-11-03,430.76,0,0,185125137,98861537,0,100,
483,483,0,0,0,0,2023-11-03,2023-11-03,430.76,0,0,185125137,98861537,0,100,
484,484,0,0,0,0,2023-11-03,2023-11-03,430.76,0,0,185125137,98861537,0,100,
486,486,0,0,0,0,2023-11-03,2023-11-03,430.76,0,0,185125137,98861537,0,100,
487,487,0,0,0,0,2023-11-03,2023-11-03,430.76,0,0,185125137,98861537,0,100,
488,488,0,0,0,0,2023-11-03,2023-11-03,430.76,0,0,185125137,98861537,0,100,
489,489,0,0,0,0,2023-11-03,2023-11-03,430.76,0,0,185125137,98861537,0,100,
505,505,0,0,0,0,2023-11-03,2023-11-03,430.76,0,0,185125137,98861537,0,100,
510,510,0,0,0,0,2023-11-03,2023-11-03,430.76,0,0,185125137,98861537,0,100,
515,515,0,0,0,0,2023-11-03,2023-11-03,430.76,0,0,185125137,98861537,0,100,
520,520,1,1,0,0,2023-11-03,2023-11-03,430.76,0,0,185125137,98861537,0,100,
525,525,0,0,0,0,2023-11-03,2023-11-03,430.76,0,0,185125137,98861537,0,100,
530,530,0,0,0,0,2023-11-03,2023-11-03,430.76,0,0,185125137,98861537,0,100,
540,540,40,40,0,0,2023-11-03,2023-11-03,430.76,0,0,185125137,98861537,0,100,
305,305,0,0,0,0,2023-11-03,2023-11-10,430.76,0,0,127761173,59416338,0,100,
310,310,0,0,0,0,2023-11-03,2023-11-10,430.76,0,0,127761173,59416338,0,100,
315,315,0,0,0,0,2023-11-03,2023-11-10,430.76,0,0,127761173,59416338,0,100,
320,320,4,4,0,0,2023-11-03,2023-11-10,430.76,0,0,127761173,59416338,0,100,
330,330,3,3,0,0,2023-11-03,2023-11-10,430.76,0,0,127761173,59416338,0,100,
335,335,0,0,0,0,2023-11-03,2023-11-10,430.76,0,0,127761173,59416338,0,100,
340,340,0,0,0,0,2023-11-03,2023-11-10,430.76,0,0,127761173,59416338,0,100,
354,354,0,0,0,0,2023-11-03,2023-11-10,430.76,0,0,127761173,59416338,0,100,
356,356,0,0,0,0,2023-11-03,2023-11-10,430.76,0,0,127761173,59416338,0,100,
357,357,0,0,0,0,2023-11-03,2023-11-10,430.76,0,0,127761173,59416338,0,100,
358,358,0,0,0,0,2023-11-03,2023-11-10,430.76,0,0,127761173,59416338,0,100,
359,359,0,0,0,0,2023-11-03,2023-11-10,430.76,0,0,127761173,59416338,0,100,
361,361,0,0,0,0,2023-11-03,2023-11-10,430.76,0,0,127761173,59416338,0,100,
362,362,0,0,0,0,2023-11-03,2023-11-10,430.76,0,0,127761173,59416338,0,100,
363,363,0,0,0,0,2023-11-03,2023-11-10,430.76,0,0,127761173,59416338,0,100,
364,364,0,0,0,0,2023-11-03,2023-11-10,430.76,0,0,127761173,59416338,0,100,
365,365,0,0,0,0,2023-11-03,2023-11-10,430.76,0,0,127761173,59416338,0,100,
366,366,0,0,0,0,2023-11-03,2023-11-10,430.76,0,0,127761173,59416338,0,100,
367,367,0,0,0,0,2023-11-03,2023-11-10,430.76,0,0,127761173,59416338,0,100,
368,368,0,0,0,0,2023-11-03,2023-11-10,430.76,0,0,127761173,59416338,0,100,
369,369,0,0,0,0,2023-11-03,2023-11-10,430.76,0,0,127761173,59416338,0,100,
371,371,0,0,0,0,2023-11-03,2023-11-10,430.76,0,0,127761173,59416338,0,100,
372,372,0,0,0,0,2023-11-03,2023-11-10,430.76,0,0,127761173,59416338,0,100,
373,373,0,0,0,0,2023-11-03,2023-11-10,430.76,0,0,127761173,59416338,0,100,
374,374,0,0,0,0,2023-11-03,2023-11-10,430.76,0,0,127761173,59416338,0,100,
376,376,0,0,0,0,2023-11-03,2023-11-10,430.76,0,0,127761173,59416338,0,100,
377,377,0,0,0,0,2023-11-03,2023-11-10,430.76,0,0,127761173,59416338,0,100,
378,378,0,0,0,0,2023-11-03,2023-11-10,430.76,0,0,127761173,59416338,0,100,
379,379,0,0,0,0,2023-11-03,2023-11-10,430.76,0,0,127761173,59416338,0,100,
381,381,0,0,0,0,2023-11-03,2023-11-10,430.76,0,0,127761173,59416338,0,100,
382,382,0,0,0,0,2023-11-03,2023-11-10,430.76,0,0,127761173,59416338,0,100,
383,383,0,0,0,0,2023-11-03,2023-11-10,430.76,0,0,127761173,59416338,0,100,
384,384,0,0,0,0,2023-11-03,2023-11-10,430.76,0,0,127761173,59416338,0,100,
387,387,0,0,0,0,2023-11-03,2023-11-10,430.76,0,0,127761173,59416338,0,100,
389,389,0,0,0,0,2023-11-03,2023-11-10,430.76,0,0,127761173,59416338,0,100,
391,391,0,0,0,0,2023-11-03,2023-11-10,430.76,0,0,127761173,59416338,0,100,
393,393,0,0,0,0,2023-11-03,2023-11-10,430.76,0,0,127761173,59416338,0,100,
397,397,0,0,0,0,2023-11-03,2023-11-10,430.76,0,0,127761173,59416338,0,100,
459,459,0,0,0,0,2023-11-03,2023-11-10,430.76,0,0,127761173,59416338,0,100,
461,461,0,0,0,0,2023-11-03,2023-11-10,430.76,0,0,127761173,59416338,0,100,
467,467,0,0,0,0,2023-11-03,2023-11-10,430.76,0,0,127761173,59416338,0,100,
471,471,0,0,0,0,2023-11-03,2023-11-10,430.76,0,0,127761173,59416338,0,100,
472,472,0,0,0,0,2023-11-03,2023-11-10,430.76,0,0,127761173,59416338,0,100,
474,474,0,0,0,0,2023-11-03,2023-11-10,430.76,0,0,127761173,59416338,0,100,
476,476,0,0,0,0,2023-11-03,2023-11-10,430.76,0,0,127761173,59416338,0,100,
477,477,0,0,0,0,2023-11-03,2023-11-10,430.76,0,0,127761173,59416338,0,100,
478,478,0,0,0,0,2023-11-03,2023-11-10,430.76,0,0,127761173,59416338,0,100,
495,495,8068,8068,0,0,2023-11-03,2023-11-10,430.76,0,0,127761173,59416338,0,100,
510,510,102,102,0,0,2023-11-03,2023-11-10,430.76,0,0,127761173,59416338,0,100,
515,515,45,45,0,0,2023-11-03,2023-11-10,430.76,0,0,127761173,59416338,0,100,
520,520,492,492,0,0,2023-11-03,2023-11-10,430.76,0,0,127761173,59416338,0,100,
530,530,0,0,0,0,2023-11-03,2023-11-10,430.76,0,0,127761173,59416338,0,100,
540,540,5,5,0,0,2023-11-03,2023-11-10,430.76,0,0,127761173,59416338,0,100,
215,215,0,0,0,0,2023-11-03,2023-11-17,430.76,0,0,672805518,235832752,0,100,
245,245,0,0,0,0,2023-11-03,2023-11-17,430.76,0,0,672805518,235832752,0,100,
255,255,0,0,0,0,2023-11-03,2023-11-17,430.76,0,0,672805518,235832752,0,100,
260,260,4,4,0,0,2023-11-03,2023-11-17,430.76,0,0,672805518,235832752,0,100,
265,265,2,2,0,0,2023-11-03,2023-11-17,430.76,0,0,672805518,235832752,0,100,
270,270,6,6,0,0,2023-11-03,2023-11-17,430.76,0,0,672805518,235832752,0,100,
275,275,0,0,0,0,2023-11-03,2023-11-17,430.76,0,0,672805518,235832752,0,100,
290,290,0,0,0,0,2023-11-03,2023-11-17,430.76,0,0,672805518,235832752,0,100,
295,295,0,0,0,0,2023-11-03,2023-11-17,430.76,0,0,672805518,235832752,0,100,
305,305,1,1,0,0,2023-11-03,2023-11-17,430.76,0,0,672805518,235832752,0,100,
315,315,2,2,0,0,2023-11-03,2023-11-17,430.76,0,0,672805518,235832752,0,100,
325,325,4,4,0,0,2023-11-03,2023-11-17,430.76,0,0,672805518,235832752,0,100,
378,378,0,0,0,0,2023-11-03,2023-11-17,430.76,0,0,672805518,235832752,0,100,
388,388,125,125,0,0,2023-11-03,2023-11-17,430.76,0,0,672805518,235832752,0,100,
510,510,4828,4828,0,0,2023-11-03,2023-11-17,430.76,0,0,672805518,235832752,0,100,
525,525,2621,2621,0,0,2023-11-03,2023-11-17,430.76,0,0,672805518,235832752,0,100,
530,530,6047,6047,0,0,2023-11-03,2023-11-17,430.76,0,0,672805518,235832752,0,100,
535,535,253,253,0,0,2023-11-03,2023-11-17,430.76,0,0,672805518,235832752,0,100,
540,540,5144,5144,0,0,2023-11-03,2023-11-17,430.76,0,0,672805518,235832752,0,100,
545,545,300,300,0,0,2023-11-03,2023-11-17,430.76,0,0,672805518,235832752,0,100,
550,550,1836,1836,0,0,2023-11-03,2023-11-17,430.76,0,0,672805518,235832752,0,100,
300,300,0,0,0,0,2023-11-03,2023-11-24,430.76,0,0,100730326,33682043,0,100,
325,325,0,0,0,0,2023-11-03,2023-11-24,430.76,0,0,100730326,33682043,0,100,
330,330,2,2,0,0,2023-11-03,2023-11-24,430.76,0,0,100730326,33682043,0,100,
335,335,1,1,0,0,2023-11-03,2023-11-24,430.76,0,0,100730326,33682043,0,100,
340,340,0,0,0,0,2023-11-03,2023-11-24,430.76,0,0,100730326,33682043,0,100,
345,345,1,1,0,0,2023-11-03,2023-11-24,430.76,0,0,100730326,33682043,0,100,
355,355,65,65,0,0,2023-11-03,2023-11-24,430.76,0,0,100730326,33682043,0,100,
360,360,2,2,0,0,2023-11-03,2023-11-24,430.76,0,0,100730326,33682043,0,100,
370,370,1,1,0,0,2023-11-03,2023-11-24,430.76,0,0,100730326,33682043,0,100,
384,384,0,0,0,0,2023-11-03,2023-11-24,430.76,0,0,100730326,33682043,0,100,
392,392,0,0,0,0,2023-11-03,2023-11-24,430.76,0,0,100730326,33682043,0,100,
394,394,0,0,0,0,2023-11-03,2023-11-24,430.76,0,0,100730326,33682043,0,100,
525,525,141,141,0,0,2023-11-03,2023-11-24,430.76,0,0,100730326,33682043,0,100,
540,540,4,4,0,0,2023-11-03,2023-11-24,430.76,0,0,100730326,33682043,0,100,
290,290,0,0,0,0,2023-11-03,2023-12-01,430.76,0,0,77639531,28317502,0,100,
295,295,0,0,0,0,2023-11-03,2023-12-01,430.76,0,0,77639531,28317502,0,100,
305,305,0,0,0,0,2023-11-03,2023-12-01,430.76,0,0,77639531,28317502,0,100,
315,315,0,0,0,0,2023-11-03,2023-12-01,430.76,0,0,77639531,28317502,0,100,
320,320,0,0,0,0,2023-11-03,2023-12-01,430.76,0,0,77639531,28317502,0,100,
325,325,0,0,0,0,2023-11-03,2023-12-01,430.76,0,0,77639531,28317502,0,100,
335,335,0,0,0,0,2023-11-03,2023-12-01,430.76,0,0,77639531,28317502,0,100,
355,355,0,0,0,0,2023-11-03,2023-12-01,430.76,0,0,77639531,28317502,0,100,
382,382,0,0,0,0,2023-11-03,2023-12-01,430.76,0,0,77639531,28317502,0,100,
384,384,0,0,0,0,2023-11-03,2023-12-01,430.76,0,0,77639531,28317502,0,100,
386,386,0,0,0,0,2023-11-03,2023-12-01,430.76,0,0,77639531,28317502,0,100,
388,388,0,0,0,0,2023-11-03,2023-12-01,430.76,0,0,77639531,28317502,0,100,
515,515,2,2,0,0,2023-11-03,2023-12-01,430.76,0,0,77639531,28317502,0,100,
530,530,0,0,0,0,2023-11-03,2023-12-01,430.76,0,0,77639531,28317502,0,100,
300,300,0,0,0,0,2023-11-03,2023-12-08,430.76,0,0,83002856,24707321,0,100,
305,305,0,0,0,0,2023-11-03,2023-12-08,430.76,0,0,83002856,24707321,0,100,
315,315,0,0,0,0,2023-11-03,2023-12-08,430.76,0,0,83002856,24707321,0,100,
320,320,0,0,0,0,2023-11-03,2023-12-08,430.76,0,0,83002856,24707321,0,100,
335,335,0,0,0,0,2023-11-03,2023-12-08,430.76,0,0,83002856,24707321,0,100,
380,380,0,0,0,0,2023-11-03,2023-12-08,430.76,0,0,83002856,24707321,0,100,
386,386,0,0,0,0,2023-11-03,2023-12-08,430.76,0,0,83002856,24707321,0,100,
392,392,0,0,0,0,2023-11-03,2023-12-08,430.76,0,0,83002856,24707321,0,100,
490,490,0,0,0,0,2023-11-03,2023-12-08,430.76,0,0,83002856,24707321,0,100,
500,500,0,0,0,0,2023-11-03,2023-12-08,430.76,0,0,83002856,24707321,0,100,
510,510,0,0,0,0,2023-11-03,2023-12-08,430.76,0,0,83002856,24707321,0,100,
520,520,0,0,0,0,2023-11-03,2023-12-08,430.76,0,0,83002856,24707321,0,100,
525,525,0,0,0,0,2023-11-03,2023-12-08,430.76,0,0,83002856,24707321,0,100,
155,155,11,11,0,0,2023-11-03,2023-12-15,430.76,0,0,878851435,217070587,0,100,
160,160,0,0,0,0,2023-11-03,2023-12-15,430.76,0,0,878851435,217070587,0,100,
165,165,1,1,0,0,2023-11-03,2023-12-15,430.76,0,0,878851435,217070587,0,100,
180,180,17,17,0,0,2023-11-03,2023-12-15,430.76,0,0,878851435,217070587,0,100,
185,185,33,33,0,0,2023-11-03,2023-12-15,430.76,0,0,878851435,217070587,0,100,
190,190,8,8,0,0,2023-11-03,2023-12-15,430.76,0,0,878851435,217070587,0,100,
195,195,42,42,0,0,2023-11-03,2023-12-15,430.76,0,0,878851435,217070587,0,100,
205,205,13,13,0,0,2023-11-03,2023-12-15,430.76,0,0,878851435,217070587,0,100,
210,210,32,32,0,0,2023-11-03,2023-12-15,430.76,0,0,878851435,217070587,0,100,
215,215,6,6,0,0,2023-11-03,2023-12-15,430.76,0,0,878851435,217070587,0,100,
230,230,9,9,0,0,2023-11-03,2023-12-15,430.76,0,0,878851435,217070587,0,100,
245,245,21,21,0,0,2023-11-03,2023-12-15,430.76,0,0,878851435,217070587,0,100,
255,255,85,85,0,0,2023-11-03,2023-12-15,430.76,0,0,878851435,217070587,0,100,
265,265,761,761,0,0,2023-11-03,2023-12-15,430.76,0,0,878851435,217070587,0,100,
270,270,104,104,0,0,2023-11-03,2023-12-15,430.76,0,0,878851435,217070587,0,100,
275,275,44,44,0,0,2023-11-03,2023-12-15,430.76,0,0,878851435,217070587,0,100,
285,285,11,11,0,0,2023-11-03,2023-12-15,430.76,0,0,878851435,217070587,0,100,
295,295,44,44,0,0,2023-11-03,2023-12-15,430.76,0,0,878851435,217070587,0,100,
305,305,85,85,0,0,2023-11-03,2023-12-15,430.76,0,0,878851435,217070587,0,100,
345,345,483,483,0,0,2023-11-03,2023-12-15,430.76,0,0,878851435,217070587,0,100,
346,346,37,37,0,0,2023-11-03,2023-12-15,430.76,0,0,878851435,217070587,0,100,
347,347,77,77,0,0,2023-11-03,2023-12-15,430.76,0,0,878851435,217070587,0,100,
349,349,54,54,0,0,2023-11-03,2023-12-15,430.76,0,0,878851435,217070587,0,100,
351,351,105,105,0,0,2023-11-03,2023-12-15,430.76,0,0,878851435,217070587,0,100,
352,352,43,43,0,0,2023-11-03,2023-12-15,430.76,0,0,878851435,217070587,0,100,
353,353,2,2,0,0,2023-11-03,2023-12-15,430.76,0,0,878851435,217070587,0,100,
354,354,13,13,0,0,2023-11-03,2023-12-15,430.76,0,0,878851435,217070587,0,100,
356,356,0,0,0,0,2023-11-03,2023-12-15,430.76,0,0,878851435,217070587,0,100,
357,357,6,6,0,0,2023-11-03,2023-12-15,430.76,0,0,878851435,217070587,0,100,
358,358,3,3,0,0,2023-11-03,2023-12-15,430.76,0,0,878851435,217070587,0,100,
359,359,5,5,0,0,2023-11-03,2023-12-15,430.76,0,0,878851435,217070587,0,100,
361,361,3,3,0,0,2023-11-03,2023-12-15,430.76,0,0,878851435,217070587,0,100,
363,363,166,166,0,0,2023-11-03,2023-12-15,430.76,0,0,878851435,217070587,0,100,
364,364,85,85,0,0,2023-11-03,2023-12-15,430.76,0,0,878851435,217070587,0,100,
366,366,45,45,0,0,2023-11-03,2023-12-15,430.76,0,0,878851435,217070587,0,100,
367,367,95,95,0,0,2023-11-03,2023-12-15,430.76,0,0,878851435,217070587,0,100,
369,369,83,83,0,0,2023-11-03,2023-12-15,430.76,0,0,878851435,217070587,0,100,
372,372,48,48,0,0,2023-11-03,2023-12-15,430.76,0,0,878851435,217070587,0,100,
373,373,129,129,0,0,2023-11-03,2023-12-15,430.76,0,0,878851435,217070587,0,100,
374,374,91,91,0,0,2023-11-03,2023-12-15,430.76,0,0,878851435,217070587,0,100,
525,525,10479,10479,0,0,2023-11-03,2023-12-15,430.76,0,0,878851435,217070587,0,100,
570,570,6833,6833,0,0,2023-11-03,2023-12-15,430.76,0,0,878851435,217070587,0,100,
575,575,6394,6394,0,0,2023-11-03,2023-12-15,430.76,0,0,878851435,217070587,0,100,
580,580,5345,5345,0,0,2023-11-03,2023-12-15,430.76,0,0,878851435,217070587,0,100,
585,585,1210,1210,0,0,2023-11-03,2023-12-15,430.76,0,0,878851435,217070587,0,100,
595,595,2687,2687,0,0,2023-11-03,2023-12-15,430.76,0,0,878851435,217070587,0,100,
610,610,765,765,0,0,2023-11-03,2023-12-15,430.76,0,0,878851435,217070587,0,100,
615,615,269,269,0,0,2023-11-03,2023-12-15,430.76,0,0,878851435,217070587,0,100,
620,620,989,989,0,0,2023-11-03,2023-12-15,430.76,0,0,878851435,217070587,0,100,
625,625,1996,1996,0,0,2023-11-03,2023-12-15,430.76,0,0,878851435,217070587,0,100,
630,630,7892,7892,0,0,2023-11-03,2023-12-15,430.76,0,0,878851435,217070587,0,100,
635,635,1444,1444,0,0,2023-11-03,2023-12-15,430.76,0,0,878851435,217070587,0,100,
640,640,104,104,0,0,2023-11-03,2023-12-15,430.76,0,0,878851435,217070587,0,100,
645,645,472,472,0,0,2023-11-03,2023-12-15,430.76,0,0,878851435,217070587,0,100,
650,650,5433,5433,0,0,2023-11-03,2023-12-15,430.76,0,0,878851435,217070587,0,100,
655,655,2046,2046,0,0,2023-11-03,2023-12-15,430.76,0,0,878851435,217070587,0,100,
660,660,39312,39312,0,0,2023-11-03,2023-12-15,430.76,0,0,878851435,217070587,0,100,
665,665,3361,3361,0,0,2023-11-03,2023-12-15,430.76,0,0,878851435,217070587,0,100,
670,670,258,258,0,0,2023-11-03,2023-12-15,430.76,0,0,878851435,217070587,0,100,
675,675,220,220,0,0,2023-11-03,2023-12-15,430.76,0,0,878851435,217070587,0,100,
680,680,611,611,0,0,2023-11-03,2023-12-15,430.76,0,0,878851435,217070587,0,100,
685,685,212,212,0,0,2023-11-03,2023-12-15,430.76,0,0,878851435,217070587,0,100,
690,690,163,163,0,0,2023-11-03,2023-12-15,430.76,0,0,878851435,217070587,0,100,
695,695,1179,1179,0,0,2023-11-03,2023-12-15,430.76,0,0,878851435,217070587,0,100,
705,705,109,109,0,0,2023-11-03,2023-12-15,430.76,0,0,878851435,217070587,0,100,
710,710,173,173,0,0,2023-11-03,2023-12-15,430.76,0,0,878851435,217070587,0,100,
715,715,86,86,0,0,2023-11-03,2023-12-15,430.76,0,0,878851435,217070587,0,100,
720,720,1332,1332,0,0,2023-11-03,2023-12-15,430.76,0,0,878851435,217070587,0,100,
375,375,0,0,0,0,2023-11-03,2023-12-22,430.76,0,0,2338637,2338637,0,100,
380,380,0,0,0,0,2023-11-03,2023-12-22,430.76,0,0,2338637,2338637,0,100,
385,385,0,0,0,0,2023-11-03,2023-12-22,430.76,0,0,2338637,2338637,0,100,
390,390,0,0,0,0,2023-11-03,2023-12-22,430.76,0,0,2338637,2338637,0,100,
395,395,0,0,0,0,2023-11-03,2023-12-22,430.76,0,0,2338637,2338637,0,100,
400,400,0,0,0,0,2023-11-03,2023-12-22,430.76,0,0,2338637,2338637,0,100,
406,406,0,0,0,0,2023-11-03,2023-12-22,430.76,0,0,2338637,2338637,0,100,
407,407,0,0,0,0,2023-11-03,2023-12-22,430.76,0,0,2338637,2338637,0,100,
408,408,0,0,0,0,2023-11-03,2023-12-22,430.76,0,0,2338637,2338637,0,100,
409,409,0,0,0,0,2023-11-03,2023-12-22,430.76,0,0,2338637,2338637,0,100,
410,410,0,0,0,0,2023-11-03,2023-12-22,430.76,0,0,2338637,2338637,0,100,
411,411,0,0,0,0,2023-11-03,2023-12-22,430.76,0,0,2338637,2338637,0,100,
412,412,0,0,0,0,2023-11-03,2023-12-22,430.76,0,0,2338637,2338637,0,100,
413,413,0,0,0,0,2023-11-03,2023-12-22,430.76,0,0,2338637,2338637,0,100,
414,414,0,0,0,0,2023-11-03,2023-12-22,430.76,0,0,2338637,2338637,0,100,
416,416,0,0,0,0,2023-11-03,2023-12-22,430.76,0,0,2338637,2338637,0,100,
417,417,0,0,0,0,2023-11-03,2023-12-22,430.76,0,0,2338637,2338637,0,100,
418,418,0,0,0,0,2023-11-03,2023-12-22,430.76,0,0,2338637,2338637,0,100,
419,419,0,0,0,0,2023-11-03,2023-12-22,430.76,0,0,2338637,2338637,0,100,
422,422,0,0,0,0,2023-11-03,2023-12-22,430.76,0,0,2338637,2338637,0,100,
424,424,0,0,0,0,2023-11-03,2023-12-22,430.76,0,0,2338637,2338637,0,100,
270,270,62,62,0,0,2023-11-03,2023-12-29,430.76,0,0,181777115,62642449,0,100,
275,275,59,59,0,0,2023-11-03,2023-12-29,430.76,0,0,181777115,62642449,0,100,
280,280,48,48,0,0,2023-11-03,2023-12-29,430.76,0,0,181777115,62642449,0,100,
285,285,17,17,0,0,2023-11-03,2023-12-29,430.76,0,0,181777115,62642449,0,100,
290,290,16,16,0,0,2023-11-03,2023-12-29,430.76,0,0,181777115,62642449,0,100,
295,295,7,7,0,0,2023-11-03,2023-12-29,430.76,0,0,181777115,62642449,0,100,
305,305,31,31,0,0,2023-11-03,2023-12-29,430.76,0,0,181777115,62642449,0,100,
310,310,66,66,0,0,2023-11-03,2023-12-29,430.76,0,0,181777115,62642449,0,100,
315,315,48,48,0,0,2023-11-03,2023-12-29,430.76,0,0,181777115,62642449,0,100,
320,320,80,80,0,0,2023-11-03,2023-12-29,430.76,0,0,181777115,62642449,0,100,
326,326,6,6,0,0,2023-11-03,2023-12-29,430.76,0,0,181777115,62642449,0,100,
327,327,200,200,0,0,2023-11-03,2023-12-29,430.76,0,0,181777115,62642449,0,100,
328,328,24,24,0,0,2023-11-03,2023-12-29,430.76,0,0,181777115,62642449,0,100,
329,329,1,1,0,0,2023-11-03,2023-12-29,430.76,0,0,181777115,62642449,0,100,
330,330,9,9,0,0,2023-11-03,2023-12-29,430.76,0,0,181777115,62642449,0,100,
331,331,5,5,0,0,2023-11-03,2023-12-29,430.76,0,0,181777115,62642449,0,100,
332,332,52,52,0,0,2023-11-03,2023-12-29,430.76,0,0,181777115,62642449,0,100,
333,333,25,25,0,0,2023-11-03,2023-12-29,430.76,0,0,181777115,62642449,0,100,
334,334,9,9,0,0,2023-11-03,2023-12-29,430.76,0,0,181777115,62642449,0,100,
336,336,20,20,0,0,2023-11-03,2023-12-29,430.76,0,0,181777115,62642449,0,100,
337,337,5,5,0,0,2023-11-03,2023-12-29,430.76,0,0,181777115,62642449,0,100,
338,338,47,47,0,0,2023-11-03,2023-12-29,430.76,0,0,181777115,62642449,0,100,
339,339,25,25,0,0,2023-11-03,2023-12-29,430.76,0,0,181777115,62642449,0,100,
341,341,30,30,0,0,2023-11-03,2023-12-29,430.76,0,0,181777115,62642449,0,100,
343,343,8,8,0,0,2023-11-03,2023-12-29,430.76,0,0,181777115,62642449,0,100,
344,344,10,10,0,0,2023-11-03,2023-12-29,430.76,0,0,181777115,62642449,0,100,
345,345,56,56,0,0,2023-11-03,2023-12-29,430.76,0,0,181777115,62642449,0,100,
346,346,23,23,0,0,2023-11-03,2023-12-29,430.76,0,0,181777115,62642449,0,100,
347,347,142,142,0,0,2023-11-03,2023-12-29,430.76,0,0,181777115,62642449,0,100,
351,351,5,5,0,0,2023-11-03,2023-12-29,430.76,0,0,181777115,62642449,0,100,
352,352,6,6,0,0,2023-11-03,2023-12-29,430.76,0,0,181777115,62642449,0,100,
353,353,27,27,0,0,2023-11-03,2023-12-29,430.76,0,0,181777115,62642449,0,100,
354,354,4,4,0,0,2023-11-03,2023-12-29,430.76,0,0,181777115,62642449,0,100,
357,357,117,117,0,0,2023-11-03,2023-12-29,430.76,0,0,181777115,62642449,0,100,
358,358,12,12,0,0,2023-11-03,2023-12-29,430.76,0,0,181777115,62642449,0,100,
361,361,15,15,0,0,2023-11-03,2023-12-29,430.76,0,0,181777115,62642449,0,100,
362,362,2,2,0,0,2023-11-03,2023-12-29,430.76,0,0,181777115,62642449,0,100,
363,363,24,24,0,0,2023-11-03,2023-12-29,430.76,0,0,181777115,62642449,0,100,
364,364,61,61,0,0,2023-11-03,2023-12-29,430.76,0,0,181777115,62642449,0,100,
366,366,52,52,0,0,2023-11-03,2023-12-29,430.76,0,0,181777115,62642449,0,100,
367,367,372,372,0,0,2023-11-03,2023-12-29,430.76,0,0,181777115,62642449,0,100,
368,368,44,44,0,0,2023-11-03,2023-12-29,430.76,0,0,181777115,62642449,0,100,
369,369,37,37,0,0,2023-11-03,2023-12-29,430.76,0,0,181777115,62642449,0,100,
371,371,17,17,0,0,2023-11-03,2023-12-29,430.76,0,0,181777115,62642449,0,100,
372,372,4,4,0,0,2023-11-03,2023-12-29,430.76,0,0,181777115,62642449,0,100,
373,373,2,2,0,0,2023-11-03,2023-12-29,430.76,0,0,181777115,62642449,0,100,
374,374,9,9,0,0,2023-11-03,2023-12-29,430.76,0,0,181777115,62642449,0,100,
376,376,64,64,0,0,2023-11-03,2023-12-29,430.76,0,0,181777115,62642449,0,100,
377,377,141,141,0,0,2023-11-03,2023-12-29,430.76,0,0,181777115,62642449,0,100,
378,378,40,40,0,0,2023-11-03,2023-12-29,430.76,0,0,181777115,62642449,0,100,
381,381,20,20,0,0,2023-11-03,2023-12-29,430.76,0,0,181777115,62642449,0,100,
382,382,55,55,0,0,2023-11-03,2023-12-29,430.76,0,0,181777115,62642449,0,100,
383,383,5,5,0,0,2023-11-03,2023-12-29,430.76,0,0,181777115,62642449,0,100,
384,384,2,2,0,0,2023-11-03,2023-12-29,430.76,0,0,181777115,62642449,0,100,
388,388,9,9,0,0,2023-11-03,2023-12-29,430.76,0,0,181777115,62642449,0,100,
389,389,22,22,0,0,2023-11-03,2023-12-29,430.76,0,0,181777115,62642449,0,100,
393,393,886,886,0,0,2023-11-03,2023-12-29,430.76,0,0,181777115,62642449,0,100,
396,396,107,107,0,0,2023-11-03,2023-12-29,430.76,0,0,181777115,62642449,0,100,
401,401,1290,1290,0,0,2023-11-03,2023-12-29,430.76,0,0,181777115,62642449,0,100,
