Watch,strike,open_interest.yt,open_interest.td,OI_Dollar.yt,OI_Dollar.td,Date.td,expiry,stkClose,diff_oi,diff_oi_d,totalOI,totalOIdiff,OI_pct,cum_sep_OI,pct
618.94,630,41882,48917,35683464,54102202,2025-08-01,2025-09-19,632.08,7035,18418738,595655559,168675191,9.08279981317189,9.08279981317189,0.340443407460569
595.03,600,99535,102752,38320975,51067744,2025-08-01,2025-09-19,632.08,3217,12746769,595655559,168675191,8.57336815352377,17.6561679666957,0.24960509318759
611.68,620,41003,47348,26241920,39393536,2025-08-01,2025-09-19,632.08,6345,13151616,595655559,168675191,6.61347575873123,24.2696437254269,0.333852132491991
615.45,625,28852,39346,21350480,37575430,2025-08-01,2025-09-19,632.08,10494,16224950,595655559,168675191,6.30824801888569,30.5778917443126,0.431796788486519
602.96,620,19231,19020,28673421,32410080,2025-08-01,2025-12-19,632.08,-211,3736659,380408956,31818097,8.51979941292444,8.51979941292444,0.115293112513144
622.18,635,23042,25085,22811580,32158970,2025-08-01,2025-09-19,632.08,2043,9347390,595655559,168675191,5.3989204858575,35.9768122301701,0.290661983266255
603.7,610,48192,48855,23710464,30778650,2025-08-01,2025-09-19,632.08,663,7068186,595655559,168675191,5.16718924803991,41.14400147821,0.229645744696405
606.85,625,15564,15648,24980220,28401120,2025-08-01,2025-12-19,632.08,84,3420900,380408956,31818097,7.4659440983298,15.9857435112542,0.120449475231963
620.74,625,65233,65515,16308250,27909390,2025-08-01,2025-08-15,632.08,282,11601140,243349966,91051840,11.4688283950695,11.4688283950695,0.415671571467524
617.16,640,11509,11547,23593450,26373348,2025-08-01,2025-12-19,632.08,38,2779898,380408956,31818097,6.93289355679628,22.9186370680505,0.105405578389213
610.22,630,12361,12353,21631750,24434234,2025-08-01,2025-12-19,632.08,-8,2802484,380408956,31818097,6.42314898600863,29.3417860540592,0.114694980820762
587.18,600,15477,18022,17504487,23104204,2025-08-01,2025-12-19,632.08,2545,5599717,380408956,31818097,6.0735173648225,35.4153034188817,0.242367882485802
625.15,640,12036,15041,13901580,22335885,2025-08-01,2025-09-19,632.08,3005,8434305,595655559,168675191,3.74979879940984,44.8938002776198,0.377612304146444
599.48,605,34094,39826,15240018,21983952,2025-08-01,2025-09-19,632.08,5732,6743934,595655559,168675191,3.69071549284408,48.5845157704639,0.306766226563814
596.85,602,24193,40704,9773972,20962560,2025-08-01,2025-09-19,632.08,16511,11188588,595655559,168675191,3.5192418979842,52.1037576684481,0.533741489589058
576.94,580,66519,66932,15631965,20481192,2025-08-01,2025-09-19,632.08,413,4849227,595655559,168675191,3.43842875140531,55.5421864198534,0.236764881653373
552.97,560,27666,27658,17816904,19443574,2025-08-01,2025-12-19,632.08,-8,1626670,380408956,31818097,5.11122929503269,40.5265327139143,0.0836610594327979
621.9,630,24989,23098,14068807,18709380,2025-08-01,2025-08-29,632.08,-1891,4640573,155069044,41373917,12.0651933599333,12.0651933599333,0.248034568756421
600.65,610,18964,19816,14697100,18527960,2025-08-01,2025-10-17,632.08,852,3830860,227356040,48158939,8.14931505668378,8.14931505668378,0.206761024959035
608.6,620,15274,16144,14433930,18404160,2025-08-01,2025-10-17,632.08,870,3970230,227356040,48158939,8.0948630174945,16.2441780741783,0.215724597047624
615.84,630,10220,12697,11957400,17978952,2025-08-01,2025-10-17,632.08,2477,6021552,227356040,48158939,7.90784005562377,24.1520181298021,0.334922302479032
608.15,610,97608,97116,11224920,17966460,2025-08-01,2025-08-15,632.08,-492,6741540,243349966,91051840,7.38297206090425,18.8518004559738,0.375229177033205
583.58,590,23259,27977,12280752,17961234,2025-08-01,2025-10-17,632.08,4718,5680482,227356040,48158939,7.90004699237372,32.0520651221758,0.316263459403736
616.82,620,57829,56393,11160997,17932974,2025-08-01,2025-08-15,632.08,-1436,6771977,243349966,91051840,7.36921163161371,26.2210120875875,0.377627101896205
543.53,550,27285,27284,15497880,17652748,2025-08-01,2025-12-19,632.08,-1,2154868,380408956,31818097,4.64046593056553,45.1669986444799,0.122069832980112
624.28,630,25028,29862,8534548,17081064,2025-08-01,2025-08-15,632.08,4834,8546516,243349966,91051840,7.01913556051206,33.2401476480995,0.500350329464253
607.86,615,19539,23555,10961379,16818270,2025-08-01,2025-09-19,632.08,4016,5856891,595655559,168675191,2.8234891366136,58.365675556467,0.348245747035813
586.13,590,39424,42461,12024320,16432407,2025-08-01,2025-09-19,632.08,3037,4408087,595655559,168675191,2.75870958504729,61.1243851415143,0.268255709586551
618.47,625,23268,23327,10703280,15232531,2025-08-01,2025-08-29,632.08,59,4529251,155069044,41373917,9.8230637186362,21.8882570785695,0.297340671750479
595.48,610,9726,10462,12556266,15190824,2025-08-01,2025-12-19,632.08,736,2634558,380408956,31818097,3.9932876869492,49.1602863314291,0.173430881695424
610.56,615,32529,33685,10539396,14956140,2025-08-01,2025-08-29,632.08,1156,4416744,155069044,41373917,9.64482633942078,31.5330834179903,0.295313095491216
614.5,620,24007,27068,9146667,14887400,2025-08-01,2025-08-29,632.08,3061,5740733,155069044,41373917,9.6004976983027,41.133581116293,0.385610180421027
618.95,635,8091,9251,10680120,14847855,2025-08-01,2025-10-17,632.08,1160,4167735,227356040,48158939,6.53066221596752,38.5827273381433,0.280696100547857
590.61,595,31903,33808,11229856,14841712,2025-08-01,2025-09-19,632.08,1905,3611856,595655559,168675191,2.491660117286,63.6160452588003,0.243358448135902
528.9,530,134461,134462,12235951,14790820,2025-08-01,2025-09-19,632.08,1,2554869,595655559,168675191,2.48311625343196,66.0991615122323,0.172733425192113
622,640,7841,8086,11565475,14554800,2025-08-01,2025-10-17,632.08,245,2989325,227356040,48158939,6.40176526649567,44.984492604639,0.20538413444362
612.59,615,54682,56528,8038254,13623248,2025-08-01,2025-08-15,632.08,1846,5584994,243349966,91051840,5.59821241150287,38.8383600596024,0.409960532172651
515.66,520,31349,31138,12163412,13513892,2025-08-01,2025-12-19,632.08,-211,1350480,380408956,31818097,3.55246420644208,52.7127505378711,0.0999327210843477
534.4,540,24092,24090,12768760,13490400,2025-08-01,2025-12-19,632.08,-2,721640,380408956,31818097,3.54628874720815,56.2590392850793,0.0534928541777857
597.4,600,49932,50324,9387216,13084240,2025-08-01,2025-08-29,632.08,392,3697024,155069044,41373917,8.43768663460645,49.5712677508994,0.282555501886239
523.97,525,124090,124055,12160820,12777665,2025-08-01,2025-09-19,632.08,-35,616845,595655559,168675191,2.14514324712279,68.2443047593551,0.04827525216853
592.32,600,14465,15282,9272065,11736576,2025-08-01,2025-10-17,632.08,817,2464511,227356040,48158939,5.16220110096921,50.1466937056082,0.209985518774811
556.29,560,31251,31267,9906567,11600057,2025-08-01,2025-10-17,632.08,16,1693490,227356040,48158939,5.10215475251944,55.2488484581276,0.145989799877708
627.34,635,8970,15033,4171050,11515278,2025-08-01,2025-08-15,632.08,6063,7344228,243349966,91051840,4.73198258018249,43.5703426397849,0.637781215529491
570.29,580,11931,11829,11191278,11485959,2025-08-01,2025-12-19,632.08,-102,294681,380408956,31818097,3.01937134203539,59.2784106271147,0.0256557593493064
598.89,600,101752,102150,7122640,11338650,2025-08-01,2025-08-15,632.08,398,4216010,243349966,91051840,4.65940069208804,48.2297433318729,0.371826452002664
538.71,540,86711,86893,9451499,11209197,2025-08-01,2025-09-19,632.08,182,1757698,595655559,168675191,1.8818252983013,70.1261300576564,0.15680855640239
474.48,475,210367,210468,10518350,10944336,2025-08-01,2025-09-19,632.08,101,425986,595655559,168675191,1.83735983566973,71.9634898933261,0.0389229643534336
612.39,625,8273,8545,8719742,10775245,2025-08-01,2025-10-17,632.08,272,2055503,227356040,48158939,4.73937046053406,59.9882189186617,0.190761602172387
604.85,615,10577,10610,9096220,10769150,2025-08-01,2025-10-17,632.08,33,1672930,227356040,48158939,4.73668964325733,64.724908561919,0.155344665084988
562.91,565,50897,50754,8703387,10607586,2025-08-01,2025-09-19,632.08,-143,1904199,595655559,168675191,1.78082548542118,73.7443153787473,0.179512944792529
496.63,500,31109,30956,9488245,10432172,2025-08-01,2025-12-19,632.08,-153,943927,380408956,31818097,2.74235709634554,62.0207677234602,0.0904823079987562
602,608,1040,17288,556400,10372800,2025-08-01,2025-09-19,632.08,16248,9816400,595655559,168675191,1.74140908168709,75.4857244604344,0.946359710010798
548.59,555,14640,14660,10086960,9397060,2025-08-01,2025-12-19,632.08,20,-689900,380408956,31818097,2.47025204106919,64.4910197645294,-0.0734165792279713
597.09,605,7754,11713,5489832,9264983,2025-08-01,2025-10-17,632.08,3959,3775151,227356040,48158939,4.07509868662385,68.8000072485429,0.407464428159231
578.96,590,8379,8380,9225279,9251520,2025-08-01,2025-12-19,632.08,1,26241,380408956,31818097,2.43199321521757,66.923012979747,0.00283639877555256
548.42,550,57160,55919,7087840,8835202,2025-08-01,2025-09-19,632.08,-1241,1747362,595655559,168675191,1.48327365815787,76.9689981185922,0.197772727776909
572.29,575,32151,31780,7233975,8612380,2025-08-01,2025-09-19,632.08,-371,1378405,595655559,168675191,1.44586579775377,78.414863916346,0.160049254677569
581.58,585,24463,24961,6409306,8536662,2025-08-01,2025-09-19,632.08,498,2127356,595655559,168675191,1.43315408897242,79.8480180053184,0.249202322875147
567.59,570,32460,32399,6199860,7808159,2025-08-01,2025-09-19,632.08,-61,1608299,595655559,168675191,1.31085136066026,81.1588693659787,0.205976722553934
615.63,620,33087,17799,9429795,7778163,2025-08-01,2025-08-22,632.08,-15288,-1651632,60984890,20108486,12.7542461747492,12.7542461747492,-0.212342168710015
587.95,595,10562,10943,6263266,7714815,2025-08-01,2025-10-17,632.08,381,1451549,227356040,48158939,3.39327470693103,72.1932819554739,0.188150850020383
546.87,550,24133,24221,6322846,7581173,2025-08-01,2025-10-17,632.08,88,1258327,227356040,48158939,3.33449377461008,75.527775730084,0.16598051515247
574.75,585,7341,7369,7451115,7553225,2025-08-01,2025-12-19,632.08,28,102109.999999999,380408956,31818097,1.98555393632741,68.9085669160744,0.0135187287549357
579.24,585,12735,12877,6163740,7417152,2025-08-01,2025-10-17,632.08,142,1253412,227356040,48158939,3.262350980427,78.790126710511,0.168988312495146
558.09,560,38684,38122,6112072,7281302,2025-08-01,2025-09-19,632.08,-562,1169230,595655559,168675191,1.22240141806517,82.3812707840438,0.160579797404365
603.61,605,42315,51441,3766035,7150299,2025-08-01,2025-08-15,632.08,9126,3384264,243349966,91051840,2.93827819971834,51.1680215315913,0.473303843657447
561.55,570,8365,8370,6223560,7072650,2025-08-01,2025-12-19,632.08,5,849089.999999999,380408956,31818097,1.85922278864539,70.7677897047198,0.120052596975674
479.43,480,120518,120518,6869526,6869526,2025-08-01,2025-09-19,632.08,0,0,595655559,168675191,1.15327153355753,83.5345423176014,0
629,635,9423,11286,3062475,6771600,2025-08-01,2025-08-08,632.08,1863,3709125,58500270,29786673,11.5753311907791,11.5753311907791,0.54774720893142
583.48,595,6082,5797,7042956,6678144,2025-08-01,2025-12-19,632.08,-285,-364812,380408956,31818097,1.75551702836355,72.5233067330833,-0.0546277528606751
630.72,635,13376,15543,2354176,6652404,2025-08-01,2025-08-01,632.08,2167,4298228,61309866,39049978,10.8504624687974,10.8504624687974,0.646116501643617
585.25,595,6633,6699,5671215,6531525,2025-08-01,2025-11-21,632.08,66,860310,69823438,8093490,9.35434459701053,9.35434459701053,0.131716559302766
551.63,555,19139,19160,6162758,6456920,2025-08-01,2025-10-17,632.08,21,294162,227356040,48158939,2.84000372279531,81.6301304333063,0.045557634290033
557.07,565,7845,7918,6064185,6278974,2025-08-01,2025-12-19,632.08,73,214788.999999999,380408956,31818097,1.65058521913454,74.1738919522179,0.0342076587671806
590.3,605,4315,4258,5281560,6259260,2025-08-01,2025-12-19,632.08,-57,977700,380408956,31818097,1.64540290160782,75.8192948538257,0.156200573230701
497.51,500,25116,25121,5651100,6255129,2025-08-01,2025-11-21,632.08,5,604029.000000001,69823438,8093490,8.95849471061565,18.3128393076262,0.0965653945745964
612.45,630,3382,3473,5164314,6095115,2025-08-01,2025-11-21,632.08,91,930801,69823438,8093490,8.72932524462631,27.0421645522525,0.152712623141647
598.5,604,10702,10880,4601860,5984000,2025-08-01,2025-09-19,632.08,178,1382140,595655559,168675191,1.00460742950944,84.5391497471108,0.230972593582888
628.22,637,6026,6766,3169676,5940548,2025-08-01,2025-08-15,632.08,740,2770872,243349966,91051840,2.44115423463836,53.6091757662296,0.466433736416236
628.18,630,25284,30153,2123856,5487846,2025-08-01,2025-08-01,632.08,4869,3363990,61309866,39049978,8.95099982766232,19.8014622964598,0.612989140001378
631.14,637,4788,9217,1168272,5401162,2025-08-01,2025-08-01,632.08,4429,4232890,61309866,39049978,8.80961312164668,28.6110754181065,0.78369987791516
622.39,625,19819,20503,2754841,5351283,2025-08-01,2025-08-08,632.08,684,2596442,58500270,29786673,9.1474500886919,20.722781279471,0.485199904396759
559.01,565,8840,8860,5498480,5307140,2025-08-01,2025-11-21,632.08,20,-191340,69823438,8093490,7.60080017830116,34.6429647305537,-0.0360533168523913
537.37,540,19891,19890,4395911,5231070,2025-08-01,2025-10-17,632.08,-1,835159,227356040,48158939,2.30082737190532,83.9309578052116,0.15965356991973
570.13,575,11528,10618,4749536,5170966,2025-08-01,2025-10-17,632.08,-910,421430,227356040,48158939,2.27439130273381,86.2053491079454,0.0814992788581476
565.49,570,11164,11444,4130680,5161244,2025-08-01,2025-10-17,632.08,280,1030564,227356040,48158939,2.27011519025402,88.4754642981994,0.199673567070264
554.12,560,8709,8773,5033802,5158524,2025-08-01,2025-11-21,632.08,64,124722,69823438,8093490,7.38795474379248,42.0309194743461,0.0241778462211284
589.3,590,73812,73149,3690600,5120430,2025-08-01,2025-08-15,632.08,-663,1429830,243349966,91051840,2.10414247602566,55.7133182422553,0.279240220059643
566.28,575,5815,5819,5105570,5074168,2025-08-01,2025-12-19,632.08,4,-31402,380408956,31818097,1.33387185553013,77.1531667093558,-0.00618860077159448
487.11,490,17898,17548,5423094,5071372,2025-08-01,2025-12-19,632.08,-350,-351721.999999999,380408956,31818097,1.3331368570618,78.4863035664176,-0.0693544074463477
539.45,540,91333,91368,4931982,5025240,2025-08-01,2025-08-29,632.08,35,93258,155069044,41373917,3.24064679214763,52.811914543047,0.0185579196217494
533.81,535,42462,42114,4840668,5011566,2025-08-01,2025-09-19,632.08,-348,170898.000000001,595655559,168675191,0.841353014217399,85.3805027613282,0.0341007182186169
629.89,633,8907,16066,1211352,4996526,2025-08-01,2025-08-01,632.08,7159,3785174,61309866,39049978,8.14962798972681,36.7607034078333,0.757561153489444
613.96,623,2905,5455,2077075,4931320,2025-08-01,2025-09-19,632.08,2550,2854245,595655559,168675191,0.827881134573613,86.2083838959018,0.578799388399049
627.8,633,2085,9288,560865,4829760,2025-08-01,2025-08-08,632.08,7203,4268895,58500270,29786673,8.25596189556048,28.9787431750315,0.883873111707414
623.21,630,6565,7050,2960815,4786950,2025-08-01,2025-08-22,632.08,485,1826135,60984890,20108486,7.84940335220741,20.6036495269566,0.381481945706556
631.24,636,4656,10052,977760,4784752,2025-08-01,2025-08-01,632.08,5396,3806992,61309866,39049978,7.80421213120903,44.5649155390423,0.795650850869596
499.69,500,154211,154345,4626330,4784695,2025-08-01,2025-08-29,632.08,134,158365,155069044,41373917,3.08552556756589,55.8974401106129,0.0330982434617045
613.51,635,1997,2169,3760351,4661181,2025-08-01,2025-12-19,632.08,172,900830.000000001,380408956,31818097,1.22530790258261,79.7116114690002,0.193262179692228
574.7,580,8835,8773,4002255,4649690,2025-08-01,2025-10-17,632.08,-62,647435,227356040,48158939,2.04511391032321,90.5205782085226,0.139242616174412
631.68,638,3899,7304,1126811,4616128,2025-08-01,2025-08-01,632.08,3405,3489317,61309866,39049978,7.5291764623984,52.0940920014407,0.755896933533906
499.29,500,64989,64887,4029318,4606977,2025-08-01,2025-09-19,632.08,-102,577659,595655559,168675191,0.773429699495174,86.981813595397,0.12538786280027
589.44,600,4347,4360,4029669,4604160,2025-08-01,2025-11-21,632.08,13,574491.000000001,69823438,8093490,6.59400357799626,48.6249230523424,0.12477650646372
588.16,590,21696,24539,2928960,4515176,2025-08-01,2025-08-29,632.08,2843,1586216,155069044,41373917,2.91171976271421,58.8091598733271,0.351307678814735
629.5,640,4220,4270,2709240,4483500,2025-08-01,2025-08-15,632.08,50,1774260,243349966,91051840,1.84240831165762,57.5557265539129,0.395731013716962
622.29,627,9388,9512,2722520,4480152,2025-08-01,2025-08-15,632.08,124,1757632,243349966,91051840,1.84103251528706,59.3967590692,0.392315260732225
601.12,615,3213,3212,3800979,4458256,2025-08-01,2025-11-21,632.08,-1,657277.000000001,69823438,8093490,6.38504222607887,55.0099652784213,0.147429174098571
624.96,635,2408,4379,1659112,4396516,2025-08-01,2025-08-29,632.08,1971,2737404,155069044,41373917,2.83519900980366,61.6443588831308,0.62263028270567
594.12,595,49523,49046,2971380,4316048,2025-08-01,2025-08-15,632.08,-477,1344668,243349966,91051840,1.77359712472695,61.1703561939269,0.311550751984223
576.5,585,5044,5034,3682120,4278900,2025-08-01,2025-11-21,632.08,-10,596780.000000001,69823438,8093490,6.12817146013349,61.1381367385548,0.139470424641847
625,633,1485,5253,778140,4202400,2025-08-01,2025-08-22,632.08,3768,3424260,60984890,20108486,6.89088723452645,27.4945367614831,0.814834380354083
627.48,645,1616,2394,2210688,4194288,2025-08-01,2025-09-19,632.08,778,1983600,595655559,168675191,0.704146538486347,87.6859601338833,0.472928897586432
625.95,630,9392,10222,1953536,4139910,2025-08-01,2025-08-08,632.08,830,2186374,58500270,29786673,7.07673656890814,36.0554797439396,0.528121142730156
525.33,530,8692,8863,4215620,4139021,2025-08-01,2025-12-19,632.08,171,-76599,380408956,31818097,1.08804509849658,80.7996565674968,-0.0185065502204507
606.28,610,10699,11125,2845934,4138500,2025-08-01,2025-08-29,632.08,426,1292566,155069044,41373917,2.66881119096859,64.3131700740994,0.312327171680561
609.27,610,54414,56344,2503044,4113112,2025-08-01,2025-08-08,632.08,1930,1610068,58500270,29786673,7.03092823332269,43.0864079772623,0.391447643536087
443.19,445,22534,22535,4123722,4078835,2025-08-01,2025-12-19,632.08,1,-44887,380408956,31818097,1.07222370442824,81.871880271925,-0.0110048580047979
501.41,505,11286,11313,3792096,4061367,2025-08-01,2025-12-19,632.08,27,269271,380408956,31818097,1.06763180412608,82.9395120760511,0.066300583030295
506.29,510,10850,10845,3797500,4023495,2025-08-01,2025-12-19,632.08,-5,225995,380408956,31818097,1.05767620255502,83.9971882786062,0.0561688283445113
627.45,640,2872,3204,2716912,4021020,2025-08-01,2025-09-05,632.08,332,1304108,23171190,9460006,17.3535325548666,17.3535325548666,0.324322684294035
631.42,639,1198,5284,427686,4005272,2025-08-01,2025-08-01,632.08,4086,3577586,61309866,39049978,6.53283437285608,58.6269263742968,0.893219237045574
538.98,545,6566,6623,3867374,3987046,2025-08-01,2025-12-19,632.08,57,119672,380408956,31818097,1.04809467209284,85.045282950699,0.0300152042389278
520.7,525,9387,9249,4167828,3977070,2025-08-01,2025-12-19,632.08,-138,-190758.000000001,380408956,31818097,1.04547223120583,86.0907551819048,-0.0479644562454272
621.53,626,8675,8822,2411650,3943434,2025-08-01,2025-08-15,632.08,147,1531784,243349966,91051840,1.62047854981003,62.7908347437369,0.388439111698078
613.25,622,3466,4473,2395006,3913875,2025-08-01,2025-09-19,632.08,1007,1518869,595655559,168675191,0.657070170984504,88.3430303048679,0.388072945610169
448.03,450,19552,19615,3675776,3864155,2025-08-01,2025-12-19,632.08,63,188379.000000001,380408956,31818097,1.0157897018597,87.1065448837645,0.048750373626317
627.71,637,3021,4136,2483262,3842344,2025-08-01,2025-08-22,632.08,1115,1359082,60984890,20108486,6.30048525134669,33.7950220128297,0.353711692654275
605.3,620,2546,2593,3233420,3811710,2025-08-01,2025-11-21,632.08,47,578290.000000001,69823438,8093490,5.45906948895871,66.5972062275135,0.151714060093764
618.8,624,870,7282,374970,3786640,2025-08-01,2025-08-22,632.08,6412,3411670,60984890,20108486,6.20914459302952,40.0041666058593,0.900975535038979
584.4,585,61580,61938,3140580,3716280,2025-08-01,2025-08-15,632.08,358,575700,243349966,91051840,1.52713397132753,64.3179687150645,0.154912977493623
610.68,619,4238,4442,2716558,3695744,2025-08-01,2025-09-19,632.08,204,979186,595655559,168675191,0.620449846250826,88.9634801511187,0.2649496285457
608.61,616,3275,4991,1928975,3688349,2025-08-01,2025-09-19,632.08,1716,1759374,595655559,168675191,0.619208356955836,89.5826885080745,0.47700854772691
529.94,535,7463,7260,3470295,3673560,2025-08-01,2025-12-19,632.08,-203,203265,380408956,31818097,0.965687043393374,88.0722319271579,0.0553318851468329
631.45,640,5604,4246,2174352,3630330,2025-08-01,2025-08-01,632.08,-1358,1455978,61309866,39049978,5.92128190265495,64.5482082769517,0.401059407822429
605.45,607,23151,23196,2268798,3595380,2025-08-01,2025-08-15,632.08,45,1326582,243349966,91051840,1.47745243572378,65.7954211507883,0.368968509587304
629.36,650,1095,1735,1772805,3581040,2025-08-01,2025-09-19,632.08,640,1808235,595655559,168675191,0.601193079774481,90.183881587849,0.504946886937873
398.74,400,28050,28053,3646500,3534678,2025-08-01,2025-12-19,632.08,3,-111822,380408956,31818097,0.929178439216347,89.0014103663742,-0.0316356963774352
560.92,565,8420,8575,2879640,3498600,2025-08-01,2025-10-17,632.08,155,618960,227356040,48158939,1.5388199055543,92.0593981140769,0.176916480878066
424.71,425,117455,117441,3523650,3405789,2025-08-01,2025-09-19,632.08,-14,-117861,595655559,168675191,0.571771546246914,90.7556531340959,-0.0346060780629687
553.31,555,18922,19640,3103208,3319160,2025-08-01,2025-09-19,632.08,718,215952,595655559,168675191,0.557228074152834,91.3128812082488,0.0650622446643127
600.25,606,5408,5724,2433600,3291300,2025-08-01,2025-09-19,632.08,316,857700,595655559,168675191,0.552550874455954,91.8654320827047,0.260596117035822
615.04,624,2787,3568,2335506,3196928,2025-08-01,2025-09-19,632.08,781,861422.000000001,595655559,168675191,0.536707490041237,92.4021395727459,0.269453049927931
519.06,520,32465,32606,2499805,3064964,2025-08-01,2025-09-19,632.08,141,565159,595655559,168675191,0.514553075798626,92.9166926485446,0.184393356659328
628.8,631,5752,13884,557944,3054480,2025-08-01,2025-08-01,632.08,8132,2496536,61309866,39049978,4.98203665948316,69.5302449364349,0.817335847672926
543.51,545,22020,20436,2840580,3044964,2025-08-01,2025-09-19,632.08,-1584,204384,595655559,168675191,0.511195430646522,93.4278880791911,0.0671219758263152
607.18,615,3437,3882,1391985,3035724,2025-08-01,2025-09-05,632.08,445,1643739,23171190,9460006,13.1012865545533,30.4548191094199,0.54146523201714
631.52,650,1591,1610,2211490,2975280,2025-08-01,2025-08-29,632.08,19,763790,155069044,41373917,1.91868081678507,66.2318508908845,0.25671197332688
623.03,628,5245,5981,1610215,2972557,2025-08-01,2025-08-15,632.08,736,1362342,243349966,91051840,1.22151527237115,67.0169364231594,0.458306434493939
544.61,545,76165,76142,2437280,2969538,2025-08-01,2025-08-22,632.08,-23,532258,60984890,20108486,4.86930123182972,44.873467837689,0.179239329484923
619.5,645,924,1158,2310000,2952900,2025-08-01,2025-12-19,632.08,234,642900,380408956,31818097,0.776243554055546,89.7776539204298,0.217718175353043
593.29,598,6284,6257,2940912,2947047,2025-08-01,2025-09-19,632.08,-27,6135,595655559,168675191,0.494756903628595,93.9226449828197,0.0020817448788567
626.31,633,2292,4389,932844,2936241,2025-08-01,2025-08-15,632.08,2097,2003397,243349966,91051840,1.20659190887251,68.2235283320319,0.682299920204098
591.93,596,7083,7201,2450718,2930807,2025-08-01,2025-09-19,632.08,118,480089.000000001,595655559,168675191,0.492030495765087,94.4146754785848,0.163807783999424
625.6,632,2436,4579,998760,2930560,2025-08-01,2025-08-15,632.08,2143,1931800,243349966,91051840,1.20425741090919,69.4277857429411,0.659191417340031
629.37,632,8031,10986,899472,2889318,2025-08-01,2025-08-01,632.08,2955,1989846,61309866,39049978,4.71264771643768,74.2428926528725,0.688690549119204
504.81,505,151612,151607,2880628,2880533,2025-08-01,2025-08-22,632.08,-5,-95,60984890,20108486,4.72335524422525,49.5968230819142,-3.29800075194417e-05
592.82,595,12921,13139,2080281,2864302,2025-08-01,2025-08-29,632.08,218,784021,155069044,41373917,1.84711398620604,68.0789648770905,0.273721486072348
613.51,616,10646,11071,1745944,2756679,2025-08-01,2025-08-15,632.08,425,1010735,243349966,91051840,1.13280434976514,70.5605900927062,0.366649508339564
418.49,420,17831,17793,2692481,2686743,2025-08-01,2025-12-19,632.08,-38,-5738,380408956,31818097,0.706277535695032,90.4839314561248,-0.00213567133142247
630.37,634,4863,7371,734313,2675673,2025-08-01,2025-08-01,632.08,2508,1941360,61309866,39049978,4.36418014679725,78.6070727996698,0.725559513438301
618.27,620,18547,15419,1706324,2667487,2025-08-01,2025-08-08,632.08,-3128,961163,58500270,29786673,4.55978579244164,47.646193769704,0.36032527993576
601.91,605,8173,8565,1863444,2646585,2025-08-01,2025-08-29,632.08,392,783141,155069044,41373917,1.7067139460794,69.7856788231699,0.295906233882532
607.31,610,8618,9796,1594330,2635124,2025-08-01,2025-08-22,632.08,1178,1040794,60984890,20108486,4.32094572934378,53.917768811258,0.39496964848713
511.24,515,6916,6917,2655744,2600792,2025-08-01,2025-12-19,632.08,1,-54952,380408956,31818097,0.683683167543511,91.1676146236683,-0.0211289484126374
597.05,598,27224,27265,2014576,2590175,2025-08-01,2025-08-15,632.08,41,575599,243349966,91051840,1.06438272524764,71.6249728179539,0.222223981005145
622.54,650,738,943,1815480,2589478,2025-08-01,2025-12-19,632.08,205,773998.000000001,380408956,31818097,0.680708999921653,91.84832362359,0.298901168498053
620.2,624,11474,6805,2879974,2585900,2025-08-01,2025-08-15,632.08,-4669,-294074,243349966,91051840,1.06262599601103,72.6875988139649,-0.113722108356858
498.44,500,15804,16221,2086128,2530476,2025-08-01,2025-10-17,632.08,417,444348,227356040,48158939,1.11300144038399,93.1723995544609,0.17559858303339
615.21,635,1106,1264,1822688,2501456,2025-08-01,2025-11-21,632.08,158,678768,69823438,8093490,3.58254487554738,70.1797511030608,0.271349166245579
598.94,615,1484,1537,2273488,2468422,2025-08-01,2025-12-19,632.08,53,194934,380408956,31818097,0.648886405292729,92.4972100288827,0.0789710997552281
631.95,645,1879,1878,1587755,2450790,2025-08-01,2025-08-08,632.08,-1,863035,58500270,29786673,4.18936527985256,51.8355590495565,0.352145634672901
624.33,625,27534,36568,1073826,2450056,2025-08-01,2025-08-01,632.08,9034,1376230,61309866,39049978,3.99618554051317,82.603258340183,0.561713691442155
624.31,635,1982,2265,1613348,2421285,2025-08-01,2025-09-05,632.08,283,807937,23171190,9460006,10.4495496346972,40.9043687441172,0.333681082565662
626.31,635,2411,2719,1391147,2362811,2025-08-01,2025-08-22,632.08,308,971664,60984890,20108486,3.87442036871756,57.7921891799756,0.411232214510598
631.15,640,964,2655,492604,2349675,2025-08-01,2025-08-08,632.08,1691,1857071,58500270,29786673,4.0165199237542,55.8520789733107,0.79035228276251
627.93,640,1252,1929,1098004,2328303,2025-08-01,2025-08-29,632.08,677,1230299,155069044,41373917,1.50146214869294,71.2871409718628,0.528410176854129
563.16,570,3260,3343,1900580,2286612,2025-08-01,2025-11-21,632.08,83,386032,69823438,8093490,3.27484876926284,73.4545998723237,0.168822694886583
579.51,580,46666,46257,1773308,2266593,2025-08-01,2025-08-15,632.08,-409,493285,243349966,91051840,0.931412910080292,73.6190117240452,0.217632808360389
593.97,605,1555,2032,1547225,2241296,2025-08-01,2025-11-21,632.08,477,694071,69823438,8093490,3.20994792608178,76.6645477984055,0.309673956496599
611.58,615,4833,6470,1164753,2212740,2025-08-01,2025-08-22,632.08,1637,1047987,60984890,20108486,3.62834138095518,61.4205305609308,0.473615065484422
624.6,628,4816,6484,847616,2204560,2025-08-01,2025-08-08,632.08,1668,1356944,58500270,29786673,3.7684612395806,59.6205402128913,0.6155169285481
453.01,455,11022,11022,2215422,2193378,2025-08-01,2025-12-19,632.08,0,-22043.9999999995,380408956,31818097,0.576584216907869,93.0737942457906,-0.0100502512562812
574.55,575,47966,47105,1630844,2119725,2025-08-01,2025-08-15,632.08,-861,488881,243349966,91051840,0.871060323057534,74.4900720471027,0.230634162450318
477.33,480,7857,7848,2160675,2095416,2025-08-01,2025-12-19,632.08,-9,-65259,380408956,31818097,0.550832457267384,93.624626703058,-0.0311436965261313
630.98,645,1422,1467,1339524,2056734,2025-08-01,2025-08-15,632.08,45,717210,243349966,91051840,0.845175380053269,75.335247427156,0.348713056720023
623.03,633,182,2015,157248,2008955,2025-08-01,2025-09-05,632.08,1833,1851707,23171190,9460006,8.67005535753667,49.5744241016538,0.921726469731776
597.62,610,1575,1615,1697850,1999370,2025-08-01,2025-11-21,632.08,40,301520,69823438,8093490,2.86346541687048,79.5280132152759,0.150807504363875
573.81,575,15878,16098,1683068,1915662,2025-08-01,2025-08-29,632.08,220,232594,155069044,41373917,1.23536068230356,72.5225016541664,0.121417034946666
625.16,631,2392,3211,885040,1875224,2025-08-01,2025-08-15,632.08,819,990184,243349966,91051840,0.770587327717153,76.1058347548732,0.528035050745937
626.3,650,745,787,1452750,1865190,2025-08-01,2025-10-17,632.08,42,412440,227356040,48158939,0.820382867330025,93.992782421791,0.221124925610796
609.03,625,1019,1160,1406220,1852520,2025-08-01,2025-11-21,632.08,141,446300,69823438,8093490,2.65314921903445,82.1811624343104,0.240915077839915
629.64,637,1775,2516,702900,1851776,2025-08-01,2025-08-08,632.08,741,1148876,58500270,29786673,3.16541445022391,62.7859546631152,0.620418452339808
631.74,650,1608,1013,2092008,1849738,2025-08-01,2025-08-15,632.08,-595,-242270,243349966,91051840,0.760114344951254,76.8659490998244,-0.130975305691941
592.16,593,21949,21998,1514481,1847832,2025-08-01,2025-08-15,632.08,49,333351,243349966,91051840,0.759331110816757,77.6252802106412,0.18040114036341
629.8,642,1429,1514,1714800,1847080,2025-08-01,2025-08-15,632.08,85,132280,243349966,91051840,0.75902209084344,78.3843023014846,0.0716157394373823
542.1,545,6388,6329,1769476,1835410,2025-08-01,2025-10-17,632.08,-59,65934,227356040,48158939,0.807284468888533,94.8000668906795,0.0359233086885219
519.82,520,101057,100954,1515855,1817172,2025-08-01,2025-08-15,632.08,-103,301317,243349966,91051840,0.746731972011042,79.1310342734957,0.165816444453249
595,596,18094,18154,1139922,1815400,2025-08-01,2025-08-15,632.08,60,675478,243349966,91051840,0.746003802605832,79.8770380761015,0.372082185744189
489.35,490,27416,27528,1809456,1789320,2025-08-01,2025-09-19,632.08,112,-20136.0000000002,595655559,168675191,0.300395081178114,94.7150705597629,-0.0112534370598888
619.1,640,632,855,1203960,1786950,2025-08-01,2025-11-21,632.08,223,582990,69823438,8093490,2.55924092422948,84.7404033585399,0.326248635943927
631.25,660,228,614,539220,1765250,2025-08-01,2025-09-19,632.08,386,1226030,595655559,168675191,0.296354155237557,95.0114247150004,0.694536184676391
619.89,627,1120,2450,677600,1741950,2025-08-01,2025-08-29,632.08,1330,1064350,155069044,41373917,1.12333832405648,73.6458399782229,0.611010648985333
597.67,603,3300,3225,1425600,1718925,2025-08-01,2025-09-19,632.08,-75,293325,595655559,168675191,0.288577009653997,95.3000017246544,0.170644443474846
622.54,631,1609,2029,1168134,1716534,2025-08-01,2025-08-29,632.08,420,548400,155069044,41373917,1.1069482056006,74.7527881838235,0.319481000667624
509.18,510,20998,20921,1574850,1715522,2025-08-01,2025-09-19,632.08,-77,140672,595655559,168675191,0.288005706331367,95.5880074309858,0.0819995313379833
629.2,636,2012,2497,720296,1697960,2025-08-01,2025-08-08,632.08,485,977664,58500270,29786673,2.90248233042343,65.6884369935387,0.575787415486819
624.7,645,702,829,1189890,1682870,2025-08-01,2025-10-17,632.08,127,492980,227356040,48158939,0.740191463574049,95.5402583542535,0.292940036960668
623.7,629,2157,3169,685926,1679570,2025-08-01,2025-08-15,632.08,1012,993644,243349966,91051840,0.690187069925459,80.567225146027,0.591606184916377
630.24,638,1008,2112,435456,1638912,2025-08-01,2025-08-08,632.08,1104,1203456,58500270,29786673,2.80154604414646,68.4899830376851,0.734301780693533
619.49,625,1814,2958,663924,1629858,2025-08-01,2025-08-22,632.08,1144,965934,60984890,20108486,2.67256036700238,64.0930909279331,0.59264917557235
616.02,619,5115,5453,966735,1624994,2025-08-01,2025-08-15,632.08,338,658259,243349966,91051840,0.667760109734308,81.2349852557613,0.405083957233073
583.29,585,8355,9403,1010955,1607913,2025-08-01,2025-08-29,632.08,1048,596958,155069044,41373917,1.03690134312042,75.7896895269439,0.371262624283777
602.58,604,12090,11241,1088100,1596222,2025-08-01,2025-08-15,632.08,-849,508122,243349966,91051840,0.65593680830841,81.8909220640697,0.318327901758026
600.8,602,5589,13281,441531,1593720,2025-08-01,2025-08-15,632.08,7692,1152189,243349966,91051840,0.654908659407826,82.5458307234775,0.722955726225435
568.88,570,14229,14223,1181007,1592976,2025-08-01,2025-08-29,632.08,-6,411969,155069044,41373917,1.02726885967002,76.8169583866139,0.258615949016181
580.94,590,1720,1744,1608200,1580064,2025-08-01,2025-11-21,632.08,24,-28135.9999999998,69823438,8093490,2.26294213699417,87.003345495534,-0.0178068736456243
597.22,599,2594,8831,321656,1571918,2025-08-01,2025-08-22,632.08,6237,1250262,60984890,20108486,2.57755322670911,66.6706441546422,0.795373550019785
423.46,425,10040,10041,1596360,1546314,2025-08-01,2025-12-19,632.08,1,-50045.9999999998,380408956,31818097,0.406487275236496,94.0311139782945,-0.0323647072974828
429.72,430,54820,54810,1534960,1534680,2025-08-01,2025-09-19,632.08,-10,-280.000000000233,595655559,168675191,0.257645543101529,95.8456529740873,-0.000182448458310679
549.73,550,56723,56674,1191183,1530198,2025-08-01,2025-08-15,632.08,-49,339015,243349966,91051840,0.628805512140487,83.174636235618,0.221549760227108
614.78,617,6112,6819,996256,1513818,2025-08-01,2025-08-15,632.08,707,517562,243349966,91051840,0.622074465381269,83.7967107009992,0.341891825833753
628.77,638,1965,1608,1112190,1484184,2025-08-01,2025-08-15,632.08,-357,371994,243349966,91051840,0.60989694159234,84.4066076425916,0.250638734819942
557.21,558,18973,18779,1366056,1483541,2025-08-01,2025-08-29,632.08,-194,117485,155069044,41373917,0.956697069725922,77.7736554563398,0.0791922838667755
623.25,632,1588,1691,997264,1479625,2025-08-01,2025-08-29,632.08,103,482361,155069044,41373917,0.954171743007586,78.7278271993474,0.326002196502492
467.77,470,6662,6612,1605542,1474476,2025-08-01,2025-12-19,632.08,-50,-131066,380408956,31818097,0.387602861800131,94.4187168400946,-0.0888898835925441
626.73,636,1352,1572,820664,1457244,2025-08-01,2025-08-22,632.08,220,636580,60984890,20108486,2.38951648514903,69.0601606397913,0.436838305733288
626.75,628,5964,11413,363804,1426625,2025-08-01,2025-08-01,632.08,5449,1062821,61309866,39049978,2.32690934278017,84.9301676829631,0.744989748532375
449.6,450,35502,35608,1278072,1424320,2025-08-01,2025-09-19,632.08,106,146248,595655559,168675191,0.239118057152221,96.0847710312396,0.102679173219501
615.15,618,4234,4952,766354,1411320,2025-08-01,2025-08-15,632.08,718,644966,243349966,91051840,0.579954878645843,84.9865625212374,0.456994870050733
499.87,500,106663,106853,853304,1389089,2025-08-01,2025-08-15,632.08,190,535785,243349966,91051840,0.570819475684661,85.5573819969221,0.385709626956948
609.95,618,1150,1715,782000,1380575,2025-08-01,2025-09-19,632.08,565,598575,595655559,168675191,0.231774047793282,96.3165450790328,0.433569346105789
593.47,595,8847,8939,973170,1367667,2025-08-01,2025-08-22,632.08,92,394497,60984890,20108486,2.24263256029485,71.3027932000861,0.28844521363753
472.69,475,5748,5878,1362276,1357818,2025-08-01,2025-12-19,632.08,130,-4458,380408956,31818097,0.356936391371396,94.775653231466,-0.00328320879528773
578.67,580,10693,10171,1069300,1352743,2025-08-01,2025-08-29,632.08,-522,283443,155069044,41373917,0.87234883578698,79.6001760351344,0.209532039714861
518.04,520,6890,6886,1315990,1349656,2025-08-01,2025-10-17,632.08,-4,33666,227356040,48158939,0.593631029111872,96.1338893833654,0.0249441339126414
606.32,608,5140,8003,539700,1344504,2025-08-01,2025-08-15,632.08,2863,804804,243349966,91051840,0.55249812527198,86.1098801221941,0.598588029488942
569.61,570,34195,33932,1162630,1323348,2025-08-01,2025-08-15,632.08,-263,160718,243349966,91051840,0.543804472937547,86.6536845951316,0.121448024253635
620.7,628,1624,1806,870464,1318380,2025-08-01,2025-08-29,632.08,182,447916,155069044,41373917,0.85018902934618,80.4503650644806,0.339747265583519
610.52,612,8118,8906,1014750,1318088,2025-08-01,2025-08-15,632.08,788,303338,243349966,91051840,0.541642976847591,87.1953275719792,0.230134862012248
613.2,621,822,1682,568824,1311960,2025-08-01,2025-09-19,632.08,860,743136,595655559,168675191,0.220254806687702,96.5367998857205,0.566431903411689
605.48,610,1077,2890,354333,1306280,2025-08-01,2025-09-05,632.08,1813,951947,23171190,9460006,5.637517969513,55.2119420711668,0.728746516826408
627.96,636,1973,1603,972689,1288812,2025-08-01,2025-08-15,632.08,-370,316123,243349966,91051840,0.52961256629064,87.7249401382698,0.245282477196053
625.59,636,973,1234,698614,1284594,2025-08-01,2025-08-29,632.08,261,585980,155069044,41373917,0.828401315223173,81.2787663797037,0.456159689364889
602.78,605,5758,5646,921280,1253412,2025-08-01,2025-08-22,632.08,-112,332132,60984890,20108486,2.05528287416768,73.3580760742538,0.264982304302177
457.98,460,6080,6090,1313280,1230180,2025-08-01,2025-12-19,632.08,10,-83100,380408956,31818097,0.32338355356702,95.099036785033,-0.0675510900843779
627.48,629,5185,8042,362950,1222384,2025-08-01,2025-08-01,632.08,2857,859434,61309866,39049978,1.99378025063699,86.9239479336001,0.703080210473959
631.3,643,1498,1038,849366,1214460,2025-08-01,2025-08-01,632.08,-460,365094,61309866,39049978,1.98085574024905,88.9048036738492,0.300622498888395
511.89,515,3895,3894,1168500,1211034,2025-08-01,2025-11-21,632.08,-1,42534,69823438,8093490,1.7344233321768,88.7377688277108,0.0351220527251919
631.14,641,600,1215,390000,1197990,2025-08-01,2025-08-08,632.08,615,807990,58500270,29786673,2.04783670229214,70.5378197399773,0.674454711642
482.33,485,4419,4419,1210806,1179873,2025-08-01,2025-12-19,632.08,0,-30933.0000000002,380408956,31818097,0.310159101511795,95.4091958865448,-0.0262172284644197
433.32,435,6935,6935,1165080,1165080,2025-08-01,2025-12-19,632.08,0,0,380408956,31818097,0.30627039180434,95.7154662783491,0
527.7,530,4951,5019,1069416,1154370,2025-08-01,2025-10-17,632.08,68,84954,227356040,48158939,0.507736675920288,96.6416260592857,0.0735933886015749
619.47,623,2955,3170,709200,1119010,2025-08-01,2025-08-15,632.08,215,409810,243349966,91051840,0.459835691943347,88.1847758302132,0.366225502899885
559.68,560,34681,34653,901706,1108896,2025-08-01,2025-08-15,632.08,-28,207190,243349966,91051840,0.455679537674561,88.6404553678878,0.186843491184024
618.41,622,2690,3083,578350,1106797,2025-08-01,2025-08-15,632.08,393,528447,243349966,91051840,0.454816993892656,89.0952723617804,0.477456118872747
621.1,630,851,1238,553150,1101820,2025-08-01,2025-09-05,632.08,387,548670,23171190,9460006,4.75512910644641,59.9670711776132,0.497967000054455
474.93,475,155074,155089,930444,1085623,2025-08-01,2025-08-15,632.08,15,155179,243349966,91051840,0.446115944803543,89.5413883065839,0.142940044564273
627.37,632,2207,2338,545129,1082494,2025-08-01,2025-08-08,632.08,131,537365,58500270,29786673,1.85040855366992,72.3882282936472,0.496413836935817
438.26,440,6184,6203,1125488,1079322,2025-08-01,2025-12-19,632.08,19,-46166,380408956,31818097,0.283726758525633,95.9991930368748,-0.0427731483283024
630.01,643,194,829,226786,1076871,2025-08-01,2025-08-15,632.08,635,850085,243349966,91051840,0.442519478305577,89.9839077848895,0.789402816121894
514.2,515,13359,13375,1082079,1070000,2025-08-01,2025-09-19,632.08,16,-12079,595655559,168675191,0.179634015637551,96.7164339013581,-0.011288785046729
454.93,455,152321,152491,609284,1067437,2025-08-01,2025-08-15,632.08,170,458153,243349966,91051840,0.438642756991386,90.4225505418809,0.429208468509149
626.97,634,1337,1506,578921,1058718,2025-08-01,2025-08-15,632.08,169,479797,243349966,91051840,0.435059851210335,90.8576103930912,0.453186778726724
399.8,400,52729,52713,1054580,1054260,2025-08-01,2025-09-19,632.08,-16,-320,595655559,168675191,0.176991548902845,96.8934254502609,-0.000303530438411777
504.2,505,12952,13059,984352,1044720,2025-08-01,2025-09-19,632.08,107,60368.0000000001,595655559,168675191,0.175389952165292,97.0688154024262,0.0577839038211196
617.51,619,5375,7008,467625,1044192,2025-08-01,2025-08-08,632.08,1633,576567,58500270,29786673,1.78493535158043,74.1731636452276,0.552165693665533
623.95,633,1028,1148,680536,1038940,2025-08-01,2025-08-29,632.08,120,358404,155069044,41373917,0.66998542920017,81.9487518089039,0.344970835659422
626.76,638,810,920,648000,1034080,2025-08-01,2025-08-29,632.08,110,386080,155069044,41373917,0.666851341393451,82.6156031502974,0.373356026613028
532.53,535,4020,4028,944700,994916,2025-08-01,2025-10-17,632.08,8,50216.0000000001,227356040,48158939,0.437602625379999,97.0792286846657,0.0504726027121889
591.22,592,12702,12701,673206,990678,2025-08-01,2025-08-15,632.08,-1,317472,243349966,91051840,0.4071001185182,91.2647105116095,0.320459321797799
459.87,460,75879,76189,1365822,990457,2025-08-01,2025-08-29,632.08,310,-375365,155069044,41373917,0.638720001394992,83.2543231516924,-0.378981621615073
464.87,465,75710,75736,832810,984568,2025-08-01,2025-08-22,632.08,26,151758,60984890,20108486,1.61444580780584,74.9725218820596,0.154136636575635
613.88,615,8210,8764,517230,981568,2025-08-01,2025-08-08,632.08,554,464338,58500270,29786673,1.67788627300353,75.8510499182312,0.473057393884071
630.33,639,760,1112,373920,964104,2025-08-01,2025-08-08,632.08,352,590184,58500270,29786673,1.64803341933294,77.4990833375641,0.612158024445496
602.85,609,1029,1563,506268,961245,2025-08-01,2025-09-19,632.08,534,454977,595655559,168675191,0.161375980711699,97.2301913831379,0.473320537428023
623.19,626,2395,3386,349670,951466,2025-08-01,2025-08-08,632.08,991,601796,58500270,29786673,1.62643010023714,79.1255134378012,0.632493436444392
259.66,260,27842,27839,890944,946526,2025-08-01,2025-12-19,632.08,-3,55582,380408956,31818097,0.248818011529676,96.2480110484045,0.0587221058903823
469.5,470,18804,18909,864984,945450,2025-08-01,2025-09-19,632.08,105,80466,595655559,168675191,0.158724280452825,97.3889156635908,0.0851086784071077
617.4,624,1382,1428,697910,942480,2025-08-01,2025-08-29,632.08,46,244570,155069044,41373917,0.607780879851171,83.8621040315435,0.259496222731517
613.22,618,2019,1949,890379,931622,2025-08-01,2025-08-29,632.08,-70,41243,155069044,41373917,0.600778837586695,84.4628828691302,0.0442701009636956
598.21,600,5204,5191,676520,929189,2025-08-01,2025-08-22,632.08,-13,252669,60984890,20108486,1.52363806838054,76.4961599504402,0.271924226395276
611.36,616,1928,1970,784696,914080,2025-08-01,2025-08-29,632.08,42,129384,155069044,41373917,0.589466457276927,85.0523493264072,0.141545597759496
617.36,621,2464,2494,502656,907816,2025-08-01,2025-08-15,632.08,30,405160,243349966,91051840,0.373049569277524,91.637760080887,0.446301893775831
628.41,634,1267,1614,378833,902226,2025-08-01,2025-08-08,632.08,347,523393,58500270,29786673,1.54225954854567,80.6677729863469,0.580112965044235
626.58,631,1147,2038,263810,900796,2025-08-01,2025-08-08,632.08,891,636986,58500270,29786673,1.53981511538323,82.2075881017301,0.707136799008877
462.95,465,4392,4392,939888,900360,2025-08-01,2025-12-19,632.08,0,-39528.0000000002,380408956,31818097,0.236682124802551,96.484693173207,-0.0439024390243905
626.15,637,689,811,541554,879935,2025-08-01,2025-08-29,632.08,122,338381,155069044,41373917,0.567447233375605,85.6197965597828,0.384552268065255
616.95,623,1489,1451,662605,877855,2025-08-01,2025-08-29,632.08,-38,215250,155069044,41373917,0.566105895384252,86.185902455167,0.245199947599547
599.63,600,22935,23675,619245,875975,2025-08-01,2025-08-08,632.08,740,256730,58500270,29786673,1.49738625137969,83.7049743531098,0.293079140386426
539.76,540,36184,36244,651312,869856,2025-08-01,2025-08-15,632.08,60,218544,243349966,91051840,0.357450635518067,91.995210716405,0.251241584814038
388.85,390,7560,7560,876960,869400,2025-08-01,2025-12-19,632.08,0,-7559.99999999988,380408956,31818097,0.228543515153203,96.7132366883602,-0.00869565217391291
604.53,606,5575,5861,529625,861567,2025-08-01,2025-08-15,632.08,286,331942,243349966,91051840,0.354044429987716,92.3492551463928,0.385277059125988
631.64,650,624,469,751296,861084,2025-08-01,2025-08-08,632.08,-155,109788,58500270,29786673,1.47193166800769,85.1769060211175,0.127499756121354
608.82,613,1921,2001,703086,836418,2025-08-01,2025-08-29,632.08,80,133332,155069044,41373917,0.539384250024783,86.7252867051918,0.159408334110457
628.95,639,466,831,404954,835155,2025-08-01,2025-08-15,632.08,365,430201,243349966,91051840,0.343190925286589,92.6924460716793,0.515115158264035
619.06,626,1068,1176,615168,816144,2025-08-01,2025-08-29,632.08,108,200976,155069044,41373917,0.526310073853296,87.2515967790451,0.246250661647945
625.97,627,5030,7887,266590,812361,2025-08-01,2025-08-01,632.08,2857,545771,61309866,39049978,1.325008604651,90.2298122785002,0.671833088983838
616.18,622,2177,1395,888216,811890,2025-08-01,2025-08-29,632.08,-782,-76326,155069044,41373917,0.523566779711365,87.7751635587565,-0.094010272327532
607.27,609,4916,4641,698072,802893,2025-08-01,2025-08-15,632.08,-275,104821,243349966,91051840,0.329933475314313,93.0223795469936,0.130554133614317
491.95,495,2688,2569,817152,783545,2025-08-01,2025-12-19,632.08,-119,-33607,380408956,31818097,0.205974383000594,96.9192110713608,-0.0428909635056059
587.52,590,2895,3046,532680,755408,2025-08-01,2025-09-05,632.08,151,222728,23171190,9460006,3.26011741304611,63.2271885906594,0.29484464024739
572.34,580,975,983,666900,752978,2025-08-01,2025-11-21,632.08,8,86078,69823438,8093490,1.07840292825455,89.8161717559654,0.114316752946301
625.8,637,837,668,702243,748160,2025-08-01,2025-09-05,632.08,-169,45917,23171190,9460006,3.22883718963074,66.4560257802901,0.0613732356715141
612.08,617,1343,1519,558688,747348,2025-08-01,2025-08-29,632.08,176,188660,155069044,41373917,0.481945319789293,88.2571088785458,0.25243929200319
597.96,599,11645,7162,826795,744848,2025-08-01,2025-08-15,632.08,-4483,-81946.9999999999,243349966,91051840,0.306080996123912,93.3284605431176,-0.110018419865529
610.83,613,3469,3431,641765,744527,2025-08-01,2025-08-15,632.08,-38,102762,243349966,91051840,0.30594908733211,93.6344096304497,0.138023201307676
587.87,592,1777,1798,698361,742574,2025-08-01,2025-09-19,632.08,21,44213,595655559,168675191,0.124664999558915,97.5135806631497,0.0595401939739339
588.69,590,5449,5634,512206,738054,2025-08-01,2025-08-22,632.08,185,225848,60984890,20108486,1.21022436869198,77.7063843191322,0.306004709682489
609.99,617,876,1050,657000,736050,2025-08-01,2025-09-19,632.08,174,79050,595655559,168675191,0.123569735710298,97.63715039886,0.10739759527206
554.69,555,23803,23586,666484,731166,2025-08-01,2025-08-15,632.08,-217,64681.9999999999,243349966,91051840,0.300458640705132,93.9348682711548,0.0884641791330558
545,550,1481,1451,635349,725500,2025-08-01,2025-11-21,632.08,-30,90151,69823438,8093490,1.03904938052463,90.85522113649,0.124260509993108
620.23,626,913,1256,354244,724712,2025-08-01,2025-08-22,632.08,343,370468,60984890,20108486,1.18834681836763,78.8947311374998,0.511193412003665
624.02,627,2313,2397,377019,714306,2025-08-01,2025-08-08,632.08,84,337287,58500270,29786673,1.22103026191161,86.3979362830291,0.472188389849728
589.81,590,37427,37443,1272518,711417,2025-08-01,2025-08-08,632.08,16,-561101,58500270,29786673,1.21609182316594,87.6140281061951,-0.788709013138567
504.87,505,54526,54497,654312,708461,2025-08-01,2025-08-15,632.08,-29,54149,243349966,91051840,0.291128456537364,94.2259967276922,0.076431871338013
621.73,628,1091,1127,504042,706629,2025-08-01,2025-08-22,632.08,36,202587,60984890,20108486,1.15869521122363,80.0534263487234,0.286694998365479
627.5,639,563,613,478550,704950,2025-08-01,2025-08-29,632.08,50,226400,155069044,41373917,0.454603950482857,88.7117128290286,0.321157528902759
624.41,634,606,729,415110,699111,2025-08-01,2025-08-29,632.08,123,284001,155069044,41373917,0.450838530996554,89.1625513600252,0.406231628453851
613.84,619,884,1332,337688,687312,2025-08-01,2025-08-29,632.08,448,349624,155069044,41373917,0.443229662265797,89.605781022291,0.508683101706358
606.7,613,981,1090,607239,686700,2025-08-01,2025-09-19,632.08,109,79461,595655559,168675191,0.115284746297482,97.7524351451574,0.115714285714286
631.12,655,284,286,658312,682968,2025-08-01,2025-09-19,632.08,2,24655.9999999999,595655559,168675191,0.1146582097121,97.8670933548695,0.036101252181654
625.17,626,4238,8218,186472,682094,2025-08-01,2025-08-01,632.08,3980,495622,61309866,39049978,1.11253546044286,91.342347738943,0.726618325333459
494.38,495,10894,10963,762580,679706,2025-08-01,2025-09-19,632.08,69,-82873.9999999999,595655559,168675191,0.114110577787792,97.9812039326573,-0.121926244582216
624.83,636,656,605,526768,675785,2025-08-01,2025-09-05,632.08,-51,149017,23171190,9460006,2.91648810440897,69.3725138846991,0.220509481565883
483.73,485,5310,5310,642510,674370,2025-08-01,2025-10-17,632.08,0,31860,227356040,48158939,0.296614068401262,97.3758427530669,0.047244094488189
558.43,560,4174,4282,217048,672274,2025-08-01,2025-08-22,632.08,108,455226,60984890,20108486,1.10236158497621,81.1557879336997,0.677143545637642
627.74,638,479,647,335779,663822,2025-08-01,2025-08-22,632.08,168,328043,60984890,20108486,1.08850241428656,82.2442903479862,0.494173136774617
599.8,601,5472,5499,410400,659880,2025-08-01,2025-08-15,632.08,27,249480,243349966,91051840,0.271165026585621,94.4971617542778,0.378068739770867
632.64,642,319,702,209583,657072,2025-08-01,2025-08-08,632.08,383,447489,58500270,29786673,1.12319481602393,88.737222922219,0.681034955073417
607.53,614,702,1010,494208,653470,2025-08-01,2025-09-19,632.08,308,159262,595655559,168675191,0.109706018877262,98.0909099515346,0.24371738564892
522.88,525,3046,3044,615292,645328,2025-08-01,2025-10-17,632.08,-2,30036.0000000001,227356040,48158939,0.283840270968829,97.6596830240358,0.046543773089034
611.53,614,2509,2593,489255,640471,2025-08-01,2025-08-15,632.08,84,151216,243349966,91051840,0.263189270386009,94.7603510246638,0.236101244240567
596.72,600,1340,1949,333660,639272,2025-08-01,2025-09-05,632.08,609,305612,23171190,9460006,2.7589088001091,72.1314226848082,0.478062546146241
344.3,345,9087,9090,627003,636300,2025-08-01,2025-12-19,632.08,3,9297,380408956,31818097,0.167267355293286,97.0864784266541,0.0146110325318246
274.62,275,16645,16645,632510,632510,2025-08-01,2025-12-19,632.08,0,0,380408956,31818097,0.166271059086211,97.2527494857403,0
478.89,480,5730,5691,618840,631701,2025-08-01,2025-10-17,632.08,-39,12861,227356040,48158939,0.277846588109117,97.9375296121449,0.0203593155622676
623.8,631,866,863,422608,621360,2025-08-01,2025-08-22,632.08,-3,198752,60984890,20108486,1.01887533125008,83.2631656792363,0.319866100167375
564.65,565,17700,17635,513300,617225,2025-08-01,2025-08-15,632.08,-65,103925,243349966,91051840,0.253636772647012,95.0139877973108,0.168374579772368
604.02,606,2338,3015,530726,596970,2025-08-01,2025-08-22,632.08,677,66244,60984890,20108486,0.978881818102812,84.2420474973391,0.110967050270533
464.57,465,13838,13839,650386,595077,2025-08-01,2025-09-19,632.08,1,-55309,595655559,168675191,0.0999028702089222,98.1908128217435,-0.092944274438434
629.21,645,370,374,543160,590546,2025-08-01,2025-08-29,632.08,4,47386,155069044,41373917,0.380827781462301,89.9866088037533,0.0802409973143498
579.12,582,1575,2049,505575,590112,2025-08-01,2025-09-19,632.08,474,84537,595655559,168675191,0.0990693347999125,98.2898821565434,0.143255856515373
601.08,607,696,987,393240,584304,2025-08-01,2025-09-19,632.08,291,191064,595655559,168675191,0.0980942746477415,98.3879764311912,0.326994167419699
508.3,510,3271,3419,549528,581230,2025-08-01,2025-10-17,632.08,148,31702,227356040,48158939,0.255647485767257,98.1931770979122,0.0545429520155532
359.15,360,6716,6716,570860,570860,2025-08-01,2025-12-19,632.08,0,0,380408956,31818097,0.150064816034457,97.4028143017748,0
604.7,611,689,890,451984,560700,2025-08-01,2025-09-19,632.08,201,108716,595655559,168675191,0.0941315818392287,98.4821080130304,0.193893347601213
632.38,680,97,117,439798,557154,2025-08-01,2025-11-21,632.08,20,117356,69823438,8093490,0.797946958727526,91.6531680952175,0.210634761663741
626.39,638,432,478,375408,554958,2025-08-01,2025-09-05,632.08,46,179550,23171190,9460006,2.39503452347506,74.5264572082832,0.323537997470079
621.35,629,653,723,364374,553095,2025-08-01,2025-08-29,632.08,70,188721,155069044,41373917,0.356676604003569,90.3432854077568,0.341209014726222
631.1,660,191,191,551990,551990,2025-08-01,2025-11-21,632.08,0,0,69823438,8093490,0.790551161344991,92.4437192565625,0
620.96,627,632,904,378568,546016,2025-08-01,2025-08-22,632.08,272,167448,60984890,20108486,0.895329974359222,85.1373774716983,0.306672331946317
625.65,634,603,646,331047,539410,2025-08-01,2025-08-22,632.08,43,208363,60984890,20108486,0.884497782975422,86.0218752546737,0.386279453476947
614.01,618,1283,1348,343844,537852,2025-08-01,2025-08-22,632.08,65,194008,60984890,20108486,0.881943051795289,86.903818306469,0.360708893896462
587.15,589,2879,2882,431850,533170,2025-08-01,2025-08-29,632.08,3,101320,155069044,41373917,0.343827488870055,90.6871128966269,0.190033197666785
621.61,624,2150,2194,275200,524366,2025-08-01,2025-08-08,632.08,44,249166,58500270,29786673,0.896347999761369,89.6335709219804,0.475175736031703
603.08,605,2693,2717,786356,521664,2025-08-01,2025-09-05,632.08,24,-264692,23171190,9460006,2.25134747071687,76.7778046790001,-0.507399398846768
349.19,350,6434,6433,495418,521073,2025-08-01,2025-12-19,632.08,-1,25655.0000000001,380408956,31818097,0.136977058973343,97.5397913607481,0.0492349440481469
428.35,430,3117,3116,517422,514140,2025-08-01,2025-12-19,632.08,-1,-3282,380408956,31818097,0.135154546676866,97.674945907425,-0.00638347531800677
484.45,485,8918,8940,535080,491700,2025-08-01,2025-09-19,632.08,22,-43380,595655559,168675191,0.0825477060644707,98.5646557190949,-0.0882245271507017
299.5,300,9826,9811,471648,490550,2025-08-01,2025-12-19,632.08,-15,18902.0000000001,380408956,31818097,0.128953325694046,97.803899233119,0.0385322597084906
577.97,581,1051,1606,330014,486618,2025-08-01,2025-09-19,632.08,555,156604,595655559,168675191,0.0816945284313212,98.6463502475262,0.321821223218212
625.37,629,1037,1336,201178,484968,2025-08-01,2025-08-08,632.08,299,283790,58500270,29786673,0.829001302045273,90.4625722240256,0.585172629946718
619.77,620,24052,21000,481040,483000,2025-08-01,2025-08-01,632.08,-3052,1959.99999999994,61309866,39049978,0.787801428239951,92.130149167183,0.00405797101449263
449.16,450,5764,5741,443828,482244,2025-08-01,2025-10-17,632.08,-23,38415.9999999999,227356040,48158939,0.212109605709178,98.4052867036213,0.0796609185391626
609.06,611,2261,2469,282625,478986,2025-08-01,2025-08-15,632.08,208,196361,243349966,91051840,0.196830107631903,95.2108179049427,0.409951439081727
601.22,604,1682,1685,373404,468430,2025-08-01,2025-08-29,632.08,3,95025.9999999999,155069044,41373917,0.30207834388919,90.9891912405161,0.202860619516256
586.97,591,1104,1156,354384,465868,2025-08-01,2025-09-19,632.08,52,111484,595655559,168675191,0.0782109715860135,98.7245612191122,0.239303837138417
576.5,577,9231,9209,323085,460450,2025-08-01,2025-08-15,632.08,-22,137365,243349966,91051840,0.189213094034293,95.400030998977,0.298327722879792
629.28,655,179,179,460388,460388,2025-08-01,2025-11-21,632.08,0,0,69823438,8093490,0.659360256651928,93.1030795132145,0
374.02,375,4657,4658,470357,456484,2025-08-01,2025-12-19,632.08,1,-13873,380408956,31818097,0.119998226329876,97.9238974594489,-0.0303909885121932
623.46,624,5111,8430,178885,455220,2025-08-01,2025-08-01,632.08,3319,276335,61309866,39049978,0.742490613174721,92.8726397803577,0.607036158341022
459.55,460,9967,9987,388713,449415,2025-08-01,2025-09-19,632.08,20,60702.0000000001,595655559,168675191,0.0754488048016354,98.8000100239138,0.135068922933147
614.85,616,3800,3903,288800,448845,2025-08-01,2025-08-08,632.08,103,160045,58500270,29786673,0.767252869089322,91.229825093115,0.356570753823703
582.86,586,256,1426,85504,447764,2025-08-01,2025-09-19,632.08,1170,362260,595655559,168675191,0.0751716311943292,98.8751816551082,0.80904226333515
616.55,621,1004,1005,307224,447225,2025-08-01,2025-08-22,632.08,1,140001,60984890,20108486,0.733337388982746,87.6371556954518,0.313043769914473
464.96,465,110556,110556,552780,442224,2025-08-01,2025-08-15,632.08,0,-110556,243349966,91051840,0.181723468989513,95.5817544679665,-0.25
549.33,550,6471,6496,355905,435232,2025-08-01,2025-08-29,632.08,25,79327.0000000001,155069044,41373917,0.280669815698354,91.2698610562144,0.182263712227042
628.52,640,258,377,261870,432796,2025-08-01,2025-08-22,632.08,119,170926,60984890,20108486,0.709677429933874,88.3468331253856,0.394934333958724
519.58,520,10222,10208,439546,428736,2025-08-01,2025-08-29,632.08,-14,-10810.0000000001,155069044,41373917,0.276480713971513,91.5463417701859,-0.0252136512912376
609.65,614,850,953,268600,414555,2025-08-01,2025-08-29,632.08,103,145955,155069044,41373917,0.267335755291043,91.813677525477,0.35207632280397
469.8,470,20361,20579,366498,411580,2025-08-01,2025-08-29,632.08,218,45082,155069044,41373917,0.265417255038988,92.079094780516,0.10953399096166
617.55,625,535,551,296925,410495,2025-08-01,2025-09-05,632.08,16,113570,23171190,9460006,1.77157496011211,78.5493796391122,0.276665976443075
625.2,632,584,603,289080,410040,2025-08-01,2025-08-22,632.08,19,120960,60984890,20108486,0.672363268999911,89.0191963943856,0.294995610184372
607.97,612,838,998,343580,402194,2025-08-01,2025-08-29,632.08,160,58614,155069044,41373917,0.259364467353007,92.338459247869,0.14573564001452
610.92,614,1176,1303,390432,401324,2025-08-01,2025-08-22,632.08,127,10892,60984890,20108486,0.658071204195006,89.6772675985806,0.0271401660503733
604.4,607,1471,1541,275077,400660,2025-08-01,2025-08-22,632.08,70,125583,60984890,20108486,0.656982409905142,90.3342500084857,0.313440323466281
620.46,629,139,463,88821,395402,2025-08-01,2025-09-05,632.08,324,306581,23171190,9460006,1.70643803792554,80.2558176770378,0.775365324404024
578.25,580,2191,2251,317695,393925,2025-08-01,2025-09-05,632.08,60,76230,23171190,9460006,1.70006374294976,81.9558814199875,0.193513993780542
595.6,598,1668,1632,395316,391680,2025-08-01,2025-08-29,632.08,-36,-3636.00000000006,155069044,41373917,0.252584261756331,92.5910435096253,-0.00928308823529427
631.73,644,143,318,167596,390186,2025-08-01,2025-08-01,632.08,175,222590,61309866,39049978,0.636416331426984,93.5090561117847,0.570471518711589
595.92,601,797,761,361041,386588,2025-08-01,2025-09-19,632.08,-36,25546.9999999999,595655559,168675191,0.0649012662030743,98.9400829213113,0.0660832721139817
428.87,430,3421,3421,386573,386573,2025-08-01,2025-11-21,632.08,0,0,69823438,8093490,0.553643606033836,93.6567231192483,0
149.91,150,40908,42951,245448,386559,2025-08-01,2025-12-19,632.08,2043,141111,380408956,31818097,0.101616692746845,98.0255141521957,0.365043887220321
249.69,250,12465,12459,336555,386229,2025-08-01,2025-12-19,632.08,-6,49674,380408956,31818097,0.101529944000582,98.1270440961963,0.128612817784268
630.77,641,426,376,460506,384648,2025-08-01,2025-08-15,632.08,-50,-75858.0000000001,243349966,91051840,0.158063716351619,95.7398181843181,-0.197214076246334
604.49,608,938,1089,289842,382239,2025-08-01,2025-08-29,632.08,151,92397,155069044,41373917,0.246496005998464,92.8375395156238,0.241725726574211
413.61,415,2737,2737,380443,380443,2025-08-01,2025-12-19,632.08,0,0,380408956,31818097,0.100008949316114,98.2270530455124,0
607.26,608,4989,5017,234483,371258,2025-08-01,2025-08-08,632.08,28,136775,58500270,29786673,0.634626130785379,91.8644512239003,0.368409569625436
479.76,480,15299,15403,351877,369672,2025-08-01,2025-08-29,632.08,104,17795,155069044,41373917,0.238391874009361,93.0759313896331,0.0481372676318466
489.74,490,14035,14098,407015,366548,2025-08-01,2025-08-29,632.08,63,-40466.9999999999,155069044,41373917,0.236377287526194,93.3123086771593,-0.11040027499809
383.91,385,3353,3354,355418,365586,2025-08-01,2025-12-19,632.08,1,10168,380408956,31818097,0.0961034156093844,98.3231564611218,0.0278128812372465
605.43,609,905,1018,330325,363426,2025-08-01,2025-08-29,632.08,113,33101,155069044,41373917,0.234363990791096,93.5466726679504,0.09108044003456
219.79,220,15294,17294,305880,363174,2025-08-01,2025-12-19,632.08,2000,57294,380408956,31818097,0.0954693611367026,98.4186258222585,0.157759090683804
544.77,545,15400,15780,369600,362940,2025-08-01,2025-08-15,632.08,380,-6660,243349966,91051840,0.149143230206985,95.8889614145251,-0.0183501405190941
618.05,623,549,729,255834,360855,2025-08-01,2025-08-22,632.08,180,105021,60984890,20108486,0.591712143778566,90.9259621522643,0.291033794737499
615.27,621,620,627,248000,359271,2025-08-01,2025-08-29,632.08,7,111271,155069044,41373917,0.231684539178561,93.778357207129,0.309713280504132
631.84,675,13,83,55575,358228,2025-08-01,2025-10-17,632.08,70,302653,227356040,48158939,0.157562561346512,98.5628492649678,0.844861373203658
622.57,623,5833,8320,174990,357760,2025-08-01,2025-08-01,632.08,2487,182770,61309866,39049978,0.583527616909161,94.0925837286939,0.510873211091234
239.73,240,13155,13176,328875,355752,2025-08-01,2025-12-19,632.08,21,26877.0000000001,380408956,31818097,0.0935183029707639,98.5121441252293,0.075549821223774
617.26,622,758,746,234980,353604,2025-08-01,2025-08-22,632.08,-12,118624,60984890,20108486,0.579822313363195,91.5057844656275,0.335471318197758
632.5,655,155,157,279000,353250,2025-08-01,2025-08-29,632.08,2,74250,155069044,41373917,0.227801752618015,94.006158959747,0.210191082802548
439.65,440,10057,10092,311767,353220,2025-08-01,2025-09-19,632.08,35,41453,595655559,168675191,0.0592993710313044,98.9993822923426,0.117357454277787
592.83,597,491,845,218986,352365,2025-08-01,2025-09-19,632.08,354,133379,595655559,168675191,0.0591558317010519,99.0585381240436,0.378525108906957
589.08,591,1755,1760,317655,337920,2025-08-01,2025-08-29,632.08,5,20265,155069044,41373917,0.217915833672129,94.2240747934191,0.0599698153409091
605.5,612,584,519,355072,337350,2025-08-01,2025-09-19,632.08,-65,-17722,595655559,168675191,0.05663507960311,99.1151732036467,-0.0525329776196828
621.52,645,141,142,282000,333416,2025-08-01,2025-11-21,632.08,1,51416,69823438,8093490,0.477513009313578,94.1342361285619,0.154209755980517
616.68,618,2413,2495,188214,329340,2025-08-01,2025-08-08,632.08,82,141126,58500270,29786673,0.562971760643156,92.4274229845435,0.428511568591729
524.8,525,17638,16446,282208,328920,2025-08-01,2025-08-15,632.08,-1192,46712,243349966,91051840,0.135163363860918,96.0241247783861,0.142016295755807
567.95,575,464,465,294640,327825,2025-08-01,2025-11-21,632.08,1,33185.0000000001,69823438,8093490,0.469505669428652,94.6037417979905,0.101227789216808
614.88,619,459,794,193239,327128,2025-08-01,2025-08-22,632.08,335,133889,60984890,20108486,0.536408280805295,92.0421927464328,0.409286273263065
620.79,623,2034,1477,252216,326417,2025-08-01,2025-08-08,632.08,-557,74201,58500270,29786673,0.557975202507612,92.9853981870511,0.227319655532647
544.42,545,5301,5620,318060,325960,2025-08-01,2025-08-29,632.08,319,7900,155069044,41373917,0.210203140221849,94.434277933641,0.0242361025892748
595.93,597,1593,3041,105138,325387,2025-08-01,2025-08-15,632.08,1448,220249,243349966,91051840,0.13371154528947,96.1578363236755,0.676883219059151
619.29,621,1239,1896,122661,324216,2025-08-01,2025-08-08,632.08,657,201555,58500270,29786673,0.554212826710031,93.5396110137611,0.621668887408394
630,642,195,270,190125,324000,2025-08-01,2025-08-22,632.08,75,133875,60984890,20108486,0.531279141439789,92.5734718878726,0.413194444444444
600.06,603,1044,1100,216108,323400,2025-08-01,2025-08-29,632.08,56,107292,155069044,41373917,0.208552262694029,94.642830196335,0.331762523191095
399.52,400,6702,6693,355206,321264,2025-08-01,2025-10-17,632.08,-9,-33942.0000000001,227356040,48158939,0.141304361212484,98.7041536261803,-0.105651426863888
429.96,430,80221,80122,240663,320488,2025-08-01,2025-08-15,632.08,-99,79825,243349966,91051840,0.131698395223939,96.2895347188994,0.249073288235441
604.5,605,8745,6381,323565,319050,2025-08-01,2025-08-08,632.08,-2364,-4515,58500270,29786673,0.54538209823647,94.0849931119976,-0.0141513869299483
621.66,622,6947,9234,173675,313956,2025-08-01,2025-08-01,632.08,2287,140281,61309866,39049978,0.512080714709114,94.604664443403,0.446817388423856
439.27,440,4277,4277,320775,312221,2025-08-01,2025-10-17,632.08,0,-8554,227356040,48158939,0.137326899254579,98.8414805254349,-0.0273972602739726
605.41,608,1080,1197,193320,310023,2025-08-01,2025-08-22,632.08,117,116703,60984890,20108486,0.508360349588234,93.0818322374608,0.376433361395767
516.83,520,958,964,277820,305588,2025-08-01,2025-11-21,632.08,6,27768,69823438,8093490,0.437658197237438,95.041399995228,0.0908674424388392
591.71,594,1337,1331,310184,304799,2025-08-01,2025-08-29,632.08,-6,-5384.99999999994,155069044,41373917,0.196556960781934,94.8393871571169,-0.0176673807984932
634.04,646,254,254,321310,303784,2025-08-01,2025-08-29,632.08,0,-17526,155069044,41373917,0.195902413637115,95.035289570754,-0.0576923076923077
444.67,445,9170,9192,339290,303336,2025-08-01,2025-09-19,632.08,22,-35954,595655559,168675191,0.0509247324929272,99.1660979361396,-0.118528628319751
603.47,607,883,855,286975,301815,2025-08-01,2025-08-29,632.08,-28,14839.9999999999,155069044,41373917,0.19463265666357,95.2299222274176,0.0491691930487217
469.01,470,3055,3047,308555,301653,2025-08-01,2025-10-17,632.08,-8,-6902,227356040,48158939,0.132678683179035,98.9741592086139,-0.0228805945904732
379.04,380,3074,3088,322770,296448,2025-08-01,2025-12-19,632.08,14,-26322,380408956,31818097,0.0779287646424392,98.5900728898717,-0.0887912888601036
632.47,650,178,168,220186,294504,2025-08-01,2025-08-01,632.08,-10,74318,61309866,39049978,0.480353357810307,95.0850178012133,0.252349713416456
566.68,567,9125,9125,282875,292000,2025-08-01,2025-08-15,632.08,0,9125,243349966,91051840,0.119991798149666,96.4095265170491,0.03125
454.62,455,7632,7629,320544,289902,2025-08-01,2025-09-19,632.08,-3,-30642,595655559,168675191,0.0486694022442591,99.2147673383839,-0.105697787528199
585.35,587,1643,1741,211947,287265,2025-08-01,2025-08-29,632.08,98,75317.9999999999,155069044,41373917,0.185249739464441,95.4151719668821,0.26218996397055
559.21,560,3642,3635,240372,287165,2025-08-01,2025-08-29,632.08,-7,46793,155069044,41373917,0.185185252061011,95.6003572189431,0.16294813086553
596.8,599,1259,1304,321045,286880,2025-08-01,2025-08-29,632.08,45,-34165,155069044,41373917,0.185001462961234,95.7853586819043,-0.119091606246514
529.8,530,14219,14199,284380,283980,2025-08-01,2025-08-15,632.08,-20,-400,243349966,91051840,0.116696133008706,96.5262226500578,-0.00140854989788013
615.75,617,2109,2232,151848,279000,2025-08-01,2025-08-08,632.08,123,127152,58500270,29786673,0.476920875749804,94.5619139877474,0.455741935483871
622.52,629,402,426,179694,276048,2025-08-01,2025-08-22,632.08,24,96354,60984890,20108486,0.452649828506701,93.5344820659675,0.349047991653626
601.71,603,2184,2136,181272,275544,2025-08-01,2025-08-15,632.08,-48,94272,243349966,91051840,0.113229520648464,96.6394521707063,0.342130476439335
289.57,290,6343,6343,272749,272749,2025-08-01,2025-12-19,632.08,0,0,380408956,31818097,0.0716988902858533,98.6617717801576,0
409.8,410,13629,13634,299838,272680,2025-08-01,2025-09-19,632.08,5,-27158,595655559,168675191,0.0457781340037826,99.2605454723877,-0.0995965967434355
598.31,601,1011,1008,204222,271152,2025-08-01,2025-08-29,632.08,-3,66930,155069044,41373917,0.174858884149695,95.960217566054,0.246835723136838
199.84,200,16938,16938,271008,271008,2025-08-01,2025-12-19,632.08,0,0,380408956,31818097,0.0712412249305718,98.7330130050881,0
620.72,621,5034,9672,115782,270816,2025-08-01,2025-08-01,632.08,4638,155034,61309866,39049978,0.441716835590539,95.5267346368038,0.572469868840837
613.89,620,345,438,159735,267618,2025-08-01,2025-09-05,632.08,93,107883,23171190,9460006,1.15496010347332,83.1108415234608,0.4031231083111
625.03,650,118,107,269748,267179,2025-08-01,2025-11-21,632.08,-11,-2569,69823438,8093490,0.382649447883102,95.4240494431111,-0.00961527664973669
329.33,330,3982,3983,246884,266861,2025-08-01,2025-12-19,632.08,1,19977,380408956,31818097,0.0701510823525406,98.8031640874407,0.0748591963606522
478,480,1331,1334,267531,266800,2025-08-01,2025-11-21,632.08,3,-730.999999999942,69823438,8093490,0.382106650205337,95.8061560933164,-0.0027398800599698
159.91,160,29556,29581,236448,266229,2025-08-01,2025-12-19,632.08,25,29781,380408956,31818097,0.0699849453596986,98.8731490328004,0.111862344072209
594.45,597,1033,1036,182841,264180,2025-08-01,2025-08-29,632.08,3,81339,155069044,41373917,0.170362822382525,96.1305803884365,0.30789234612764
354.25,355,3510,3510,263250,263250,2025-08-01,2025-12-19,632.08,0,0,380408956,31818097,0.0692018407684387,98.9423508735688,0
578.46,579,4904,4846,250104,261684,2025-08-01,2025-08-15,632.08,-58,11580,243349966,91051840,0.107534019544511,96.7469861902508,0.0442518457376072
507.14,510,907,912,259402,260832,2025-08-01,2025-11-21,632.08,5,1429.99999999997,69823438,8093490,0.373559377010339,96.1797154703267,0.00548245614035077
632.88,650,146,151,270684,258512,2025-08-01,2025-08-22,632.08,5,-12171.9999999999,60984890,20108486,0.42389516485149,93.958377230819,-0.0470848548616695
599.24,602,903,932,223041,257232,2025-08-01,2025-08-29,632.08,29,34190.9999999999,155069044,41373917,0.165882237592179,96.2964626260287,0.132918921440567
582.45,583,4675,4674,247775,257070,2025-08-01,2025-08-15,632.08,-1,9295.00000000003,243349966,91051840,0.10563798476142,96.8526241750122,0.0361574668378264
403.72,405,2001,2000,258129,256000,2025-08-01,2025-12-19,632.08,-1,-2129,380408956,31818097,0.067295997100552,99.0096468706694,-0.00831640625
612.99,614,1167,2533,96861,255833,2025-08-01,2025-08-08,632.08,1366,158972,58500270,29786673,0.437319349124372,94.9992333368718,0.621389734709752
592.16,595,836,900,173888,255600,2025-08-01,2025-09-05,632.08,64,81712,23171190,9460006,1.10309397143608,84.2139354948969,0.319687010954617
554.27,555,3257,3473,234504,253529,2025-08-01,2025-08-29,632.08,216,19025,155069044,41373917,0.16349426904315,96.4599568950719,0.0750407251241475
632.61,660,23,92,56212,251988,2025-08-01,2025-08-15,632.08,69,195776,243349966,91051840,0.103549634356637,96.9561738093689,0.77692588535962
541.79,542,11950,11950,250950,250950,2025-08-01,2025-08-15,632.08,0,0,243349966,91051840,0.103123088170064,97.0592968975389,0
369.08,370,2711,2711,249412,249412,2025-08-01,2025-12-19,632.08,0,0,380408956,31818097,0.0655641766751675,99.0752110473445,0
594.21,599,480,520,180000,249080,2025-08-01,2025-09-19,632.08,40,69080,595655559,168675191,0.0418161127243001,99.302361585112,0.277340613457524
629.9,641,163,223,144744,247530,2025-08-01,2025-08-22,632.08,60,102786,60984890,20108486,0.40588742555738,94.3642646563764,0.4152466367713
590.1,592,1316,1300,246092,247000,2025-08-01,2025-08-29,632.08,-16,908,155069044,41373917,0.159283886473176,96.619240781545,0.00367611336032389
610.22,611,3073,3166,147504,246948,2025-08-01,2025-08-08,632.08,93,99444,58500270,29786673,0.422131385034633,95.4213647219064,0.402692064726177
583.41,587,447,685,159132,245915,2025-08-01,2025-09-19,632.08,238,86783,595655559,168675191,0.0412847653789797,99.343646350491,0.352898359189151
629.03,645,124,153,169880,244341,2025-08-01,2025-09-05,632.08,29,74461,23171190,9460006,1.05450345882106,85.268438953718,0.304742143152398
623.73,634,170,237,126480,243399,2025-08-01,2025-09-05,632.08,67,116919,23171190,9460006,1.05043806554605,86.318877019264,0.480359409857888
448.65,450,1772,1777,253396,239895,2025-08-01,2025-11-21,632.08,5,-13501,69823438,8093490,0.343573743819375,96.5232892141461,-0.0562787886366951
613.19,617,511,626,160454,238506,2025-08-01,2025-08-22,632.08,115,78052,60984890,20108486,0.39109031761802,94.7553549739944,0.327253821706791
572.52,573,4847,4958,164798,237984,2025-08-01,2025-08-15,632.08,111,73186,243349966,91051840,0.0977949592152398,97.1570918567542,0.30752487562189
607.39,611,610,659,232410,237899,2025-08-01,2025-08-29,632.08,49,5488.99999999997,155069044,41373917,0.153414887886972,96.772655669432,0.0230728166154543
600.9,603,1112,1128,235744,236880,2025-08-01,2025-08-22,632.08,16,1136.00000000003,60984890,20108486,0.388424083408202,95.1437790574026,0.00479567713610279
409.97,410,78869,78932,236607,236796,2025-08-01,2025-08-15,632.08,63,189.000000000029,243349966,91051840,0.0973067734063295,97.2543986301605,0.00079815537424631
531.4,535,1256,657,513704,236520,2025-08-01,2025-11-21,632.08,-599,-277184,69823438,8093490,0.338740123337954,96.8620293374841,-1.17192626416371
580.98,584,665,770,224105,232540,2025-08-01,2025-09-19,632.08,105,8434.99999999997,595655559,168675191,0.0390393401835103,99.3826856906745,0.0362733293196868
594.72,595,8260,8219,223020,230132,2025-08-01,2025-08-08,632.08,-41,7112,58500270,29786673,0.393386218559333,95.8147509404657,0.0309040029200633
408.65,410,1711,1695,225852,228825,2025-08-01,2025-12-19,632.08,-16,2973,380408956,31818097,0.0601523692833352,99.1353634166279,0.0129924614880367
606.17,609,723,797,161229,225551,2025-08-01,2025-08-22,632.08,74,64322,60984890,20108486,0.369847350712611,95.5136264081152,0.285177188307744
589.73,594,435,528,188355,225456,2025-08-01,2025-09-19,632.08,93,37101,595655559,168675191,0.0378500622706352,99.4205357529451,0.164559825420481
584.25,588,413,598,122661,224250,2025-08-01,2025-09-19,632.08,185,101589,595655559,168675191,0.0376475962679633,99.4581833492131,0.453016722408027
626.46,639,109,177,98863,221958,2025-08-01,2025-09-05,632.08,68,123095,23171190,9460006,0.95790505364636,87.2767820729104,0.554586903828652
568.52,570,1365,1486,193830,219928,2025-08-01,2025-09-05,632.08,121,26098,23171190,9460006,0.949144174295753,88.2259262472061,0.11866610890837
579.12,580,2243,2479,195141,218152,2025-08-01,2025-08-22,632.08,236,23011,60984890,20108486,0.357714837232633,95.8713412453478,0.105481499138216
418.95,420,2060,2060,216300,216300,2025-08-01,2025-11-21,632.08,0,0,69823438,8093490,0.309781365964821,97.1718107034489,0
630.88,643,298,178,306940,215736,2025-08-01,2025-08-29,632.08,-120,-91204,155069044,41373917,0.139122544664685,96.9117782140967,-0.422757444283754
564.36,565,3374,3365,182196,215360,2025-08-01,2025-08-22,632.08,-9,33164,60984890,20108486,0.353136654013806,96.2244778993616,0.153993313521545
633.47,705,1,30,7017,214590,2025-08-01,2025-08-01,632.08,29,207573,61309866,39049978,0.350008920260893,95.8767435570647,0.967300433384594
588.83,593,269,509,112980,212253,2025-08-01,2025-09-19,632.08,240,99273,595655559,168675191,0.0356335128234739,99.4938168620365,0.467710703735636
513.17,515,870,1157,154860,211731,2025-08-01,2025-10-17,632.08,287,56871,227356040,48158939,0.0931275016929394,99.0672867103069,0.26860025220681
585.22,589,516,556,187824,210168,2025-08-01,2025-09-19,632.08,40,22344,595655559,168675191,0.0352834783163671,99.5291003403529,0.106314948041567
364.11,365,2358,2357,214578,209773,2025-08-01,2025-12-19,632.08,-1,-4805.00000000003,380408956,31818097,0.0551440749991175,99.190507491627,-0.0229057123652712
424.96,425,52190,52290,156570,209160,2025-08-01,2025-08-15,632.08,100,52590,243349966,91051840,0.0859502893869317,97.3403489195474,0.251434308663224
636.75,655,103,113,197142,206225,2025-08-01,2025-09-05,632.08,10,9083,23171190,9460006,0.890006080827096,89.1159323280332,0.0440441265607952
574.98,578,575,682,168475,205964,2025-08-01,2025-09-19,632.08,107,37489,595655559,168675191,0.0345777013053949,99.5636780416583,0.182017245732264
628,639,127,185,134874,203500,2025-08-01,2025-08-22,632.08,58,68626,60984890,20108486,0.333689213836411,96.558167113198,0.337228501228501
584.33,586,843,1217,129822,203239,2025-08-01,2025-08-29,632.08,374,73417,155069044,41373917,0.131063553857983,97.0428417679547,0.361234802375528
632.04,643,202,185,187860,202760,2025-08-01,2025-08-08,632.08,-17,14900,58500270,29786673,0.346596690921256,96.161347631387,0.0734858946537779
612.45,616,597,566,178503,200930,2025-08-01,2025-08-22,632.08,-31,22427,60984890,20108486,0.329475055214497,96.8876421684125,0.11161598566665
487.98,490,982,990,201310,199980,2025-08-01,2025-11-21,632.08,8,-1330,69823438,8093490,0.286408125592441,97.4582188290413,-0.00665066506650665
324.41,325,3161,3361,186499,198299,2025-08-01,2025-12-19,632.08,200,11800,380408956,31818097,0.0521278473790717,99.2426353390061,0.059506099375186
214.81,215,10134,10309,172278,195871,2025-08-01,2025-12-19,632.08,175,23593,380408956,31818097,0.0514895869065712,99.2941249259126,0.120451725880809
503.49,505,1269,1268,203040,191468,2025-08-01,2025-10-17,632.08,-1,-11572,227356040,48158939,0.0842150487842769,99.1515017590912,-0.0604382977834416
536,540,385,465,157465,186000,2025-08-01,2025-11-21,632.08,80,28535,69823438,8093490,0.266386195420512,97.7246050244618,0.153413978494624
549.79,555,355,356,183180,185476,2025-08-01,2025-11-21,632.08,1,2296,69823438,8093490,0.265635731085026,97.9902407555469,0.0123789600810887
449.84,450,11582,11585,150566,185360,2025-08-01,2025-08-29,632.08,3,34794,155069044,41373917,0.119533850998656,97.1623756189533,0.187710401381096
526.55,530,536,532,182240,183540,2025-08-01,2025-11-21,632.08,-4,1300,69823438,8093490,0.262863023158499,98.2531037787054,0.007082924703062
584.81,585,9941,9657,218702,183483,2025-08-01,2025-08-08,632.08,-284,-35219,58500270,29786673,0.313644706255202,96.4749923376422,-0.191946937863453
638.23,690,0,35,0,181195,2025-08-01,2025-08-01,632.08,35,181195,61309866,39049978,0.295539709710016,96.1722832667747,1
593.82,596,815,829,144255,180722,2025-08-01,2025-08-29,632.08,14,36467,155069044,41373917,0.116542925227552,97.2789185441809,0.20178506213964
622.45,632,175,189,154525,180495,2025-08-01,2025-09-05,632.08,14,25970,23171190,9460006,0.778963013984176,89.8948953420174,0.143882101997285
569.31,570,2615,2613,141210,180297,2025-08-01,2025-08-22,632.08,-2,39087,60984890,20108486,0.295642084457314,97.1832842528698,0.216792292717017
586.27,588,983,1036,188736,179228,2025-08-01,2025-08-29,632.08,53,-9508,155069044,41373917,0.115579483420302,97.3944980276012,-0.0530497466913652
573.47,575,1074,1153,151434,176409,2025-08-01,2025-09-05,632.08,79,24975,23171190,9460006,0.761329046976008,90.6562243889934,0.141574409468905
587.34,588,2635,2662,137020,175692,2025-08-01,2025-08-15,632.08,27,38672,243349966,91051840,0.0721972568510653,97.4125461763985,0.220112469548983
564.2,565,2208,2190,198720,175200,2025-08-01,2025-08-29,632.08,-18,-23520,155069044,41373917,0.112981930810124,97.5074799584113,-0.134246575342466
540.72,545,203,407,84448,174196,2025-08-01,2025-11-21,632.08,204,89748,69823438,8093490,0.249480697298234,98.5025844760036,0.515212748857609
474.82,475,9642,9634,231408,173412,2025-08-01,2025-08-29,632.08,-8,-57996,155069044,41373917,0.111828896036787,97.6193088544481,-0.334440523147187
596.67,597,5115,5228,173910,172524,2025-08-01,2025-08-08,632.08,113,-1386,58500270,29786673,0.294911459383008,96.7699037970252,-0.0080336648814078
620,622,721,849,77868,169800,2025-08-01,2025-08-08,632.08,128,91932,58500270,29786673,0.290255070617623,97.0601588676428,0.541413427561837
509.65,510,4820,4822,159060,168770,2025-08-01,2025-08-29,632.08,2,9709.99999999997,155069044,41373917,0.108835390769546,97.7281442452176,0.0575339219055518
639.03,695,0,30,0,167910,2025-08-01,2025-08-01,632.08,30,167910,61309866,39049978,0.273871092786274,96.446154359561,1
629.63,655,67,66,174870,167442,2025-08-01,2025-10-17,632.08,-1,-7428,227356040,48158939,0.0736474826004183,99.2251492416916,-0.0443616296986419
571.6,572,4205,4184,147175,167360,2025-08-01,2025-08-15,632.08,-21,20185,243349966,91051840,0.068773381295644,97.4813195576941,0.12060826959847
602.93,606,547,544,131280,167008,2025-08-01,2025-08-29,632.08,-3,35728,155069044,41373917,0.107699122721102,97.8358433679387,0.213929871622916
607,611,360,414,159840,165600,2025-08-01,2025-09-05,632.08,54,5760,23171190,9460006,0.714680601212109,91.3709049902055,0.0347826086956522
624.6,655,59,54,162840,164160,2025-08-01,2025-12-19,632.08,-5,1320,380408956,31818097,0.0431535581407289,99.3372784840534,0.00804093567251462
583.94,585,1479,1540,121278,163240,2025-08-01,2025-08-22,632.08,61,41962,60984890,20108486,0.267672861261207,97.4509571141311,0.257057093849547
631.01,665,107,48,353849,163152,2025-08-01,2025-09-19,632.08,-59,-190697,595655559,168675191,0.0273903260928016,99.5910683677511,-1.1688302932235
394.23,395,2083,2083,156225,160391,2025-08-01,2025-11-21,632.08,0,4166,69823438,8093490,0.229709399299416,98.732293875303,0.025974025974026
577.56,578,3625,3624,210250,159456,2025-08-01,2025-08-15,632.08,-1,-50794,243349966,91051840,0.0655253841292914,97.5468449418234,-0.318545554886615
556.73,557,6169,5869,185070,158463,2025-08-01,2025-08-15,632.08,-300,-26607,243349966,91051840,0.0651173298294194,97.6119622716529,-0.16790670377312
631.65,642,537,153,306090,158355,2025-08-01,2025-08-01,632.08,-384,-147735,61309866,39049978,0.258286325401527,96.7044406849625,-0.932935493037795
434.71,435,5300,5452,153700,158108,2025-08-01,2025-09-19,632.08,152,4408,595655559,168675191,0.026543527985441,99.6176118957366,0.0278796771826853
580.05,583,508,532,136652,156940,2025-08-01,2025-09-19,632.08,24,20288,595655559,168675191,0.0263474415085581,99.6439593372451,0.129272333375812
534.79,535,7513,7454,150260,156534,2025-08-01,2025-08-15,632.08,-59,6274,243349966,91051840,0.0643246442861636,97.676286915939,0.0400807492301992
630.2,660,43,52,123625,154960,2025-08-01,2025-10-17,632.08,9,31335,227356040,48158939,0.0681574151273923,99.293306656819,0.202213474445018
580.63,582,1120,1130,168000,154810,2025-08-01,2025-08-29,632.08,10,-13190,155069044,41373917,0.0998329492506577,97.9356763171894,-0.0852012143918352
384.62,385,4072,4072,154736,154736,2025-08-01,2025-10-17,632.08,0,0,227356040,48158939,0.0680588912438834,99.3613655480629,0
324.78,325,6546,6666,144012,146652,2025-08-01,2025-10-17,632.08,120,2640,227356040,48158939,0.0645032346622505,99.4258687827251,0.018001800180018
576.32,579,399,543,119301,145524,2025-08-01,2025-09-19,632.08,144,26223,595655559,168675191,0.0244308976557373,99.6683902349008,0.180197080893873
529.5,530,2873,2910,152269,145500,2025-08-01,2025-08-29,632.08,37,-6769,155069044,41373917,0.0938291719912841,98.0295054891807,-0.0465223367697594
309.44,310,2590,2590,142450,145040,2025-08-01,2025-12-19,632.08,0,2589.99999999997,380408956,31818097,0.0381273883572815,99.3754058724106,0.0178571428571427
626.5,640,0,107,0,144450,2025-08-01,2025-09-12,632.08,107,144450,1003977,1003977,14.3877797997364,14.3877797997364,1
590.83,593,552,662,83904,143654,2025-08-01,2025-08-29,632.08,110,59750,155069044,41373917,0.0926387345239582,98.1221442237046,0.415929942779178
586.47,587,2699,2701,137649,143153,2025-08-01,2025-08-15,632.08,2,5504,243349966,91051840,0.0588259790428736,97.7351128949819,0.03844837341865
579.66,581,1035,1051,129375,140834,2025-08-01,2025-08-29,632.08,16,11459,155069044,41373917,0.09082018974722,98.2129644134519,0.0813652953122115
574.85,575,9441,9357,132174,140355,2025-08-01,2025-08-08,632.08,-84,8180.99999999997,58500270,29786673,0.23992196959091,97.3000808372338,0.0582879127925615
389.82,390,7780,7779,140040,140022,2025-08-01,2025-09-19,632.08,-1,-18,595655559,168675191,0.0235072094743936,99.6918974443752,-0.000128551227664224
339.29,340,1536,1928,109056,136888,2025-08-01,2025-12-19,632.08,392,27832,380408956,31818097,0.0359844314496108,99.4113903038603,0.203319502074689
548.74,549,5261,5258,110481,136708,2025-08-01,2025-08-15,632.08,-3,26227,243349966,91051840,0.0561775299364538,97.7912904249183,0.191846856072798
573.6,574,3384,3383,152280,135320,2025-08-01,2025-08-15,632.08,-1,-16960,243349966,91051840,0.0556071579644272,97.8468975828828,-0.125332545078333
563.72,565,1049,1055,125880,135040,2025-08-01,2025-09-05,632.08,6,9160,23171190,9460006,0.582792683500502,91.953697673706,0.0678317535545024
524.6,525,3300,3334,151800,133360,2025-08-01,2025-08-29,632.08,34,-18440,155069044,41373917,0.0860004012148292,98.2989648146667,-0.138272345530894
609.94,610,21333,22200,213330,133200,2025-08-01,2025-08-01,632.08,867,-80130,61309866,39049978,0.217257039837601,96.9216977248001,-0.601576576576577
393.78,395,1088,1090,126208,132980,2025-08-01,2025-12-19,632.08,2,6772,380408956,31818097,0.0349571159938727,99.4463474198541,0.0509249511204692
164.91,165,11432,14632,102888,131688,2025-08-01,2025-12-19,632.08,3200,28800,380408956,31818097,0.0346174815085058,99.4809649013626,0.218698742482231
575.65,576,3315,3759,172380,131565,2025-08-01,2025-08-15,632.08,444,-40815,243349966,91051840,0.0540641127519204,97.9009616956347,-0.310226884049709
630.04,643,0,100,0,129600,2025-08-01,2025-09-12,632.08,100,129600,1003977,1003977,12.9086622502308,27.2964420499673,1
574.89,576,1107,1150,110700,127650,2025-08-01,2025-08-29,632.08,43,16950,155069044,41373917,0.0823181704789513,98.3812829851457,0.132784958871915
614.89,615,11637,11510,151281,126610,2025-08-01,2025-08-01,632.08,-127,-24671,61309866,39049978,0.206508361965756,97.1282060867659,-0.194858226048496
616.47,623,143,193,91806,126029,2025-08-01,2025-09-05,632.08,50,34223,23171190,9460006,0.543903873732855,92.4976015474389,0.271548611827437
630.35,645,83,86,111220,125990,2025-08-01,2025-08-22,632.08,3,14770,60984890,20108486,0.206592157499997,97.6575492716311,0.117231526311612
269.66,270,3652,3652,124168,124168,2025-08-01,2025-12-19,632.08,0,0,380408956,31818097,0.0326406615936771,99.5136055629563,0
568.63,569,3350,3353,117250,124061,2025-08-01,2025-08-15,632.08,3,6810.99999999999,243349966,91051840,0.0509804879118002,97.9519421835465,0.0549004118941487
537.75,538,4925,4925,123125,123125,2025-08-01,2025-08-15,632.08,0,0,243349966,91051840,0.0505958566684164,98.0025380402149,0
509.85,510,8040,8162,112560,122430,2025-08-01,2025-08-15,632.08,122,9869.99999999999,243349966,91051840,0.0503102597515876,98.0528482999665,0.0806174957118352
554.5,555,2557,2439,127850,121950,2025-08-01,2025-08-22,632.08,-118,-5900,60984890,20108486,0.199967565736365,97.8575168373674,-0.048380483804838
608.56,614,213,224,97980,121856,2025-08-01,2025-09-05,632.08,11,23876,23171190,9460006,0.525894440466804,93.0234959879057,0.19593618697479
631.24,647,79,77,117473,121352,2025-08-01,2025-08-08,632.08,-2,3879,58500270,29786673,0.207438358831506,97.5075191960653,0.0319648625486189
630.83,644,97,92,99328,121164,2025-08-01,2025-08-08,632.08,-5,21836,58500270,29786673,0.207116992793367,97.7146361888586,0.180218546763065
607.84,611,280,379,84280,119764,2025-08-01,2025-08-22,632.08,99,35484,60984890,20108486,0.196383071282083,98.0538999086495,0.296282689288935
574.44,577,241,466,68926,119296,2025-08-01,2025-09-19,632.08,225,50370,595655559,168675191,0.0200276818032685,99.7119251261785,0.422227065450644
623.08,635,0,100,0,119200,2025-08-01,2025-09-12,632.08,100,119200,1003977,1003977,11.8727819462,39.1692239961672,1
562.7,563,3935,3935,129855,118050,2025-08-01,2025-08-15,632.08,0,-11805,243349966,91051840,0.0485103827793426,98.1013586827458,-0.1
194.86,195,8396,8406,117544,117684,2025-08-01,2025-12-19,632.08,10,140.000000000015,380408956,31818097,0.0309361801671147,99.5445417431234,0.00118962645729253
583.53,584,2403,2502,151389,117594,2025-08-01,2025-08-15,632.08,99,-33795,243349966,91051840,0.0483229983274376,98.1496816810733,-0.287387111587326
628.79,642,87,89,102138,117569,2025-08-01,2025-08-29,632.08,2,15431,155069044,41373917,0.0758171953391291,98.4571001804848,0.13125058476299
459.11,460,1279,1316,112552,117124,2025-08-01,2025-10-17,632.08,37,4572,227356040,48158939,0.051515675589705,99.4773844583148,0.0390355520644787
625.64,637,0,103,0,117008,2025-08-01,2025-09-12,632.08,103,117008,1003977,1003977,11.6544502513504,50.8236742475176,1
574.24,575,1537,1537,104516,116812,2025-08-01,2025-08-22,632.08,0,12296,60984890,20108486,0.19154252799341,98.2454424366429,0.105263157894737
414.8,415,5823,5815,151398,116300,2025-08-01,2025-09-19,632.08,-8,-35098,595655559,168675191,0.0195247065594833,99.731449832738,-0.301788478073947
612.83,619,197,187,87665,115379,2025-08-01,2025-09-05,632.08,-10,27714,23171190,9460006,0.497941624923019,93.5214376128287,0.240199689718233
619.05,627,79,145,63279,115275,2025-08-01,2025-09-05,632.08,66,51996,23171190,9460006,0.497492791695204,94.0189304045239,0.451060507482108
494.69,495,3698,3686,92450,114266,2025-08-01,2025-08-29,632.08,-12,21816,155069044,41373917,0.0736871764038218,98.5307873568886,0.190922934206151
566.99,568,871,1124,86229,113524,2025-08-01,2025-08-29,632.08,253,27295,155069044,41373917,0.0732086798703679,98.603996036759,0.240433740882985
566.05,567,1196,1193,118404,113335,2025-08-01,2025-08-29,632.08,-3,-5069.00000000002,155069044,41373917,0.0730867986778844,98.6770828354368,-0.0447258128556934
590.25,591,1652,1487,82600,111525,2025-08-01,2025-08-15,632.08,-165,28925,243349966,91051840,0.0458290592076762,98.1955107402809,0.259358888141672
604.8,609,18,263,6876,110460,2025-08-01,2025-09-05,632.08,245,103584,23171190,9460006,0.476712676388222,94.4956430809121,0.937751222161869
189.87,190,8380,8390,108940,109070,2025-08-01,2025-12-19,632.08,10,129.999999999985,380408956,31818097,0.0286717750146766,99.5732135181381,0.0011918951132299
449.93,450,15539,15537,62156,108759,2025-08-01,2025-08-15,632.08,-2,46603,243349966,91051840,0.0446924245717791,98.2402031648527,0.428497871440525
488.75,490,857,858,115695,107250,2025-08-01,2025-10-17,632.08,1,-8445,227356040,48158939,0.0471727076175324,99.5245571659324,-0.0787412587412587
560.67,561,3246,3221,90888,106293,2025-08-01,2025-08-15,632.08,-25,15405,243349966,91051840,0.0436790691805562,98.2838822340333,0.144929581439982
582.46,584,683,690,105182,106260,2025-08-01,2025-08-29,632.08,7,1078.00000000001,155069044,41373917,0.0685243148851811,98.745607150322,0.010144927536232
581.51,582,2161,2166,86440,106134,2025-08-01,2025-08-15,632.08,5,19694,243349966,91051840,0.0436137311808788,98.3274959652142,0.18555787966156
632,646,53,75,74147,105000,2025-08-01,2025-08-01,632.08,22,30853,61309866,39049978,0.171261180052163,97.299467266818,0.293838095238095
521.62,525,302,309,106304,104442,2025-08-01,2025-11-21,632.08,7,-1862,69823438,8093490,0.149580145280157,98.8818740205832,-0.01782807682733
563.7,564,3560,3452,117480,103560,2025-08-01,2025-08-15,632.08,-108,-13920,243349966,91051840,0.0425559952615732,98.3700519604757,-0.13441483198146
489.99,490,102770,102770,102770,102770,2025-08-01,2025-08-01,632.08,0,0,61309866,39049978,0.167623918799627,97.4670911856177,0
419.75,420,4079,4104,110133,102600,2025-08-01,2025-09-19,632.08,25,-7533.00000000002,595655559,168675191,0.0172247196302922,99.7486745523683,-0.0734210526315791
633.99,655,70,48,153930,100848,2025-08-01,2025-08-15,632.08,-22,-53082,243349966,91051840,0.0414415508897174,98.4114935113654,-0.526356496906235
588.25,589,1369,1344,88985,100800,2025-08-01,2025-08-15,632.08,-25,11815,243349966,91051840,0.0414218262105695,98.452915337576,0.117212301587302
617.85,618,6935,6717,117895,100755,2025-08-01,2025-08-01,632.08,-218,-17140,61309866,39049978,0.164337335201483,97.6314285208191,-0.170115627016029
299.95,300,20186,20147,100930,100735,2025-08-01,2025-09-19,632.08,-39,-195,595655559,168675191,0.0169116192198586,99.7655861715882,-0.00193577207524694
575.68,577,714,763,92106,100716,2025-08-01,2025-08-29,632.08,49,8610.00000000002,155069044,41373917,0.0649491332389977,98.810556283561,0.0854879065888242
555.26,556,1360,1354,115600,100196,2025-08-01,2025-08-29,632.08,-6,-15404,155069044,41373917,0.0646137987411595,98.8751700823022,-0.153738672202483
628.64,641,24,81,22200,100116,2025-08-01,2025-08-29,632.08,57,77916,155069044,41373917,0.0645622088184151,98.9397322911206,0.778257221622917
473.25,475,554,566,101936,99050,2025-08-01,2025-11-21,632.08,12,-2886,69823438,8093490,0.141857809980654,99.0237318305638,-0.0291367995961636
514.86,515,6887,7044,89531,98616,2025-08-01,2025-08-15,632.08,157,9085.00000000002,243349966,91051840,0.0405243533093405,98.4934396908854,0.0921250101403425
615.37,623,0,128,0,97664,2025-08-01,2025-09-12,632.08,128,97664,1003977,1003977,9.72771288585296,60.5513871333706,1
469.93,470,13836,13886,83016,97202,2025-08-01,2025-08-15,632.08,50,14186,243349966,91051840,0.0399432971361089,98.5333829880215,0.145943499104957
319.45,320,1784,1761,96336,96855,2025-08-01,2025-12-19,632.08,-23,519,380408956,31818097,0.0254607570280233,99.5986742751661,0.00535852563109803
565.68,566,2997,2997,110889,95904,2025-08-01,2025-08-15,632.08,0,-14985,243349966,91051840,0.0394099089374847,98.572792896959,-0.15625
573.2,576,125,339,35000,94920,2025-08-01,2025-09-19,632.08,214,59920,595655559,168675191,0.0159353838918844,99.78152155548,0.631268436578171
174.89,175,8564,8564,102768,94204,2025-08-01,2025-12-19,632.08,0,-8564,380408956,31818097,0.0247638754330484,99.6234381505992,-0.0909090909090909
608.32,609,1322,1372,60812,93296,2025-08-01,2025-08-08,632.08,50,32484,58500270,29786673,0.159479605820623,97.8741157946792,0.348182129994855
610.19,613,302,328,84862,92168,2025-08-01,2025-08-22,632.08,26,7306,60984890,20108486,0.151132518235255,98.3965749548782,0.0792682926829268
294.52,295,1923,1919,88458,92112,2025-08-01,2025-12-19,632.08,-4,3654,380408956,31818097,0.0242139409567424,99.6476520915559,0.0396690984887962
209.84,210,5745,5745,91920,91920,2025-08-01,2025-12-19,632.08,0,0,380408956,31818097,0.0241634689589169,99.6718155605148,0
637.31,670,32,28,118880,91532,2025-08-01,2025-10-17,632.08,-4,-27348,227356040,48158939,0.0402593218988156,99.5648164878312,-0.29878075427173
631.5,665,26,27,91000,90450,2025-08-01,2025-11-21,632.08,1,-550,69823438,8093490,0.129541028902072,99.1532728594659,-0.00608070757324489
567.71,568,3067,3067,88943,88943,2025-08-01,2025-08-15,632.08,0,0,243349966,91051840,0.036549419530225,98.6093423164892,0
489.9,490,8831,8876,70648,88760,2025-08-01,2025-08-15,632.08,45,18112,243349966,91051840,0.0364742191909737,98.6458165356802,0.20405588102749
633.3,665,29,28,94395,88760,2025-08-01,2025-09-05,632.08,-1,-5635,23171190,9460006,0.383061897123108,94.8787049780352,-0.0634858044164038
628.79,644,55,58,78595,88218,2025-08-01,2025-08-29,632.08,3,9623,155069044,41373917,0.0568894975582619,98.9966217886789,0.109082046747829
204.84,205,5306,5506,84896,88096,2025-08-01,2025-12-19,632.08,200,3200,380408956,31818097,0.0231582350022274,99.6949737955171,0.0363240101707229
580.45,581,1595,1601,94105,88055,2025-08-01,2025-08-15,632.08,6,-6050,243349966,91051840,0.0361845129659891,98.6820010486461,-0.0687070580886946
534.46,535,1642,1630,83742,88020,2025-08-01,2025-08-29,632.08,-12,4278,155069044,41373917,0.0567618124994696,99.0533836011783,0.0486025903203817
616.86,617,8320,6215,141440,87010,2025-08-01,2025-08-01,632.08,-2105,-54430,61309866,39049978,0.141918431203226,97.7733469520224,-0.625560280427537
607.15,612,175,179,65100,86815,2025-08-01,2025-09-05,632.08,4,21715,23171190,9460006,0.374667852622157,95.2533728306574,0.250129585901054
464.12,465,893,985,86621,86680,2025-08-01,2025-10-17,632.08,92,59.0000000000146,227356040,48158939,0.0381252242078108,99.602941712039,0.000680664513151991
562.14,563,833,998,69139,85828,2025-08-01,2025-08-29,632.08,165,16689,155069044,41373917,0.0553482486162744,99.1087318497946,0.194447033602088
629.28,670,21,21,78120,85512,2025-08-01,2025-12-19,632.08,0,7392,380408956,31818097,0.0224789660314937,99.7174527615486,0.0864440078585462
224.8,225,4260,4260,85200,85200,2025-08-01,2025-12-19,632.08,0,0,380408956,31818097,0.0223969490350275,99.7398497105836,0
602.36,606,85,234,32725,85176,2025-08-01,2025-09-05,632.08,149,52451,23171190,9460006,0.367594413579967,95.6209672442374,0.615795529257068
473.97,475,733,826,80630,85078,2025-08-01,2025-10-17,632.08,93,4448,227356040,48158939,0.037420602505216,99.6403623145442,0.0522814358588589
550.72,551,3038,3033,69874,84924,2025-08-01,2025-08-15,632.08,-5,15050,243349966,91051840,0.0348978885824048,98.7168989372285,0.177217276623805
628.62,660,27,27,82917,84726,2025-08-01,2025-12-19,632.08,0,1809,380408956,31818097,0.022272346290396,99.762122056874,0.0213511790949649
601.85,604,387,387,57663,83205,2025-08-01,2025-08-22,632.08,0,25542,60984890,20108486,0.136435435072524,98.5330103899507,0.306976744186047
454.13,455,954,956,82998,83172,2025-08-01,2025-10-17,632.08,2,174,227356040,48158939,0.0365822698178592,99.6769445843621,0.00209205020920502
618.8,619,3913,4086,70434,81720,2025-08-01,2025-08-01,632.08,173,11286,61309866,39049978,0.133290129846312,97.9066370818687,0.138105726872247
540.79,541,3885,3891,62160,81711,2025-08-01,2025-08-15,632.08,6,19551,243349966,91051840,0.0335775678719429,98.7504765051005,0.239270110511437
579.82,580,3454,4498,69080,80964,2025-08-01,2025-08-08,632.08,1044,11884,58500270,29786673,0.138399361233717,98.012515155913,0.146781285509609
453.57,455,558,558,79794,79794,2025-08-01,2025-11-21,632.08,0,0,69823438,8093490,0.1142796778354,99.2675525373013,0
621.8,631,40,86,27200,79120,2025-08-01,2025-09-05,632.08,46,51920,23171190,9460006,0.341458509468008,95.9624257537054,0.656218402426694
632.96,830,4,4,78440,78816,2025-08-01,2025-09-19,632.08,0,376,595655559,168675191,0.0132318080154105,99.7947533634954,0.00477060495330897
605.44,606,1322,1403,66100,78568,2025-08-01,2025-08-08,632.08,81,12468,58500270,29786673,0.134303653641257,98.1468188095542,0.158690561042664
479.9,480,7730,7831,61840,78310,2025-08-01,2025-08-15,632.08,101,16470,243349966,91051840,0.0321799921681518,98.7826564972686,0.210317967054016
585.39,586,1267,1264,67151,77104,2025-08-01,2025-08-15,632.08,-3,9953,243349966,91051840,0.031684409604561,98.8143409068732,0.129085391159992
549.51,550,1561,1573,62440,77077,2025-08-01,2025-08-22,632.08,12,14637,60984890,20108486,0.126387044397391,98.6593974343481,0.189901008082826
600.01,602,391,385,74681,76615,2025-08-01,2025-08-22,632.08,-6,1934,60984890,20108486,0.125629479695708,98.7850269140438,0.0252430986099328
184.87,185,5824,5835,69888,75855,2025-08-01,2025-12-19,632.08,11,5967,380408956,31818097,0.0199403822658686,99.7820624391398,0.0786632390745501
581.51,583,493,509,59160,75841,2025-08-01,2025-08-29,632.08,16,16681,155069044,41373917,0.0489078916356768,99.1576397414303,0.2199469943698
631,660,105,26,294000,75400,2025-08-01,2025-08-29,632.08,-79,-218600,155069044,41373917,0.0486235021865486,99.2062632436168,-2.89920424403183
334.39,335,1216,1216,74176,74176,2025-08-01,2025-12-19,632.08,0,0,380408956,31818097,0.0194990151598849,99.8015614542997,0
631.82,645,832,56,607360,73808,2025-08-01,2025-08-01,632.08,-776,-533552,61309866,39049978,0.120385192164667,98.0270222740334,-7.2289182744418
314.43,315,1288,1288,73416,73416,2025-08-01,2025-12-19,632.08,0,0,380408956,31818097,0.0192992301684927,99.8208606844682,0
493.61,495,523,524,65898,72836,2025-08-01,2025-10-17,632.08,1,6937.99999999999,227356040,48158939,0.0320360963359495,99.708980680698,0.0952550936350155
561.7,562,2407,2408,91466,72240,2025-08-01,2025-08-15,632.08,1,-19226,243349966,91051840,0.0296856421175748,98.8440265489908,-0.266140642303433
615.86,622,104,117,67600,71838,2025-08-01,2025-09-05,632.08,13,4238,23171190,9460006,0.310031552112775,96.2724573058181,0.0589938472674629
379.83,380,4346,4221,73882,71757,2025-08-01,2025-09-19,632.08,-125,-2125,595655559,168675191,0.0120467271589754,99.8068000906544,-0.0296138355839848
635.09,700,11,11,71401,71401,2025-08-01,2025-12-19,632.08,0,0,380408956,31818097,0.0187695370663145,99.8396302215345,0
632.69,680,18,15,79920,70965,2025-08-01,2025-12-19,632.08,-3,-8954.99999999999,380408956,31818097,0.0186549235712526,99.8582851451058,-0.126188966391883
409.46,410,1322,1309,72710,70686,2025-08-01,2025-10-17,632.08,-13,-2024,227356040,48158939,0.0310904429897706,99.7400711236878,-0.0286336756924992
567.99,569,749,697,67410,70397,2025-08-01,2025-08-29,632.08,-52,2987,155069044,41373917,0.0453971973929239,99.2516604410098,0.0424307854027871
612.09,613,798,772,47082,70252,2025-08-01,2025-08-08,632.08,-26,23170,58500270,29786673,0.120088334635037,98.2669071441893,0.32981267437226
519.7,520,2316,2334,62532,70020,2025-08-01,2025-08-22,632.08,18,7487.99999999999,60984890,20108486,0.11481532556671,98.8998422396105,0.10694087403599
555.73,556,2587,2583,64675,69741,2025-08-01,2025-08-15,632.08,-4,5066.00000000002,243349966,91051840,0.0286587260094378,98.8726852750002,0.0726401973014441
389.57,390,1603,1618,75341,69574,2025-08-01,2025-10-17,632.08,15,-5767,227356040,48158939,0.0306013422823515,99.7706724659701,-0.0828901601172852
608.94,612,233,226,58483,69156,2025-08-01,2025-08-22,632.08,-7,10673,60984890,20108486,0.113398581189537,99.0132408208,0.154332234368674
631.32,650,21,37,36141,69116,2025-08-01,2025-09-05,632.08,16,32975,23171190,9460006,0.298284205515556,96.5707415113337,0.47709647549048
631.67,647,217,45,196819,68985,2025-08-01,2025-08-01,632.08,-172,-127834,61309866,39049978,0.112518595294271,98.1395408693276,-1.85306950786403
553.68,554,1861,2143,42803,68576,2025-08-01,2025-08-15,632.08,282,25773,243349966,91051840,0.0281799916092859,98.9008652666095,0.375831194587028
304.49,305,1342,1342,68442,68442,2025-08-01,2025-12-19,632.08,0,0,380408956,31818097,0.017991689974828,99.8762768350806,0
632.83,665,20,21,64000,67557,2025-08-01,2025-10-17,632.08,1,3557,227356040,48158939,0.0297141874920059,99.8003866534621,0.0526518347469544
595.98,597,656,662,81344,67524,2025-08-01,2025-08-22,632.08,6,-13820,60984890,20108486,0.1107225084771,99.1239633292771,-0.204667969906996
612.04,618,104,113,60424,67348,2025-08-01,2025-09-05,632.08,9,6924,23171190,9460006,0.290654040642712,96.8613955519764,0.102809289065748
234.75,235,2691,2691,67275,67275,2025-08-01,2025-12-19,632.08,0,0,380408956,31818097,0.0176849148630454,99.8939617499437,0
618.28,626,63,87,48699,67164,2025-08-01,2025-09-05,632.08,24,18465,23171190,9460006,0.28985995108581,97.1512555030622,0.274924066464177
552.73,553,2473,2473,56879,66771,2025-08-01,2025-08-15,632.08,0,9891.99999999999,243349966,91051840,0.0274382614871621,98.9283035280967,0.148148148148148
630.4,644,33,49,44847,66640,2025-08-01,2025-09-05,632.08,16,21793,23171190,9460006,0.287598522130283,97.4388540251925,0.32702581032413
498.89,499,6048,6036,60480,66396,2025-08-01,2025-08-15,632.08,-12,5915.99999999999,243349966,91051840,0.0272841624313192,98.955587690528,0.0891017531176576
633.29,670,29,18,111070,66078,2025-08-01,2025-09-19,632.08,-11,-44992,595655559,168675191,0.0110933238180356,99.8178934144724,-0.680892278821998
636.18,675,17,17,65994,65994,2025-08-01,2025-11-21,632.08,0,0,69823438,8093490,0.0945155407558133,99.3620680780571,0
530.85,531,4394,4394,79092,65910,2025-08-01,2025-08-15,632.08,0,-13182,243349966,91051840,0.0270844500549468,98.9826721405829,-0.2
593.11,594,772,737,54040,65593,2025-08-01,2025-08-15,632.08,-35,11553,243349966,91051840,0.0269541849864076,99.0096263255693,0.176131599408473
570.99,572,398,649,36218,65549,2025-08-01,2025-08-29,632.08,251,29331,155069044,41373917,0.0422708480746164,99.2939312890844,0.447466780576363
633.31,680,14,14,61012,65366,2025-08-01,2025-08-01,632.08,0,4354,61309866,39049978,0.106615793288473,98.2461566626161,0.0666095523666738
576.7,578,498,502,64740,65260,2025-08-01,2025-08-29,632.08,4,520,155069044,41373917,0.0420844794787024,99.3360157685631,0.00796812749003984
631.97,641,1105,72,477360,65016,2025-08-01,2025-08-01,632.08,-1033,-412344,61309866,39049978,0.106044922688299,98.3522015853044,-6.3421926910299
369.85,370,4293,4302,55809,64530,2025-08-01,2025-09-19,632.08,9,8720.99999999999,595655559,168675191,0.0108334420832628,99.8287268565557,0.135146443514644
632,660,23,23,64400,64400,2025-08-01,2025-08-22,632.08,0,0,60984890,20108486,0.105599928113341,99.2295632573905,0
414.41,415,1865,1087,111900,64133,2025-08-01,2025-10-17,632.08,-778,-47767,227356040,48158939,0.0282081795583702,99.8285948330205,-0.744811563469665
623.15,634,0,59,0,64015,2025-08-01,2025-09-12,632.08,59,64015,1003977,1003977,6.37614208293616,66.9275292163068,1
279.6,280,1592,1592,63680,63680,2025-08-01,2025-12-19,632.08,0,0,380408956,31818097,0.0167398792787623,99.9107016292224,0
354.89,355,5772,5772,69264,63492,2025-08-01,2025-09-19,632.08,0,-5772.00000000001,595655559,168675191,0.0106591802998686,99.8393860368556,-0.090909090909091
611.22,612,899,809,49445,63102,2025-08-01,2025-08-08,632.08,-90,13657,58500270,29786673,0.107866168822811,98.3747733130121,0.216427371557161
539.66,540,1637,1813,52384,61642,2025-08-01,2025-08-22,632.08,176,9258.00000000001,60984890,20108486,0.101077496409356,99.3306407537998,0.150189805651991
504.68,505,1966,1926,57014,61632,2025-08-01,2025-08-29,632.08,-40,4618.00000000001,155069044,41373917,0.0397448764822462,99.3757606450453,0.0749286085150572
604.96,605,15217,15312,121736,61248,2025-08-01,2025-08-01,632.08,95,-60488,61309866,39049978,0.0998990929127133,98.4521006782171,-0.987591431556949
577.74,579,490,486,56840,61236,2025-08-01,2025-08-29,632.08,-4,4396,155069044,41373917,0.0394895063646617,99.41525015141,0.071787837219936
553.42,554,1050,1048,69300,60784,2025-08-01,2025-08-29,632.08,-2,-8516.00000000001,155069044,41373917,0.0391980233011561,99.4544481747111,-0.140102658594367
603.58,604,1450,1395,53650,58590,2025-08-01,2025-08-08,632.08,-55,4940,58500270,29786673,0.100153383907459,98.4749266969195,0.0843147294760198
637.27,646,67,67,73700,58491,2025-08-01,2025-08-15,632.08,0,-15209,243349966,91051840,0.024035754334151,99.0336620799035,-0.260022909507445
630.77,665,17,17,58191,58191,2025-08-01,2025-12-19,632.08,0,0,380408956,31818097,0.0152969584659305,99.9259985876884,0
596.35,598,341,352,42966,58080,2025-08-01,2025-08-22,632.08,11,15114,60984890,20108486,0.0952367053543919,99.4258774591542,0.260227272727273
628.44,641,20,46,26540,57776,2025-08-01,2025-09-05,632.08,26,31236,23171190,9460006,0.249344120867336,97.6881981460598,0.540639711991138
599.97,600,16742,19128,117194,57384,2025-08-01,2025-08-01,632.08,2386,-59810,61309866,39049978,0.0935966814867937,98.5456973597039,-1.04227659277847
319.93,320,8196,8197,57372,57379,2025-08-01,2025-09-19,632.08,1,7.00000000000728,595655559,168675191,0.00963291605912806,99.8490189529147,0.000121995852141154
429.32,430,840,841,59640,57188,2025-08-01,2025-10-17,632.08,1,-2452,227356040,48158939,0.0251534993308293,99.8537483323513,-0.0428761278589914
630.42,647,33,34,41514,56372,2025-08-01,2025-08-29,632.08,1,14858,155069044,41373917,0.0363528390618053,99.4908010137729,0.26357056694813
627.78,643,26,37,30108,56314,2025-08-01,2025-09-05,632.08,11,26206,23171190,9460006,0.243034561453253,97.9312327075131,0.465354973896367
573,574,564,558,50760,55800,2025-08-01,2025-08-29,632.08,-6,5040,155069044,41373917,0.0359839711141832,99.5267849848871,0.0903225806451613
533.82,534,3091,3091,55638,55638,2025-08-01,2025-08-15,632.08,0,0,243349966,91051840,0.0228633687172983,99.0565254486208,0
284.59,285,1340,1340,54940,54940,2025-08-01,2025-12-19,632.08,0,0,380408956,31818097,0.0144423518777513,99.9404409395661,0
634.95,647,47,45,72709,54225,2025-08-01,2025-08-15,632.08,-2,-18484,243349966,91051840,0.0222827234748823,99.0788081720957,-0.340875979714154
529.99,530,54008,54043,54008,54043,2025-08-01,2025-08-01,632.08,35,35,61309866,39049978,0.0881473138434196,98.6338446735473,0.000647632440834151
616.52,624,69,72,36984,53856,2025-08-01,2025-09-05,632.08,3,16872,23171190,9460006,0.232426560742025,98.1636592682551,0.313279857397505
558.78,559,2441,2441,65907,53702,2025-08-01,2025-08-15,632.08,0,-12205,243349966,91051840,0.0220678066583334,99.100875978754,-0.227272727272727
516.84,517,3341,3335,43433,53360,2025-08-01,2025-08-15,632.08,-6,9926.99999999999,243349966,91051840,0.0219272683194047,99.1228032470734,0.186038230884558
439.87,440,4031,4031,52403,52403,2025-08-01,2025-08-29,632.08,0,0,155069044,41373917,0.0337933340196513,99.5605783189068,0
538.79,539,2484,2484,52164,52164,2025-08-01,2025-08-15,632.08,0,0,243349966,91051840,0.0214357950639697,99.1442390421374,0
449.99,450,52116,52116,52116,52116,2025-08-01,2025-08-01,632.08,0,0,61309866,39049978,0.085004263424748,98.7188489369721,0
502.67,505,222,223,59718,51959,2025-08-01,2025-11-21,632.08,1,-7758.99999999999,69823438,8093490,0.0744148404723354,99.4364829185294,-0.149329278854481
484.92,485,6510,6411,52080,51288,2025-08-01,2025-08-15,632.08,-99,-791.999999999993,243349966,91051840,0.0210758196695207,99.1653148618069,-0.0154422087037902
543.81,544,2701,2696,45917,51224,2025-08-01,2025-08-15,632.08,-5,5307,243349966,91051840,0.0210495200973235,99.1863643819042,0.10360377947837
635.75,675,12,13,52800,51025,2025-08-01,2025-12-19,632.08,1,-1775,380408956,31818097,0.0134131962970924,99.9538541358632,-0.0347868691817736
546.78,547,2300,2315,59800,50930,2025-08-01,2025-08-15,632.08,15,-8870,243349966,91051840,0.0209287064375427,99.2072930883418,-0.174160612605537
494.9,495,4947,5084,39576,50840,2025-08-01,2025-08-15,632.08,137,11264,243349966,91051840,0.0208917226641404,99.2281848110059,0.221557828481511
598.6,599,1240,1239,38440,49560,2025-08-01,2025-08-08,632.08,-1,11120,58500270,29786673,0.0847175577138362,98.5596442546334,0.224374495560936
551.71,552,1664,1697,46592,49213,2025-08-01,2025-08-15,632.08,33,2620.99999999999,243349966,91051840,0.0202231382271901,99.2484079492331,0.0532582854123907
603.75,608,32,115,13344,48875,2025-08-01,2025-09-05,632.08,83,35531,23171190,9460006,0.210930038552185,98.3745893068073,0.726976982097187
559.88,560,3840,4069,38400,48828,2025-08-01,2025-08-08,632.08,229,10428,58500270,29786673,0.0834662814376754,98.643110536071,0.213565986728926
532.77,533,2148,2103,42960,48369,2025-08-01,2025-08-15,632.08,-45,5409,243349966,91051840,0.0198763126188397,99.2682842618519,0.111827823606029
545.83,546,2827,2827,62194,48059,2025-08-01,2025-08-15,632.08,0,-14135,243349966,91051840,0.0197489240660095,99.2880331859179,-0.294117647058824
349.89,350,4344,4351,47784,47861,2025-08-01,2025-09-19,632.08,7,77,595655559,168675191,0.00803501273124188,99.857053965646,0.00160882555734314
606.47,607,729,901,39366,47753,2025-08-01,2025-08-08,632.08,172,8387,58500270,29786673,0.0816286830812918,98.7247392191523,0.175632944527045
620.15,630,0,48,0,47280,2025-08-01,2025-09-12,632.08,48,47280,1003977,1003977,4.70927122832495,71.6368004446317,1
374.85,375,3128,3128,46920,46920,2025-08-01,2025-09-19,632.08,0,0,595655559,168675191,0.0078770355268354,99.8649310011728,0
369.3,370,390,670,25740,46900,2025-08-01,2025-11-21,632.08,280,21160,69823438,8093490,0.0671694223936667,99.5036523409231,0.451172707889126
444.23,445,451,595,35178,45815,2025-08-01,2025-10-17,632.08,144,10637,227356040,48158939,0.0201512130489254,99.8738995454003,0.232172869147659
599.37,601,277,280,37949,45640,2025-08-01,2025-08-22,632.08,3,7691,60984890,20108486,0.0748382099238024,99.500715669078,0.168514460999124
558.21,559,600,574,47400,45346,2025-08-01,2025-08-29,632.08,-26,-2054,155069044,41373917,0.0292424579595654,99.5898207768663,-0.0452961672473868
409,410,451,451,45100,45100,2025-08-01,2025-11-21,632.08,0,0,69823438,8093490,0.0645914914702424,99.5682438323934,0
551.32,552,664,663,47144,45084,2025-08-01,2025-08-29,632.08,-1,-2060,155069044,41373917,0.0290735009625777,99.6188942778289,-0.0456924851388519
404.77,405,1942,1952,40782,44896,2025-08-01,2025-09-19,632.08,10,4114,595655559,168675191,0.0075372418374425,99.8724682430102,0.0916339985744832
569.85,570,3202,2991,41626,44865,2025-08-01,2025-08-08,632.08,-211,3239,58500270,29786673,0.0766919537294443,98.8014311728818,0.0721943608603589
560.36,561,602,696,44548,44544,2025-08-01,2025-08-29,632.08,94,-4,155069044,41373917,0.0287252689840533,99.647619546813,-8.97988505747127e-05
329.77,330,1890,1926,43470,44298,2025-08-01,2025-10-17,632.08,36,827.999999999993,227356040,48158939,0.0194839776414121,99.8933835230417,0.0186915887850466
570.72,571,1565,1570,51645,43960,2025-08-01,2025-08-15,632.08,5,-7685.00000000001,243349966,91051840,0.0180645186529428,99.3060977045709,-0.174818016378526
384.24,385,578,578,43928,43928,2025-08-01,2025-11-21,632.08,0,0,69823438,8093490,0.0629129720023239,99.6311568043957,0
522.83,523,2454,2580,34356,43860,2025-08-01,2025-08-15,632.08,126,9503.99999999999,243349966,91051840,0.0180234255713847,99.3241211301423,0.216689466484268
611.08,617,68,74,36992,43808,2025-08-01,2025-09-05,632.08,6,6816,23171190,9460006,0.189062365808575,98.5636516726159,0.155588020452885
525.84,526,2635,2731,39525,43696,2025-08-01,2025-08-15,632.08,96,4171,243349966,91051840,0.0179560329176294,99.3420771630599,0.0954549615525449
614.66,621,64,68,40320,43112,2025-08-01,2025-09-05,632.08,4,2792,23171190,9460006,0.18605863574551,98.7497103083614,0.0647615513082205
631.78,649,0,25,0,43050,2025-08-01,2025-08-15,632.08,25,43050,243349966,91051840,0.0176905716107641,99.3597677346707,1
626.69,638,0,38,0,42978,2025-08-01,2025-09-12,632.08,38,42978,1003977,1003977,4.28077535640757,75.9175758010393,1
630.95,670,9,11,32175,42955,2025-08-01,2025-11-21,632.08,2,10780,69823438,8093490,0.0615194571198284,99.6926762615155,0.250960307298335
615.88,616,3550,3570,53250,42840,2025-08-01,2025-08-01,632.08,20,-10410,61309866,39049978,0.0698745614612826,98.7887234984334,-0.242997198879552
399.97,400,14138,14250,28276,42750,2025-08-01,2025-08-15,632.08,112,14474,243349966,91051840,0.0175672923660898,99.3773350270368,0.338573099415205
601.53,602,935,904,30855,42488,2025-08-01,2025-08-08,632.08,-31,11633,58500270,29786673,0.0726287246195616,98.8740598975013,0.273794953869328
564.88,565,3422,3500,47908,42000,2025-08-01,2025-08-08,632.08,78,-5908.00000000001,58500270,29786673,0.0717945404354544,98.9458544379368,-0.140666666666667
616.22,617.5,418,325,66880,41600,2025-08-01,2025-08-08,632.08,-93,-25280,58500270,29786673,0.0711107829074977,99.0169652208443,-0.607692307692308
583.03,585,193,208,38986,40976,2025-08-01,2025-09-05,632.08,15,1990,23171190,9460006,0.176840291758861,98.9265506001203,0.0485650136665365
603.49,607,55,109,20845,38259,2025-08-01,2025-09-05,632.08,54,17414,23171190,9460006,0.165114523682211,99.0916651238025,0.455160877179226
535.76,536,1592,1591,38208,38184,2025-08-01,2025-08-15,632.08,-1,-24,243349966,91051840,0.0156909822621467,99.3930260092989,-0.000628535512256443
384.83,385,2190,2215,39420,37655,2025-08-01,2025-09-19,632.08,25,-1765,595655559,168675191,0.00632160641012334,99.8787898494204,-0.0468729252423317
631.08,660,35,13,82040,37596,2025-08-01,2025-08-01,632.08,-22,-44444,61309866,39049978,0.0613212888118203,98.8500447872452,-1.18214703691882
621.59,632,0,36,0,37476,2025-08-01,2025-09-12,632.08,36,37476,1003977,1003977,3.73275483402508,79.6503306350644,1
563.24,564,491,491,45172,37316,2025-08-01,2025-08-29,632.08,0,-7856,155069044,41373917,0.0240641194641014,99.6716836662771,-0.210526315789474
613.91,614,3479,4138,38269,37242,2025-08-01,2025-08-01,632.08,659,-1027.00000000001,61309866,39049978,0.0607438939762158,98.9107886812214,-0.0275763922453146
602.56,603,921,834,30393,36696,2025-08-01,2025-08-08,632.08,-87,6303,58500270,29786673,0.0627279156147485,99.079693136459,0.171762589928058
526.83,527,2289,2154,34335,36618,2025-08-01,2025-08-15,632.08,-135,2283,243349966,91051840,0.0150474646049468,99.4080734739038,0.0623463870227757
557.77,558,1589,1590,46081,36570,2025-08-01,2025-08-15,632.08,1,-9510.99999999999,243349966,91051840,0.0150277399257989,99.4231012138296,-0.260076565490839
634.64,644,35,39,44590,36504,2025-08-01,2025-08-22,632.08,4,-8086,60984890,20108486,0.0598574499355496,99.5605731190136,-0.221509971509972
514.59,515,881,881,29073,36121,2025-08-01,2025-08-29,632.08,0,7048,155069044,41373917,0.0232934949931077,99.6949771612702,0.195121951219512
631.63,646,22,25,22242,35925,2025-08-01,2025-08-08,632.08,3,13683,58500270,29786673,0.0614099729796119,99.1411031094387,0.380876826722338
269.96,270,8533,8937,25599,35748,2025-08-01,2025-09-19,632.08,404,10149,595655559,168675191,0.00600145494487025,99.8847913043652,0.28390399462907
339.92,340,4449,4450,40041,35600,2025-08-01,2025-09-19,632.08,1,-4441,595655559,168675191,0.00597660837074468,99.890767912736,-0.124747191011236
547.84,548,2216,2219,57616,35504,2025-08-01,2025-08-15,632.08,3,-22112,243349966,91051840,0.0145896876763895,99.437690901506,-0.622803064443443
569.99,571,174,348,13920,35148,2025-08-01,2025-08-29,632.08,174,21228,155069044,41373917,0.0226660325577296,99.7176431938279,0.603960396039604
499.96,500,8597,8694,25791,34776,2025-08-01,2025-08-08,632.08,97,8985,58500270,29786673,0.0594458794805563,99.2005489889192,0.258367839889579
635.76,644,39,42,48867,34608,2025-08-01,2025-08-15,632.08,3,-14259,243349966,91051840,0.0142214936656289,99.4519123951717,-0.412014563106796
597.45,597.5,3598,6844,21588,34220,2025-08-01,2025-08-01,632.08,3246,12632,61309866,39049978,0.0558148341084288,98.9666035153298,0.369140853302163
591.96,592,8026,8523,72234,34092,2025-08-01,2025-08-01,632.08,497,-38142,61309866,39049978,0.0556060585746509,99.0222095739045,-1.11879619852165
633.29,690,6,6,32520,34026,2025-08-01,2025-09-19,632.08,0,1506,595655559,168675191,0.00571236169727411,99.8964802744332,0.0442602715570445
234.97,235,11304,11304,22608,33912,2025-08-01,2025-09-19,632.08,0,11304,595655559,168675191,0.00569322311990712,99.9021734975531,0.333333333333333
493.9,494,3333,3333,33330,33330,2025-08-01,2025-08-15,632.08,0,0,243349966,91051840,0.0136963240833163,99.465608719255,0
531.78,532,1511,1511,33242,33242,2025-08-01,2025-08-15,632.08,0,0,243349966,91051840,0.0136601621715452,99.4792688814265,0
499.8,500,1624,1653,30856,33060,2025-08-01,2025-08-22,632.08,29,2204,60984890,20108486,0.054210149432097,99.6147832684457,0.0666666666666667
550.51,551,675,673,47250,32977,2025-08-01,2025-08-29,632.08,-2,-14273,155069044,41373917,0.0212660110292548,99.7389092048572,-0.432816811717257
521.83,522,1759,1920,22867,32640,2025-08-01,2025-08-15,632.08,161,9773,243349966,91051840,0.0134127818205654,99.4926816632471,0.299417892156863
453.94,454,5156,5436,20624,32616,2025-08-01,2025-08-15,632.08,280,11992,243349966,91051840,0.0134029194809914,99.5060845827281,0.367672308069659
612.91,613,1629,3609,16290,32481,2025-08-01,2025-08-01,632.08,1980,16191,61309866,39049978,0.0529784227549935,99.0751879966595,0.498476032141868
571.99,573,345,320,32085,32320,2025-08-01,2025-08-29,632.08,-25,234.999999999996,155069044,41373917,0.0208423287887169,99.7597515336459,0.00727103960396028
565.05,566,333,333,31635,31635,2025-08-01,2025-08-29,632.08,0,0,155069044,41373917,0.0204005900752184,99.7801521237211,0
394.81,395,1613,1636,29034,31084,2025-08-01,2025-09-19,632.08,23,2050.00000000001,595655559,168675191,0.00521845209539965,99.9073919496485,0.0659503281430964
229.79,230,1479,1479,31059,31059,2025-08-01,2025-12-19,632.08,0,0,380408956,31818097,0.00816463427322673,99.9620187701364,0
459.93,460,4362,4362,21810,30534,2025-08-01,2025-08-15,632.08,0,8724,243349966,91051840,0.0125473615229517,99.518631944251,0.285714285714286
639.1,700,5,5,32595,30450,2025-08-01,2025-09-19,632.08,0,-2145,595655559,168675191,0.00511201474407796,99.9125039643926,-0.0704433497536946
154.92,155,3805,3805,30440,30440,2025-08-01,2025-12-19,632.08,0,0,380408956,31818097,0.00800191465523751,99.9700206847917,0
517.86,518,2158,2158,30212,30212,2025-08-01,2025-08-15,632.08,0,0,243349966,91051840,0.0124150418003346,99.5310469860514,0
439.95,440,5997,6036,23988,30180,2025-08-01,2025-08-15,632.08,39,6192,243349966,91051840,0.012401892014236,99.5434488780656,0.205168986083499
149.99,150,30061,30062,30061,30062,2025-08-01,2025-09-19,632.08,1,1,595655559,168675191,0.00504687642812715,99.9175508408208,3.32645865211895e-05
600.59,601,746,718,25364,29438,2025-08-01,2025-08-08,632.08,-28,4074,58500270,29786673,0.050321135269974,99.2508701241892,0.138392553841973
364.87,365,2223,2228,31122,28964,2025-08-01,2025-09-19,632.08,5,-2158,595655559,168675191,0.00486254170927665,99.92241338253,-0.0745062836624777
528.81,529,1524,1524,28956,28956,2025-08-01,2025-08-15,632.08,0,0,243349966,91051840,0.0118989126959648,99.5553477907616,0
631.79,680,6,6,25848,28926,2025-08-01,2025-08-15,632.08,0,3078,243349966,91051840,0.0118865847714974,99.5672343755331,0.106409458618544
619.28,628,0,33,0,28776,2025-08-01,2025-09-12,632.08,33,28776,1003977,1003977,2.86620111815311,82.5165317532175,1
524.72,525,994,1007,30814,28196,2025-08-01,2025-08-22,632.08,13,-2618,60984890,20108486,0.046234403308754,99.6610176717544,-0.0928500496524328
552.3,553,401,400,24461,28000,2025-08-01,2025-08-29,632.08,-1,3539,155069044,41373917,0.018056472960522,99.7982085966816,0.126392857142857
633.5,655,13,13,23504,27950,2025-08-01,2025-08-01,632.08,0,4446,61309866,39049978,0.0455880950710282,99.1207760917305,0.159069767441861
224.98,225,13834,13836,27668,27672,2025-08-01,2025-09-19,632.08,2,4.00000000000364,595655559,168675191,0.00464563783245075,99.9270590203625,0.000144550448106521
244.76,245,1151,1151,32228,27624,2025-08-01,2025-12-19,632.08,0,-4604,380408956,31818097,0.00726165868713144,99.9772823434788,-0.166666666666667
597.95,598,4257,5502,25542,27510,2025-08-01,2025-08-01,632.08,1245,1968,61309866,39049978,0.0448704291736668,99.1656465209042,0.071537622682661
558.9,560,242,248,26136,27280,2025-08-01,2025-09-05,632.08,6,1144,23171190,9460006,0.117732408219,99.2093975320214,0.0419354838709678
483.06,485,138,139,28842,26966,2025-08-01,2025-11-21,632.08,1,-1876,69823438,8093490,0.0386202696005888,99.7312965311161,-0.0695690869984425
618.7,627,0,32,0,26560,2025-08-01,2025-09-12,632.08,32,26560,1003977,1003977,2.64547893029422,85.1620106835117,1
324.94,325,4122,4422,37098,26532,2025-08-01,2025-09-19,632.08,300,-10566,595655559,168675191,0.00445425205878084,99.9315132724213,-0.398236092265943
594.95,595,5603,5287,33618,26435,2025-08-01,2025-08-01,632.08,-316,-7183,61309866,39049978,0.0431170409017041,99.2087635618059,-0.271723094382447
549.99,550,1496,26333,4488,26333,2025-08-01,2025-08-01,632.08,24837,21845,61309866,39049978,0.0429506728982249,99.2517142347041,0.829567462879277
620.2,628,28,33,21840,25740,2025-08-01,2025-09-05,632.08,5,3900,23171190,9460006,0.111086223884056,99.3204837559055,0.151515151515151
579.98,580,11975,12860,47900,25720,2025-08-01,2025-08-01,632.08,885,-22180,61309866,39049978,0.0419508338184918,99.2936650685226,-0.862363919129082
600.96,601,5952,6364,35712,25456,2025-08-01,2025-08-01,632.08,412,-10256,61309866,39049978,0.0415202342800749,99.3351853028027,-0.40289126335638
593.74,594,920,979,36800,25454,2025-08-01,2025-08-08,632.08,59,-11346,58500270,29786673,0.0435109102915252,99.2943810344807,-0.445745265969985
608.02,613,48,51,23616,25398,2025-08-01,2025-09-05,632.08,3,1782,23171190,9460006,0.109610253077205,99.4300940089827,0.0701630049610206
636.91,665,9,9,25281,25281,2025-08-01,2025-08-22,632.08,0,0,60984890,20108486,0.0414545307862325,99.7024722025407,0
606.94,607.5,387,449,20898,25144,2025-08-01,2025-08-08,632.08,62,4246,58500270,29786673,0.0429809982073587,99.3373620326881,0.168867324212536
542.81,543,1320,1320,25080,25080,2025-08-01,2025-08-15,632.08,0,0,243349966,91051840,0.0103061448547727,99.5775405203878,0
359.89,360,1922,2274,26908,25014,2025-08-01,2025-09-19,632.08,352,-1894,595655559,168675191,0.00419940679173616,99.935712679213,-0.0757175981450389
536.79,537,1370,1185,32880,24885,2025-08-01,2025-08-15,632.08,-185,-7995,243349966,91051840,0.0102260133457343,99.5877665337336,-0.321277878239904
607.94,608,3491,4145,31419,24870,2025-08-01,2025-08-01,632.08,654,-6549,61309866,39049978,0.0405644337894981,99.3757497365922,-0.263329312424608
424.32,425,364,365,24388,24820,2025-08-01,2025-10-17,632.08,1,431.999999999996,227356040,48158939,0.0109167981637963,99.9043003212055,0.0174053182917001
622.31,633,0,23,0,24587,2025-08-01,2025-09-12,632.08,23,24587,1003977,1003977,2.44896048415452,87.6109711676662,1
199.98,200,12100,12101,12100,24202,2025-08-01,2025-09-19,632.08,1,12102,595655559,168675191,0.00406308639856075,99.9397757656116,0.500041318899265
349.71,350,642,825,16050,23925,2025-08-01,2025-10-17,632.08,183,7875,227356040,48158939,0.0105231424685265,99.914823463674,0.329153605015674
515.9,516,2380,2381,26180,23810,2025-08-01,2025-08-15,632.08,1,-2370,243349966,91051840,0.00978426271898472,99.5975507964526,-0.099538009239815
344.9,345,2359,2365,25949,23650,2025-08-01,2025-09-19,632.08,6,-2299,595655559,168675191,0.00397041539236269,99.9437461810039,-0.0972093023255814
534.99,535,23524,23626,47048,23626,2025-08-01,2025-08-01,632.08,102,-23422,61309866,39049978,0.0385353965705944,99.4142851331627,-0.991365444848895
289.96,290,5853,5852,29265,23408,2025-08-01,2025-09-19,632.08,-1,-5857,595655559,168675191,0.00392978788602223,99.9476759688899,-0.250213602187287
254.71,255,795,795,23055,23055,2025-08-01,2025-12-19,632.08,0,0,380408956,31818097,0.00606058286387979,99.9833429263427,0
611.93,612,2642,3289,31704,23023,2025-08-01,2025-08-01,632.08,647,-8681,61309866,39049978,0.0375518680794377,99.4518370012422,-0.377057724883812
611.59,612.5,231,253,25641,23023,2025-08-01,2025-08-08,632.08,22,-2618,58500270,29786673,0.0393553739153683,99.3767174066034,-0.11371237458194
556.33,557,341,342,23870,22914,2025-08-01,2025-08-29,632.08,1,-956,155069044,41373917,0.0147766436220501,99.8129852403037,-0.0417212184690582
523.9,524,2289,2289,34335,22890,2025-08-01,2025-08-15,632.08,0,-11445,243349966,91051840,0.00940620636865016,99.6069570028212,-0.5
623.96,636,0,19,0,22876,2025-08-01,2025-09-12,632.08,19,22876,1003977,1003977,2.27853825336636,89.8895094210326,1
606.91,607,2216,2540,19944,22860,2025-08-01,2025-08-01,632.08,324,2916,61309866,39049978,0.0372860054856424,99.4891230067278,0.12755905511811
374.38,375,368,368,22816,22816,2025-08-01,2025-11-21,632.08,0,0,69823438,8093490,0.0326767066382495,99.7639732377544,0
620.82,631,0,22,0,22396,2025-08-01,2025-09-12,632.08,22,22396,1003977,1003977,2.23072839318032,92.1202378142129,1
534.71,535,580,754,19720,21866,2025-08-01,2025-08-22,632.08,174,2146,60984890,20108486,0.0358547830454396,99.7383269855861,0.0981432360742706
468.33,470,128,130,22016,21710,2025-08-01,2025-11-21,632.08,2,-306,69823438,8093490,0.0310927113041899,99.7950659490586,-0.0140948871487794
554.99,555,21644,21675,64932,21675,2025-08-01,2025-08-01,632.08,31,-43257,61309866,39049978,0.0353532007393394,99.5244762074672,-1.99570934256055
458.45,460,139,139,21545,21545,2025-08-01,2025-11-21,632.08,0,0,69823438,8093490,0.0308564009695426,99.8259223500281,0
561.16,562,201,256,17487,21504,2025-08-01,2025-08-29,632.08,55,4017,155069044,41373917,0.0138673712336809,99.8268526115374,0.186802455357143
631.81,685,4,4,19232,21276,2025-08-01,2025-08-15,632.08,0,2044,243349966,91051840,0.00874296403230235,99.6156999668535,0.0960706899793194
329.93,330,3039,3039,21273,21273,2025-08-01,2025-09-19,632.08,0,0,595655559,168675191,0.00357135926603516,99.951247328156,0
339.76,340,860,876,22360,21024,2025-08-01,2025-10-17,632.08,16,-1336,227356040,48158939,0.00924717020933334,99.9240706338833,-0.0635464231354644
632.03,647,13,14,17069,20958,2025-08-01,2025-08-22,632.08,1,3889,60984890,20108486,0.034365889649059,99.7726928752352,0.185561599389255
617.84,625,0,29,0,20764,2025-08-01,2025-09-12,632.08,29,20764,1003977,1003977,2.06817486854779,94.1884126827607,1
544.92,545,2343,2590,18744,20720,2025-08-01,2025-08-08,632.08,247,1976,58500270,29786673,0.0354186399481575,99.4121360465516,0.0953667953667954
634.39,648,0,15,0,20415,2025-08-01,2025-08-08,632.08,15,20415,58500270,29786673,0.0348972748330905,99.4470333213847,1
592.75,593,807,807,20982,20175,2025-08-01,2025-08-08,632.08,0,-807,58500270,29786673,0.0344870203163165,99.481520341701,-0.04
594.46,596,131,131,19912,20174,2025-08-01,2025-08-22,632.08,0,262,60984890,20108486,0.0330803253068096,99.805773200542,0.012987012987013
548.38,549,322,323,19964,20026,2025-08-01,2025-08-29,632.08,1,62,155069044,41373917,0.0129142474109791,99.8397668589483,0.00309597523219814
630.57,643,16,16,19888,19888,2025-08-01,2025-08-22,632.08,0,0,60984890,20108486,0.0326113566819584,99.8383845572239,0
547.45,548,360,360,19800,19800,2025-08-01,2025-08-29,632.08,0,0,155069044,41373917,0.0127685058792263,99.8525353648276,0
511.86,512,1405,1405,19670,19670,2025-08-01,2025-08-15,632.08,0,0,243349966,91051840,0.00808300914247919,99.623782975996,0
631.9,730,2,2,19222,19620,2025-08-01,2025-08-29,632.08,0,398,155069044,41373917,0.0126524285530515,99.8651877933806,0.0202854230377166
585.79,586,930,933,17670,19593,2025-08-01,2025-08-08,632.08,3,1923,58500270,29786673,0.0334921531131395,99.5150124948141,0.0981472975042107
204.98,205,9768,9768,19536,19536,2025-08-01,2025-09-19,632.08,0,0,595655559,168675191,0.00327974778457494,99.9545270759405,0
632.51,730,0,2,0,19498,2025-08-01,2025-10-17,632.08,2,19498,227356040,48158939,0.00857597625292911,99.9326466101363,1
444.95,445,3891,3890,15564,19450,2025-08-01,2025-08-15,632.08,-1,3886,243349966,91051840,0.00799260436305136,99.631775580359,0.199794344473008
404.98,405,9724,9722,19448,19444,2025-08-01,2025-08-15,632.08,-2,-4,243349966,91051840,0.00799013877815787,99.6397657191372,-0.00020571898786258
611.04,616,27,39,13068,19344,2025-08-01,2025-09-05,632.08,12,6276,23171190,9460006,0.0834829803734724,99.5135769893562,0.324441687344913
527.87,528,1486,1485,29720,19305,2025-08-01,2025-08-15,632.08,-1,-10415,243349966,91051840,0.00793301939479211,99.647698738532,-0.53949753949754
264.69,265,622,622,19282,19282,2025-08-01,2025-12-19,632.08,0,0,380408956,31818097,0.00506875553161267,99.9884116818743,0
304.94,305,3211,3212,19266,19272,2025-08-01,2025-09-19,632.08,1,6,595655559,168675191,0.00323542686856718,99.9577625028091,0.000311332503113325
610.94,611,2933,3210,29330,19260,2025-08-01,2025-08-01,632.08,277,-10070,61309866,39049978,0.0314141935981397,99.5558904010653,-0.522845275181724
414.96,415,4824,4775,9648,19100,2025-08-01,2025-08-15,632.08,-49,9452,243349966,91051840,0.007848778577598,99.6555475171096,0.494869109947644
514.75,515,608,761,13376,19025,2025-08-01,2025-08-22,632.08,153,5649,60984890,20108486,0.0311962520552222,99.8695808092791,0.296925098554534
484.81,485,982,982,23568,18658,2025-08-01,2025-08-29,632.08,0,-4910,155069044,41373917,0.0120320597320507,99.8772198531127,-0.263157894736842
510.88,511,1554,1554,18648,18648,2025-08-01,2025-08-15,632.08,0,0,243349966,91051840,0.00766303784895536,99.6632105549585,0
219.98,220,9219,9219,18438,18438,2025-08-01,2025-09-19,632.08,0,0,595655559,168675191,0.00309541306572445,99.9608579158748,0
314.98,315,9193,9193,27579,18386,2025-08-01,2025-08-29,632.08,0,-9193,155069044,41373917,0.0118566539947199,99.8890765071074,-0.5
486.9,487,1825,1826,12775,18260,2025-08-01,2025-08-15,632.08,1,5485,243349966,91051840,0.00750359669250992,99.670714151651,0.300383351588171
434.35,435,279,279,19530,18135,2025-08-01,2025-10-17,632.08,0,-1395,227356040,48158939,0.00797647601532821,99.9406230861516,-0.0769230769230769
505.91,506,1702,2002,18722,18018,2025-08-01,2025-08-15,632.08,300,-704,243349966,91051840,0.0074041514351393,99.6781183030862,-0.0390720390720391
443.77,445,136,144,17816,17712,2025-08-01,2025-11-21,632.08,8,-104,69823438,8093490,0.0253668402864952,99.8512891903146,-0.00587172538392051
588.8,589,738,855,20664,17100,2025-08-01,2025-08-08,632.08,117,-3564,58500270,29786673,0.0292306343201493,99.5442431291343,-0.208421052631579
179.88,180,1407,1417,16884,17004,2025-08-01,2025-12-19,632.08,10,120,380408956,31818097,0.00446992630741322,99.9928816081817,0.00705716302046577
638.14,655,92,10,207000,16860,2025-08-01,2025-08-08,632.08,-82,-190140,58500270,29786673,0.0288203798033753,99.5730635089377,-11.2775800711744
549.91,550,1860,1870,13020,16830,2025-08-01,2025-08-08,632.08,10,3810,58500270,29786673,0.0287690979887785,99.6018326069265,0.226381461675579
309.95,310,3360,3360,16800,16800,2025-08-01,2025-09-19,632.08,0,0,595655559,168675191,0.00282042192776715,99.9636783378026,0
419.91,420,1952,1852,19520,16668,2025-08-01,2025-08-29,632.08,-100,-2852,155069044,41373917,0.010748760403785,99.8998252675112,-0.17110631149508
518.9,519,1636,1636,21268,16360,2025-08-01,2025-08-15,632.08,0,-4908,243349966,91051840,0.00672282814290593,99.6848411312291,-0.3
259.97,260,5403,5423,16209,16269,2025-08-01,2025-09-19,632.08,20,60,595655559,168675191,0.0027312764489788,99.9664096142516,0.00368799557440531
399.14,400,180,189,15480,16254,2025-08-01,2025-11-21,632.08,9,773.999999999998,69823438,8093490,0.0232787162385215,99.8745679065531,0.0476190476190475
495.93,496,2317,2317,20853,16219,2025-08-01,2025-08-15,632.08,0,-4634,243349966,91051840,0.006664886897909,99.691506018127,-0.285714285714286
503.88,504,1292,1351,14212,16212,2025-08-01,2025-08-15,632.08,59,2000,243349966,91051840,0.00666201038219993,99.6981680285092,0.123365408339502
508.88,509,1349,1349,16188,16188,2025-08-01,2025-08-15,632.08,0,0,243349966,91051840,0.00665214804262598,99.7048201765518,0
458.96,459,4021,4021,16084,16084,2025-08-01,2025-08-15,632.08,0,0,243349966,91051840,0.00660941123780556,99.7114295877896,0
451.96,452,4000,4004,16000,16016,2025-08-01,2025-08-15,632.08,4,16,243349966,91051840,0.00658146794234605,99.718011055732,0.000999000999000999
454.85,455,1063,1064,14882,15960,2025-08-01,2025-08-29,632.08,1,1078,155069044,41373917,0.0102921895874976,99.9101174570987,0.0675438596491227
598.94,599,879,2647,5274,15882,2025-08-01,2025-08-01,632.08,1768,10608,61309866,39049978,0.0259044767770329,99.5817948778424,0.667925953910087
463.49,465,107,105,18404,15855,2025-08-01,2025-11-21,632.08,-2,-2549,69823438,8093490,0.0227072748838291,99.8972751814369,-0.160769473352255
379.65,380,383,453,14937,15855,2025-08-01,2025-10-17,632.08,70,917.999999999998,227356040,48158939,0.00697364362961283,99.9475967297812,0.0578997161778618
597.07,597.5,366,366,15738,15738,2025-08-01,2025-08-08,632.08,0,0,58500270,29786673,0.0269024399374567,99.6287350468639,0
447.96,448,3875,3923,15500,15692,2025-08-01,2025-08-15,632.08,48,192.000000000002,243349966,91051840,0.00644832635809779,99.7244593820901,0.0122355340300791
428.89,429,1390,1390,15290,15290,2025-08-01,2025-08-15,632.08,0,0,243349966,91051840,0.00628313217023421,99.7307425142603,0
602.03,602.5,321,320,11877,15040,2025-08-01,2025-08-08,632.08,-1,3163,58500270,29786673,0.0257092830511722,99.6544443299151,0.21030585106383
169.9,170,1484,1502,14840,15020,2025-08-01,2025-12-19,632.08,18,180.000000000002,380408956,31818097,0.00394838232988395,99.9968299905116,0.0119840213049269
284.96,285,3718,3718,14872,14872,2025-08-01,2025-09-19,632.08,0,0,595655559,168675191,0.00249674493510435,99.9689063591867,0
586.77,587,708,646,19824,14858,2025-08-01,2025-08-08,632.08,-62,-4966,58500270,29786673,0.0253981733759519,99.679842503291,-0.334230717458608
545.51,546,303,302,16362,14798,2025-08-01,2025-08-29,632.08,-1,-1564,155069044,41373917,0.00954284595963589,99.9196603030583,-0.105689958102446
269.99,270,14724,14724,14724,14724,2025-08-01,2025-08-15,632.08,0,0,243349966,91051840,0.00605054532861533,99.7367930595889,0
274.96,275,3659,3659,14636,14636,2025-08-01,2025-09-19,632.08,0,0,595655559,168675191,0.00245712472230953,99.971363483909,0
496.88,497,1210,1212,10890,14544,2025-08-01,2025-08-15,632.08,2,3654,243349966,91051840,0.00597657778181074,99.7427696373708,0.251237623762376
214.98,215,7253,7253,14506,14506,2025-08-01,2025-09-19,632.08,0,0,595655559,168675191,0.00243530002882085,99.9737987839378,0
477.95,478,2901,2901,14505,14505,2025-08-01,2025-08-15,632.08,0,0,243349966,91051840,0.00596055148000308,99.7487301888508,0
626.94,639,0,12,0,14472,2025-08-01,2025-09-12,632.08,12,14472,1003977,1003977,1.44146728460911,95.6298799673698,1
591.74,592,524,546,11528,14196,2025-08-01,2025-08-08,632.08,22,2668,58500270,29786673,0.0242665546671836,99.7041090579582,0.187940264863342
633.32,680,3,3,14184,14004,2025-08-01,2025-08-08,632.08,0,-180,58500270,29786673,0.0239383510537644,99.728047409012,-0.012853470437018
546.48,547,269,269,12643,13988,2025-08-01,2025-08-29,632.08,0,1345,155069044,41373917,0.00902049799184936,99.9286808010502,0.0961538461538462
500.91,501,1547,1547,13923,13923,2025-08-01,2025-08-15,632.08,0,0,243349966,91051840,0.00572138974533491,99.7544515785961,0
554.9,555,1386,1392,12474,13920,2025-08-01,2025-08-08,632.08,6,1446,58500270,29786673,0.0237947619728935,99.7518421709849,0.103879310344828
194.98,195,6891,6891,13782,13782,2025-08-01,2025-09-19,632.08,0,0,595655559,168675191,0.0023137532743147,99.9761125372121,0
404.47,405,255,258,13260,13674,2025-08-01,2025-10-17,632.08,3,414,227356040,48158939,0.00601435528169826,99.9536110850629,0.0302764370337867
364.68,365,341,427,12276,13664,2025-08-01,2025-10-17,632.08,86,1388,227356040,48158939,0.00600995689404161,99.9596210419569,0.101580796252928
294.95,295,3080,2726,15400,13630,2025-08-01,2025-09-19,632.08,-354,-1770,595655559,168675191,0.00228823517115871,99.9784007723833,-0.129860601614086
513.91,514,1509,1510,18108,13590,2025-08-01,2025-08-15,632.08,1,-4518,243349966,91051840,0.00558454978374643,99.7600361283798,-0.332450331125828
632.47,700,2,2,13180,13506,2025-08-01,2025-10-17,632.08,0,325.999999999998,227356040,48158939,0.0059404623690666,99.965561504326,0.0241374204057455
244.99,245,13323,13389,13323,13389,2025-08-01,2025-08-15,632.08,66,66.0000000000036,243349966,91051840,0.00550195268981464,99.7655380810696,0.00492941967286606
464.87,465,1021,1020,16336,13260,2025-08-01,2025-08-29,632.08,-1,-3076,155069044,41373917,0.00855102969487579,99.937231830745,-0.231975867269985
419.4,420,220,221,13860,13260,2025-08-01,2025-10-17,632.08,1,-600,227356040,48158939,0.0058322620327131,99.9713937663587,-0.0452488687782805
334.92,335,1657,1657,13256,13256,2025-08-01,2025-09-19,632.08,0,0,595655559,168675191,0.00222544720681437,99.9806262195901,0
506.91,507,1468,1468,13212,13212,2025-08-01,2025-08-15,632.08,0,0,243349966,91051840,0.00542921793545679,99.7709672990051,0
419.96,420,3273,3292,9819,13168,2025-08-01,2025-08-15,632.08,19,3349,243349966,91051840,0.00541113697957122,99.7763784359847,0.254328675577157
574.98,575,6502,6578,26008,13156,2025-08-01,2025-08-01,632.08,76,-12852,61309866,39049978,0.0214582103311072,99.6032530881735,-0.976892672544846
628.97,642,0,10,0,13030,2025-08-01,2025-09-12,632.08,10,13030,1003977,1003977,1.29783849630021,96.92771846367,1
587.97,588,965,4316,4825,12948,2025-08-01,2025-08-01,632.08,3351,8123,61309866,39049978,0.0211189500887182,99.6243720382622,0.627355576150757
593.97,594,4053,4282,28371,12846,2025-08-01,2025-08-01,632.08,229,-15525,61309866,39049978,0.0209525820852389,99.6453246203474,-1.20854740775339
509.82,510,708,710,15576,12780,2025-08-01,2025-08-22,632.08,2,-2796,60984890,20108486,0.0209560105790139,99.8905368198582,-0.218779342723005
502.89,503,1156,1156,12716,12716,2025-08-01,2025-08-15,632.08,0,0,243349966,91051840,0.00522539625092859,99.7816038322356,0
374.64,375,355,353,13845,12708,2025-08-01,2025-10-17,632.08,-2,-1137,227356040,48158939,0.00558947103406622,99.9769832373928,-0.0894711992445705
507.9,508,1262,1262,12620,12620,2025-08-01,2025-08-15,632.08,0,0,243349966,91051840,0.00518594689263281,99.7867897791282,0
490.95,491,2514,2515,15084,12575,2025-08-01,2025-08-15,632.08,1,-2509,243349966,91051840,0.00516745500593166,99.7919572341342,-0.199522862823062
549.09,550,100,137,7300,12467,2025-08-01,2025-09-05,632.08,37,5167,23171190,9460006,0.0538038831842473,99.5673808725404,0.414454158979707
633.5,675,3,3,11424,12450,2025-08-01,2025-08-15,632.08,0,1026,243349966,91051840,0.00511608865398403,99.7970733227881,0.0824096385542169
394.51,395,255,253,11220,12397,2025-08-01,2025-10-17,632.08,-2,1177,227356040,48158939,0.00545268117794451,99.9824359185707,0.0949423247559893
587.76,588,589,516,12958,12384,2025-08-01,2025-08-08,632.08,-73,-574.000000000004,58500270,29786673,0.0211691330655397,99.7730113040504,-0.0463501291989667
512.89,513,1114,1114,12254,12254,2025-08-01,2025-08-15,632.08,0,0,243349966,91051840,0.00503554621413015,99.8021088690023,0
597.74,598,451,469,13981,12194,2025-08-01,2025-08-08,632.08,18,-1787,58500270,29786673,0.0208443482397603,99.7938556522902,-0.146547482368378
319.99,320,12127,12127,12127,12127,2025-08-01,2025-08-15,632.08,0,0,243349966,91051840,0.00498335800055135,99.8070922270028,0
631.85,647,6,8,8214,12120,2025-08-01,2025-09-05,632.08,2,3906,23171190,9460006,0.0523063338568282,99.6196872063973,0.322277227722772
629.41,750,1,1,12059,12059,2025-08-01,2025-12-19,632.08,0,0,380408956,31818097,0.00317000948842014,100,0
501.92,502,1498,1499,14980,11992,2025-08-01,2025-08-15,632.08,1,-2988,243349966,91051840,0.00492788234044791,99.8120201093433,-0.249166110740494
399.94,400,2000,1994,14000,11964,2025-08-01,2025-08-29,632.08,-6,-2036,155069044,41373917,0.00771527294641734,99.9449471036915,-0.170177198261451
324.99,325,11901,11901,11901,11901,2025-08-01,2025-08-15,632.08,0,0,243349966,91051840,0.00489048763623004,99.8169105969795,0
429.91,430,1316,1320,14476,11880,2025-08-01,2025-08-29,632.08,4,-2596,155069044,41373917,0.00766110352753577,99.952608207219,-0.218518518518519
279.95,280,2366,2366,11830,11830,2025-08-01,2025-09-19,632.08,0,0,595655559,168675191,0.00198604710746937,99.9826122666976,0
608.94,609,1246,1910,12460,11460,2025-08-01,2025-08-01,632.08,664,-1000,61309866,39049978,0.0186919345085504,99.664016554856,-0.087260034904014
444.9,445,1135,1135,13620,11350,2025-08-01,2025-08-29,632.08,0,-2270,155069044,41373917,0.00731932028935446,99.9599275275083,-0.2
589.98,590,5272,5660,31632,11320,2025-08-01,2025-08-01,632.08,388,-20312,61309866,39049978,0.0184635862684808,99.6824801411244,-1.79434628975265
450.96,451,2812,2812,11248,11248,2025-08-01,2025-08-15,632.08,0,0,243349966,91051840,0.00462214981365561,99.8215327467932,0
629.55,642,3,9,3060,11205,2025-08-01,2025-09-05,632.08,6,8145,23171190,9460006,0.0483574645928845,99.6680446709902,0.726907630522088
539.93,540,1083,1600,6498,11200,2025-08-01,2025-08-08,632.08,517,4702,58500270,29786673,0.0191452107827878,99.8130008630729,0.419821428571429
473.94,474,1866,1865,9330,11190,2025-08-01,2025-08-15,632.08,-1,1860,243349966,91051840,0.00459831582635191,99.8261310626195,0.166219839142091
637.89,675,3,3,11133,11133,2025-08-01,2025-08-22,632.08,0,0,60984890,20108486,0.0182553416100283,99.9087921614682,0
637.14,651,0,8,0,11088,2025-08-01,2025-08-22,632.08,8,11088,60984890,20108486,0.0181815528403839,99.9269737143086,1
497.92,498,1374,1374,10992,10992,2025-08-01,2025-08-15,632.08,0,0,243349966,91051840,0.00451695152486687,99.8306480141444,0
423.96,425,101,105,11615,10920,2025-08-01,2025-11-21,632.08,4,-695,69823438,8093490,0.0156394476021075,99.912914629039,-0.0636446886446886
433.8,435,91,91,10920,10920,2025-08-01,2025-11-21,632.08,0,0,69823438,8093490,0.0156394476021075,99.9285540766412,0
627.37,641,0,8,0,10904,2025-08-01,2025-09-12,632.08,8,10904,1003977,1003977,1.08608065722621,98.0137991208962,1
344.74,345,177,419,4779,10894,2025-08-01,2025-10-17,632.08,242,6115,227356040,48158939,0.00479160351315056,99.9872275220839,0.561318156783551
595.7,596,238,363,6902,10890,2025-08-01,2025-08-08,632.08,125,3988,58500270,29786673,0.0186152986986214,99.8316161617716,0.366207529843893
478.92,479,1358,1357,21728,10856,2025-08-01,2025-08-15,632.08,-1,-10872,243349966,91051840,0.00446106493394784,99.8351090790783,-1.00147383935151
514.96,515,2701,2701,10804,10804,2025-08-01,2025-08-08,632.08,0,0,58500270,29786673,0.0184682908301107,99.8500844526017,0
284.99,285,10804,10804,10804,10804,2025-08-01,2025-08-15,632.08,0,0,243349966,91051840,0.00443969653153763,99.8395487756099,0
588.96,589,1387,2684,6935,10736,2025-08-01,2025-08-01,632.08,1297,3801,61309866,39049978,0.0175110478956193,99.6999911890201,0.354042473919523
339.98,340,5220,5220,5220,10440,2025-08-01,2025-08-15,632.08,0,5220,243349966,91051840,0.00429011771466613,99.8438388933245,0.5
612.43,612.5,846,1477,10998,10339,2025-08-01,2025-08-01,632.08,631,-658.999999999998,61309866,39049978,0.0168635175291363,99.7168547065492,-0.0637392397717379
354.71,355,310,356,9610,10324,2025-08-01,2025-10-17,632.08,46,714,227356040,48158939,0.00454089541672172,99.9917684175006,0.0691592406044169
520.9,521,1259,1029,13849,10290,2025-08-01,2025-08-15,632.08,-230,-3559,243349966,91051840,0.00422847809232897,99.8480673714169,-0.345869776482021
587.47,587.5,765,3419,6120,10257,2025-08-01,2025-08-01,632.08,2654,4137,61309866,39049978,0.0167297707028099,99.733584477252,0.403334308277274
595.94,596,1051,1691,6306,10146,2025-08-01,2025-08-01,632.08,640,3840,61309866,39049978,0.0165487231696119,99.7501332004216,0.378474275576582
344.98,345,5019,5019,5019,10038,2025-08-01,2025-08-15,632.08,0,5019,243349966,91051840,0.00412492352680255,99.8521922949437,0.5
483.92,484,1273,1229,10184,9832,2025-08-01,2025-08-15,632.08,-44,-352,243349966,91051840,0.00404027177879285,99.8562325667225,-0.0358014646053702
529.71,530,350,337,9100,9773,2025-08-01,2025-08-22,632.08,-13,672.999999999998,60984890,20108486,0.0160252810163304,99.9429989953249,0.0688631945155017
259.99,260,9633,9633,9633,9633,2025-08-01,2025-08-15,632.08,0,0,243349966,91051840,0.00395849654649222,99.8601910632689,0
534.94,535,1448,1563,7240,9378,2025-08-01,2025-08-08,632.08,115,2138,58500270,29786673,0.016030695242945,99.8661151478446,0.227980379611857
633.3,680,2,2,8816,9340,2025-08-01,2025-09-19,632.08,0,524,595655559,168675191,0.00156802028603245,99.9841802869836,0.0561027837259101
389.28,390,129,129,9288,9288,2025-08-01,2025-11-21,632.08,0,0,69823438,8093490,0.0133021235648694,99.941856200206,0
436.95,437,884,1806,2652,9030,2025-08-01,2025-08-15,632.08,922,6378,243349966,91051840,0.00371070526469685,99.8639017685336,0.706312292358804
279.99,280,8988,8988,8988,8988,2025-08-01,2025-08-15,632.08,0,0,243349966,91051840,0.00369344617044245,99.8675952147041,0
427.98,428,4437,4437,8874,8874,2025-08-01,2025-08-15,632.08,0,0,243349966,91051840,0.00364660005746621,99.8712418147615,0
529.94,530,1443,1459,8658,8754,2025-08-01,2025-08-08,632.08,16,96,58500270,29786673,0.0149640334993326,99.881079181344,0.0109664153529815
471.89,472,789,789,8679,8679,2025-08-01,2025-08-15,632.08,0,0,243349966,91051840,0.00356646854842791,99.87480828331,0
154.99,155,8558,8558,8558,8558,2025-08-01,2025-09-19,632.08,0,0,595655559,168675191,0.0014367363605852,99.9856170233442,0
603.94,604,886,1426,6202,8556,2025-08-01,2025-08-01,632.08,540,2354,61309866,39049978,0.0139553395859648,99.7640885400076,0.275128564749883
617.48,626,0,10,0,8520,2025-08-01,2025-09-12,632.08,10,8520,1003977,1003977,0.848625018302212,98.8624241391984,1
394.98,395,4258,4258,4258,8516,2025-08-01,2025-08-15,632.08,0,4258,243349966,91051840,0.00349948682548819,99.8783077701355,0.5
601.95,602,1657,1695,13256,8475,2025-08-01,2025-08-01,632.08,38,-4781,61309866,39049978,0.013823223818496,99.7779117638261,-0.564129793510324
590.77,591,313,368,7512,8464,2025-08-01,2025-08-08,632.08,55,952.000000000001,58500270,29786673,0.014468309291564,99.8955474906355,0.112476370510397
359.99,360,8319,8452,8319,8452,2025-08-01,2025-08-15,632.08,133,133,243349966,91051840,0.00347318725329101,99.8817809573888,0.0157359204921912
443.96,444,2112,2112,4224,8448,2025-08-01,2025-08-15,632.08,0,4224,243349966,91051840,0.00347154353002868,99.8852525009188,0.5
304.98,305,4217,4217,8434,8434,2025-08-01,2025-08-15,632.08,0,0,243349966,91051840,0.00346579049861055,99.8887182914174,0
466.93,467,1191,1192,4764,8344,2025-08-01,2025-08-15,632.08,1,3580,243349966,91051840,0.00342880672520826,99.8921470981426,0.429050814956855
602.96,603,1270,2086,11430,8344,2025-08-01,2025-08-01,632.08,816,-3086,61309866,39049978,0.0136095551081452,99.7915213189342,-0.369846596356663
611.98,695,1,1,8302,8302,2025-08-01,2025-11-21,632.08,0,0,69823438,8093490,0.0118899902923715,99.9537461904984,0
592.97,593,1833,2766,9165,8298,2025-08-01,2025-08-01,632.08,933,-867,61309866,39049978,0.0135345264006938,99.8050558453349,-0.104483007953724
580.97,581,2700,2731,16200,8193,2025-08-01,2025-08-01,632.08,31,-8007,61309866,39049978,0.0133632652206416,99.8184191105556,-0.977297693152691
364.99,365,7666,8126,7666,8126,2025-08-01,2025-08-15,632.08,460,460.000000000001,243349966,91051840,0.00333922380741159,99.89548632195,0.0566084174255477
189.98,190,3909,4020,7818,8040,2025-08-01,2025-09-19,632.08,111,222,595655559,168675191,0.00134977335114571,99.9869667966954,0.0276119402985075
249.97,250,2654,2654,7962,7962,2025-08-01,2025-09-19,632.08,0,0,595655559,168675191,0.0013366785350525,99.9883034752304,0
264.98,265,3960,3970,11880,7940,2025-08-01,2025-09-19,632.08,10,-3940,595655559,168675191,0.00133298512538519,99.9896364603558,-0.496221662468514
492.75,495,35,35,7315,7875,2025-08-01,2025-11-21,632.08,0,560.000000000001,69823438,8093490,0.0112784477899814,99.9650246382884,0.0711111111111112
504.97,505,2000,2596,8000,7788,2025-08-01,2025-08-08,632.08,596,-212,58500270,29786673,0.0133127590693171,99.9088602497048,-0.0272213662044171
529.42,530,134,134,8308,7772,2025-08-01,2025-09-05,632.08,0,-536,23171190,9460006,0.0335416523708968,99.701586323361,-0.0689655172413793
229.98,230,3795,3795,7590,7590,2025-08-01,2025-09-19,632.08,0,0,595655559,168675191,0.00127422633522337,99.990910686691,0
465.92,466,897,947,3588,7576,2025-08-01,2025-08-15,632.08,50,3988,243349966,91051840,0.00311321185884201,99.8985995338089,0.526399155227033
487.95,488,1499,1499,13491,7495,2025-08-01,2025-08-15,632.08,0,-5996,243349966,91051840,0.00307992646277995,99.9016794602716,-0.8
509.97,510,2376,2493,9504,7479,2025-08-01,2025-08-08,632.08,117,-2025,58500270,29786673,0.0127845563789706,99.9216448060838,-0.270758122743682
625.8,700,1,1,7420,7420,2025-08-01,2025-11-21,632.08,0,0,69823438,8093490,0.0106268041398935,99.9756514424283,0
369.67,370,223,223,7359,7359,2025-08-01,2025-10-17,632.08,0,0,227356040,48158939,0.00323677347652607,99.9950051909771,0
244.97,245,2440,2440,7320,7320,2025-08-01,2025-09-19,632.08,0,0,595655559,168675191,0.00122889812566997,99.9921395848167,0
482.94,483,1196,1195,10764,7170,2025-08-01,2025-08-15,632.08,-1,-3594,243349966,91051840,0.00294637394771611,99.9046258342194,-0.501255230125523
519.96,520,1144,1788,3432,7152,2025-08-01,2025-08-08,632.08,644,3720,58500270,29786673,0.0122255845998659,99.9338703906837,0.520134228187919
631.88,646,4,5,5544,7060,2025-08-01,2025-09-05,632.08,1,1516,23171190,9460006,0.0304688710420138,99.7320551944031,0.214730878186969
569.98,570,3035,3489,9105,6978,2025-08-01,2025-08-01,632.08,454,-2127,61309866,39049978,0.0113815287086095,99.8298006392642,-0.30481513327601
476.96,477,1739,1739,13912,6956,2025-08-01,2025-08-15,632.08,0,-6956,243349966,91051840,0.00285843475318176,99.9074842689726,-1
438.74,440,55,55,6930,6930,2025-08-01,2025-11-21,632.08,0,0,69823438,8093490,0.00992503405518359,99.9855764764835,0
446.97,447,2256,2256,6768,6768,2025-08-01,2025-08-15,632.08,0,0,243349966,91051840,0.00278117975985252,99.9102654487324,0
334.78,335,295,302,6785,6644,2025-08-01,2025-10-17,632.08,7,-141.000000000001,227356040,48158939,0.00292228875907585,99.9979274797362,-0.0212221553281157
596.96,597,634,1658,4438,6632,2025-08-01,2025-08-01,632.08,1024,2194,61309866,39049978,0.0108171823438662,99.840617821608,0.330820265379976
254.97,255,2176,2199,6528,6597,2025-08-01,2025-09-19,632.08,23,69,595655559,168675191,0.00110751925342142,99.9932471040701,0.0104592996816735
209.97,210,2161,2161,6483,6483,2025-08-01,2025-09-19,632.08,0,0,595655559,168675191,0.00108838067605443,99.9943354847461,0
559.98,560,3217,3235,9651,6470,2025-08-01,2025-08-01,632.08,18,-3181,61309866,39049978,0.0105529508089285,99.851170772417,-0.491653786707883
584.98,585,2967,3229,11868,6458,2025-08-01,2025-08-01,632.08,262,-5410,61309866,39049978,0.0105333781026369,99.8617041505196,-0.837720656550015
460.96,461,1603,1608,4809,6432,2025-08-01,2025-08-15,632.08,5,1623,243349966,91051840,0.00264310700581729,99.9129085557382,0.252332089552239
633.58,665,2,2,5910,6284,2025-08-01,2025-08-15,632.08,0,374,243349966,91051840,0.0025822892451113,99.9154908449833,0.0595162316995544
349.99,350,6269,6269,6269,6269,2025-08-01,2025-08-15,632.08,0,0,243349966,91051840,0.00257612528287758,99.9180669702662,0
492.92,493,776,776,6208,6208,2025-08-01,2025-08-15,632.08,0,0,243349966,91051840,0.00255105850312714,99.9206180287693,0
264.98,265,3092,3092,6184,6184,2025-08-01,2025-08-15,632.08,0,0,243349966,91051840,0.00254119616355319,99.9231592249329,0
184.99,185,4760,6142,4760,6142,2025-08-01,2025-09-19,632.08,1382,1382,595655559,168675191,0.00103113282621106,99.9953666175724,0.225008140670791
430.98,431,3053,3053,6106,6106,2025-08-01,2025-08-15,632.08,0,0,243349966,91051840,0.00250914355993787,99.9256683684928,0
414.92,415,761,759,7610,6072,2025-08-01,2025-08-29,632.08,-2,-1538,155069044,41373917,0.00391567513629606,99.9638432026446,-0.253293807641634
480.93,481,765,861,6885,6027,2025-08-01,2025-08-15,632.08,96,-857.999999999999,243349966,91051840,0.00247668002550697,99.9281450485183,-0.142359382777501
299.99,300,5995,5995,5995,5995,2025-08-01,2025-08-15,632.08,0,0,243349966,91051840,0.00246353023940838,99.9306085787577,0
394.95,395,1176,1175,5880,5875,2025-08-01,2025-08-29,632.08,-1,-5,155069044,41373917,0.0037886349515381,99.9676318375962,-0.000851063829787234
484.67,485,154,173,4620,5709,2025-08-01,2025-09-05,632.08,19,1089,23171190,9460006,0.0246383547845406,99.7566935491876,0.190751445086705
274.99,275,5644,5644,5644,5644,2025-08-01,2025-08-15,632.08,0,0,243349966,91051840,0.00231929352313943,99.9329278722809,0
463.96,464,1408,1408,5632,5632,2025-08-01,2025-08-15,632.08,0,0,243349966,91051840,0.00231436235335246,99.9352422346342,0
431.97,432,1647,1869,4941,5607,2025-08-01,2025-08-15,632.08,222,666,243349966,91051840,0.00230408908296293,99.9375463237172,0.118780096308186
456.96,457,1363,1363,5452,5452,2025-08-01,2025-08-15,632.08,0,0,243349966,91051840,0.00224039480654787,99.9397867185237,0
448.95,449,1079,1086,4316,5430,2025-08-01,2025-08-15,632.08,7,1114,243349966,91051840,0.00223135432860508,99.9420180728523,0.205156537753223
384.98,385,2705,2705,5410,5410,2025-08-01,2025-08-15,632.08,0,0,243349966,91051840,0.00222313571229346,99.9442412085646,0
468.93,469,708,764,3540,5348,2025-08-01,2025-08-15,632.08,56,1808,243349966,91051840,0.00219765800172744,99.9464388665664,0.338070306656694
434.89,435,482,482,5784,5302,2025-08-01,2025-08-29,632.08,0,-482,155069044,41373917,0.00341912212988171,99.9710509597261,-0.0909090909090909
424.9,425,495,525,4950,5250,2025-08-01,2025-08-29,632.08,30,300,155069044,41373917,0.00338558868009788,99.9744365484062,0.0571428571428571
379.3,380,74,75,4810,5250,2025-08-01,2025-11-21,632.08,1,440,69823438,8093490,0.0075189651933209,99.9930954416768,0.0838095238095238
314.94,315,873,874,4365,5244,2025-08-01,2025-09-19,632.08,1,878.999999999999,595655559,168675191,0.000880374558881604,99.9962469921312,0.167620137299771
404.93,405,744,744,5208,5208,2025-08-01,2025-08-29,632.08,0,0,155069044,41373917,0.0033585039706571,99.9777950523768,0
633.33,685,0,1,0,5167,2025-08-01,2025-09-05,632.08,1,5167,23171190,9460006,0.0222992431549696,99.7789927923426,1
399.96,400,880,1283,3520,5132,2025-08-01,2025-08-22,632.08,403,1612,60984890,20108486,0.00841519924033642,99.9514141945652,0.3141075604053
469.99,470,5126,5126,5126,5126,2025-08-01,2025-08-01,632.08,0,0,61309866,39049978,0.00836080770426085,99.8700649582238,0
470.92,471,634,634,5072,5072,2025-08-01,2025-08-15,632.08,0,0,243349966,91051840,0.00208424109662707,99.948523107663,0
638.16,655,67,3,154569,5052,2025-08-01,2025-08-22,632.08,-64,-149517,60984890,20108486,0.00828401920541301,99.9596982137707,-29.5956057007126
485.95,486,999,999,4995,4995,2025-08-01,2025-08-15,632.08,0,0,243349966,91051840,0.00205259942382733,99.9505757070868,0
491.95,492,984,984,4920,4920,2025-08-01,2025-08-15,632.08,0,0,243349966,91051840,0.00202177961265875,99.9525974866995,0
605.95,606,880,980,7040,4900,2025-08-01,2025-08-01,632.08,100,-2140,61309866,39049978,0.00799218840243428,99.8780571466263,-0.436734693877551
554.08,555,42,52,3696,4784,2025-08-01,2025-09-05,632.08,10,1088,23171190,9460006,0.0206463284794609,99.799639120822,0.22742474916388
389.95,390,959,955,4795,4775,2025-08-01,2025-08-29,632.08,-4,-20,155069044,41373917,0.00307927351380331,99.9808743258906,-0.00418848167539267
488.94,489,782,792,21114,4752,2025-08-01,2025-08-15,632.08,10,-16362,243349966,91051840,0.00195274323564113,99.9545502299351,-3.44318181818182
359.69,360,152,152,4712,4712,2025-08-01,2025-10-17,632.08,0,0,227356040,48158939,0.00207252026381177,100,0
577.97,578,1121,1566,4484,4698,2025-08-01,2025-08-01,632.08,445,214,61309866,39049978,0.00766271451319108,99.8857198611395,0.0455512984248616
602.46,602.5,647,1170,9058,4680,2025-08-01,2025-08-01,632.08,523,-4378,61309866,39049978,0.00763335545375356,99.8933532165933,-0.935470085470086
539.22,540,60,60,3660,4680,2025-08-01,2025-09-05,632.08,0,1020,23171190,9460006,0.0201974952516466,99.8198366160737,0.217948717948718
578.98,579,1686,2333,6744,4666,2025-08-01,2025-08-01,632.08,647,-2078,61309866,39049978,0.00761052062974661,99.900963737223,-0.445349335619374
461.93,462,663,663,4641,4641,2025-08-01,2025-08-15,632.08,0,0,243349966,91051840,0.00190712991511164,99.9564573598502,0
249.99,250,4612,4612,4612,4612,2025-08-01,2025-08-15,632.08,0,0,243349966,91051840,0.00189521292145979,99.9583525727717,0
475.95,476,914,914,4570,4570,2025-08-01,2025-08-15,632.08,0,0,243349966,91051840,0.00187795382720538,99.9602305265989,0
630.8,646,3,3,3591,4560,2025-08-01,2025-08-22,632.08,0,968.999999999999,60984890,20108486,0.00747726199063407,99.9671754757613,0.2125
442.97,443,1518,1518,6072,4554,2025-08-01,2025-08-15,632.08,0,-1518,243349966,91051840,0.00187137893415609,99.9621019055331,-0.333333333333333
329.99,330,3976,4291,3976,4291,2025-08-01,2025-08-15,632.08,315,315,243349966,91051840,0.00176330412965827,99.9638652096627,0.0734094616639478
467.95,468,858,858,4290,4290,2025-08-01,2025-08-15,632.08,0,0,243349966,91051840,0.00176289319884269,99.9656281028616,0
179.99,180,4075,4196,4075,4196,2025-08-01,2025-09-19,632.08,121,121,595655559,168675191,0.000704433952911367,99.9969514260842,0.028836987607245
441.96,442,1048,1048,4192,4192,2025-08-01,2025-08-15,632.08,0,0,243349966,91051840,0.00172262197891575,99.9673507248405,0
379.99,380,4173,4173,8346,4173,2025-08-01,2025-08-15,632.08,0,-4173,243349966,91051840,0.00171481429341971,99.9690655391339,-1
633.41,675,1,1,3765,4159,2025-08-01,2025-09-19,632.08,0,394,595655559,168675191,0.000698222309379975,99.9976496483935,0.0947343111324838
309.99,310,4117,4117,4117,4117,2025-08-01,2025-08-15,632.08,0,0,243349966,91051840,0.00169180216774717,99.9707573413016,0
364.95,365,822,822,3288,4110,2025-08-01,2025-08-29,632.08,0,822,155069044,41373917,0.00265043228099091,99.9835247581716,0.2
374.95,375,753,822,3765,4110,2025-08-01,2025-08-29,632.08,69,345,155069044,41373917,0.00265043228099091,99.9861751904526,0.0839416058394161
481.94,482,672,672,4032,4032,2025-08-01,2025-08-15,632.08,0,0,243349966,91051840,0.00165687304842278,99.9724142143501,0
524.47,525,24,75,1320,3975,2025-08-01,2025-09-05,632.08,51,2655,23171190,9460006,0.0171549238515588,99.8369915399252,0.667924528301887
544.24,545,46,50,3680,3800,2025-08-01,2025-09-05,632.08,4,120,23171190,9460006,0.0163996756316788,99.8533912155569,0.0315789473684209
438.95,439,564,754,2820,3770,2025-08-01,2025-08-15,632.08,190,950,243349966,91051840,0.00154920917474055,99.9739634235248,0.251989389920424
479.99,480,3767,3767,3767,3767,2025-08-01,2025-08-01,632.08,0,0,61309866,39049978,0.00614419871672856,99.9071079359397,0
524.96,525,524,919,3144,3676,2025-08-01,2025-08-08,632.08,395,532,58500270,29786673,0.00628373168192215,99.9401541223656,0.144722524483134
633.62,670,1,1,3194,3638,2025-08-01,2025-08-15,632.08,0,444.000000000001,243349966,91051840,0.00149496630708385,99.9754583898319,0.122045079714129
334.99,335,3585,3585,3585,3585,2025-08-01,2025-08-15,632.08,0,0,243349966,91051840,0.00147318697385805,99.9769315768057,0
620.13,629,0,4,0,3548,2025-08-01,2025-09-12,632.08,4,3548,1003977,1003977,0.353394549875147,99.2158186890736,1
633.29,651,0,2,0,3542,2025-08-01,2025-08-15,632.08,2,3542,243349966,91051840,0.00145551694878807,99.9783870937545,1
434.98,435,1762,1762,1762,3524,2025-08-01,2025-08-08,632.08,0,1762,58500270,29786673,0.0060239038212986,99.9461780261869,0.5
414.99,415,3515,3514,3515,3514,2025-08-01,2025-08-08,632.08,-1,-1,58500270,29786673,0.00600680988309969,99.95218483607,-0.000284575981787137
534.35,535,50,54,3450,3510,2025-08-01,2025-09-05,632.08,4,60,23171190,9460006,0.0151481214387349,99.8685393369956,0.0170940170940171
389.98,390,1749,1749,3498,3498,2025-08-01,2025-08-15,632.08,0,0,243349966,91051840,0.0014374359929025,99.9798245297474,0
164.99,165,3479,3479,3479,3479,2025-08-01,2025-09-19,632.08,0,0,595655559,168675191,0.000584062374208448,99.9982337107677,0
374.99,375,3458,3459,3458,3459,2025-08-01,2025-08-15,632.08,1,1.00000000000045,243349966,91051840,0.00142140969109484,99.9812459394385,0.00028910089621291
239.98,240,1713,1713,3426,3426,2025-08-01,2025-09-19,632.08,0,0,595655559,168675191,0.000575164614555373,99.9988088753823,0
409.92,410,496,425,3472,3400,2025-08-01,2025-08-29,632.08,-71,-72.0000000000005,155069044,41373917,0.00219257171663482,99.9883677621692,-0.0211764705882354
459.91,460,377,377,3393,3393,2025-08-01,2025-08-22,632.08,0,0,60984890,20108486,0.00556367323118891,99.9727391489925,0
607.44,607.5,418,561,3762,3366,2025-08-01,2025-08-01,632.08,143,-396,61309866,39049978,0.00549014411481506,99.9125980800545,-0.117647058823529
434.96,435,835,831,2505,3324,2025-08-01,2025-08-15,632.08,-4,819,243349966,91051840,0.0013659340309914,99.9826118734695,0.246389891696751
457.96,458,822,821,3288,3284,2025-08-01,2025-08-15,632.08,-1,-4,243349966,91051840,0.00134949679836816,99.9839613702679,-0.00121802679658952
369.99,370,2912,3234,2912,3234,2025-08-01,2025-08-15,632.08,322,322,243349966,91051840,0.00132895025758911,99.9852903205255,0.0995670995670997
489.97,490,956,1064,2868,3192,2025-08-01,2025-08-08,632.08,108,324,58500270,29786673,0.00545638507309453,99.9576412211431,0.101503759398496
632.07,648,0,2,0,3186,2025-08-01,2025-09-05,632.08,2,3186,23171190,9460006,0.0137498333059286,99.8822891703016,1
638.61,670,0,1,0,3139,2025-08-01,2025-09-05,632.08,1,3139,23171190,9460006,0.0135469952125894,99.8958361655142,1
433.97,434,1034,1034,3102,3102,2025-08-01,2025-08-15,632.08,0,0,243349966,91051840,0.00127470738993241,99.9865650279154,0
254.99,255,3100,3101,3100,3101,2025-08-01,2025-08-15,632.08,1,1,243349966,91051840,0.00127429645911683,99.9878393243745,0.000322476620445018
639.41,670,1,1,3270,3059,2025-08-01,2025-08-29,632.08,0,-211,155069044,41373917,0.00197266967093703,99.9903404318402,-0.0689767898005886
499.99,500,3029,3035,3029,3035,2025-08-01,2025-08-01,632.08,6,6,61309866,39049978,0.00495026363293634,99.9175483436875,0.00197693574958814
585.97,586,661,1002,3966,3006,2025-08-01,2025-08-01,632.08,341,-960,61309866,39049978,0.00490296292606479,99.9224513066135,-0.31936127744511
514.51,515,36,61,1836,2989,2025-08-01,2025-09-05,632.08,25,1153,23171190,9460006,0.0128996395955495,99.9087358051097,0.385747741719639
479.98,480,1469,1487,2938,2974,2025-08-01,2025-08-08,632.08,18,36,58500270,29786673,0.00508373722035813,99.9627249583634,0.0121049092131809
289.99,290,2972,2972,2972,2972,2025-08-01,2025-08-15,632.08,0,0,243349966,91051840,0.00122128638390687,99.9890606107584,0
452.95,453,561,584,2244,2920,2025-08-01,2025-08-15,632.08,23,676.000000000001,243349966,91051840,0.00119991798149666,99.9902605287399,0.231506849315069
159.99,160,2911,2912,2911,2912,2025-08-01,2025-09-19,632.08,1,1,595655559,168675191,0.000488873134146306,99.9992977485164,0.000343406593406593
539.99,540,2703,2845,2703,2845,2025-08-01,2025-08-01,632.08,142,142,61309866,39049978,0.0046403624499848,99.9270916690635,0.0499121265377856
404.09,405,21,31,1932,2821,2025-08-01,2025-11-21,632.08,10,889,69823438,8093490,0.00404019063054443,99.9971356323073,0.315136476426799
544.99,545,2469,2768,4938,2768,2025-08-01,2025-08-01,632.08,299,-2170,61309866,39049978,0.00451477091794655,99.9316064399815,-0.783959537572254
519.99,520,2595,2730,2595,2730,2025-08-01,2025-08-01,632.08,135,135,61309866,39049978,0.00445279068135624,99.9360592306628,0.0494505494505495
504.58,505,46,65,1978,2730,2025-08-01,2025-09-05,632.08,19,752,23171190,9460006,0.0117818722301272,99.9205176773398,0.275457875457875
592.47,592.5,668,904,5344,2712,2025-08-01,2025-08-01,632.08,236,-2632,61309866,39049978,0.00442343162191873,99.9404826622848,-0.970501474926254
455.96,456,665,665,2660,2660,2025-08-01,2025-08-15,632.08,0,0,243349966,91051840,0.00109307596944558,99.9913536047094,0
590.97,591,699,885,4893,2655,2025-08-01,2025-08-01,632.08,186,-2238,61309866,39049978,0.00433046126703327,99.9448131235518,-0.842937853107345
424.99,425,2635,2636,2635,2636,2025-08-01,2025-08-08,632.08,1,1,58500270,29786673,0.00450596210923471,99.9672309204727,0.000379362670713202
462.97,463,873,873,4365,2619,2025-08-01,2025-08-15,632.08,0,-1746,243349966,91051840,0.00107622780600676,99.9924298325154,-0.666666666666667
494.97,495,818,857,2454,2571,2025-08-01,2025-08-08,632.08,39,117,58500270,29786673,0.00439485151094174,99.9716257719836,0.0455075845974327
504.99,505,2569,2568,2569,2568,2025-08-01,2025-08-01,632.08,-1,-1,61309866,39049978,0.00418855914641862,99.9490016826982,-0.000389408099688474
439.84,440,160,160,2560,2560,2025-08-01,2025-09-05,632.08,0,0,23171190,9460006,0.0110482025308152,99.9315658798707,0
634.3,647,0,2,0,2540,2025-08-01,2025-09-12,632.08,2,2540,1003977,1003977,0.252993843484462,99.468812532558,1
472.96,473,628,628,2512,2512,2025-08-01,2025-08-15,632.08,0,0,243349966,91051840,0.00103225820873959,99.9934620907241,0
449.98,450,1511,1250,1511,2500,2025-08-01,2025-08-08,632.08,-261,989,58500270,29786673,0.00427348454972943,99.9758992565334,0.3956
319.99,320,2493,2493,2493,2493,2025-08-01,2025-08-29,632.08,0,0,155069044,41373917,0.00160767096752076,99.9919481028077,0
583.96,584,257,620,1542,2480,2025-08-01,2025-08-01,632.08,363,938,61309866,39049978,0.00404502596694633,99.9530467086651,0.378225806451613
519.5,520,48,49,2688,2450,2025-08-01,2025-09-05,632.08,1,-238.000000000001,23171190,9460006,0.0105734750783192,99.942139354949,-0.0971428571428573
437.96,438,432,604,864,2416,2025-08-01,2025-08-15,632.08,172,1552,243349966,91051840,0.000992808850443809,99.9944548995746,0.642384105960265
169.99,170,2328,2328,2328,2328,2025-08-01,2025-09-19,632.08,0,0,595655559,168675191,0.000390829895704877,99.9996885784122,0
432.98,433,1114,1114,2228,2228,2025-08-01,2025-08-15,632.08,0,0,243349966,91051840,0.000915553857114572,99.9953704534317,0
434.92,435,276,276,2208,2208,2025-08-01,2025-08-22,632.08,0,0,60984890,20108486,0.00362056896388597,99.9763597179564,0
581.97,582,416,728,2912,2184,2025-08-01,2025-08-01,632.08,312,-728.000000000001,61309866,39049978,0.003562232545085,99.9566089412102,-0.333333333333334
389.99,390,2173,2173,2173,2173,2025-08-01,2025-08-01,632.08,0,0,61309866,39049978,0.00354429089765096,99.9601532321079,0
499.59,500,47,52,1692,2132,2025-08-01,2025-09-05,632.08,5,440,23171190,9460006,0.00920108117019454,99.9513404361192,0.206378986866792
354.99,355,2014,2110,2014,2110,2025-08-01,2025-08-15,632.08,96,96,243349966,91051840,0.000867064020876009,99.9962375174525,0.0454976303317536
445.97,446,684,699,3420,2097,2025-08-01,2025-08-15,632.08,15,-1323,243349966,91051840,0.000861721920273455,99.9970992393728,-0.630901287553648
479.85,480,136,136,2040,2040,2025-08-01,2025-08-22,632.08,0,0,60984890,20108486,0.00334509089054682,99.9797048088469,0
494.87,495,130,154,2600,2002,2025-08-01,2025-08-22,632.08,24,-598,60984890,20108486,0.00328278037395821,99.9829875892209,-0.298701298701299
414,415,21,20,2079,2000,2025-08-01,2025-11-21,632.08,-1,-79,69823438,8093490,0.00286436769269368,100,-0.0395
404.96,405,204,496,816,1984,2025-08-01,2025-08-22,632.08,292,1168,60984890,20108486,0.00325326486610044,99.986240854087,0.588709677419355
429.88,430,160,165,2080,1980,2025-08-01,2025-09-05,632.08,5,-100,23171190,9460006,0.00854509414492739,99.9598855302641,-0.0505050505050505
349.97,350,653,648,1959,1944,2025-08-01,2025-08-29,632.08,-5,-15.0000000000002,155069044,41373917,0.00125363512268767,99.9932017379304,-0.00771604938271617
484.99,485,1930,1930,1930,1930,2025-08-01,2025-08-01,632.08,0,0,61309866,39049978,0.00314794359524452,99.9633011757031,0
435.98,436,954,954,2862,1908,2025-08-01,2025-08-15,632.08,0,-953.999999999999,243349966,91051840,0.000784055996128637,99.997883295369,-0.5
379.95,380,366,377,1830,1885,2025-08-01,2025-08-29,632.08,11,55.0000000000002,155069044,41373917,0.00121558755466371,99.994417325485,0.0291777188328914
174.99,175,1854,1855,1854,1855,2025-08-01,2025-09-19,632.08,1,1,595655559,168675191,0.000311421587857623,100,0.000539083557951483
582.97,583,565,585,3955,1755,2025-08-01,2025-08-01,632.08,20,-2200,61309866,39049978,0.00286250829515759,99.9661636839983,-1.25356125356125
414.99,415,1750,1750,1750,1750,2025-08-01,2025-08-01,632.08,0,0,61309866,39049978,0.00285435300086939,99.9690180369991,0
344.97,345,552,552,1656,1656,2025-08-01,2025-08-29,632.08,0,0,155069044,41373917,0.00106791140080802,99.9954852368858,0
586.97,587,240,551,1920,1653,2025-08-01,2025-08-01,632.08,311,-267,61309866,39049978,0.00269614029167834,99.9717141772908,-0.161524500907441
429.99,430,1594,1594,1594,1594,2025-08-01,2025-08-08,632.08,0,0,58500270,29786673,0.00272477374890748,99.9786240302823,0
454.77,455,7,69,140,1587,2025-08-01,2025-09-05,632.08,62,1447,23171190,9460006,0.00684902242828271,99.9667345526924,0.911783238815375
379.99,380,1583,1583,1583,1583,2025-08-01,2025-08-08,632.08,0,0,58500270,29786673,0.00270597041688867,99.9813300006991,0
419.99,420,1178,1578,1178,1578,2025-08-01,2025-08-08,632.08,400,400,58500270,29786673,0.00269742344778922,99.9840274241469,0.253485424588086
459.99,460,1544,1544,1544,1544,2025-08-01,2025-08-01,632.08,0,0,61309866,39049978,0.00251835487619562,99.974232532167,0
524.99,525,1499,1514,1499,1514,2025-08-01,2025-08-01,632.08,15,15,61309866,39049978,0.00246942311046643,99.9767019552775,0.00990752972258917
635.27,650,0,1,0,1473,2025-08-01,2025-09-12,632.08,1,1473,1003977,1003977,0.146716508445911,99.6155290410039,1
616.68,624,0,2,0,1464,2025-08-01,2025-09-12,632.08,2,1464,1003977,1003977,0.145820073567422,99.7613491145714,1
564.99,565,1384,1448,5536,1448,2025-08-01,2025-08-01,632.08,64,-4088,61309866,39049978,0.00236177322586221,99.9790637285034,-2.8232044198895
294.99,295,1441,1441,1441,1441,2025-08-01,2025-08-15,632.08,0,0,243349966,91051840,0.000592151305252288,99.9984754466742,0
314.99,315,1420,1420,1420,1420,2025-08-01,2025-08-15,632.08,0,0,243349966,91051840,0.000583521758125086,99.9990589684323,0
509.99,510,1401,1401,1401,1401,2025-08-01,2025-08-01,632.08,0,0,61309866,39049978,0.00228511345955315,99.9813488419629,0
464.99,465,1383,1383,1383,1383,2025-08-01,2025-08-01,632.08,0,0,61309866,39049978,0.00225575440011564,99.983604596363,0
514.99,515,1423,1373,1423,1373,2025-08-01,2025-08-01,632.08,-50,-50,61309866,39049978,0.00223944381153924,99.9858440401746,-0.0364166059723234
636,649,0,1,0,1300,2025-08-01,2025-08-22,632.08,1,1300,60984890,20108486,0.00213167556750533,99.9883725296545,1
384.95,385,252,253,1260,1265,2025-08-01,2025-08-29,632.08,1,4.99999999999977,155069044,41373917,0.000815765653395013,99.9963010025392,0.00395256916996029
489.9,490,122,122,1220,1220,2025-08-01,2025-08-22,632.08,0,0,60984890,20108486,0.00200049553258192,99.9903730251871,0
633.8,646,0,1,0,1220,2025-08-01,2025-09-12,632.08,1,1220,1003977,1003977,0.121516727972852,99.8828658425442,1
440.98,441,598,598,1196,1196,2025-08-01,2025-08-15,632.08,0,0,243349966,91051840,0.000491473255434932,99.9995504416878,0
369.97,370,395,394,1580,1182,2025-08-01,2025-08-29,632.08,-1,-398,155069044,41373917,0.000762241108547751,99.9970632436478,-0.336717428087986
633.24,645,0,1,0,1176,2025-08-01,2025-09-12,632.08,1,1176,1003977,1003977,0.117134157455798,100,1
637.3,649,0,1,0,1170,2025-08-01,2025-08-08,632.08,1,1170,58500270,29786673,0.00199999076927337,99.9860274149162,1
394.99,395,1165,1165,1165,1165,2025-08-01,2025-08-01,632.08,0,0,61309866,39049978,0.00190018356915019,99.9877442237437,0
469.97,470,385,386,1155,1158,2025-08-01,2025-08-08,632.08,1,3,58500270,29786673,0.00197947804343467,99.9880068929597,0.00259067357512953
384.99,385,1118,1118,1118,1118,2025-08-01,2025-08-08,632.08,0,0,58500270,29786673,0.001911102290639,99.9899179952503,0
474.76,475,45,46,1395,1104,2025-08-01,2025-09-05,632.08,1,-291,23171190,9460006,0.00476453734141406,99.9714990900338,-0.263586956521739
426.98,427,547,547,1094,1094,2025-08-01,2025-08-15,632.08,0,0,243349966,91051840,0.000449558312245665,100,0
637.07,648,0,1,0,1093,2025-08-01,2025-08-22,632.08,1,1093,60984890,20108486,0.00179224722714102,99.9921652724142,1
444.99,445,945,1091,945,1091,2025-08-01,2025-08-08,632.08,146,146,58500270,29786673,0.00186494865750192,99.9917829439078,0.133822181484876
469.92,470,137,136,1233,1088,2025-08-01,2025-08-22,632.08,-1,-145,60984890,20108486,0.00178404847495831,99.9939493208892,-0.133272058823529
354.96,355,257,257,1028,1028,2025-08-01,2025-08-29,632.08,0,0,155069044,41373917,0.00066293050726488,99.9977261741551,0
359.97,360,340,340,1020,1020,2025-08-01,2025-08-29,632.08,0,0,155069044,41373917,0.000657771514990445,99.9983839456701,0
444.85,445,68,68,1020,1020,2025-08-01,2025-09-05,632.08,0,0,23171190,9460006,0.00440201819587168,99.9759011082297,0
374.92,375,3,120,21,960,2025-08-01,2025-09-05,632.08,117,939,23171190,9460006,0.0041430759490557,99.9800441841787,0.978125
454.99,455,944,944,944,944,2025-08-01,2025-08-01,632.08,0,0,61309866,39049978,0.00153971956161183,99.9892839433053,0
324.98,325,445,465,1335,930,2025-08-01,2025-08-29,632.08,20,-405,155069044,41373917,0.000599732851903053,99.9989836785219,-0.435483870967742
374.99,375,919,919,919,919,2025-08-01,2025-08-08,632.08,0,0,58500270,29786673,0.00157093292048054,99.9933538768283,0
474.99,475,860,860,860,860,2025-08-01,2025-08-01,632.08,0,0,61309866,39049978,0.0014027106175701,99.9906866539229,0
419.87,420,25,65,300,845,2025-08-01,2025-09-05,632.08,40,545,23171190,9460006,0.00364676997599174,99.9836909541547,0.644970414201184
484.98,485,288,421,576,842,2025-08-01,2025-08-08,632.08,133,266,58500270,29786673,0.00143930959634887,99.9947931864246,0.315914489311164
449.93,450,118,118,1180,826,2025-08-01,2025-08-22,632.08,0,-354,60984890,20108486,0.00135443386058415,99.9953037547498,-0.428571428571428
444.99,445,792,792,792,792,2025-08-01,2025-08-01,632.08,0,0,61309866,39049978,0.0012917986152506,99.9919784525381,0
484.87,485,59,59,767,767,2025-08-01,2025-08-22,632.08,0,0,60984890,20108486,0.00125768858482814,99.9965614433346,0
464.99,465,760,760,760,760,2025-08-01,2025-08-08,632.08,0,0,58500270,29786673,0.00129913930311775,99.9960923257277,0
434.95,435,148,148,740,740,2025-08-01,2025-08-01,632.08,0,0,61309866,39049978,0.00120698355465334,99.9931854360928,0
494.99,495,710,710,710,710,2025-08-01,2025-08-01,632.08,0,0,61309866,39049978,0.00115805178892415,99.9943434878817,0
474.9,475,68,68,680,680,2025-08-01,2025-08-22,632.08,0,0,60984890,20108486,0.00111503029684894,99.9976764736314,0
334.97,335,224,224,672,672,2025-08-01,2025-08-29,632.08,0,0,155069044,41373917,0.000433355351052529,99.999417033873,0
339.97,340,224,224,896,672,2025-08-01,2025-08-29,632.08,0,-224,155069044,41373917,0.000433355351052529,99.9998503892241,-0.333333333333334
439.99,440,609,609,609,609,2025-08-01,2025-08-01,632.08,0,0,61309866,39049978,0.000993314844302547,99.995336802726,0
414.88,415,35,50,455,600,2025-08-01,2025-09-05,632.08,15,145,23171190,9460006,0.00258942246815981,99.9862803766229,0.241666666666667
509.56,510,16,13,736,572,2025-08-01,2025-09-05,632.08,-3,-164,23171190,9460006,0.00246858275297902,99.9887489593758,-0.286713286713287
419.95,420,120,114,600,570,2025-08-01,2025-08-22,632.08,-6,-30,60984890,20108486,0.000934657748829259,99.9986111313802,-0.0526315789473684
489.62,490,15,15,570,570,2025-08-01,2025-09-05,632.08,0,0,23171190,9460006,0.00245995134475182,99.9912089107206,0
379.98,380,275,275,550,550,2025-08-01,2025-08-01,632.08,0,0,61309866,39049978,0.000897082371701807,99.9962338850977,0
374.99,375,489,487,489,487,2025-08-01,2025-08-01,632.08,-2,-1.99999999999994,61309866,39049978,0.000794325663670509,99.9970282107614,-0.00410677618069804
409.89,410,33,43,429,473,2025-08-01,2025-09-05,632.08,10,44.0000000000001,23171190,9460006,0.00204132804573265,99.9932502387663,0.0930232558139536
409.99,410,470,470,470,470,2025-08-01,2025-08-01,632.08,0,0,61309866,39049978,0.000766597663090635,99.9977948084245,0
384.98,385,210,210,420,420,2025-08-01,2025-08-01,632.08,0,0,61309866,39049978,0.000685044720208653,99.9984798531447,0
454.99,455,40,419,80,419,2025-08-01,2025-08-08,632.08,379,339,58500270,29786673,0.000716236010534652,99.9968085617383,0.809069212410501
439.99,440,348,393,348,393,2025-08-01,2025-08-08,632.08,45,45,58500270,29786673,0.000671791771217466,99.9974803535095,0.114503816793893
424.99,425,309,309,309,309,2025-08-01,2025-08-01,632.08,0,0,61309866,39049978,0.000503997187010652,99.9989838503317,0
404.99,405,265,265,265,265,2025-08-01,2025-08-08,632.08,0,0,58500270,29786673,0.000452989362271319,99.9979333428718,0
404.9,405,15,26,180,260,2025-08-01,2025-09-05,632.08,11,80,23171190,9460006,0.00112208306953592,99.9943723218359,0.307692307692308
409.96,410,62,64,310,256,2025-08-01,2025-08-22,632.08,2,-54,60984890,20108486,0.000419776111754895,99.999030907492,-0.2109375
424.88,425,11,21,132,252,2025-08-01,2025-09-05,632.08,10,120,23171190,9460006,0.00108755743662712,99.9954598792725,0.476190476190476
399.99,400,250,250,250,250,2025-08-01,2025-08-08,632.08,0,0,58500270,29786673,0.000427348454972943,99.9983606913267,0
399.9,400,20,25,220,250,2025-08-01,2025-09-05,632.08,5,30,23171190,9460006,0.00107892602839992,99.9965388053009,0.12
474.99,475,249,249,498,249,2025-08-01,2025-08-08,632.08,0,-249,58500270,29786673,0.000425639061153051,99.9987863303879,-1
404.99,405,238,238,238,238,2025-08-01,2025-08-01,632.08,0,0,61309866,39049978,0.000388192008118237,99.9993720423398,0
329.98,330,116,116,348,232,2025-08-01,2025-08-29,632.08,0,-116,155069044,41373917,0.000149610775958611,100,-0.5
459.98,460,109,109,327,218,2025-08-01,2025-08-08,632.08,0,-109,58500270,29786673,0.000372647852736406,99.9991589782406,-0.5
399.99,400,213,213,213,213,2025-08-01,2025-08-01,632.08,0,0,61309866,39049978,0.000347415536677245,99.9997194578765,0
409.99,410,172,172,516,172,2025-08-01,2025-08-08,632.08,0,-344,58500270,29786673,0.000294015737021385,99.9994529939777,-2
389.99,390,168,168,168,168,2025-08-01,2025-08-08,632.08,0,0,58500270,29786673,0.000287178161741818,99.9997401721394,0
384.92,385,20,20,160,160,2025-08-01,2025-09-05,632.08,0,0,23171190,9460006,0.00069051265817595,99.9972293179591,0
494.61,495,5,4,195,156,2025-08-01,2025-09-05,632.08,-1,-39,23171190,9460006,0.000673249841721552,99.9979025678008,-0.25
454.91,455,17,17,153,153,2025-08-01,2025-08-22,632.08,0,0,60984890,20108486,0.000250881816791012,99.9992817893088,0
394.99,395,152,152,152,152,2025-08-01,2025-08-08,632.08,0,0,58500270,29786673,0.000259827860623549,100,0
424.96,425,36,36,144,144,2025-08-01,2025-08-22,632.08,0,0,60984890,20108486,0.000236124062862129,99.9995179133717,0
429.99,430,137,137,137,137,2025-08-01,2025-08-01,632.08,0,0,61309866,39049978,0.000223455063496632,99.99994291294,0
434.87,435,10,10,130,130,2025-08-01,2025-09-05,632.08,0,0,23171190,9460006,0.00056104153476796,99.9984636093356,0
429.95,430,24,25,144,125,2025-08-01,2025-08-22,632.08,1,-19,60984890,20108486,0.00020496880456782,99.9997228821762,-0.152
439.93,440,13,14,78,98,2025-08-01,2025-08-22,632.08,1,20,60984890,20108486,0.000160695542781171,99.999883577719,0.204081632653061
464.76,465,3,3,72,72,2025-08-01,2025-09-05,632.08,0,0,23171190,9460006,0.000310730696179178,99.9987743400317,0
394.9,395,6,6,60,60,2025-08-01,2025-09-05,632.08,0,0,23171190,9460006,0.000258942246815981,99.9990332822786,0
479.71,480,0,2,0,58,2025-08-01,2025-09-05,632.08,2,58,23171190,9460006,0.000250310838588782,99.9992835931172,1
414.96,415,14,14,70,56,2025-08-01,2025-08-22,632.08,0,-14,60984890,20108486,9.18260244463834e-05,99.9999754037434,-0.25
449.82,450,3,3,54,54,2025-08-01,2025-09-05,632.08,0,0,23171190,9460006,0.000233048022134383,99.9995166411393,0
469.76,470,2,2,48,48,2025-08-01,2025-09-05,632.08,0,0,23171190,9460006,0.000207153797452785,99.9997237949367,0
459.8,460,1,2,19,40,2025-08-01,2025-09-05,632.08,1,21,23171190,9460006,0.000172628164543988,99.9998964231013,0.525
419.99,420,35,35,35,35,2025-08-01,2025-08-01,632.08,0,0,61309866,39049978,5.70870600173878e-05,100,0
389.92,390,3,3,24,24,2025-08-01,2025-09-05,632.08,0,0,23171190,9460006,0.000103576898726393,100,0
444.95,445,3,3,15,15,2025-08-01,2025-08-22,632.08,0,0,60984890,20108486,2.45962565481384e-05,100,0
665,665,0,0,0,0,2025-08-01,2025-08-01,632.08,0,0,61309866,39049978,0,100,
627.78,670,0,0,0,0,2025-08-01,2025-08-01,632.08,0,0,61309866,39049978,0,100,
635.98,675,0,0,0,0,2025-08-01,2025-08-01,632.08,0,0,61309866,39049978,0,100,
685,685,0,0,0,0,2025-08-01,2025-08-01,632.08,0,0,61309866,39049978,0,100,
616.7,700,0,0,0,0,2025-08-01,2025-08-01,632.08,0,0,61309866,39049978,0,100,
634.81,710,0,0,0,0,2025-08-01,2025-08-01,632.08,0,0,61309866,39049978,0,100,
715,715,0,0,0,0,2025-08-01,2025-08-01,632.08,0,0,61309866,39049978,0,100,
720,720,0,0,0,0,2025-08-01,2025-08-01,632.08,0,0,61309866,39049978,0,100,
635.35,725,0,0,0,0,2025-08-01,2025-08-01,632.08,0,0,61309866,39049978,0,100,
633.1,730,0,0,0,0,2025-08-01,2025-08-01,632.08,0,0,61309866,39049978,0,100,
638.71,651,0,0,0,0,2025-08-01,2025-08-08,632.08,0,0,58500270,29786673,0,100,
636.56,660,0,0,0,0,2025-08-01,2025-08-08,632.08,0,0,58500270,29786673,0,100,
665,665,0,0,0,0,2025-08-01,2025-08-08,632.08,0,0,58500270,29786673,0,100,
628.6,670,0,0,0,0,2025-08-01,2025-08-08,632.08,0,0,58500270,29786673,0,100,
633.4,675,2,0,7916,0,2025-08-01,2025-08-08,632.08,-2,-7916,58500270,29786673,0,100,-Inf
685,685,0,0,0,0,2025-08-01,2025-08-08,632.08,0,0,58500270,29786673,0,100,
690,690,0,0,0,0,2025-08-01,2025-08-08,632.08,0,0,58500270,29786673,0,100,
695,695,0,0,0,0,2025-08-01,2025-08-08,632.08,0,0,58500270,29786673,0,100,
617.18,700,0,0,0,0,2025-08-01,2025-08-08,632.08,0,0,58500270,29786673,0,100,
637.25,705,0,0,0,0,2025-08-01,2025-08-08,632.08,0,0,58500270,29786673,0,100,
636.82,710,0,0,0,0,2025-08-01,2025-08-08,632.08,0,0,58500270,29786673,0,100,
636.82,715,0,0,0,0,2025-08-01,2025-08-08,632.08,0,0,58500270,29786673,0,100,
720,720,0,0,0,0,2025-08-01,2025-08-08,632.08,0,0,58500270,29786673,0,100,
725,725,0,0,0,0,2025-08-01,2025-08-08,632.08,0,0,58500270,29786673,0,100,
730,730,0,0,0,0,2025-08-01,2025-08-08,632.08,0,0,58500270,29786673,0,100,
648,648,0,0,0,0,2025-08-01,2025-08-15,632.08,0,0,243349966,91051840,0,100,
631.79,690,0,0,0,0,2025-08-01,2025-08-15,632.08,0,0,243349966,91051840,0,100,
636.93,695,0,0,0,0,2025-08-01,2025-08-15,632.08,0,0,243349966,91051840,0,100,
635.89,700,0,0,0,0,2025-08-01,2025-08-15,632.08,0,0,243349966,91051840,0,100,
601.7,705,0,0,0,0,2025-08-01,2025-08-15,632.08,0,0,243349966,91051840,0,100,
710,710,0,0,0,0,2025-08-01,2025-08-15,632.08,0,0,243349966,91051840,0,100,
715,715,0,0,0,0,2025-08-01,2025-08-15,632.08,0,0,243349966,91051840,0,100,
720,720,0,0,0,0,2025-08-01,2025-08-15,632.08,0,0,243349966,91051840,0,100,
725,725,0,0,0,0,2025-08-01,2025-08-15,632.08,0,0,243349966,91051840,0,100,
730,730,0,0,0,0,2025-08-01,2025-08-15,632.08,0,0,243349966,91051840,0,100,
586.99,735,0,0,0,0,2025-08-01,2025-08-15,632.08,0,0,243349966,91051840,0,100,
740,740,0,0,0,0,2025-08-01,2025-08-15,632.08,0,0,243349966,91051840,0,100,
745,745,0,0,0,0,2025-08-01,2025-08-15,632.08,0,0,243349966,91051840,0,100,
750,750,0,0,0,0,2025-08-01,2025-08-15,632.08,0,0,243349966,91051840,0,100,
755,755,0,0,0,0,2025-08-01,2025-08-15,632.08,0,0,243349966,91051840,0,100,
760,760,0,0,0,0,2025-08-01,2025-08-15,632.08,0,0,243349966,91051840,0,100,
765,765,0,0,0,0,2025-08-01,2025-08-15,632.08,0,0,243349966,91051840,0,100,
770,770,0,0,0,0,2025-08-01,2025-08-15,632.08,0,0,243349966,91051840,0,100,
775,775,0,0,0,0,2025-08-01,2025-08-15,632.08,0,0,243349966,91051840,0,100,
780,780,0,0,0,0,2025-08-01,2025-08-15,632.08,0,0,243349966,91051840,0,100,
785,785,0,0,0,0,2025-08-01,2025-08-15,632.08,0,0,243349966,91051840,0,100,
602.96,790,0,0,0,0,2025-08-01,2025-08-15,632.08,0,0,243349966,91051840,0,100,
604.5,795,0,0,0,0,2025-08-01,2025-08-15,632.08,0,0,243349966,91051840,0,100,
553.08,800,0,0,0,0,2025-08-01,2025-08-15,632.08,0,0,243349966,91051840,0,100,
805,805,0,0,0,0,2025-08-01,2025-08-15,632.08,0,0,243349966,91051840,0,100,
810,810,0,0,0,0,2025-08-01,2025-08-15,632.08,0,0,243349966,91051840,0,100,
815,815,0,0,0,0,2025-08-01,2025-08-15,632.08,0,0,243349966,91051840,0,100,
820,820,0,0,0,0,2025-08-01,2025-08-15,632.08,0,0,243349966,91051840,0,100,
825,825,0,0,0,0,2025-08-01,2025-08-15,632.08,0,0,243349966,91051840,0,100,
830,830,0,0,0,0,2025-08-01,2025-08-15,632.08,0,0,243349966,91051840,0,100,
636.41,670,0,0,0,0,2025-08-01,2025-08-22,632.08,0,0,60984890,20108486,0,100,
637.68,680,0,0,0,0,2025-08-01,2025-08-22,632.08,0,0,60984890,20108486,0,100,
685,685,0,0,0,0,2025-08-01,2025-08-22,632.08,0,0,60984890,20108486,0,100,
690,690,0,0,0,0,2025-08-01,2025-08-22,632.08,0,0,60984890,20108486,0,100,
695,695,0,0,0,0,2025-08-01,2025-08-22,632.08,0,0,60984890,20108486,0,100,
636.89,700,0,0,0,0,2025-08-01,2025-08-22,632.08,0,0,60984890,20108486,0,100,
705,705,0,0,0,0,2025-08-01,2025-08-22,632.08,0,0,60984890,20108486,0,100,
630.66,710,0,0,0,0,2025-08-01,2025-08-22,632.08,0,0,60984890,20108486,0,100,
715,715,0,0,0,0,2025-08-01,2025-08-22,632.08,0,0,60984890,20108486,0,100,
720,720,0,0,0,0,2025-08-01,2025-08-22,632.08,0,0,60984890,20108486,0,100,
725,725,0,0,0,0,2025-08-01,2025-08-22,632.08,0,0,60984890,20108486,0,100,
730,730,0,0,0,0,2025-08-01,2025-08-22,632.08,0,0,60984890,20108486,0,100,
648,648,0,0,0,0,2025-08-01,2025-08-29,632.08,0,0,155069044,41373917,0,100,
649,649,0,0,0,0,2025-08-01,2025-08-29,632.08,0,0,155069044,41373917,0,100,
637.38,651,0,0,0,0,2025-08-01,2025-08-29,632.08,0,0,155069044,41373917,0,100,
637.1,665,0,0,0,0,2025-08-01,2025-08-29,632.08,0,0,155069044,41373917,0,100,
636.07,675,0,0,0,0,2025-08-01,2025-08-29,632.08,0,0,155069044,41373917,0,100,
680,680,0,0,0,0,2025-08-01,2025-08-29,632.08,0,0,155069044,41373917,0,100,
638.85,685,0,0,0,0,2025-08-01,2025-08-29,632.08,0,0,155069044,41373917,0,100,
630.4,690,0,0,0,0,2025-08-01,2025-08-29,632.08,0,0,155069044,41373917,0,100,
580.97,695,0,0,0,0,2025-08-01,2025-08-29,632.08,0,0,155069044,41373917,0,100,
640,700,1,0,6601,0,2025-08-01,2025-08-29,632.08,-1,-6601,155069044,41373917,0,100,-Inf
633.97,705,0,0,0,0,2025-08-01,2025-08-29,632.08,0,0,155069044,41373917,0,100,
710,710,0,0,0,0,2025-08-01,2025-08-29,632.08,0,0,155069044,41373917,0,100,
715,715,0,0,0,0,2025-08-01,2025-08-29,632.08,0,0,155069044,41373917,0,100,
635.17,720,0,0,0,0,2025-08-01,2025-08-29,632.08,0,0,155069044,41373917,0,100,
631.88,725,0,0,0,0,2025-08-01,2025-08-29,632.08,0,0,155069044,41373917,0,100,
380,380,0,0,0,0,2025-08-01,2025-09-05,632.08,0,0,23171190,9460006,0,100,
649,649,0,0,0,0,2025-08-01,2025-09-05,632.08,0,0,23171190,9460006,0,100,
651,651,0,0,0,0,2025-08-01,2025-09-05,632.08,0,0,23171190,9460006,0,100,
635.11,660,9,0,21843,0,2025-08-01,2025-09-05,632.08,-9,-21843,23171190,9460006,0,100,-Inf
675,675,0,0,0,0,2025-08-01,2025-09-05,632.08,0,0,23171190,9460006,0,100,
638.5,680,1,0,4750,0,2025-08-01,2025-09-05,632.08,-1,-4750,23171190,9460006,0,100,-Inf
690,690,0,0,0,0,2025-08-01,2025-09-05,632.08,0,0,23171190,9460006,0,100,
695,695,0,0,0,0,2025-08-01,2025-09-05,632.08,0,0,23171190,9460006,0,100,
636.4,700,0,0,0,0,2025-08-01,2025-09-05,632.08,0,0,23171190,9460006,0,100,
705,705,0,0,0,0,2025-08-01,2025-09-05,632.08,0,0,23171190,9460006,0,100,
710,710,0,0,0,0,2025-08-01,2025-09-05,632.08,0,0,23171190,9460006,0,100,
715,715,0,0,0,0,2025-08-01,2025-09-05,632.08,0,0,23171190,9460006,0,100,
720,720,0,0,0,0,2025-08-01,2025-09-05,632.08,0,0,23171190,9460006,0,100,
632.48,725,0,0,0,0,2025-08-01,2025-09-05,632.08,0,0,23171190,9460006,0,100,
730,730,0,0,0,0,2025-08-01,2025-09-05,632.08,0,0,23171190,9460006,0,100,
644,644,0,0,0,0,2025-08-01,2025-09-12,632.08,0,0,1003977,1003977,0,100,
648,648,0,0,0,0,2025-08-01,2025-09-12,632.08,0,0,1003977,1003977,0,100,
649,649,0,0,0,0,2025-08-01,2025-09-12,632.08,0,0,1003977,1003977,0,100,
651,651,0,0,0,0,2025-08-01,2025-09-12,632.08,0,0,1003977,1003977,0,100,
633.3,685,5,0,23620,0,2025-08-01,2025-09-19,632.08,-5,-23620,595655559,168675191,0,100,-Inf
627.64,695,0,0,0,0,2025-08-01,2025-09-19,632.08,0,0,595655559,168675191,0,100,
634.79,705,0,0,0,0,2025-08-01,2025-09-19,632.08,0,0,595655559,168675191,0,100,
710,710,0,0,0,0,2025-08-01,2025-09-19,632.08,0,0,595655559,168675191,0,100,
715,715,0,0,0,0,2025-08-01,2025-09-19,632.08,0,0,595655559,168675191,0,100,
593.69,720,0,0,0,0,2025-08-01,2025-09-19,632.08,0,0,595655559,168675191,0,100,
553.12,725,0,0,0,0,2025-08-01,2025-09-19,632.08,0,0,595655559,168675191,0,100,
593.85,730,0,0,0,0,2025-08-01,2025-09-19,632.08,0,0,595655559,168675191,0,100,
611,735,0,0,0,0,2025-08-01,2025-09-19,632.08,0,0,595655559,168675191,0,100,
740,740,0,0,0,0,2025-08-01,2025-09-19,632.08,0,0,595655559,168675191,0,100,
745,745,0,0,0,0,2025-08-01,2025-09-19,632.08,0,0,595655559,168675191,0,100,
594.66,750,0,0,0,0,2025-08-01,2025-09-19,632.08,0,0,595655559,168675191,0,100,
594.64,755,0,0,0,0,2025-08-01,2025-09-19,632.08,0,0,595655559,168675191,0,100,
633.19,760,0,0,0,0,2025-08-01,2025-09-19,632.08,0,0,595655559,168675191,0,100,
765,765,0,0,0,0,2025-08-01,2025-09-19,632.08,0,0,595655559,168675191,0,100,
770,770,0,0,0,0,2025-08-01,2025-09-19,632.08,0,0,595655559,168675191,0,100,
775,775,0,0,0,0,2025-08-01,2025-09-19,632.08,0,0,595655559,168675191,0,100,
633.18,780,0,0,0,0,2025-08-01,2025-09-19,632.08,0,0,595655559,168675191,0,100,
785,785,0,0,0,0,2025-08-01,2025-09-19,632.08,0,0,595655559,168675191,0,100,
790,790,0,0,0,0,2025-08-01,2025-09-19,632.08,0,0,595655559,168675191,0,100,
795,795,0,0,0,0,2025-08-01,2025-09-19,632.08,0,0,595655559,168675191,0,100,
594.64,800,0,0,0,0,2025-08-01,2025-09-19,632.08,0,0,595655559,168675191,0,100,
594.62,805,0,0,0,0,2025-08-01,2025-09-19,632.08,0,0,595655559,168675191,0,100,
810,810,0,0,0,0,2025-08-01,2025-09-19,632.08,0,0,595655559,168675191,0,100,
815,815,0,0,0,0,2025-08-01,2025-09-19,632.08,0,0,595655559,168675191,0,100,
820,820,0,0,0,0,2025-08-01,2025-09-19,632.08,0,0,595655559,168675191,0,100,
633.88,825,0,0,0,0,2025-08-01,2025-09-19,632.08,0,0,595655559,168675191,0,100,
680,680,0,0,0,0,2025-08-01,2025-10-17,632.08,0,0,227356040,48158939,0,100,
685,685,0,0,0,0,2025-08-01,2025-10-17,632.08,0,0,227356040,48158939,0,100,
635.68,690,0,0,0,0,2025-08-01,2025-10-17,632.08,0,0,227356040,48158939,0,100,
619.61,695,0,0,0,0,2025-08-01,2025-10-17,632.08,0,0,227356040,48158939,0,100,
632.45,705,0,0,0,0,2025-08-01,2025-10-17,632.08,0,0,227356040,48158939,0,100,
710,710,0,0,0,0,2025-08-01,2025-10-17,632.08,0,0,227356040,48158939,0,100,
715,715,0,0,0,0,2025-08-01,2025-10-17,632.08,0,0,227356040,48158939,0,100,
635.49,720,0,0,0,0,2025-08-01,2025-10-17,632.08,0,0,227356040,48158939,0,100,
725,725,0,0,0,0,2025-08-01,2025-10-17,632.08,0,0,227356040,48158939,0,100,
619.74,685,0,0,0,0,2025-08-01,2025-11-21,632.08,0,0,69823438,8093490,0,100,
635.8,690,0,0,0,0,2025-08-01,2025-11-21,632.08,0,0,69823438,8093490,0,100,
705,705,0,0,0,0,2025-08-01,2025-11-21,632.08,0,0,69823438,8093490,0,100,
710,710,0,0,0,0,2025-08-01,2025-11-21,632.08,0,0,69823438,8093490,0,100,
715,715,0,0,0,0,2025-08-01,2025-11-21,632.08,0,0,69823438,8093490,0,100,
720,720,0,0,0,0,2025-08-01,2025-11-21,632.08,0,0,69823438,8093490,0,100,
725,725,0,0,0,0,2025-08-01,2025-11-21,632.08,0,0,69823438,8093490,0,100,
730,730,0,0,0,0,2025-08-01,2025-11-21,632.08,0,0,69823438,8093490,0,100,
735,735,0,0,0,0,2025-08-01,2025-11-21,632.08,0,0,69823438,8093490,0,100,
740,740,0,0,0,0,2025-08-01,2025-11-21,632.08,0,0,69823438,8093490,0,100,
745,745,0,0,0,0,2025-08-01,2025-11-21,632.08,0,0,69823438,8093490,0,100,
750,750,0,0,0,0,2025-08-01,2025-11-21,632.08,0,0,69823438,8093490,0,100,
755,755,0,0,0,0,2025-08-01,2025-11-21,632.08,0,0,69823438,8093490,0,100,
760,760,0,0,0,0,2025-08-01,2025-11-21,632.08,0,0,69823438,8093490,0,100,
765,765,0,0,0,0,2025-08-01,2025-11-21,632.08,0,0,69823438,8093490,0,100,
770,770,0,0,0,0,2025-08-01,2025-11-21,632.08,0,0,69823438,8093490,0,100,
775,775,0,0,0,0,2025-08-01,2025-11-21,632.08,0,0,69823438,8093490,0,100,
780,780,0,0,0,0,2025-08-01,2025-11-21,632.08,0,0,69823438,8093490,0,100,
785,785,0,0,0,0,2025-08-01,2025-11-21,632.08,0,0,69823438,8093490,0,100,
790,790,0,0,0,0,2025-08-01,2025-11-21,632.08,0,0,69823438,8093490,0,100,
795,795,0,0,0,0,2025-08-01,2025-11-21,632.08,0,0,69823438,8093490,0,100,
800,800,0,0,0,0,2025-08-01,2025-11-21,632.08,0,0,69823438,8093490,0,100,
636.75,685,0,0,0,0,2025-08-01,2025-12-19,632.08,0,0,380408956,31818097,0,100,
636.46,690,0,0,0,0,2025-08-01,2025-12-19,632.08,0,0,380408956,31818097,0,100,
623.59,695,0,0,0,0,2025-08-01,2025-12-19,632.08,0,0,380408956,31818097,0,100,
537.36,705,0,0,0,0,2025-08-01,2025-12-19,632.08,0,0,380408956,31818097,0,100,
601.65,710,0,0,0,0,2025-08-01,2025-12-19,632.08,0,0,380408956,31818097,0,100,
599.77,715,0,0,0,0,2025-08-01,2025-12-19,632.08,0,0,380408956,31818097,0,100,
720,720,0,0,0,0,2025-08-01,2025-12-19,632.08,0,0,380408956,31818097,0,100,
626.5,725,0,0,0,0,2025-08-01,2025-12-19,632.08,0,0,380408956,31818097,0,100,
730,730,0,0,0,0,2025-08-01,2025-12-19,632.08,0,0,380408956,31818097,0,100,
735,735,0,0,0,0,2025-08-01,2025-12-19,632.08,0,0,380408956,31818097,0,100,
557.52,740,0,0,0,0,2025-08-01,2025-12-19,632.08,0,0,380408956,31818097,0,100,
625.55,745,0,0,0,0,2025-08-01,2025-12-19,632.08,0,0,380408956,31818097,0,100,
629.39,755,0,0,0,0,2025-08-01,2025-12-19,632.08,0,0,380408956,31818097,0,100,
760,760,0,0,0,0,2025-08-01,2025-12-19,632.08,0,0,380408956,31818097,0,100,
556.84,765,0,0,0,0,2025-08-01,2025-12-19,632.08,0,0,380408956,31818097,0,100,
770,770,0,0,0,0,2025-08-01,2025-12-19,632.08,0,0,380408956,31818097,0,100,
775,775,0,0,0,0,2025-08-01,2025-12-19,632.08,0,0,380408956,31818097,0,100,
602,780,0,0,0,0,2025-08-01,2025-12-19,632.08,0,0,380408956,31818097,0,100,
785,785,0,0,0,0,2025-08-01,2025-12-19,632.08,0,0,380408956,31818097,0,100,
790,790,0,0,0,0,2025-08-01,2025-12-19,632.08,0,0,380408956,31818097,0,100,
795,795,0,0,0,0,2025-08-01,2025-12-19,632.08,0,0,380408956,31818097,0,100,
593.9,800,0,0,0,0,2025-08-01,2025-12-19,632.08,0,0,380408956,31818097,0,100,
805,805,0,0,0,0,2025-08-01,2025-12-19,632.08,0,0,380408956,31818097,0,100,
810,810,0,0,0,0,2025-08-01,2025-12-19,632.08,0,0,380408956,31818097,0,100,
815,815,0,0,0,0,2025-08-01,2025-12-19,632.08,0,0,380408956,31818097,0,100,
820,820,0,0,0,0,2025-08-01,2025-12-19,632.08,0,0,380408956,31818097,0,100,
516.96,825,0,0,0,0,2025-08-01,2025-12-19,632.08,0,0,380408956,31818097,0,100,
830,830,0,0,0,0,2025-08-01,2025-12-19,632.08,0,0,380408956,31818097,0,100,
835,835,0,0,0,0,2025-08-01,2025-12-19,632.08,0,0,380408956,31818097,0,100,
593.89,840,0,0,0,0,2025-08-01,2025-12-19,632.08,0,0,380408956,31818097,0,100,
