Watch,strike,open_interest.yt,open_interest.td,OI_Dollar.yt,OI_Dollar.td,Date.td,expiry,stkClose,diff_oi,diff_oi_d,totalOI,totalOIdiff,OI_pct,cum_sep_OI,pct
435.59,440,135981,142409,36714870,62802369,2023-09-18,2023-10-20,443.37,6428,26087499,473926306,145207170,13.2515051823268,13.2515051823268,0.415390365290201
437.49,450,30907,29265,29392557,36610515,2023-09-18,2023-12-15,443.37,-1642,7217958,508084803,96118471,7.20559142565026,7.20559142565026,0.197155325457727
442.66,450,46524,45225,16748640,33195150,2023-09-18,2023-09-29,443.37,-1299,16446510,154689262,55771573,21.4592464731004,21.4592464731004,0.495449184594737
427.69,430,141366,136816,20498070,31604496,2023-09-18,2023-10-20,443.37,-4550,11106426,473926306,145207170,6.66865198236116,19.920157164688,0.35141917782837
442.1,460,16635,16790,23754780,30054100,2023-09-18,2023-12-15,443.37,155,6299320,508084803,96118471,5.91517396752369,13.1207653931739,0.209599355828323
438.97,445,48426,48255,18401880,29097765,2023-09-18,2023-10-20,443.37,-171,10695885,473926306,145207170,6.13972354596413,26.0598807106521,0.367584417566092
424.04,430,47242,48707,22156498,29029372,2023-09-18,2023-12-15,443.37,1465,6872874,508084803,96118471,5.71348952548774,18.8342549186617,0.236755862303876
441.46,450,33723,31170,18446481,26619180,2023-09-18,2023-10-20,443.37,-2553,8172699,473926306,145207170,5.6167340075864,31.6766147182385,0.307022943606828
431.88,435,82649,81142,16199204,25316304,2023-09-18,2023-10-20,443.37,-1507,9117100,473926306,145207170,5.34182291202042,37.0184376302589,0.360127607884626
440.48,448,33110,33406,15661030,25121312,2023-09-18,2023-10-20,443.37,296,9460282,473926306,145207170,5.30067896252208,42.319116592781,0.376583914088563
439.45,450,23346,23318,17766306,24600490,2023-09-18,2023-11-17,443.37,-28,6834184,443991078,126746889,5.54076224027187,5.54076224027187,0.277806824173015
440.15,452,20025,19981,17021250,23677485,2023-09-18,2023-11-17,443.37,-44,6656235,443991078,126746889,5.33287405383403,10.8736362941059,0.281120862287528
431.44,440,26350,27492,17364650,23533152,2023-09-18,2023-12-15,443.37,1142,6168502,508084803,96118471,4.63173703701585,23.4659919556775,0.262119668457502
397.58,400,76144,96272,14619648,23297824,2023-09-18,2023-12-15,443.37,20128,8678176,508084803,96118471,4.58542035944342,28.0514123151209,0.372488692506219
436.69,445,27890,28020,16622440,23284620,2023-09-18,2023-11-17,443.37,130,6662180,443991078,126746889,5.244389167658,16.1180254617639,0.286119335423984
443.28,460,13082,12892,15044300,21555424,2023-09-18,2023-10-20,443.37,-190,6511124,473926306,145207170,4.54826493636333,46.8673815291443,0.302064297134679
419.85,425,35790,40924,14208630,21075860,2023-09-18,2023-12-15,443.37,5134,6867230,508084803,96118471,4.14809887553358,32.1995111906545,0.325833916148617
421.6,425,24499,61515,6002255,20915100,2023-09-18,2023-11-17,443.37,37016,14912845,443991078,126746889,4.71070276777048,20.8287282295344,0.71301810653547
427.82,435,28990,28966,16089450,20797588,2023-09-18,2023-12-15,443.37,-24,4708138,508084803,96118471,4.09333006561111,36.2928412562656,0.22637903972326
443.2,465,12792,9529,21106800,20773220,2023-09-18,2023-11-17,443.37,-3263,-333580,443991078,126746889,4.67874717068076,25.5074754002151,-0.016058174900184
440.97,445,51480,48224,9832680,19434272,2023-09-18,2023-09-29,443.37,-3256,9601592,154689262,55771573,12.5634266714648,34.0226731445651,0.494054626795385
442.82,460,10989,11041,14252733,18968438,2023-09-18,2023-11-17,443.37,52,4715705,443991078,126746889,4.2722565699845,29.7797319701996,0.248607977103861
419.03,424,34048,37053,13074432,18415341,2023-09-18,2023-12-15,443.37,3005,5340909,508084803,96118471,3.62446207626486,39.9173033325305,0.290024985146895
418.06,421,7255,55481,1523550,16311414,2023-09-18,2023-11-17,443.37,48226,14787864,443991078,126746889,3.67381571572931,33.453547685929,0.906596080511475
418.7,420,124821,124083,10734606,16130790,2023-09-18,2023-10-20,443.37,-738,5396184,473926306,145207170,3.40364942730147,50.2710309564458,0.334526951252852
441.5,454,12467,12684,11594310,15855000,2023-09-18,2023-11-17,443.37,217,4260690,443991078,126746889,3.571017704099,37.024565390028,0.268728476821192
441.6,455,11759,11787,11535579,15794580,2023-09-18,2023-11-17,443.37,28,4259001,443991078,126746889,3.55740932253598,40.5819747125639,0.269649525343504
427.08,434,22156,22550,12274424,15604600,2023-09-18,2023-12-15,443.37,394,3330176,508084803,96118471,3.0712589528091,42.9885622853396,0.213409891954936
415.64,420,35952,35775,12187728,15597900,2023-09-18,2023-12-15,443.37,-177,3410172,508084803,96118471,3.06994027530479,46.0585025606444,0.21863020021926
406.78,410,48548,48327,12185548,15561294,2023-09-18,2023-12-15,443.37,-221,3375746,508084803,96118471,3.06273557251032,49.1212381331547,0.216932216562453
425.82,430,35473,37104,10748319,15509472,2023-09-18,2023-11-17,443.37,1631,4761153,443991078,126746889,3.49319451865202,44.075169231216,0.30698356462425
433.46,440,24140,23505,11394080,15372270,2023-09-18,2023-11-17,443.37,-635,3978190,443991078,126746889,3.46229254633806,47.537461777554,0.258790016048378
443.02,455,12395,12027,9916000,14408346,2023-09-18,2023-10-20,443.37,-368,4492346,473926306,145207170,3.04020811201816,53.311239068464,0.311787765229958
437.75,440,70893,63755,7514658,14344875,2023-09-18,2023-09-29,443.37,-7138,6830217,154689262,55771573,9.27334891545348,43.2960220600186,0.476143361304996
436.16,444,15253,15769,8678957,12362896,2023-09-18,2023-11-17,443.37,516,3683939,443991078,126746889,2.78449198927371,50.3219537668277,0.297983498364784
398.65,400,86861,86884,9207266,11729340,2023-09-18,2023-11-17,443.37,23,2522074,443991078,126746889,2.64179632906948,52.9637500958972,0.215022669647227
436.53,448,10344,10122,9340632,11609934,2023-09-18,2023-12-15,443.37,-222,2269302,508084803,96118471,2.28503862572721,51.4062767588819,0.195462093066162
423.2,427,48935,30267,13065645,11501460,2023-09-18,2023-11-17,443.37,-18668,-1564185,443991078,126746889,2.59047097338294,55.5542210692801,-0.135998821019245
429.8,435,21267,21732,8017659,11300640,2023-09-18,2023-11-17,443.37,465,3282981,443991078,126746889,2.54524033476186,58.099461404042,0.290512838210933
434.89,445,10924,10650,8629960,10767150,2023-09-18,2023-12-15,443.37,-274,2137190,508084803,96118471,2.11916395381737,53.5254407126993,0.19849170857655
442.48,458,6831,6830,7944453,10600160,2023-09-18,2023-11-17,443.37,-1,2655707,443991078,126746889,2.38747139869329,60.4869328027353,0.250534614571856
443.58,458,7320,7318,7532280,10552556,2023-09-18,2023-10-20,443.37,-2,3020276,473926306,145207170,2.22662381606646,55.5378628845304,0.286212743149622
419,422,32913,33289,7372512,9986700,2023-09-18,2023-11-17,443.37,376,2614188,443991078,126746889,2.24930195556767,62.736234758303,0.261766950043558
422.53,426,28557,28582,7396263,9917954,2023-09-18,2023-11-17,443.37,25,2521691,443991078,126746889,2.23381831109678,64.9700530693997,0.254255161901336
442.04,456,7070,7059,7458850,9854364,2023-09-18,2023-11-17,443.37,-11,2395514,443991078,126746889,2.2194959512227,67.1895490206224,0.243091690138501
437.35,446,9124,11171,5738996,9662915,2023-09-18,2023-11-17,443.37,2047,3923919,443991078,126746889,2.17637594059942,69.3659249612219,0.406080256320168
424.94,429,23538,23608,7132014,9584848,2023-09-18,2023-11-17,443.37,70,2452834,443991078,126746889,2.15879292961828,71.5247178908401,0.255907448923551
413.99,415,91568,92005,6318192,9292505,2023-09-18,2023-10-20,443.37,437,2974313,473926306,145207170,1.96074893551066,57.4986118200411,0.320076556321466
443.14,464,4446,4448,6860178,9278528,2023-09-18,2023-11-17,443.37,2,2418350,443991078,126746889,2.08980055225344,73.6145184430936,0.260639403146706
388.13,390,45283,45359,6973582,8482133,2023-09-18,2023-12-15,443.37,76,1508551,508084803,96118471,1.6694325336867,55.194873246386,0.177850429838815
432.7,442,8492,8796,6003844,8180280,2023-09-18,2023-12-15,443.37,304,2176436,508084803,96118471,1.61002256940167,56.8048958157877,0.266058863510784
434.67,442,11289,11128,5892858,8156824,2023-09-18,2023-11-17,443.37,-161,2263966,443991078,126746889,1.83715943949667,75.4516778825903,0.277554842423963
423.25,425,45765,46551,5034150,8146425,2023-09-18,2023-10-20,443.37,786,3112275,473926306,145207170,1.71892230856668,59.2175341286078,0.382041815888565
402.22,405,29381,29295,6463820,8144010,2023-09-18,2023-12-15,443.37,-86,1680190,508084803,96118471,1.60288399729995,58.4077798130876,0.206309913666609
424.18,426,44229,44659,5263251,8127938,2023-09-18,2023-10-20,443.37,430,2864687,473926306,145207170,1.71502149112609,60.9325556197339,0.352449415829698
425.95,428,39294,38644,5147514,7922020,2023-09-18,2023-10-20,443.37,-650,2774506,473926306,145207170,1.67157211990676,62.6041277396406,0.350227088545598
422.33,428,19382,13939,8508698,7903413,2023-09-18,2023-12-15,443.37,-5443,-605285,508084803,96118471,1.55553028812003,59.9633101012077,-0.0765852676558849
439.83,454,5576,5574,6412400,7898358,2023-09-18,2023-12-15,443.37,-2,1485958,508084803,96118471,1.55453537546566,61.5178454766733,0.188135052880611
442.71,454,7013,6984,5392997,7884936,2023-09-18,2023-10-20,443.37,-29,2491939,473926306,145207170,1.66374727466595,64.2678750143066,0.316037948817847
420.64,424,22597,23348,5536265,7844928,2023-09-18,2023-11-17,443.37,751,2308663,443991078,126746889,1.76691118103954,77.2185890636298,0.294287340814345
409.2,410,94903,95475,5314568,7638000,2023-09-18,2023-10-20,443.37,572,2323432,473926306,145207170,1.61164297134416,65.8795179856507,0.304193768002095
433.75,435,61029,58895,3844827,7361875,2023-09-18,2023-09-29,443.37,-2134,3517048,154689262,55771573,4.75913770924836,48.055159769267,0.477738076237372
432.59,439,12355,11418,5535040,7318938,2023-09-18,2023-11-17,443.37,-937,1783898,443991078,126746889,1.6484425842449,78.8670316478747,0.243737274451567
442.84,456,5526,5527,4752360,7273532,2023-09-18,2023-10-20,443.37,1,2521172,473926306,145207170,1.53473903176837,67.4142570174191,0.346622796187602
378.54,380,49052,49042,5935292,7160132,2023-09-18,2023-12-15,443.37,-10,1224840,508084803,96118471,1.40923955168956,62.9270850283629,0.171063885414403
438.41,448,5670,7449,3906630,7143591,2023-09-18,2023-11-17,443.37,1779,3236961,443991078,126746889,1.60894922307425,80.475980870949,0.453127985630756
439.44,446,9463,10638,3870367,6978528,2023-09-18,2023-10-20,443.37,1175,3108161,473926306,145207170,1.47249222329516,68.8867492407142,0.445389199556124
441.76,451,7714,7109,4535832,6568716,2023-09-18,2023-10-20,443.37,-605,2032884,473926306,145207170,1.38602055147367,70.2727697921879,0.309479660865228
373.7,375,48887,49563,5279796,6443190,2023-09-18,2023-12-15,443.37,676,1163394,508084803,96118471,1.26813279239135,64.1952178207542,0.180561802461203
432.53,436,17532,18390,3646656,6381330,2023-09-18,2023-10-20,443.37,858,2734674,473926306,145207170,1.34648149284205,71.61925128503,0.428542952644668
415.86,417,55103,55133,4298034,6285162,2023-09-18,2023-10-20,443.37,30,1987128,473926306,145207170,1.32618973043459,72.9454410154646,0.316161779123593
439.15,442,22064,21908,2934512,6243780,2023-09-18,2023-09-29,443.37,-156,3309268,154689262,55771573,4.03633705357001,52.091496822837,0.530010346296634
438.36,444,11205,10886,3966570,6139704,2023-09-18,2023-10-20,443.37,-319,2173134,473926306,145207170,1.29549761688055,74.2409386323451,0.353947682168391
427.38,432,13351,13216,4419181,6105792,2023-09-18,2023-11-17,443.37,-135,1686611,443991078,126746889,1.37520601258569,81.8511868835346,0.276231322652327
441.9,452,6085,5955,3882230,6014550,2023-09-18,2023-10-20,443.37,-130,2132320,473926306,145207170,1.26908971370751,75.5100283460526,0.35452693883998
422.38,424,34794,37125,3618576,6014250,2023-09-18,2023-10-20,443.37,2331,2395674,473926306,145207170,1.26902641272671,76.7790547587793,0.398332959221848
426.81,429,27179,27320,3723523,5983080,2023-09-18,2023-10-20,443.37,141,2259557,473926306,145207170,1.26244944082087,78.0415041996002,0.377657828409448
448.62,468,3103,3074,6013614,5957412,2023-09-18,2023-12-15,443.37,-29,-56202,508084803,96118471,1.17252316243751,65.3677409831917,-0.00943396226415094
417.21,420,19885,21285,4056540,5938515,2023-09-18,2023-11-17,443.37,1400,1881975,443991078,126746889,1.33753025550662,83.1887171390413,0.316910035589705
446.25,475,2157,2045,6201375,5879375,2023-09-18,2023-12-15,443.37,-112,-322000,508084803,96118471,1.15716411222793,66.5249050954197,-0.0547677261613692
411.28,415,16229,15563,4722639,5789436,2023-09-18,2023-12-15,443.37,-666,1066797,508084803,96118471,1.13946253968159,67.6643676351013,0.184266135768666
437.08,442,10642,11401,3437366,5609292,2023-09-18,2023-10-20,443.37,759,2171926,473926306,145207170,1.18357895077468,79.2250831503749,0.387201450735672
438.85,452,3850,3843,4004000,5053545,2023-09-18,2023-12-15,443.37,-7,1049545,508084803,96118471,0.994626284856625,68.6589939199579,0.207684902380408
433.45,443,5088,5157,3780384,4924935,2023-09-18,2023-12-15,443.37,69,1144551,508084803,96118471,0.969313581299931,69.6283075012578,0.232399209329667
439.78,453,3751,3711,4028574,4905942,2023-09-18,2023-12-15,443.37,-40,877368.000000001,508084803,96118471,0.965575425801508,70.5938829270593,0.178837825640825
429.27,430,66615,66632,2931060,4864136,2023-09-18,2023-09-29,443.37,17,1933076,154689262,55771573,3.14445614201715,55.2359529648542,0.397414052567609
448.15,467,2550,2550,4806750,4806750,2023-09-18,2023-12-15,443.37,0,0,508084803,96118471,0.946052700576443,71.5399356276358,0
443.18,450,7872,6908,2204160,4711256,2023-09-18,2023-09-22,443.37,-964,2507096,47965757,25232076,9.82212372880929,9.82212372880929,0.532150237643635
417.72,419,36369,36500,3018627,4672000,2023-09-18,2023-10-20,443.37,131,1653373,473926306,145207170,0.985807274433085,80.2108904248079,0.353889768835617
443,462,2250,2455,3213000,4664500,2023-09-18,2023-11-17,443.37,205,1451500,443991078,126746889,1.05058417412613,84.2393013131674,0.311180190802873
435.89,447,4214,4125,3581900,4582875,2023-09-18,2023-12-15,443.37,-89,1000975,508084803,96118471,0.901990174266244,72.441925801902,0.218416387093255
428.9,434,10059,8970,3832479,4574700,2023-09-18,2023-11-17,443.37,-1089,742221,443991078,126746889,1.03035854247504,85.2696598556424,0.162244737359827
441.38,444,15561,17445,1431612,4570590,2023-09-18,2023-09-22,443.37,1884,3138978,47965757,25232076,9.52886034926958,19.3509840780789,0.686777418232657
408.11,410,23638,24105,3380234,4555845,2023-09-18,2023-11-17,443.37,467,1175611,443991078,126746889,1.02611183551756,86.29577169116,0.258044555949555
368.85,370,39232,39241,3923200,4512715,2023-09-18,2023-12-15,443.37,9,589514.999999999,508084803,96118471,0.888181455803156,73.3301072577052,0.130634219089838
443.45,465,2082,2087,3710124,4497485,2023-09-18,2023-12-15,443.37,5,787361,508084803,96118471,0.885183924700066,74.2152911824053,0.175066954086562
443.09,453,4379,4356,2285838,4316796,2023-09-18,2023-09-29,443.37,-23,2030958,154689262,55771573,2.79062421281705,58.0265771776712,0.470478104594241
442.82,451,5510,5246,2248080,4291228,2023-09-18,2023-09-29,443.37,-264,2043148,154689262,55771573,2.77409559300891,60.8006727706801,0.476121986526934
421.44,423,27826,27507,2838252,4291092,2023-09-18,2023-10-20,443.37,-319,1452840,473926306,145207170,0.905434441109078,81.116324865917,0.338571160907294
440.05,447,6158,6147,2721836,4272165,2023-09-18,2023-10-20,443.37,-11,1550329,473926306,145207170,0.90144078222997,82.017765648147,0.362890712320334
438.18,442,2164,11126,426308,4250132,2023-09-18,2023-10-06,443.37,8962,3823824,42650604,18727217,9.96499838548594,9.96499838548594,0.899695350638521
431.17,437,7694,7246,3169928,4224418,2023-09-18,2023-11-17,443.37,-448,1054490,443991078,126746889,0.951464614791201,87.2472363059512,0.249617817176236
434.15,438,10464,10932,2532288,4208820,2023-09-18,2023-10-20,443.37,468,1676532,473926306,145207170,0.888074780132589,82.9058404282796,0.39833777638388
441.4,446,7683,8946,1674894,4115160,2023-09-18,2023-09-29,443.37,1263,2440266,154689262,55771573,2.66027515213047,63.4609479228106,0.592994197066457
438.29,451,3504,3211,3451440,4081181,2023-09-18,2023-12-15,443.37,-293,629741.000000001,508084803,96118471,0.803247996378274,75.0185391787835,0.154303619467012
428.18,433,8543,8450,2955878,4072900,2023-09-18,2023-11-17,443.37,-93,1117022,443991078,126746889,0.917338253360127,88.1645745593113,0.274257163200668
440.41,444,8975,11237,1516775,4034083,2023-09-18,2023-09-29,443.37,2262,2517308,154689262,55771573,2.6078623350081,66.0688102578187,0.624009967073062
412.72,415,13687,17562,2326790,4004136,2023-09-18,2023-11-17,443.37,3875,1677346,443991078,126746889,0.901850554753715,89.066425114065,0.418903353932034
442.05,448,7076,6659,1974204,3962105,2023-09-18,2023-09-29,443.37,-417,1987901,154689262,55771573,2.56133163270247,68.6301418905212,0.50172850038048
441.9,445,14952,12738,1674624,3948780,2023-09-18,2023-09-22,443.37,-2214,2274156,47965757,25232076,8.23249802979238,27.5834821078713,0.575913573306186
431.9,438,6896,6473,2965280,3948530,2023-09-18,2023-11-17,443.37,-423,983250,443991078,126746889,0.889326429212616,89.9557515432776,0.249016722679073
399.47,400,71074,73612,2842960,3901436,2023-09-18,2023-10-20,443.37,2538,1058476,473926306,145207170,0.823215751184742,83.7290561794643,0.271304206963795
439.94,455,2636,2587,3084120,3896022,2023-09-18,2023-12-15,443.37,-49,811902.000000001,508084803,96118471,0.766805457867631,75.7853446366511,0.20839256041162
425.02,427,19548,19602,2384856,3881196,2023-09-18,2023-10-20,443.37,54,1496340,473926306,145207170,0.818945045012969,84.5480012244773,0.385535798758939
439.8,443,12371,12035,1868021,3851200,2023-09-18,2023-09-29,443.37,-336,1983179,154689262,55771573,2.48963628774698,71.1197781782681,0.514950924387204
437.61,443,5483,7079,1847771,3815581,2023-09-18,2023-10-20,443.37,1596,1967810,473926306,145207170,0.805100065494149,85.3531012899714,0.515730107682159
434.84,439,9116,9021,2306348,3752736,2023-09-18,2023-10-20,443.37,-95,1446388,473926306,145207170,0.791839565031446,86.1449408550029,0.385422262583885
442.33,453,3494,3515,2477246,3750505,2023-09-18,2023-10-20,443.37,21,1273259,473926306,145207170,0.791368816737512,86.9363096717404,0.3394900153446
392.87,395,17349,17601,2984028,3749013,2023-09-18,2023-12-15,443.37,252,764985,508084803,96118471,0.73787150843006,76.5232161450812,0.204049705882588
432.84,434,31866,31986,1848228,3710376,2023-09-18,2023-09-29,443.37,120,1862148,154689262,55771573,2.39859958734563,73.5183777656138,0.501875820671544
349.22,350,47239,47326,3165013,3691428,2023-09-18,2023-12-15,443.37,87,526415,508084803,96118471,0.726537770506787,77.249753915588,0.14260470473757
404.97,408,11705,11811,2844315,3578733,2023-09-18,2023-12-15,443.37,106,734418,508084803,96118471,0.704357418066684,77.9541113336547,0.205217321325732
420.78,426,6859,6854,2812190,3577788,2023-09-18,2023-12-15,443.37,-5,765598,508084803,96118471,0.704171425493315,78.658282759148,0.213986407243805
426.3,433,5254,5324,2784620,3567080,2023-09-18,2023-12-15,443.37,70,782460.000000001,508084803,96118471,0.702063903296868,79.3603466624449,0.219355887728899
440.79,449,4229,4321,2161019,3547541,2023-09-18,2023-10-20,443.37,92,1386522,473926306,145207170,0.74854274917586,87.6848524209163,0.390840303184657
430.22,438,4377,4556,2761887,3544568,2023-09-18,2023-12-15,443.37,179,782681,508084803,96118471,0.697633146882372,80.0579798093272,0.220811393659256
429.22,437,4399,4507,2604208,3506446,2023-09-18,2023-12-15,443.37,108,902238,508084803,96118471,0.690130068700362,80.7481098780276,0.257308397163396
441.89,459,2018,2007,3004802,3433977,2023-09-18,2023-12-15,443.37,-11,429175,508084803,96118471,0.675866898542132,81.4239767765697,0.124978996656064
431.03,434,11889,11469,2187576,3406293,2023-09-18,2023-10-20,443.37,-420,1218717,473926306,145207170,0.718738959385808,88.4035913803021,0.357783960452022
438.74,440,20042,26877,941974,3386502,2023-09-18,2023-09-22,443.37,6835,2444528,47965757,25232076,7.06024925239896,34.6437313602702,0.721844546378534
442.71,447,9689,7750,1569618,3324750,2023-09-18,2023-09-22,443.37,-1939,1755132,47965757,25232076,6.93150740850395,41.5752387687742,0.527898939769908
434.1,444,3323,3347,2542095,3313530,2023-09-18,2023-12-15,443.37,24,771435.000000001,508084803,96118471,0.652160816547784,82.0761375931175,0.232813645870115
437.34,449,2904,2760,2686200,3218160,2023-09-18,2023-12-15,443.37,-144,531960,508084803,96118471,0.633390327952793,82.7095279210703,0.165299425758819
436.89,440,10702,10290,1755128,3200190,2023-09-18,2023-10-06,443.37,-412,1445062,42650604,18727217,7.5032700592001,17.468268444686,0.45155506391808
384.55,385,70463,70975,2466205,3193875,2023-09-18,2023-10-27,443.37,512,727670,38114356,12392570,8.37971655614488,8.37971655614488,0.227832961527925
432.11,441,3441,3460,2401818,3075940,2023-09-18,2023-12-15,443.37,19,674122,508084803,96118471,0.6053989377045,83.3149268587748,0.219159671515049
379.61,380,78309,78414,2427579,3058146,2023-09-18,2023-10-27,443.37,105,630567.000000001,38114356,12392570,8.02360664312418,16.4033231992691,0.206192575501628
359.04,360,31488,31452,2550528,3019392,2023-09-18,2023-12-15,443.37,-36,468864,508084803,96118471,0.594269299568088,83.9091961583429,0.155284242655475
425.52,432,4451,4579,2278912,2967192,2023-09-18,2023-12-15,443.37,128,688280,508084803,96118471,0.583995424086715,84.4931915824296,0.231963418612614
374.72,375,104816,104806,2305952,2934568,2023-09-18,2023-10-20,443.37,-10,628616.000000001,473926306,145207170,0.619203442148662,89.0227948224507,0.214210745840614
389.62,390,81261,76428,2519091,2904264,2023-09-18,2023-10-20,443.37,-4833,385173,473926306,145207170,0.612809199074086,89.6356040215248,0.132623273917247
442.16,446,7332,7550,989820,2899200,2023-09-18,2023-09-22,443.37,218,1909380,47965757,25232076,6.04431198698688,47.619550755761,0.65858857615894
430.77,439,3471,3497,2238795,2878031,2023-09-18,2023-12-15,443.37,26,639236,508084803,96118471,0.566446975584901,85.0596385580145,0.222108795909426
429.41,432,9949,10988,1661483,2845892,2023-09-18,2023-10-20,443.37,1039,1184409,473926306,145207170,0.600492516235214,90.23609653776,0.416181991445916
443.09,454,2601,2603,1563201,2839873,2023-09-18,2023-09-29,443.37,2,1276672,154689262,55771573,1.83585658324493,75.3542343488587,0.449552497594083
414.91,416,25552,25827,1839744,2815143,2023-09-18,2023-10-20,443.37,275,975399,473926306,145207170,0.594004376705774,90.8301009144658,0.346482931772915
442.38,449,3716,4244,1174256,2809528,2023-09-18,2023-09-29,443.37,528,1635272,154689262,55771573,1.81623983699657,77.1704741858553,0.582045097966634
430.18,433,9738,9615,1684674,2711430,2023-09-18,2023-10-20,443.37,-123,1026756,473926306,145207170,0.572120594631014,91.4022215090968,0.378676934311415
436.24,438,10671,15323,917706,2696848,2023-09-18,2023-09-29,443.37,4652,1779142,154689262,55771573,1.74339703036401,78.9138712162193,0.65971163372945
441.9,458,1647,1651,2132865,2658110,2023-09-18,2023-12-15,443.37,4,525245,508084803,96118471,0.523162665819784,85.5828012238343,0.197600926974429
399.28,400,36607,36763,1866957,2646936,2023-09-18,2023-10-27,443.37,156,779979,38114356,12392570,6.94472182607519,23.3480450253443,0.294672406132978
441.84,447,6528,5065,1599360,2613540,2023-09-18,2023-09-29,443.37,-1463,1014180,154689262,55771573,1.68954196704358,80.6034131832629,0.388048394132097
435.33,446,2564,2412,2146068,2573604,2023-09-18,2023-12-15,443.37,-152,427536.000000001,508084803,96118471,0.506530402957162,86.0893316267915,0.166123459553218
384.65,385,72536,72432,2031008,2535120,2023-09-18,2023-10-20,443.37,-104,504111.999999999,473926306,145207170,0.534918608210788,91.9371401173076,0.198851336425889
442.85,448,6299,4863,1228305,2504445,2023-09-18,2023-09-22,443.37,-1436,1276140,47965757,25232076,5.22131861694584,52.8408693727069,0.509550020064326
426.53,431,5380,5545,1700080,2478615,2023-09-18,2023-11-17,443.37,165,778535,443991078,126746889,0.558257839586587,90.5140093828642,0.314100818400599
404.34,405,36882,37291,1733454,2461206,2023-09-18,2023-10-20,443.37,409,727752,473926306,145207170,0.519322512559579,92.4564626298672,0.295689186520755
433.3,437,6389,6627,1424747,2451990,2023-09-18,2023-10-20,443.37,238,1027243,473926306,145207170,0.517377906429191,92.9738405362964,0.418942573175258
394.38,395,39519,39447,1778355,2445714,2023-09-18,2023-10-27,443.37,-72,667359,38114356,12392570,6.41677902153194,29.7648240468762,0.272868781877194
403.14,406,6914,8466,1590220,2421276,2023-09-18,2023-12-15,443.37,1552,831056,508084803,96118471,0.476549581035196,86.5658812078266,0.343230594116491
391.01,393,12159,12158,2225097,2419442,2023-09-18,2023-12-15,443.37,-1,194345,508084803,96118471,0.476188617670582,87.0420698254972,0.0803263727752102
374.66,375,70332,70336,1898964,2391424,2023-09-18,2023-10-27,443.37,4,492460,38114356,12392570,6.27433925421697,36.0391633010932,0.205927514317829
399.61,402,9817,9786,2130289,2338854,2023-09-18,2023-12-15,443.37,-31,208565,508084803,96118471,0.460327485921676,87.5023973114189,0.0891740142822083
405.26,407,12897,13110,1676610,2281140,2023-09-18,2023-11-17,443.37,213,604530,443991078,126746889,0.513780594483027,91.0277899773473,0.265012230726742
416.5,421,5057,5052,1896375,2273400,2023-09-18,2023-12-15,443.37,-5,377025,508084803,96118471,0.447444990792216,87.9498423022111,0.165841910794405
441.65,450,3015,2669,1501470,2228615,2023-09-18,2023-10-13,443.37,-346,727145,30280851,12108347,7.35981627464829,7.35981627464829,0.326276633694021
441.41,457,1412,1412,2201308,2201308,2023-09-18,2023-12-15,443.37,0,0,508084803,96118471,0.433256020845796,88.3830983230569,0
363.96,365,21055,21093,1894950,2193672,2023-09-18,2023-12-15,443.37,38,298722,508084803,96118471,0.431753122125954,88.8148514451829,0.136174414406529
442.85,452,2476,2397,1146388,2193255,2023-09-18,2023-09-29,443.37,-79,1046867,154689262,55771573,1.41784566791714,82.02125885118,0.477312031660705
420.52,422,11739,14649,1103466,2168052,2023-09-18,2023-10-20,443.37,2910,1064586,473926306,145207170,0.457466060134674,93.4313065964311,0.491033425397546
412.08,413,23441,23444,1500224,2156848,2023-09-18,2023-10-20,443.37,3,656624,473926306,145207170,0.455101979504805,93.8864085759359,0.30443684487734
369.76,370,90163,89859,1803260,2156616,2023-09-18,2023-10-20,443.37,-304,353356,473926306,145207170,0.455053026746314,94.3414616026822,0.163847435055661
442.29,450,2530,2796,1092960,2155716,2023-09-18,2023-10-06,443.37,266,1062756,42650604,18727217,5.05436218441361,22.5226306290997,0.492994438970625
430.46,436,5490,3875,2234430,2146750,2023-09-18,2023-11-17,443.37,-1615,-87680.0000000005,443991078,126746889,0.483511968229235,91.5113019455765,-0.0408431349714687
436.32,441,5044,4546,1462760,2127528,2023-09-18,2023-10-20,443.37,-498,664768,473926306,145207170,0.448915363647276,94.7903769663295,0.312460282543873
416.8,418,16650,17711,1332000,2125320,2023-09-18,2023-10-20,443.37,1061,793320,473926306,145207170,0.448449468428537,95.238826434758,0.373270848625148
424.54,425,56701,46198,1701030,2125108,2023-09-18,2023-09-29,443.37,-10503,424078,154689262,55771573,1.37379154346214,83.3950503946421,0.199555975508068
443.91,465,1369,1007,2594255,2123763,2023-09-18,2023-09-29,443.37,-362,-470492,154689262,55771573,1.3729220584167,84.7679724530588,-0.221536960574226
424.81,431,3055,3427,1506115,2121313,2023-09-18,2023-12-15,443.37,372,615198,508084803,96118471,0.417511601896898,89.2323630470798,0.290008122328011
403.38,405,12993,13028,1572153,2110536,2023-09-18,2023-11-17,443.37,35,538383,443991078,126746889,0.475355498021967,91.9866574435984,0.255093019024551
416.28,419,7224,7659,1408680,2083248,2023-09-18,2023-11-17,443.37,435,674568,443991078,126746889,0.469209428573247,92.4558668721717,0.323805903089791
379.2,380,25436,25764,1602468,2061120,2023-09-18,2023-11-17,443.37,328,458652,443991078,126746889,0.464225544640336,92.9200924168121,0.222525617140196
443.35,455,4981,1729,3277498,2014285,2023-09-18,2023-09-29,443.37,-3252,-1263213,154689262,55771573,1.30214920800385,86.0701216610627,-0.627127243662143
374.8,375,100562,100572,1508430,2011440,2023-09-18,2023-10-13,443.37,10,503010,30280851,12108347,6.64261384199539,14.0024301166437,0.250074573439924
383.34,385,12022,12117,1647014,2011422,2023-09-18,2023-12-15,443.37,95,364408,508084803,96118471,0.395883125833228,89.628246172913,0.181169341888475
428.69,430,14661,15152,1084914,1984912,2023-09-18,2023-10-06,443.37,491,899998,42650604,18727217,4.65388954397926,27.1765201730789,0.453419597443111
435.1,440,2659,3938,850880,1929620,2023-09-18,2023-10-27,443.37,1279,1078740,38114356,12392570,5.06271180339503,41.1018751044882,0.55904271307304
441.87,449,3202,2695,1261588,1921535,2023-09-18,2023-10-06,443.37,-507,659947,42650604,18727217,4.50529375855967,31.6818139316386,0.343447816459237
394.56,395,40596,43248,1420860,1902912,2023-09-18,2023-10-20,443.37,2652,482052,473926306,145207170,0.401520653297519,95.6403470880555,0.253323327615781
407.7,411,4523,5686,1212164,1876380,2023-09-18,2023-12-15,443.37,1163,664216,508084803,96118471,0.369304491872393,89.9975506647854,0.353987998166683
419.67,420,57345,56197,1376280,1854501,2023-09-18,2023-09-29,443.37,-1148,478221,154689262,55771573,1.19885567751949,87.2689773385822,0.257870446012162
389.48,390,35391,35438,1344858,1842776,2023-09-18,2023-10-27,443.37,47,497918,38114356,12392570,4.83486064935742,45.9367357538456,0.270199959192002
438.3,441,4446,6819,529074,1841130,2023-09-18,2023-09-29,443.37,2373,1312056,154689262,55771573,1.19021189719038,88.4591892357726,0.712636261426407
443.19,470,864,684,1848960,1833804,2023-09-18,2023-12-15,443.37,-180,-15155.9999999998,508084803,96118471,0.360924788376321,90.3584754531617,-0.00826478729460715
440.18,442,8458,10016,558228,1822912,2023-09-18,2023-09-22,443.37,1558,1264684,47965757,25232076,3.80044455464343,56.6413139273503,0.693771284625917
443.63,460,3146,1113,3432286,1821981,2023-09-18,2023-09-29,443.37,-2033,-1610305,154689262,55771573,1.17783288668091,89.6370221224535,-0.883820961909043
442.64,456,1341,1341,1693683,1791576,2023-09-18,2023-12-15,443.37,0,97892.9999999995,508084803,96118471,0.352613577383459,90.7110890305452,0.054640718562874
379.7,380,59556,59529,1369788,1785870,2023-09-18,2023-10-20,443.37,-27,416082,473926306,145207170,0.376824408645508,96.017171496701,0.232985603655361
428.75,436,2275,2446,1358175,1773350,2023-09-18,2023-12-15,443.37,171,415175,508084803,96118471,0.349026380936649,91.0601154114818,0.234119040234584
429.72,433,5352,5403,1150680,1772184,2023-09-18,2023-10-27,443.37,51,621504,38114356,12392570,4.6496495965982,50.5863853504438,0.350699475900922
434.51,435,12838,36163,308112,1771987,2023-09-18,2023-09-22,443.37,23325,1463875,47965757,25232076,3.69427506377101,60.3355889911213,0.82612062052374
424.1,428,3870,4524,1145520,1764360,2023-09-18,2023-11-17,443.37,654,618840,443991078,126746889,0.397386363696254,93.3174787805083,0.35074474597021
419.63,421,12818,12845,1153620,1759765,2023-09-18,2023-10-20,443.37,27,606145,473926306,145207170,0.371316168298959,96.388487665,0.344446559625859
440.81,443,6261,8013,482097,1754847,2023-09-18,2023-09-22,443.37,1752,1272750,47965757,25232076,3.65854123807532,63.9941302291966,0.725276904482271
400.56,402,11999,11999,1379885,1727856,2023-09-18,2023-11-17,443.37,0,347971,443991078,126746889,0.389164576861159,93.7066433573695,0.201388888888889
384.1,385,19180,19167,1361780,1725030,2023-09-18,2023-11-17,443.37,-13,363250,443991078,126746889,0.388528077584478,94.0951714349539,0.210576047952789
417.35,422,3546,3701,1283652,1720965,2023-09-18,2023-12-15,443.37,155,437313,508084803,96118471,0.338716094210753,91.3988315056926,0.254109177118652
436.25,440,3517,4480,773740,1680000,2023-09-18,2023-10-13,443.37,963,906260,30280851,12108347,5.54806071995797,19.5504908366017,0.539440476190476
439.96,445,4393,3326,1150966,1676304,2023-09-18,2023-10-06,443.37,-1067,525338,42650604,18727217,3.9303171415814,35.61213107322,0.313390649905984
443.96,463,872,876,1465832,1667904,2023-09-18,2023-12-15,443.37,4,202072,508084803,96118471,0.328272758829199,91.7271042645218,0.121153255822877
440.98,447,2782,2770,887458,1667540,2023-09-18,2023-10-06,443.37,-12,780082,42650604,18727217,3.90976878076568,39.5218998539857,0.46780407066697
359.8,360,69679,76949,1114864,1538980,2023-09-18,2023-10-20,443.37,7270,424116,473926306,145207170,0.324729811474107,96.7132174764741,0.275582528687832
354.55,355,33974,33979,1291012,1529055,2023-09-18,2023-11-17,443.37,5,238043,443991078,126746889,0.344388677107606,94.4395601120615,0.155679815310764
405.31,406,22127,22085,1062096,1523865,2023-09-18,2023-10-20,443.37,-42,461769,473926306,145207170,0.321540497057785,97.0347579735319,0.303024874250672
443.11,449,3765,2512,881010,1479568,2023-09-18,2023-09-22,443.37,-1253,598558,47965757,25232076,3.08463389830374,67.0787641275004,0.404549165702421
441.7,448,3333,2341,1183215,1474830,2023-09-18,2023-10-06,443.37,-992,291615,42650604,18727217,3.45793461682278,42.9798344708084,0.197727873721039
443.61,451,1979,1977,660986,1461003,2023-09-18,2023-09-22,443.37,-2,800017,47965757,25232076,3.04592920320219,70.1246933307026,0.547580668896642
393.83,395,11826,12424,1087992,1453608,2023-09-18,2023-11-17,443.37,598,365616,443991078,126746889,0.327395768074421,94.766955880136,0.251523106642231
441.1,449,2339,1808,1061906,1428320,2023-09-18,2023-10-13,443.37,-531,366414,30280851,12108347,4.71690838543474,24.2673992220364,0.256534950151227
319.59,320,34690,34703,1422290,1422823,2023-09-18,2023-12-15,443.37,13,533,508084803,96118471,0.280036519809076,92.0071407843309,0.000374607382647033
389.72,390,50351,50500,1158073,1414000,2023-09-18,2023-10-13,443.37,149,255927,30280851,12108347,4.66961777263129,28.9370169946677,0.18099504950495
440.95,448,1916,1986,829628,1400130,2023-09-18,2023-10-13,443.37,70,570502,30280851,12108347,4.62381324752069,33.5608302421884,0.407463592666395
410.38,414,3771,3815,1067193,1381030,2023-09-18,2023-12-15,443.37,44,313837,508084803,96118471,0.271810924445225,92.2789517087761,0.227248502928973
428.57,431,5544,5663,870408,1376109,2023-09-18,2023-10-20,443.37,119,505701,473926306,145207170,0.290363497990761,97.3251214715226,0.367486151169711
423.25,429,2387,2386,1105181,1371950,2023-09-18,2023-12-15,443.37,-1,266769,508084803,96118471,0.270023821200572,92.5489755299766,0.194445132840118
439.49,441,10426,9076,573430,1370476,2023-09-18,2023-09-22,443.37,-1350,797046,47965757,25232076,2.85719664551526,72.9818899762178,0.581583333090109
439.29,445,2701,2337,883227,1334427,2023-09-18,2023-10-13,443.37,-364,451200,30280851,12108347,4.4068345371139,37.9676647793023,0.338122654892325
415.37,418,4663,4962,881307,1305006,2023-09-18,2023-11-17,443.37,299,423699,443991078,126746889,0.29392617659763,95.0608820567336,0.324672070473239
443.3,456,1025,1024,796425,1300480,2023-09-18,2023-10-06,443.37,-1,504055,42650604,18727217,3.04914790890183,46.0289823797103,0.387591504675197
443.11,455,814,1093,634106,1299577,2023-09-18,2023-10-13,443.37,279,665471,30280851,12108347,4.29174530134573,42.259410080648,0.512067388080891
423.56,424,28980,29371,840420,1292324,2023-09-18,2023-09-29,443.37,391,451904,154689262,55771573,0.835432261613608,90.4724543840671,0.349683206378586
438.98,443,3763,3196,812808,1284792,2023-09-18,2023-10-06,443.37,-567,471984,42650604,18727217,3.01236531140333,49.0413476911136,0.367362187809388
443.27,455,739,1088,533558,1276224,2023-09-18,2023-10-06,443.37,349,742666,42650604,18727217,2.99227649859308,52.0336241897067,0.581924489744747
396.81,399,5785,5786,1116505,1267134,2023-09-18,2023-12-15,443.37,1,150629,508084803,96118471,0.249394194142036,92.7983697241187,0.118873773413072
339.36,340,19248,19347,1077888,1238208,2023-09-18,2023-12-15,443.37,99,160320,508084803,96118471,0.243701050039082,93.0420707741578,0.129477438362537
411.89,414,5540,5853,903020,1234983,2023-09-18,2023-11-17,443.37,313,331963,443991078,126746889,0.27815491373455,95.3390369704681,0.268799651493179
438.79,444,2255,2361,683265,1230081,2023-09-18,2023-10-13,443.37,106,546816,30280851,12108347,4.0622405228968,46.3216506035448,0.444536579298436
436.24,437,16559,16101,579565,1223676,2023-09-18,2023-09-22,443.37,-458,644111,47965757,25232076,2.55114497619625,75.5330349524141,0.526373811368369
391.98,394,6043,6039,1045439,1219878,2023-09-18,2023-12-15,443.37,-4,174439,508084803,96118471,0.240093384568324,93.2821641587261,0.142997086593905
440.33,442.5,4301,5608,305371,1216936,2023-09-18,2023-09-22,443.37,1307,911565,47965757,25232076,2.53709328511171,78.0701282375258,0.749065686280955
436.83,441,589,2906,140771,1211802,2023-09-18,2023-10-13,443.37,2317,1071031,30280851,12108347,4.0018756408134,50.3235262443582,0.883833332508116
443.26,454,1114,1125,729670,1208250,2023-09-18,2023-10-06,443.37,11,478580,42650604,18727217,2.83290243673923,54.8665266264459,0.396093523691289
442.2,452,554,1232,327414,1207360,2023-09-18,2023-10-13,443.37,678,879946,30280851,12108347,3.98720630407646,54.3107325484347,0.728818248078452
440.53,446,2363,2203,687633,1205041,2023-09-18,2023-10-06,443.37,-160,517408,42650604,18727217,2.82537851046611,57.691905136912,0.429369623108259
407.1,409,6202,6309,880684,1198710,2023-09-18,2023-11-17,443.37,107,318026,443991078,126746889,0.269985154971965,95.6090221254401,0.265306871553587
437.16,438,8673,14254,320901,1197336,2023-09-18,2023-09-22,443.37,5581,876435,47965757,25232076,2.49623080065222,80.566359038178,0.731987512277255
299.69,300,38553,38571,1118037,1195701,2023-09-18,2023-12-15,443.37,18,77664,508084803,96118471,0.235334926953129,93.5174990856792,0.064952693022754
401.33,404,4320,4436,950400,1184412,2023-09-18,2023-12-15,443.37,116,234012,508084803,96118471,0.233113053767129,93.7506121394463,0.197576518981571
442.5,451,1417,1393,673075,1184050,2023-09-18,2023-10-06,443.37,-24,510975,42650604,18727217,2.77616232586061,60.4680674627726,0.431548498796504
443.87,470,577,451,1221509,1178463,2023-09-18,2023-10-20,443.37,-126,-43046,473926306,145207170,0.248659545815547,97.5737810173382,-0.0365272392938938
389,390,13462,11730,1076960,1173000,2023-09-18,2023-11-17,443.37,-1732,96040,443991078,126746889,0.264194498070522,95.8732166235106,0.0818755328218244
354.14,355,13432,13601,980536,1169686,2023-09-18,2023-12-15,443.37,169,189150,508084803,96118471,0.230214718703169,93.9808268581495,0.161710065778337
411.08,413,4851,5574,790713,1070208,2023-09-18,2023-11-17,443.37,723,279495,443991078,126746889,0.241042681492802,96.1142593050034,0.261159512917115
406.18,408,5868,5880,809784,1070160,2023-09-18,2023-11-17,443.37,12,260376,443991078,126746889,0.241031870464748,96.3552911754682,0.243305673917919
369.7,370,35125,35409,878125,1062270,2023-09-18,2023-10-27,443.37,284,184145,38114356,12392570,2.78706007783524,53.3734454282791,0.173350466453915
419.78,423,3430,3292,788900,1060024,2023-09-18,2023-11-17,443.37,-138,271124,443991078,126746889,0.238748941707338,96.5940401171755,0.255771567436209
424.14,425,12187,12272,670285,1055392,2023-09-18,2023-10-06,443.37,85,385107,42650604,18727217,2.47450657439693,62.9425740371696,0.36489475000758
441.35,447.5,1915,1698,653015,1044270,2023-09-18,2023-10-06,443.37,-217,391255,42650604,18727217,2.44842956971958,65.3910036068891,0.374668428663085
409.97,412,4841,5061,735832,1027383,2023-09-18,2023-11-17,443.37,220,291551,443991078,126746889,0.231397217400842,96.8254373345763,0.283780245536475
364.74,365,39061,39240,898403,1020240,2023-09-18,2023-10-27,443.37,179,121837,38114356,12392570,2.6767866679946,56.0502320962737,0.119419940406179
413.57,416,4008,4114,701400,999702,2023-09-18,2023-11-17,443.37,106,298302,443991078,126746889,0.225162632659929,97.0505999672363,0.298390920494307
422.9,425,3788,4759,534108,999390,2023-09-18,2023-10-27,443.37,971,465282,38114356,12392570,2.62208287082169,58.6723149670953,0.465565995257107
400.42,403,3714,3836,783654,989688,2023-09-18,2023-12-15,443.37,122,206034,508084803,96118471,0.194787955505924,94.1756148136554,0.20818075999709
413.1,417,2530,2530,799480,986700,2023-09-18,2023-12-15,443.37,0,187220,508084803,96118471,0.194199864702507,94.3698146783579,0.18974358974359
442.96,453,1111,973,667711,976892,2023-09-18,2023-10-06,443.37,-138,309181,42650604,18727217,2.29045290894356,67.6814565158327,0.31649455620478
432,433,9218,9660,497772,966000,2023-09-18,2023-09-29,443.37,442,468228,154689262,55771573,0.624477735241894,91.096932119309,0.484708074534162
377.58,379,6733,6733,868557,956086,2023-09-18,2023-12-15,443.37,0,87528.9999999999,508084803,96118471,0.188174492595481,94.5579891709534,0.0915492957746478
444.28,464,483,483,895482,952476,2023-09-18,2023-12-15,443.37,0,56994,508084803,96118471,0.187463981283455,94.7454531522369,0.0598377281947262
439.92,448,1176,1177,624456,951016,2023-09-18,2023-10-27,443.37,1,326560,38114356,12392570,2.49516481401391,61.1674797811093,0.343380132405764
413.97,418,2344,2345,768832,945035,2023-09-18,2023-12-15,443.37,1,176203,508084803,96118471,0.185999461983515,94.9314526142204,0.186451295454666
414.58,417,3896,3799,705176,919358,2023-09-18,2023-11-17,443.37,-97,214182,443991078,126746889,0.207066773535481,97.2576667407718,0.232969093650134
438.1,443,1873,1874,522567,918260,2023-09-18,2023-10-13,443.37,1,395693,30280851,12108347,3.03247752185036,57.343210070285,0.430916080412955
418.36,420,3738,5573,414918,913972,2023-09-18,2023-10-27,443.37,1835,499054,38114356,12392570,2.39797308919505,63.5654528703043,0.546027668243666
433.06,435,4109,4644,435554,900936,2023-09-18,2023-10-06,443.37,535,465382,42650604,18727217,2.1123639890305,69.7938205048632,0.516553895060248
447.65,466,489,489,897315,897315,2023-09-18,2023-12-15,443.37,0,0,508084803,96118471,0.17660732907219,95.1080599432926,0
437.97,439,7620,8668,312420,892804,2023-09-18,2023-09-22,443.37,1048,580384,47965757,25232076,1.86133620282486,82.4276952410029,0.650068772093315
443.11,457,635,637,711200,884793,2023-09-18,2023-10-20,443.37,2,173593,473926306,145207170,0.186694215703654,97.7604752330418,0.196196172438073
439.3,447,1300,1136,646100,874720,2023-09-18,2023-10-27,443.37,-164,228620,38114356,12392570,2.29498827161083,65.8604411419151,0.261363636363636
434.6,436,6403,6204,448210,868560,2023-09-18,2023-09-29,443.37,-199,420350,154689262,55771573,0.561486937600103,91.6584190569091,0.48396196002579
374.88,375,71950,71965,791450,863580,2023-09-18,2023-10-06,443.37,15,72129.9999999999,42650604,18727217,2.0247778906015,71.8185983954647,0.083524398434424
421.28,422,3361,11985,157967,862920,2023-09-18,2023-10-06,443.37,8624,704953,42650604,18727217,2.02323043303209,73.8418288284968,0.816938997821351
413.01,414,8627,8681,569382,859419,2023-09-18,2023-10-20,443.37,54,290037,473926306,145207170,0.181340218747005,97.9418154517888,0.337480321007564
443.55,461,489,489,853305,853305,2023-09-18,2023-12-15,443.37,0,0,508084803,96118471,0.167945389226688,95.2760053325193,0
359.76,360,35133,35151,667527,843624,2023-09-18,2023-10-27,443.37,18,176097,38114356,12392570,2.21340221516533,68.0738433570805,0.208738727205485
427.36,428,12642,13106,467754,838784,2023-09-18,2023-09-29,443.37,464,371030,154689262,55771573,0.54223802554569,92.2006570824548,0.442342724706241
435.32,437,5863,4961,451451,833448,2023-09-18,2023-09-29,443.37,-902,381997,154689262,55771573,0.538788529484354,92.7394456119391,0.458333333333333
359.86,360,59295,59292,652245,830088,2023-09-18,2023-10-13,443.37,-3,177843,30280851,12108347,2.74129680173123,60.0845068720163,0.214245959464539
412.15,416,2142,2153,655452,828905,2023-09-18,2023-12-15,443.37,11,173453,508084803,96118471,0.163143041300529,95.4391483738198,0.209255584174302
433.58,438,1816,1841,539352,813722,2023-09-18,2023-10-27,443.37,25,274370,38114356,12392570,2.1349488366011,70.2087921936816,0.337179036575145
409.52,413,2309,2330,667301,810840,2023-09-18,2023-12-15,443.37,21,143539,508084803,96118471,0.159587532477329,95.5987359062971,0.177025060431158
369.92,370,100465,100451,602790,803608,2023-09-18,2023-09-29,443.37,-14,200818,154689262,55771573,0.519498244163839,93.258943856103,0.249895471423878
436.91,439,2179,3824,207005,799216,2023-09-18,2023-09-29,443.37,1645,592211,154689262,55771573,0.516659003777521,93.7756028598805,0.740989920121719
402.4,403,13265,13252,623455,795120,2023-09-18,2023-10-20,443.37,-13,171665,473926306,145207170,0.167772919530658,98.1095883713195,0.215898229198109
408.64,412,2352,2365,632688,794640,2023-09-18,2023-12-15,443.37,13,161952,508084803,96118471,0.15639908836242,95.7551349946595,0.203805496828753
431.08,432,8782,8476,447882,779792,2023-09-18,2023-09-29,443.37,-306,331910,154689262,55771573,0.504102217515266,94.2797050773958,0.425639144797587
354.83,355,45518,45559,637252,774503,2023-09-18,2023-10-20,443.37,41,137251,473926306,145207170,0.163422665126337,98.2730110364458,0.177211708669947
403.34,404,11462,11464,538714,756624,2023-09-18,2023-10-20,443.37,2,217910,473926306,145207170,0.159650137673514,98.4326611741194,0.28800302395906
437.54,441,2295,2178,413100,753588,2023-09-18,2023-10-06,443.37,-117,340488,42650604,18727217,1.76688705276014,75.6087158812569,0.451822481249702
324.51,325,14803,15088,666135,739312,2023-09-18,2023-12-15,443.37,285,73177,508084803,96118471,0.145509567622317,95.9006445622819,0.0989798623585171
379.5,381,5271,4892,664146,733800,2023-09-18,2023-12-15,443.37,-379,69654,508084803,96118471,0.144424709353096,96.045069271635,0.0949223221586263
387.18,389,4006,4006,681020,729092,2023-09-18,2023-12-15,443.37,0,48072,508084803,96118471,0.143498092384393,96.1885673640194,0.0659340659340659
442.18,451,767,813,416481,717066,2023-09-18,2023-10-13,443.37,46,300585,30280851,12108347,2.36805101679606,62.4525578888123,0.419187355138858
414.72,419,1669,1675,552439,716900,2023-09-18,2023-12-15,443.37,6,164461,508084803,96118471,0.141098492961617,96.329665856981,0.229405774863998
421.53,427,1572,1295,680676,708365,2023-09-18,2023-12-15,443.37,-277,27689,508084803,96118471,0.139418655275151,96.4690845122561,0.0390886054505799
369.39,370,8064,11476,403200,700036,2023-09-18,2023-11-17,443.37,3412,296836,443991078,126746889,0.157668934059076,97.4153356748308,0.42402962133376
439.61,444,1461,1594,350640,699766,2023-09-18,2023-10-06,443.37,133,349126,42650604,18727217,1.64069423260688,77.2494101138638,0.498918209801562
443.25,452,963,797,389052,697375,2023-09-18,2023-09-22,443.37,-166,308323,47965757,25232076,1.45390179081298,83.8815970318158,0.4421193762323
409,411,3311,3481,503272,696200,2023-09-18,2023-11-17,443.37,170,192928,443991078,126746889,0.156804952733757,97.5721406275646,0.277115771330078
374.31,375,8587,9943,489459,686067,2023-09-18,2023-11-17,443.37,1356,196608,443991078,126746889,0.1545226996656,97.7266633272302,0.286572594221847
433.85,436,3032,3146,354744,676390,2023-09-18,2023-10-06,443.37,114,321646,42650604,18727217,1.58588609905735,78.8352962129212,0.475533346146454
314.59,315,11516,16478,426092,675598,2023-09-18,2023-12-15,443.37,4962,249506,508084803,96118471,0.132969535008903,96.602054047265,0.36931133603119
443.28,456,512,527,432640,670344,2023-09-18,2023-10-13,443.37,15,237704,30280851,12108347,2.21375548527352,64.6663133740858,0.354600026255177
442.9,447.5,2743,1456,490997,669760,2023-09-18,2023-09-22,443.37,-1287,178763,47965757,25232076,1.39632946895845,85.2779265007743,0.266906055900621
421.6,422,15727,16713,408902,668520,2023-09-18,2023-09-29,443.37,986,259618,154689262,55771573,0.432169622736968,94.7118747001327,0.388347394244002
434.89,437.5,2584,2539,361760,662679,2023-09-18,2023-10-06,443.37,-45,300919,42650604,18727217,1.55373884036906,80.3890350532902,0.454094667252169
435.32,438,2538,2463,368010,660084,2023-09-18,2023-10-06,443.37,-75,292074,42650604,18727217,1.54765451856204,81.9366895718523,0.442480047993892
389.82,390,36375,36394,545625,655092,2023-09-18,2023-10-06,443.37,19,109467,42650604,18727217,1.53595011221881,83.4726396840711,0.167101720063747
334.42,335,11199,11216,593547,650528,2023-09-18,2023-12-15,443.37,17,56981,508084803,96118471,0.128035319332312,96.7300893665973,0.0875919253283487
430.15,431,3334,7612,150030,647020,2023-09-18,2023-09-29,443.37,4278,496990,154689262,55771573,0.418270791155497,95.1301454912882,0.768121541837965
438.38,445,1095,975,479610,645450,2023-09-18,2023-10-27,443.37,-120,165840,38114356,12392570,1.69345639737426,71.9022485910558,0.256937020683244
395.78,397,5200,5289,525200,645258,2023-09-18,2023-11-17,443.37,89,120058,443991078,126746889,0.145331298751909,97.8719946259821,0.186062009304805
429.8,430,32660,31948,489900,638960,2023-09-18,2023-09-22,443.37,-712,149060,47965757,25232076,1.33211699337926,86.6100434941536,0.233285338675347
445.57,459,472,475,522504,637925,2023-09-18,2023-10-20,443.37,3,115421,473926306,145207170,0.134604260604179,98.5672654347235,0.180931927734452
431.25,435,1198,1662,286322,623250,2023-09-18,2023-10-27,443.37,464,336928,38114356,12392570,1.63521062772253,73.5374592187784,0.54059847573205
439.99,446,985,1010,356570,607010,2023-09-18,2023-10-13,443.37,25,250440,30280851,12108347,2.00460020096529,66.6709135750511,0.412579693909491
401.48,403,3585,3942,426615,599184,2023-09-18,2023-11-17,443.37,357,172569,443991078,126746889,0.13495406319854,98.0069486891806,0.288006689097172
443.11,452.5,636,637,366336,598143,2023-09-18,2023-10-06,443.37,1,231807,42650604,18727217,1.40242562567227,84.8750653097433,0.387544450072976
428.34,429,9257,9037,379537,596442,2023-09-18,2023-09-29,443.37,-220,216905,154689262,55771573,0.38557427470305,95.5157197659913,0.363664865988646
441.35,451,598,616,389298,594440,2023-09-18,2023-10-27,443.37,18,205142,38114356,12392570,1.55962231134117,75.0970815301195,0.34510127178521
419.4,420,9605,9846,393805,590760,2023-09-18,2023-10-06,443.37,241,196955,42650604,18727217,1.38511520258892,86.2601805123323,0.333392579050714
431.72,432,3818,21042,72542,589176,2023-09-18,2023-09-22,443.37,17224,516634,47965757,25232076,1.22832628285216,87.8383697770057,0.876875500699282
440.8,450,983,639,593732,587880,2023-09-18,2023-10-27,443.37,-344,-5852.00000000012,38114356,12392570,1.54241094877741,76.6394924788969,-0.00995441246512914
428.15,430,3121,3152,343310,583120,2023-09-18,2023-10-13,443.37,31,239810,30280851,12108347,1.92570545656065,68.5966190316118,0.411253258334477
294.72,295,20816,20816,541216,582848,2023-09-18,2023-12-15,443.37,0,41632,508084803,96118471,0.11471470836336,96.8448040749607,0.0714285714285714
423.18,424,6903,6977,352053,572114,2023-09-18,2023-10-06,443.37,74,220061,42650604,18727217,1.34139718162022,87.6015776939525,0.384645367881227
405.93,409,1895,1815,466170,557205,2023-09-18,2023-12-15,443.37,-80,91034.9999999999,508084803,96118471,0.109667716237519,96.9544717911982,0.163377930923089
384.9,385,55711,55712,445688,557120,2023-09-18,2023-09-29,443.37,1,111432,154689262,55771573,0.360154281426464,95.8758740474177,0.200014359563469
437.17,443,1428,952,571200,555016,2023-09-18,2023-10-27,443.37,-476,-16184,38114356,12392570,1.45618622022631,78.0956786991233,-0.0291595197255575
381.43,383,3503,3528,493923,553896,2023-09-18,2023-12-15,443.37,25,59973.0000000001,508084803,96118471,0.109016447004419,97.0634882382026,0.10827483859786
446.03,472,213,213,553161,553161,2023-09-18,2023-10-20,443.37,0,0,473926306,145207170,0.116718779480454,98.683984214204,0
441.74,453,466,487,354160,548362,2023-09-18,2023-10-27,443.37,21,194202,38114356,12392570,1.4387282314307,79.534406930554,0.354149266360543
416.48,418,284,3596,30104,546592,2023-09-18,2023-10-27,443.37,3312,516488,38114356,12392570,1.43408431195847,80.9684912425124,0.9449241847667
434.58,437,2136,2222,279816,537724,2023-09-18,2023-10-06,443.37,86,257908,42650604,18727217,1.26076526372288,88.8623429576754,0.479628954631
442.55,452.5,522,537,327816,534315,2023-09-18,2023-10-13,443.37,15,206499,30280851,12108347,1.76453099022878,70.3611500218405,0.386474270795317
433.87,437,1516,1706,272880,533978,2023-09-18,2023-10-13,443.37,190,261098,30280851,12108347,1.76341807566769,72.1245680975082,0.488967710280199
443.1,455,782,448,492660,533120,2023-09-18,2023-09-22,443.37,-334,40460.0000000001,47965757,25232076,1.11145957729803,88.9498293543038,0.0758928571428573
395.75,398,2366,2365,442442,532125,2023-09-18,2023-12-15,443.37,-1,89683,508084803,96118471,0.104731532385549,97.1682197705882,0.168537467700258
432.42,435,1660,2051,263940,529158,2023-09-18,2023-10-13,443.37,391,265218,30280851,12108347,1.74750042526876,73.872068522777,0.501207578832787
440.35,447,1025,795,396675,528675,2023-09-18,2023-10-13,443.37,-230,132000,30280851,12108347,1.74590535781177,75.6179738805888,0.249680805788055
418.57,423,1078,1180,416108,522740,2023-09-18,2023-12-15,443.37,102,106632,508084803,96118471,0.10288439979182,97.27110417038,0.203986685541569
364.79,365,24738,24713,445284,518973,2023-09-18,2023-10-20,443.37,-25,73689,473926306,145207170,0.109504999707697,98.7934892139117,0.141990045724922
364.48,365,9963,9952,458298,517504,2023-09-18,2023-11-17,443.37,-11,59205.9999999999,443991078,126746889,0.116557297126588,98.1235059863072,0.114406845164482
438.53,442.5,1116,1298,241056,515306,2023-09-18,2023-10-06,443.37,182,274250,42650604,18727217,1.20820328828169,90.070546245957,0.532208047257358
380.47,382,3521,3347,450688,512091,2023-09-18,2023-12-15,443.37,-174,61403,508084803,96118471,0.100788489830112,97.3718926602101,0.119906422881871
442.68,453,501,495,332163,510840,2023-09-18,2023-10-13,443.37,-6,178677,30280851,12108347,1.68700674891865,77.3049806295074,0.34977096546864
329.47,330,9578,9585,450166,508005,2023-09-18,2023-12-15,443.37,7,57839,508084803,96118471,0.0999842933700184,97.4718769535801,0.113855178590762
443.6,453,1950,538,902850,505720,2023-09-18,2023-09-22,443.37,-1412,-397130,47965757,25232076,1.05433549188018,90.0041648461839,-0.785276437554378
397.69,399,4075,3840,468625,503040,2023-09-18,2023-11-17,443.37,-235,34415.0000000001,443991078,126746889,0.113299574006305,98.2368055603136,0.0684140426208652
404.34,406,2817,2952,369027,490032,2023-09-18,2023-11-17,443.37,135,121005,443991078,126746889,0.110369785403661,98.3471753457172,0.246932853364678
407.26,408,6613,6616,350489,489584,2023-09-18,2023-10-20,443.37,3,139095,473926306,145207170,0.103303824624582,98.8967930385363,0.284108549298997
449.9,474,204,203,491640,489230,2023-09-18,2023-10-20,443.37,-1,-2410.00000000006,473926306,145207170,0.10322912946723,99.0000221680035,-0.00492610837438436
430.76,431,4288,20131,72896,483144,2023-09-18,2023-09-22,443.37,15843,410248,47965757,25232076,1.00726858120888,91.0114334273928,0.849121586938884
413.69,415,1085,3683,100905,482473,2023-09-18,2023-10-27,443.37,2598,381568,38114356,12392570,1.26585636131436,82.2343476038268,0.790858763081043
358.04,359,5006,5006,480576,480576,2023-09-18,2023-12-15,443.37,0,0,508084803,96118471,0.0945857851213865,97.5664627387015,0
433.08,436,1146,1610,195966,470120,2023-09-18,2023-10-13,443.37,464,274154,30280851,12108347,1.55253232480157,78.857512954309,0.583157491704246
384.32,386,2785,2787,476235,468216,2023-09-18,2023-12-15,443.37,2,-8018.99999999994,508084803,96118471,0.0921531203522338,97.6586158590538,-0.017126710748885
443.97,462,258,258,503100,465174,2023-09-18,2023-12-15,443.37,0,-37925.9999999999,508084803,96118471,0.0915544014017676,97.7501702604555,-0.0815307820299499
434.78,438,646,1420,122740,457240,2023-09-18,2023-10-13,443.37,774,334500,30280851,12108347,1.50999719261523,80.3675101469242,0.73156329280028
357.2,358,5533,5537,431574,442960,2023-09-18,2023-12-15,443.37,4,11386.0000000001,508084803,96118471,0.0871822966135832,97.8373525570691,0.0257043525374753
414.75,415,17825,17582,338675,439550,2023-09-18,2023-09-29,443.37,-243,100875,154689262,55771573,0.284150298680719,96.1600243460984,0.229496075531794
438.92,446,857,617,416502,436836,2023-09-18,2023-10-27,443.37,-240,20333.9999999999,38114356,12392570,1.14611932574697,83.3804669295737,0.0465483613987856
398.53,401,1748,1765,361836,435955,2023-09-18,2023-12-15,443.37,17,74119.0000000001,508084803,96118471,0.0858035897601921,97.9231561468293,0.170015253867945
349.85,350,28870,28885,375310,433275,2023-09-18,2023-10-20,443.37,15,57965,473926306,145207170,0.0914224415303927,99.0914446095339,0.133783393918412
437.48,442,692,953,186148,430756,2023-09-18,2023-10-13,443.37,261,244608,30280851,12108347,1.4225359782656,81.7900461251898,0.567857441335698
440.96,447.5,846,635,360396,415290,2023-09-18,2023-10-13,443.37,-211,54894,30280851,12108347,1.37146079547104,83.1615069206609,0.132182330419707
436.1,439,1683,1424,252450,412960,2023-09-18,2023-10-06,443.37,-259,160510,42650604,18727217,0.968239511918753,91.0387857578758,0.388681712514529
441.81,452,276,403,198720,410657,2023-09-18,2023-10-27,443.37,127,211937,38114356,12392570,1.07743392017433,84.4579008497481,0.516092505424235
445.1,457,344,344,409360,409360,2023-09-18,2023-10-13,443.37,0,0,30280851,12108347,1.35187746209643,84.5133843827573,0
443.69,452.5,484,459,212960,404379,2023-09-18,2023-09-22,443.37,-25,191419,47965757,25232076,0.843057683838911,91.8544911112317,0.473365333016799
435.58,443,0,543,0,402906,2023-09-18,2023-11-17,443.37,543,402906,443991078,126746889,0.0907464181070774,98.4379217638243,1
442.66,454,755,355,544355,402570,2023-09-18,2023-10-13,443.37,-400,-141785,30280851,12108347,1.32945405001993,85.8428384327772,-0.352199617457833
309.62,310,10578,10587,359652,402306,2023-09-18,2023-12-15,443.37,9,42653.9999999999,508084803,96118471,0.0791808764254655,98.0023370232548,0.106023772948949
420.19,422,1973,2207,248598,399467,2023-09-18,2023-10-27,443.37,234,150869,38114356,12392570,1.04807490384988,85.5059757535979,0.377675752940794
436.39,442,1260,711,459900,398871,2023-09-18,2023-10-27,443.37,-549,-61029,38114356,12392570,1.04651118859256,86.5524869421905,-0.153004354791399
437.75,442.5,646,829,188632,393775,2023-09-18,2023-10-13,443.37,183,205143,30280851,12108347,1.30040929166753,87.1432477244447,0.520965018094089
410.14,411,4725,4570,278775,393020,2023-09-18,2023-10-20,443.37,-155,114245,473926306,145207170,0.082928504922451,99.1743731144563,0.290684952419724
443.15,457,274,281,232078,389185,2023-09-18,2023-10-06,443.37,7,157107,42650604,18727217,0.912495869929533,91.9512816278053,0.403682053522104
344.3,345,5534,5540,343108,387800,2023-09-18,2023-12-15,443.37,6,44691.9999999999,508084803,96118471,0.0763258412198564,98.0786628644746,0.115244971634863
359.51,360,8138,7835,349934,383915,2023-09-18,2023-11-17,443.37,-303,33981,443991078,126746889,0.086469079903448,98.5243908437277,0.0885117799512913
402.46,404,2656,2459,321376,378686,2023-09-18,2023-11-17,443.37,-197,57310,443991078,126746889,0.0852913535348113,98.6096821972625,0.151339104165456
349.6,350,9388,9417,328580,376680,2023-09-18,2023-11-17,443.37,29,48100,443991078,126746889,0.0848395426540531,98.6945217399166,0.127694594881597
396.68,398,2792,2838,279200,374616,2023-09-18,2023-11-17,443.37,46,95416.0000000001,443991078,126746889,0.0843746684477295,98.7788964083643,0.254703483033293
430.68,433,1133,1597,152955,370504,2023-09-18,2023-10-13,443.37,464,217549,30280851,12108347,1.22355874344483,88.3668064678896,0.587170448902036
443.54,452.5,336,412,247968,369152,2023-09-18,2023-10-27,443.37,76,121184,38114356,12392570,0.968537944075456,87.521024886266,0.328276699029126
389.08,391,1908,1909,295740,366528,2023-09-18,2023-12-15,443.37,1,70788,508084803,96118471,0.0721391385524278,98.150802003027,0.193131220534311
432.76,437,299,861,84916,365064,2023-09-18,2023-10-27,443.37,562,280148,38114356,12392570,0.957812326672921,88.4788372129389,0.767394210330243
436.73,437.5,3615,4711,119295,362747,2023-09-18,2023-09-22,443.37,1096,243452,47965757,25232076,0.756262431133944,92.6107535423657,0.671134427024896
435.44,436,7747,6421,224663,359576,2023-09-18,2023-09-22,443.37,-1326,134913,47965757,25232076,0.749651464898177,93.3604050072638,0.375200235833315
376.63,378,2322,2607,269352,357159,2023-09-18,2023-12-15,443.37,285,87807,508084803,96118471,0.0702951550393055,98.2210971580663,0.245848487648358
348.32,349,5111,5111,347548,347548,2023-09-18,2023-12-15,443.37,0,0,508084803,96118471,0.0684035416819975,98.2895006997484,0
304.83,305,20172,20173,322752,342941,2023-09-18,2023-11-17,443.37,1,20189.0000000001,443991078,126746889,0.0772405160808209,98.8561369244452,0.0588701846673336
393.78,396,1534,1535,299130,340770,2023-09-18,2023-12-15,443.37,1,41640,508084803,96118471,0.0670695124097227,98.3565702121581,0.122193855092878
426.43,427,5223,5860,182805,334020,2023-09-18,2023-09-29,443.37,637,151215,154689262,55771573,0.215929661620598,96.375954007719,0.452712412430393
339.67,340,9909,9907,287361,326931,2023-09-18,2023-11-17,443.37,-2,39570.0000000001,443991078,126746889,0.0736345877652974,98.9297715122104,0.121034713746938
409.8,410,16152,16234,242280,324680,2023-09-18,2023-09-29,443.37,82,82400,154689262,55771573,0.209891750598694,96.5858457583177,0.253788345447826
346.35,347,4980,4980,323700,323700,2023-09-18,2023-12-15,443.37,0,0,508084803,96118471,0.0637098370367909,98.4202800491949,0
404.84,405,20175,20178,302625,322848,2023-09-18,2023-09-29,443.37,3,20223,154689262,55771573,0.208707440856496,96.7945531991742,0.0626393844781445
427.16,430,786,1122,143838,318648,2023-09-18,2023-10-27,443.37,336,174810,38114356,12392570,0.836031441801089,89.31486865474,0.548599081117722
407.81,408,12337,16316,172718,310004,2023-09-18,2023-09-29,443.37,3979,137286,154689262,55771573,0.200404343515454,96.9949575426897,0.442852350292254
428.03,431,751,1042,155457,309474,2023-09-18,2023-10-27,443.37,291,154017,38114356,12392570,0.81196177104501,90.126830425785,0.497673471761764
370.77,372,2348,2491,241844,306393,2023-09-18,2023-12-15,443.37,143,64549,508084803,96118471,0.0603035159073632,98.4805835651022,0.210673873097623
274.8,275,14893,15115,268074,302300,2023-09-18,2023-12-15,443.37,222,34226,508084803,96118471,0.0594979417245038,98.5400815068267,0.113218656963282
390.02,392,1435,1503,231035,297594,2023-09-18,2023-12-15,443.37,68,66559,508084803,96118471,0.0585717183908766,98.5986532252176,0.22365706297842
448.47,463,562,204,816586,296412,2023-09-18,2023-10-20,443.37,-358,-520174,473926306,145207170,0.0625439010764682,99.2369170155328,-1.75490196078431
431.42,434,605,1148,91960,296184,2023-09-18,2023-10-13,443.37,543,204224,30280851,12108347,0.97812310492859,89.3449295728182,0.689517327066958
430.49,432,2018,1912,171530,288712,2023-09-18,2023-10-06,443.37,-106,117182,42650604,18727217,0.676923590577991,92.6282052183833,0.405878522541495
329.73,330,10790,10688,258960,288576,2023-09-18,2023-11-17,443.37,-102,29616,443991078,126746889,0.0649959006608687,98.9947674128713,0.102628077178975
435.51,439,543,817,118917,285133,2023-09-18,2023-10-13,443.37,274,166216,30280851,12108347,0.941628093609391,90.2865576664276,0.582941995489824
420.91,422,2690,2588,188300,282092,2023-09-18,2023-10-13,443.37,-102,93792,30280851,12108347,0.931585443222847,91.2181431096504,0.332487273655403
435.73,441,287,535,97867,281945,2023-09-18,2023-10-27,443.37,248,184078,38114356,12392570,0.739734392993548,90.8665648187785,0.652886201209456
400.42,401,4757,4854,199794,281532,2023-09-18,2023-10-20,443.37,97,81738,473926306,145207170,0.059404172428445,99.2963211879612,0.290332892886066
344.64,345,7759,7758,240529,279288,2023-09-18,2023-11-17,443.37,-1,38759,443991078,126746889,0.0629039667324126,99.0576713796037,0.138777892354845
365.9,367,2520,2522,234360,277420,2023-09-18,2023-12-15,443.37,2,43060,508084803,96118471,0.0546011213801252,98.6532543465977,0.155215918102516
423.67,425,1295,2085,104895,277305,2023-09-18,2023-10-13,443.37,790,172410,30280851,12108347,0.915776772588062,92.1339198822385,0.621734191594093
443.5,470,835,104,1720935,275600,2023-09-18,2023-11-17,443.37,-731,-1445335,443991078,126746889,0.0620733194102608,99.119744699014,-5.24432148040639
309.82,310,15106,15142,256802,272556,2023-09-18,2023-11-17,443.37,36,15754,443991078,126746889,0.0613877200478339,99.1811324190618,0.0578009656731094
432.67,433,8222,8097,147996,267201,2023-09-18,2023-09-22,443.37,-125,119205,47965757,25232076,0.557066158676491,93.9174711659403,0.446124827377143
440.16,449,392,299,230496,264316,2023-09-18,2023-10-27,443.37,-93,33820,38114356,12392570,0.693481479786776,91.5600462985653,0.127952904856308
425.46,426,4579,4891,155686,264114,2023-09-18,2023-09-29,443.37,312,108428,154689262,55771573,0.170738418805049,97.1656959614947,0.410534844801866
432.2,434,1433,1462,147599,263160,2023-09-18,2023-10-06,443.37,29,115561,42650604,18727217,0.61701353631475,93.2452187546981,0.439128286973704
434.18,437.5,671,782,130174,259624,2023-09-18,2023-10-13,443.37,111,129450,30280851,12108347,0.8573867359276,92.991306618166,0.498605675900533
359.93,360,36942,36938,332478,258566,2023-09-18,2023-10-06,443.37,-4,-73912,42650604,18727217,0.606242293778536,93.8514610484766,-0.285853515156672
424.88,425,18096,21438,199056,257256,2023-09-18,2023-09-22,443.37,3342,58200,47965757,25232076,0.536332617454573,94.4538037833949,0.226233790465529
394.79,395,12096,12202,205632,256242,2023-09-18,2023-10-06,443.37,106,50610,42650604,18727217,0.600793367428044,94.4522544159046,0.197508605146697
399.86,400,15736,17916,188832,250824,2023-09-18,2023-09-29,443.37,2180,61992,154689262,55771573,0.162147001515852,97.3278429630106,0.24715338245144
314.79,315,11877,11901,225663,249921,2023-09-18,2023-11-17,443.37,24,24258,443991078,126746889,0.0562896446311023,99.2374220636929,0.0970626718042901
395.54,396,5317,5424,196729,249504,2023-09-18,2023-10-20,443.37,107,52775,473926306,145207170,0.0526461597174984,99.3489673476788,0.211519654995511
443.34,458,1577,169,1439801,247754,2023-09-18,2023-09-29,443.37,-1408,-1192047,154689262,55771573,0.160162377657474,97.4880053406681,-4.81141374104959
304.65,305,7087,7067,219697,247345,2023-09-18,2023-12-15,443.37,-20,27648,508084803,96118471,0.0486818339260582,98.7019361805238,0.111779093978047
361.98,363,2232,2418,191952,246636,2023-09-18,2023-12-15,443.37,186,54684,508084803,96118471,0.0485422902916465,98.7504784708154,0.221719457013575
443.45,465,4404,114,7125672,245670,2023-09-18,2023-10-20,443.37,-4290,-6880002,473926306,145207170,0.0518371731827859,99.4008045208615,-28.0050555623397
399.75,400,9734,9776,175212,244400,2023-09-18,2023-10-06,443.37,42,69188,42650604,18727217,0.573028227220416,95.0252826431251,0.283093289689034
430.41,434,305,679,70760,243761,2023-09-18,2023-10-27,443.37,374,173001,38114356,12392570,0.639551669192574,92.1995979677579,0.70971566411362
379.97,380,79913,80714,239739,242142,2023-09-18,2023-09-22,443.37,801,2403,47965757,25232076,0.504822638366783,94.9586264217617,0.00992392893426171
408.94,410,762,2284,57150,242104,2023-09-18,2023-10-27,443.37,1522,184954,38114356,12392570,0.635204225935236,92.8348021936931,0.763944420579586
369.81,371,2029,2030,202900,241570,2023-09-18,2023-12-15,443.37,1,38670,508084803,96118471,0.0475452126443546,98.7980236834598,0.160077824233141
411.1,412,2525,2676,151500,240840,2023-09-18,2023-10-20,443.37,151,89340,473926306,145207170,0.0508180273917945,99.4516225482533,0.370951669157947
360.04,361,2487,2506,253674,240576,2023-09-18,2023-12-15,443.37,19,-13098.0000000001,508084803,96118471,0.047349576011625,98.8453732594714,-0.0544443335993618
432,436,287,595,76916,238000,2023-09-18,2023-10-27,443.37,308,161084,38114356,12392570,0.624436629599619,93.4592388232927,0.676823529411765
433.2,437.5,170,551,48960,236930,2023-09-18,2023-10-27,443.37,381,187970,38114356,12392570,0.621629288449738,94.0808681117425,0.793356687629258
365.07,366,2534,2534,235662,235662,2023-09-18,2023-12-15,443.37,0,0,508084803,96118471,0.0463824146301026,98.8917556741015,0
399.61,400,5993,6040,173797,235560,2023-09-18,2023-10-13,443.37,47,61763,30280851,12108347,0.777917370948392,93.7692239891144,0.26219646799117
437.85,447,0,257,0,235155,2023-09-18,2023-11-17,443.37,257,235155,443991078,126746889,0.0529639021259792,99.2903859658189,1
372.72,374,1105,1823,146965,233344,2023-09-18,2023-12-15,443.37,718,86379,508084803,96118471,0.0459261915771175,98.9376818656786,0.370178791826659
399.54,401,1419,1592,166023,232432,2023-09-18,2023-11-17,443.37,173,66409.0000000001,443991078,126746889,0.0523506015136638,99.3427365673326,0.285713671095202
386.22,388,1298,1298,193402,231044,2023-09-18,2023-12-15,443.37,0,37642,508084803,96118471,0.0454735112398156,98.9831553769185,0.162921348314607
366.97,368,2228,2228,209432,229484,2023-09-18,2023-12-15,443.37,0,20052,508084803,96118471,0.0451664758806022,99.0283218527991,0.0873786407766992
436.68,442.5,393,393,152484,228726,2023-09-18,2023-10-27,443.37,0,76242,38114356,12392570,0.600104590511775,94.6809727022542,0.333333333333333
443.05,460,71,134,82715,227130,2023-09-18,2023-10-27,443.37,63,144415,38114356,12392570,0.595917191936812,95.2768898941911,0.635825298287324
394.92,396,1965,2099,188640,226692,2023-09-18,2023-11-17,443.37,134,38052,443991078,126746889,0.0510577827422019,99.3937943500748,0.167857710020645
429.81,432,1095,1029,144540,225351,2023-09-18,2023-10-13,443.37,-66,80811,30280851,12108347,0.744202994823362,94.5134269839378,0.358600583090379
385.27,387,1650,1271,255750,219883,2023-09-18,2023-12-15,443.37,-379,-35867,508084803,96118471,0.0432768306986737,99.0715986834977,-0.163118567601861
391,392,2194,2194,190878,219400,2023-09-18,2023-11-17,443.37,0,28522,443991078,126746889,0.0494154073969928,99.4432097574717,0.13
324.75,325,8810,8724,185010,218100,2023-09-18,2023-11-17,443.37,-86,33090,443991078,126746889,0.0491226087205293,99.4923323661923,0.15171939477304
382.52,384,1464,1465,199104,216820,2023-09-18,2023-12-15,443.37,1,17715.9999999999,508084803,96118471,0.0426739785799104,99.1142726620776,0.0817083294898992
444.55,480,172,61,567600,216245,2023-09-18,2023-12-15,443.37,-111,-351355,508084803,96118471,0.0425608084955849,99.1568334705732,-1.62480057342366
437.56,444,339,333,140346,214452,2023-09-18,2023-10-27,443.37,-6,74106,38114356,12392570,0.562654134835703,95.8395440290268,0.345559845559846
369.97,370,71277,71295,213831,213885,2023-09-18,2023-09-22,443.37,18,54,47965757,25232076,0.445911861664145,95.4045382834258,0.000252472122869766
354.95,355,42208,42138,168832,210690,2023-09-18,2023-09-29,443.37,-70,41858,154689262,55771573,0.136202084925585,97.6242074255936,0.198671033271631
418.68,419,6596,6534,151708,209088,2023-09-18,2023-09-29,443.37,-62,57380,154689262,55771573,0.135166460358444,97.7593738859521,0.274429905111723
445.43,500,41,38,227140,207366,2023-09-18,2023-11-17,443.37,-3,-19774,443991078,126746889,0.0467049925719453,99.5390373587642,-0.0953579661082338
334.7,335,6867,6861,185409,205830,2023-09-18,2023-11-17,443.37,-6,20421,443991078,126746889,0.0463590396742162,99.5853963984384,0.09921294271972
404.39,407,784,785,193648,204885,2023-09-18,2023-12-15,443.37,1,11237,508084803,96118471,0.0403249612643896,99.1971584318376,0.0548454010786537
239.91,240,22349,22349,178792,201141,2023-09-18,2023-12-15,443.37,0,22349,508084803,96118471,0.0395880764022773,99.2367465082399,0.111111111111111
389.97,391,1939,1942,164815,200026,2023-09-18,2023-11-17,443.37,3,35211,443991078,126746889,0.0450518061986822,99.6304482046371,0.176032115824943
431.34,433,1971,1202,187245,199532,2023-09-18,2023-10-06,443.37,-769,12287,42650604,18727217,0.467829248092243,95.4931118912173,0.0615790950824932
352.28,353,2739,2739,197208,197208,2023-09-18,2023-12-15,443.37,0,0,508084803,96118471,0.0388139930254911,99.2755605012654,0
289.74,290,7578,7583,174294,197158,2023-09-18,2023-12-15,443.37,5,22864,508084803,96118471,0.0388041521485932,99.314364653414,0.115967903914627
392.83,394,1481,1683,133290,196911,2023-09-18,2023-11-17,443.37,202,63621,443991078,126746889,0.0443502155239255,99.6747984201611,0.323095205448147
433.62,434,4751,5171,104522,196498,2023-09-18,2023-09-22,443.37,420,91976,47965757,25232076,0.409663085271436,95.8142013686973,0.468076010951766
442.72,452,244,211,136152,195808,2023-09-18,2023-10-06,443.37,-33,59656,42650604,18727217,0.459097835988442,95.9522097272057,0.304665795064553
415.26,416,2565,2587,141075,191438,2023-09-18,2023-10-13,443.37,22,50363,30280851,12108347,0.632208123873401,95.1456351078112,0.263077340966788
394.96,395,47514,47547,237570,190188,2023-09-18,2023-09-22,443.37,33,-47382,47965757,25232076,0.396507867060245,96.2107092357575,-0.249132437377753
199.95,200,37435,37435,187175,187175,2023-09-18,2023-12-15,443.37,0,0,508084803,96118471,0.0368393226671651,99.3512039760811,0
442.72,455,116,152,99760,186656,2023-09-18,2023-10-27,443.37,36,86896,38114356,12392570,0.48972623333843,96.3292702623652,0.465540888050746
391.9,393,1695,1696,152550,186560,2023-09-18,2023-11-17,443.37,1,34010,443991078,126746889,0.0420188623700227,99.7168172825311,0.182300600343053
389.89,390,16859,16666,151731,183326,2023-09-18,2023-09-29,443.37,-193,31595,154689262,55771573,0.118512427837428,97.8778863137895,0.172343257366658
420.62,421,4641,4726,116025,179588,2023-09-18,2023-09-29,443.37,85,63563,154689262,55771573,0.116095970514101,97.9939822843036,0.353937902309731
404.14,405,1280,2016,80640,173376,2023-09-18,2023-10-27,443.37,736,92736,38114356,12392570,0.454883718880099,96.7841539812453,0.534883720930233
408.21,409,2206,2186,123536,172694,2023-09-18,2023-10-20,443.37,-20,49158,473926306,145207170,0.0364389985982335,99.4880615468516,0.284653780675646
428.97,431,800,835,96800,169505,2023-09-18,2023-10-13,443.37,35,72705,30280851,12108347,0.559776209724093,95.7054113175353,0.428925400430666
284.76,285,6901,7002,151822,168048,2023-09-18,2023-12-15,443.37,101,16226,508084803,96118471,0.033074793618655,99.3842787696998,0.0965557459773398
394.8,397,758,757,141746,166540,2023-09-18,2023-12-15,443.37,-1,24794,508084803,96118471,0.0327779927714154,99.4170567624712,0.14887714663144
319.77,320,6739,7203,134780,165669,2023-09-18,2023-11-17,443.37,464,30889,443991078,126746889,0.0373135876392543,99.7541308701703,0.186450090240178
409.63,410,4418,4448,114868,164576,2023-09-18,2023-10-06,443.37,30,49708,42650604,18727217,0.385870268097493,96.3380799953032,0.302036748979195
397.48,398,3071,3136,116698,163072,2023-09-18,2023-10-20,443.37,65,46374,473926306,145207170,0.0344087251404863,99.522470271992,0.284377452904239
430.82,432.5,1744,958,156960,160944,2023-09-18,2023-10-06,443.37,-786,3983.99999999997,42650604,18727217,0.377354562200338,96.7154345575036,0.024753951685058
429.17,432.5,442,482,99008,160506,2023-09-18,2023-10-27,443.37,40,61498,38114356,12392570,0.421116914582002,97.2052708958273,0.383150785640412
417.7,418,4773,5349,100233,160470,2023-09-18,2023-09-29,443.37,576,60237,154689262,55771573,0.1037370001804,98.097719284484,0.375378575434661
394.87,395,12190,12184,121900,158392,2023-09-18,2023-09-29,443.37,-6,36492,154689262,55771573,0.102393661946619,98.2001129464306,0.230390423758776
422.57,423,2671,3656,72117,157208,2023-09-18,2023-09-29,443.37,985,85091,154689262,55771573,0.101628256523714,98.3017412029544,0.541263803368785
419.01,420,1425,1564,91200,154836,2023-09-18,2023-10-13,443.37,139,63636,30280851,12108347,0.511333053354412,96.2167443708897,0.410989692319616
434.22,439,438,317,138408,151526,2023-09-18,2023-10-27,443.37,-121,13118,38114356,12392570,0.397556238389545,97.6028271342168,0.0865726014017394
374.92,375,18935,18888,132545,151104,2023-09-18,2023-09-29,443.37,-47,18559,154689262,55771573,0.097682281269142,98.3994234842235,0.122822691656078
379.92,380,18436,18850,129052,150800,2023-09-18,2023-09-29,443.37,414,21748,154689262,55771573,0.0974857582551528,98.4969092424786,0.1442175066313
409.94,410,24730,24940,173110,149640,2023-09-18,2023-09-22,443.37,210,-23470,47965757,25232076,0.311972559924364,96.5226817956819,-0.156843090082866
448.44,461,748,119,939488,149464,2023-09-18,2023-10-20,443.37,-629,-790024,473926306,145207170,0.0315373926510845,99.5540076646431,-5.28571428571429
427.84,428,9235,9341,129290,149456,2023-09-18,2023-09-22,443.37,106,20166,47965757,25232076,0.311588952927398,96.8342707486093,0.134929343753345
375.63,377,1089,1089,150282,149193,2023-09-18,2023-12-15,443.37,0,-1089,508084803,96118471,0.0293637989404694,99.4464205614117,-0.0072992700729927
444.58,480,127,41,428244,145222,2023-09-18,2023-11-17,443.37,-86,-283022,443991078,126746889,0.0327083149179858,99.7868391850883,-1.94889204115079
384.96,385,35982,36021,143928,144084,2023-09-18,2023-09-22,443.37,39,156,47965757,25232076,0.300389296472481,97.1346600450818,0.00108270175730824
416.73,417,5209,5227,109389,141129,2023-09-18,2023-09-29,443.37,18,31740,154689262,55771573,0.0912338698726225,98.5881431123513,0.224900622834428
426.85,427,8916,9384,115908,140760,2023-09-18,2023-09-22,443.37,468,24852,47965757,25232076,0.293459352679454,97.4281193977612,0.176555839727195
409.4,410,2129,2323,87289,139380,2023-09-18,2023-10-13,443.37,194,52091,30280851,12108347,0.460290894730799,96.6770352656205,0.373733677715598
447.19,490,32,32,136992,136992,2023-09-18,2023-12-15,443.37,0,0,508084803,96118471,0.0269624281598519,99.4733829895715,0
353.17,354,1617,1611,118041,133713,2023-09-18,2023-12-15,443.37,-6,15672,508084803,96118471,0.0263170634528898,99.4997000530244,0.117206255188351
429.55,431,955,922,76400,133690,2023-09-18,2023-10-06,443.37,-33,57290,42650604,18727217,0.313453943114147,97.0288885006177,0.428528685765577
374.68,376,1153,1012,153349,133584,2023-09-18,2023-12-15,443.37,-141,-19765,508084803,96118471,0.0262916739904933,99.5259917270149,-0.147959336447479
269.81,270,6972,7022,111552,133418,2023-09-18,2023-12-15,443.37,50,21866,508084803,96118471,0.0262590022791924,99.5522507292941,0.16389092925992
443.22,464,2173,63,4324270,130914,2023-09-18,2023-10-20,443.37,-2110,-4193356,473926306,145207170,0.0276232820045233,99.5816309466477,-32.0313793788288
329.9,330,13301,13077,119709,130770,2023-09-18,2023-10-20,443.37,-224,11061,473926306,145207170,0.027592897533736,99.6092238441814,0.0845836200963525
425.93,427,1276,1207,84216,129149,2023-09-18,2023-10-06,443.37,-69,44933,42650604,18727217,0.302806966110023,97.3316954667277,0.347915973023407
425.03,426,789,1326,48129,128622,2023-09-18,2023-10-06,443.37,537,80493,42650604,18727217,0.30157134468717,97.6332668114149,0.625810514530951
324.9,325,12795,12841,102360,128410,2023-09-18,2023-10-20,443.37,46,26050,473926306,145207170,0.0270949298180549,99.6363187739994,0.202865820418971
401.41,402,2172,2172,91224,128148,2023-09-18,2023-10-20,443.37,0,36924,473926306,145207170,0.0270396469614835,99.6633584209609,0.288135593220339
443.37,454,221,119,118677,126497,2023-09-18,2023-09-22,443.37,-102,7820,47965757,25232076,0.263723555952635,97.6918429537138,0.0618196478967881
426.4,429,363,481,64614,125060,2023-09-18,2023-10-27,443.37,118,60446,38114356,12392570,0.328117835704741,97.9309449699216,0.483335998720614
425.52,428,295,488,48675,121024,2023-09-18,2023-10-27,443.37,193,72349,38114356,12392570,0.317528649834724,98.2484736197563,0.597807046536224
299.85,300,7951,7965,111314,119475,2023-09-18,2023-11-17,443.37,14,8160.99999999999,443991078,126746889,0.0269093245157508,99.8137485096041,0.0683071772337308
443.23,460,97,71,109610,119067,2023-09-18,2023-10-06,443.37,-26,9456.99999999999,42650604,18727217,0.27916837942084,97.9124351908358,0.0794258694684504
445.23,456,109,110,100171,118470,2023-09-18,2023-10-27,443.37,1,18299,38114356,12392570,0.310827762641457,98.5593013823978,0.154461044990293
426.89,428,1056,1045,66528,115995,2023-09-18,2023-10-06,443.37,-11,49467,42650604,18727217,0.271965667825009,98.1844008586608,0.426458036984353
356.13,357,1324,1324,115188,115188,2023-09-18,2023-12-15,443.37,0,0,508084803,96118471,0.0226710185622301,99.5749217478564,0
448.56,469,56,56,114464,114464,2023-09-18,2023-12-15,443.37,0,0,508084803,96118471,0.0225285226647489,99.5974502705211,0
219.94,220,18559,18559,111354,111354,2023-09-18,2023-12-15,443.37,0,0,508084803,96118471,0.0219164201217016,99.6193666906428,0
402.86,403,7941,7937,103233,111118,2023-09-18,2023-09-29,443.37,-4,7885,154689262,55771573,0.0718330403567379,98.659976152708,0.0709606004427726
406.28,407,1463,1529,73150,110088,2023-09-18,2023-10-20,443.37,66,36938,473926306,145207170,0.023228927916907,99.6865873488778,0.335531574740208
404.71,405,3671,3778,77091,109562,2023-09-18,2023-10-06,443.37,107,32471,42650604,18727217,0.256882645788557,98.4412835044493,0.296371004545371
354.97,355,36280,36318,72560,108954,2023-09-18,2023-09-22,443.37,38,36394,47965757,25232076,0.227149547540759,97.9189925012546,0.334030875415313
364.97,365,36139,36236,108417,108708,2023-09-18,2023-09-22,443.37,97,291,47965757,25232076,0.22663668166438,98.145629182919,0.00267689590462523
446.22,480,222,32,683760,108096,2023-09-18,2023-10-20,443.37,-190,-575664,473926306,145207170,0.022808609404349,99.7093959582822,-5.32548845470693
339.88,340,8774,8793,87740,105516,2023-09-18,2023-10-20,443.37,19,17776,473926306,145207170,0.0222642209694095,99.7316601792516,0.168467341445847
264.83,265,6135,6143,92025,104431,2023-09-18,2023-12-15,443.37,8,12406,508084803,96118471,0.020553852306423,99.6399205429492,0.118796142907757
309.93,310,14842,14682,74210,102774,2023-09-18,2023-10-20,443.37,-160,28564,473926306,145207170,0.0216856500048343,99.7533458292564,0.277930215813338
406.79,407,4879,4881,68306,102501,2023-09-18,2023-09-29,443.37,2,34195,154689262,55771573,0.066262517950341,98.7262386706584,0.333606501399986
294.86,295,7290,7303,87480,102242,2023-09-18,2023-11-17,443.37,13,14762,443991078,126746889,0.0230279402146004,99.8367764498187,0.144382934606131
444.07,475,35,33,92365,102069,2023-09-18,2023-10-20,443.37,-2,9704,473926306,145207170,0.021536892699938,99.7748827219564,0.0950729408537362
279.9,280,10130,10161,91170,101610,2023-09-18,2023-11-17,443.37,31,10440,443991078,126746889,0.022885595011889,99.8596620448306,0.102745792736935
443.6,462,3409,55,4615786,101200,2023-09-18,2023-10-20,443.37,-3354,-4514586,473926306,145207170,0.0213535308588673,99.7962362528152,-44.610533596838
279.78,280,4590,4588,91800,100936,2023-09-18,2023-12-15,443.37,-2,9136,508084803,96118471,0.019865975011262,99.6597865179605,0.0905128001902195
424.62,427,275,415,44000,98770,2023-09-18,2023-10-27,443.37,140,54770,38114356,12392570,0.259141201283842,98.8184425836816,0.554520603422092
425.46,427,400,638,36800,98252,2023-09-18,2023-10-13,443.37,238,61452,30280851,12108347,0.324469084438875,97.0015043500594,0.625452916988967
361.07,362,1047,1047,97371,97371,2023-09-18,2023-12-15,443.37,0,0,508084803,96118471,0.0191643204884441,99.6789508384489,0
443.82,460,101,60,116150,97080,2023-09-18,2023-10-13,443.37,-41,-19070,30280851,12108347,0.320598651603286,97.3221030016627,-0.196435929130614
367.88,369,872,865,87200,96880,2023-09-18,2023-12-15,443.37,-7,9680,508084803,96118471,0.0190676830773071,99.6980185215262,0.0999174236168456
445.25,472,54,36,144450,96300,2023-09-18,2023-12-15,443.37,-18,-48150,508084803,96118471,0.0189535289052918,99.7169720504315,-0.5
411.78,412,4381,4353,78858,95766,2023-09-18,2023-09-29,443.37,-28,16908,154689262,55771573,0.0619086281502849,98.7881472988086,0.176555353674582
426.36,428,499,572,49900,93808,2023-09-18,2023-10-13,443.37,73,43908,30280851,12108347,0.309793142867748,97.6318961445304,0.468062425379499
445.04,500,995,17,5475485,93432,2023-09-18,2023-12-15,443.37,-978,-5382053,508084803,96118471,0.0183890562064302,99.7353611066379,-57.6039579587294
414.26,415,1185,1261,56880,93314,2023-09-18,2023-10-13,443.37,76,36434,30280851,12108347,0.308161748822713,97.9400578933531,0.39044516364104
415.73,416,3429,3447,68580,93069,2023-09-18,2023-09-29,443.37,18,24489,154689262,55771573,0.0601651328584139,98.848312431667,0.263127357122135
351.26,352,1250,1250,92500,92500,2023-09-18,2023-12-15,443.37,0,0,508084803,96118471,0.0182056222610539,99.753566728899,0
442.24,457,0,62,0,91512,2023-09-18,2023-11-17,443.37,62,91512,443991078,126746889,0.020611224985021,99.8802732698156,1
364.93,365,13084,13060,65420,91420,2023-09-18,2023-09-29,443.37,-24,26000,154689262,55771573,0.0590991247989793,98.907411556466,0.284401662655874
428.82,429,4560,5048,63840,90864,2023-09-18,2023-09-22,443.37,488,27024,47965757,25232076,0.189435142241162,98.3350643251601,0.297411516111991
428.91,432,225,289,48600,89301,2023-09-18,2023-10-27,443.37,64,40701,38114356,12392570,0.234297543949057,99.0527401276307,0.455773171633016
299.95,300,17957,17663,89785,88315,2023-09-18,2023-10-20,443.37,-294,-1469.99999999999,473926306,145207170,0.0186347537332102,99.8148710065484,-0.0166449640491421
414.52,415,1642,1804,52544,86592,2023-09-18,2023-10-06,443.37,162,34048,42650604,18727217,0.203026433107489,98.6443099375568,0.39320029563932
443.9,485,25,21,89975,86310,2023-09-18,2023-10-20,443.37,-4,-3665,473926306,145207170,0.0182116921781506,99.8330826987266,-0.0424632139960607
423.89,424,2193,7594,24123,83534,2023-09-18,2023-09-22,443.37,5401,59411,47965757,25232076,0.174153406981568,98.5092177321417,0.711219383723993
249.95,250,16571,16571,33142,82855,2023-09-18,2023-10-20,443.37,0,49713,473926306,145207170,0.0174826758825242,99.8505653746091,0.6
427.2,429,377,446,40339,80280,2023-09-18,2023-10-13,443.37,69,39941,30280851,12108347,0.265118044403706,98.2051759377568,0.497521175884405
443.87,457,3349,61,2813160,80093,2023-09-18,2023-09-29,443.37,-3288,-2733067,154689262,55771573,0.0517767031560342,98.9591882596221,-34.1236687350955
349.96,350,19487,19483,77948,77932,2023-09-18,2023-09-29,443.37,-4,-16,154689262,55771573,0.0503797089677757,99.0095679685898,-0.000205307190884361
421.99,424,304,383,42864,76983,2023-09-18,2023-10-27,443.37,79,34119,38114356,12392570,0.2019790128423,99.254719140473,0.443201745839991
419.91,420,9738,8376,87642,75384,2023-09-18,2023-09-22,443.37,-1362,-12258,47965757,25232076,0.15716211880071,98.6663798509424,-0.162607449856734
364.92,365,9474,9366,85266,74928,2023-09-18,2023-10-06,443.37,-108,-10338,42650604,18727217,0.175678637517068,98.8199885750739,-0.137972453555413
304.95,305,14795,14647,73975,73235,2023-09-18,2023-10-20,443.37,-148,-740,473926306,145207170,0.0154528244313157,99.8660181990404,-0.0101044582508363
359.93,360,10047,10021,60282,70147,2023-09-18,2023-09-29,443.37,-26,9865.00000000001,154689262,55771573,0.0453470390207176,99.0549150076106,0.140633241621167
417.12,418,751,791,45811,69608,2023-09-18,2023-10-13,443.37,40,23797,30280851,12108347,0.229874649163592,98.4350505869204,0.34187162395127
209.95,210,13890,13892,69450,69460,2023-09-18,2023-12-15,443.37,2,10,508084803,96118471,0.0136709461865168,99.7672376750855,0.000143967751223726
189.95,190,13524,13524,67620,67620,2023-09-18,2023-12-15,443.37,0,0,508084803,96118471,0.0133088019166753,99.7805464770022,0
384.83,385,3817,3822,49621,64974,2023-09-18,2023-10-06,443.37,5,15353,42650604,18727217,0.152340163811045,98.9723287388849,0.236294517807123
443.27,464,58,31,115072,64263,2023-09-18,2023-09-29,443.37,-27,-50809,154689262,55771573,0.0415432843683746,99.0964582919789,-0.79064158224795
445.91,458,52,53,52000,64077,2023-09-18,2023-10-13,443.37,1,12077,30280851,12108347,0.211608980209968,98.6466595671304,0.188476364374112
443.3,456,3429,50,2606040,63500,2023-09-18,2023-09-29,443.37,-3379,-2542540,154689262,55771573,0.0410500374615531,99.1375083294405,-40.04
411.59,412,1546,1546,44834,63386,2023-09-18,2023-10-06,443.37,0,18552,42650604,18727217,0.148616887113721,99.1209456259987,0.292682926829268
249.88,250,5126,5141,61512,61692,2023-09-18,2023-12-15,443.37,15,179.999999999993,508084803,96118471,0.0121420675516642,99.7926885445539,0.00291772028788162
445.66,466,702,30,1427868,61020,2023-09-18,2023-10-20,443.37,-672,-1366848,473926306,145207170,0.0128754194961273,99.8788936185366,-22.4
350.3,351,869,869,60830,60830,2023-09-18,2023-12-15,443.37,0,0,508084803,96118471,0.011972410833945,99.8046609553878,0
344.87,345,4608,4616,55296,60008,2023-09-18,2023-10-20,443.37,8,4712.00000000001,473926306,145207170,0.0126618841875386,99.8915555027241,0.0785228636181844
434.19,441,0,88,0,59928,2023-09-18,2023-11-17,443.37,88,59928,443991078,126746889,0.0134975685254648,99.8937708383411,1
371.83,373,510,512,62220,59904,2023-09-18,2023-12-15,443.37,2,-2315.99999999999,508084803,96118471,0.0117901577937965,99.8164511131816,-0.0386618589743589
395.85,396,3950,3950,39500,59250,2023-09-18,2023-09-29,443.37,0,19750,154689262,55771573,0.0383025940094019,99.1758109234499,0.333333333333333
274.92,275,7399,7404,51793,59232,2023-09-18,2023-11-17,443.37,5,7439,443991078,126746889,0.0133408086186813,99.9071116469597,0.125590896812534
149.98,150,29996,29555,59992,59110,2023-09-18,2023-12-15,443.37,-441,-881.999999999993,508084803,96118471,0.0116338846686584,99.8280849978503,-0.0149213331077651
424.55,426,375,406,33750,58870,2023-09-18,2023-10-13,443.37,31,25120,30280851,12108347,0.194413294395194,98.8410728615256,0.426702904705283
404.53,405,1071,1245,36414,58515,2023-09-18,2023-10-13,443.37,174,22101,30280851,12108347,0.193240936326393,99.034313797852,0.377698026147142
314.95,315,11657,11566,69942,57830,2023-09-18,2023-10-20,443.37,-91,-12112,473926306,145207170,0.0122023190668804,99.903757821791,-0.209441466366937
259.85,260,3849,3849,61584,57735,2023-09-18,2023-12-15,443.37,0,-3849,508084803,96118471,0.011363260553967,99.8394482584042,-0.0666666666666667
427.76,429,423,456,29187,56544,2023-09-18,2023-10-06,443.37,33,27357,42650604,18727217,0.132574910310766,99.2535205363094,0.483817911714771
443.76,460,681,34,740247,55216,2023-09-18,2023-09-22,443.37,-647,-685031,47965757,25232076,0.115115456220153,98.7814953071626,-12.4063858301941
422.78,424,371,451,30793,55022,2023-09-18,2023-10-13,443.37,80,24229,30280851,12108347,0.181705593412814,99.2160193912648,0.440351132274363
442.07,454,44,46,35376,54878,2023-09-18,2023-10-27,443.37,2,19502,38114356,12392570,0.143982493105747,99.3987016335787,0.355370093662306
413.76,414,2242,2264,42598,54336,2023-09-18,2023-09-29,443.37,22,11738,154689262,55771573,0.0351259029214323,99.2109368263713,0.216026207302709
284.89,285,4589,4759,45890,52349,2023-09-18,2023-11-17,443.37,170,6459,443991078,126746889,0.0117905522416827,99.9189021992014,0.123383445720071
439.7,447.5,72,67,38664,52260,2023-09-18,2023-10-27,443.37,-5,13596,38114356,12392570,0.137113690180152,99.5358153237589,0.2601607347876
423.71,426,197,225,30732,51525,2023-09-18,2023-10-27,443.37,28,20793,38114356,12392570,0.135185282941682,99.6710006067005,0.403551673944687
334.9,335,5002,5029,45018,50290,2023-09-18,2023-10-20,443.37,27,5272,473926306,145207170,0.0106113544159332,99.9143691762069,0.104831974547624
234.92,235,6244,6249,49952,49992,2023-09-18,2023-12-15,443.37,5,39.9999999999927,508084803,96118471,0.00983930235756333,99.8492875607618,0.000800128020483132
224.92,225,6156,6144,43092,49152,2023-09-18,2023-12-15,443.37,-12,6060,508084803,96118471,0.00967397562567916,99.8589615363875,0.123291015625
444,525,6,6,48600,48600,2023-09-18,2023-12-15,443.37,0,0,508084803,96118471,0.00956533234472671,99.8685268687322,0
412.77,413,2073,2069,35241,47587,2023-09-18,2023-09-29,443.37,-4,12346,154689262,55771573,0.0307629627194162,99.2416997890907,0.259440603526173
387.88,388,3951,3954,35559,47448,2023-09-18,2023-09-29,443.37,3,11889,154689262,55771573,0.0306731051570988,99.2723728942478,0.25056904400607
345.28,346,651,651,41013,46872,2023-09-18,2023-12-15,443.37,0,5859,508084803,96118471,0.00922523163913643,99.8777521003713,0.125
254.87,255,3522,3532,49308,45916,2023-09-18,2023-12-15,443.37,10,-3392.00000000001,508084803,96118471,0.00903707407284921,99.8867891744442,-0.0738740308389234
319.92,320,5642,5632,33852,45056,2023-09-18,2023-10-20,443.37,-10,11204,473926306,145207170,0.0095069633041218,99.923876139511,0.248668323863636
443.34,475,570,14,1539000,44324,2023-09-18,2023-11-17,443.37,-556,-1494676,443991078,126746889,0.0099830834888984,99.9288852826903,-33.7215955238697
355.13,356,474,492,41712,42804,2023-09-18,2023-12-15,443.37,18,1092,508084803,96118471,0.00842457789472597,99.8952137523389,0.0255116344266891
347.26,348,564,565,36660,41810,2023-09-18,2023-12-15,443.37,1,5150,508084803,96118471,0.00822894126199638,99.9034426936009,0.123176273618752
405.94,406,6810,6951,40860,41706,2023-09-18,2023-09-22,443.37,141,846,47965757,25232076,0.0869495294320071,98.8684448365946,0.0202848511005611
443.1,457,21,30,21504,41700,2023-09-18,2023-10-27,443.37,9,20196,38114356,12392570,0.109407594345816,99.7804082010463,0.48431654676259
443.05,470,106,15,219844,40425,2023-09-18,2023-09-29,443.37,-91,-179419,154689262,55771573,0.0261330356595793,99.2985059299074,-4.43831787260359
407.68,408,1227,1257,30675,40224,2023-09-18,2023-10-06,443.37,30,9549,42650604,18727217,0.0943105049579134,99.3478310412673,0.237395584725537
444.7,510,24,6,156720,39180,2023-09-18,2023-12-15,443.37,-18,-117540,508084803,96118471,0.00771131113716857,99.9111540047381,-3
447.4,486,11,10,42460,38600,2023-09-18,2023-11-17,443.37,-1,-3860,443991078,126746889,0.00869386839345452,99.9375791510838,-0.1
363.08,364,398,398,36616,36616,2023-09-18,2023-12-15,443.37,0,0,508084803,96118471,0.00720667096984595,99.9183606757079,0
399.95,400,6593,7298,32965,36490,2023-09-18,2023-09-22,443.37,705,3525,47965757,25232076,0.0760751049962581,98.9445199415908,0.0966018087147164
179.97,180,11664,11664,34992,34992,2023-09-18,2023-12-15,443.37,0,0,508084803,96118471,0.00688703928820323,99.9252477149961,0
444.12,479,13,10,45344,34880,2023-09-18,2023-12-15,443.37,-3,-10464,508084803,96118471,0.00686499572395201,99.9321127107201,-0.3
289.96,290,8617,8626,34468,34504,2023-09-18,2023-10-20,443.37,9,36,473926306,145207170,0.00728045680587311,99.9311565963169,0.00104335729190818
443.75,458,98,24,90650,34200,2023-09-18,2023-10-06,443.37,-74,-56450,42650604,18727217,0.0801864376879633,99.4280174789553,-1.65058479532164
391.87,392,2673,2629,24057,34177,2023-09-18,2023-09-29,443.37,-44,10120,154689262,55771573,0.0220939705562756,99.3205999004637,0.296105568072095
443.37,466,34,15,58480,33945,2023-09-18,2023-11-17,443.37,-19,-24535,443991078,126746889,0.00764542390196408,99.9452245749857,-0.722786861098836
425.87,426,2012,2593,24144,33709,2023-09-18,2023-09-22,443.37,581,9565,47965757,25232076,0.0702772188084095,99.0147971603992,0.283752113678839
443.29,462,22,18,36806,33678,2023-09-18,2023-10-13,443.37,-4,-3128,30280851,12108347,0.111218802932586,99.3272381941974,-0.0928796246808005
443.71,459,173,22,174038,33638,2023-09-18,2023-10-06,443.37,-151,-140400,42650604,18727217,0.0788687541212781,99.5068862330766,-4.17385100184315
446.31,472,21,13,53949,33397,2023-09-18,2023-11-17,443.37,-8,-20552,443991078,126746889,0.00752199799834717,99.9527465729841,-0.615384615384615
379.79,380,1569,1589,26673,33369,2023-09-18,2023-10-13,443.37,20,6696,30280851,12108347,0.110198356050165,99.4374365502476,0.200665288141688
294.97,295,11210,11060,33630,33180,2023-09-18,2023-10-20,443.37,-150,-450,473926306,145207170,0.00700108847724524,99.9381576847941,-0.0135623869801085
410.78,411,1486,1489,23776,32758,2023-09-18,2023-09-29,443.37,3,8982,154689262,55771573,0.0211766476718985,99.3417765481356,0.274192563648574
448,471,14,14,32200,32200,2023-09-18,2023-12-15,443.37,0,0,508084803,96118471,0.00633752472222634,99.9384502354423,0
444.87,490,7,7,28910,31591,2023-09-18,2023-10-20,443.37,0,2681.00000000001,473926306,145207170,0.00666580428223792,99.9448234890764,0.0848659428318194
403.82,404,1710,1729,23940,31122,2023-09-18,2023-09-29,443.37,19,7181.99999999999,154689262,55771573,0.020119043557141,99.3618955916927,0.230769230769231
414.92,415,3660,3839,29280,30712,2023-09-18,2023-09-22,443.37,179,1432,47965757,25232076,0.0640290113632523,99.0788261717625,0.0466267257098203
444.11,458,10,22,10300,30558,2023-09-18,2023-10-27,443.37,12,20258,38114356,12392570,0.0801745148206099,99.860582715867,0.662936056024609
397.88,398,2537,2537,30444,30444,2023-09-18,2023-09-29,443.37,0,0,154689262,55771573,0.0196807455193626,99.3815763372121,0
361.95,362,6017,6017,30085,30085,2023-09-18,2023-09-29,443.37,0,0,154689262,55771573,0.0194486673548161,99.4010250045669,0
396.86,397,2131,2135,23441,29890,2023-09-18,2023-09-29,443.37,4,6449,154689262,55771573,0.0193226081846586,99.4203476127516,0.215757778521245
229.92,230,3723,3732,26061,29856,2023-09-18,2023-12-15,443.37,9,3795,508084803,96118471,0.00587618441325434,99.9443264198555,0.127110128617363
244.89,245,2651,2641,26510,29051,2023-09-18,2023-12-15,443.37,-10,2541,508084803,96118471,0.00571774629519868,99.9500441661507,0.0874668686103747
184.96,185,7182,7182,28728,28728,2023-09-18,2023-12-15,443.37,0,0,508084803,96118471,0.00565417423043846,99.9556983403812,0
375.93,376,4053,4053,28371,28371,2023-09-18,2023-09-29,443.37,0,0,154689262,55771573,0.0183406395719956,99.4386882523236,0
405.85,406,1889,1876,26446,28140,2023-09-18,2023-09-29,443.37,-13,1693.99999999999,154689262,55771573,0.0181913079396552,99.4568795602632,0.0601990049751241
289.88,290,2292,2310,25212,27720,2023-09-18,2023-11-17,443.37,18,2508,443991078,126746889,0.0062433687012062,99.9589899416853,0.0904761904761905
443.77,720,7,1,191121,27623,2023-09-18,2023-12-15,443.37,-6,-163498,508084803,96118471,0.0054366908509956,99.9611350312322,-5.91890815624661
420.9,421,2660,2738,26600,27380,2023-09-18,2023-09-22,443.37,78,780,47965757,25232076,0.0570823890051396,99.1359085607676,0.0284879474068663
443,482,10,7,33000,27300,2023-09-18,2023-10-20,443.37,-3,-5700,473926306,145207170,0.00576038925342963,99.9505838783298,-0.208791208791209
415.5,416,498,540,16434,27000,2023-09-18,2023-10-06,443.37,42,10566,42650604,18727217,0.0633050823852342,99.5701913154618,0.391333333333333
421.9,422,2347,2679,23470,26790,2023-09-18,2023-09-22,443.37,332,3320,47965757,25232076,0.0558523448300837,99.1917609055977,0.123926838372527
381.9,382,2492,2660,17444,26600,2023-09-18,2023-09-29,443.37,168,9156,154689262,55771573,0.0171957637240522,99.4740753239873,0.344210526315789
394.67,395,706,803,18356,26499,2023-09-18,2023-10-13,443.37,97,8143,30280851,12108347,0.0875107506060513,99.5249473008536,0.307294614891128
445,469,16,11,31200,26400,2023-09-18,2023-09-29,443.37,-5,-4800,154689262,55771573,0.0170664722674803,99.4911417962548,-0.181818181818182
413.52,414,536,550,16616,26400,2023-09-18,2023-10-06,443.37,14,9784,42650604,18727217,0.0618983027766735,99.6320896182385,0.370606060606061
376.92,377,3197,3271,19182,26168,2023-09-18,2023-09-29,443.37,74,6986,154689262,55771573,0.016916494177857,99.5080582904326,0.266967288291043
388.88,389,2155,2159,15085,25908,2023-09-18,2023-09-29,443.37,4,10823,154689262,55771573,0.0167484152843137,99.5248067057169,0.4177474139262
378.9,379,2522,2551,42874,25510,2023-09-18,2023-09-29,443.37,29,-17364,154689262,55771573,0.0164911252857357,99.5412978310027,-0.680674245393963
389.95,390,1548,5043,6192,25215,2023-09-18,2023-09-22,443.37,3495,19023,47965757,25232076,0.052568752328875,99.2443296579266,0.754431885782273
443.49,466,12,11,27012,24761,2023-09-18,2023-10-06,443.37,-1,-2251,42650604,18727217,0.0580554498126216,99.6901450680511,-0.0909090909090909
329.97,330,7962,7962,23886,23886,2023-09-18,2023-09-29,443.37,0,0,154689262,55771573,0.0154412786583726,99.556739109661,0
408.94,409,660,3976,4620,23856,2023-09-18,2023-09-22,443.37,3316,19236,47965757,25232076,0.0497354810849749,99.2940651390116,0.806338028169014
388.95,389,26,4667,104,23335,2023-09-18,2023-09-22,443.37,4641,23231,47965757,25232076,0.0486492895337814,99.3427144285454,0.995543175487465
264.98,265,11613,11613,23226,23226,2023-09-18,2023-10-20,443.37,0,0,473926306,145207170,0.00490076193407167,99.9554846402639,0
393.88,394,1931,1930,21241,23160,2023-09-18,2023-09-29,443.37,-1,1919,154689262,55771573,0.0149719506710168,99.571711060332,0.0828583765112263
412.93,413,3061,3245,21427,22715,2023-09-18,2023-09-22,443.37,184,1288,47965757,25232076,0.0473567007396548,99.390071129285,0.056702619414484
443.82,500,205,4,1044270,22472,2023-09-18,2023-10-20,443.37,-201,-1021798,473926306,145207170,0.00474166546897694,99.9602263057329,-45.4698291206835
382.92,383,2693,2771,18851,22168,2023-09-18,2023-09-29,443.37,78,3317,154689262,55771573,0.0143306650464206,99.5860417253785,0.149630097437748
279.97,280,6943,7260,13886,21780,2023-09-18,2023-10-20,443.37,317,7894,473926306,145207170,0.00459565120658232,99.9648219569394,0.362442607897153
390.91,391,2347,2347,21123,21123,2023-09-18,2023-09-29,443.37,0,0,154689262,55771573,0.0136551171858328,99.5996968425643,0
269.93,270,2970,3008,20790,21056,2023-09-18,2023-11-17,443.37,38,266.000000000004,443991078,126746889,0.0047424376397041,99.963732379325,0.0126329787234044
204.95,205,4081,4181,20405,20905,2023-09-18,2023-12-15,443.37,100,500,508084803,96118471,0.00411447063099819,99.9652495018632,0.0239177230327673
439.08,449,0,21,0,20832,2023-09-18,2023-11-17,443.37,21,20832,443991078,126746889,0.00469198617545193,99.9684243655004,1
417.46,418,323,379,11951,20466,2023-09-18,2023-10-06,443.37,56,8515,42650604,18727217,0.0479852524480075,99.7381303204991,0.416055897586241
392.88,393,1687,1688,16870,20256,2023-09-18,2023-09-29,443.37,1,3386,154689262,55771573,0.013094638721594,99.6127914812859,0.167160347551343
408.8,409,1008,1005,15120,20100,2023-09-18,2023-09-29,443.37,-3,4980,154689262,55771573,0.012993791385468,99.6257852726714,0.247761194029851
373.92,374,2458,2469,14748,19752,2023-09-18,2023-09-29,443.37,11,5004,154689262,55771573,0.012768824251033,99.6385540969224,0.253341433778858
422.89,423,1583,1753,15830,19283,2023-09-18,2023-09-22,443.37,170,3453,47965757,25232076,0.0402015963179733,99.430272725603,0.179069646839185
386.92,387,2298,2363,20682,18904,2023-09-18,2023-09-29,443.37,65,-1778,154689262,55771573,0.0122206284751685,99.6507747253976,-0.0940541684299619
391.95,392,3766,3766,15064,18830,2023-09-18,2023-09-22,443.37,0,3766,47965757,25232076,0.0392571725700066,99.469529898173,0.2
413.29,414,145,263,7105,18673,2023-09-18,2023-10-13,443.37,118,11568,30280851,12108347,0.0616660344189138,99.5866133352725,0.619504096824292
349.98,350,9265,9278,18530,18556,2023-09-18,2023-09-22,443.37,13,26,47965757,25232076,0.038685931715828,99.5082158298888,0.00140116404397499
366.96,367,4608,4608,18432,18432,2023-09-18,2023-09-29,443.37,0,0,154689262,55771573,0.011915500637659,99.6626902260352,0
367.94,368,3043,3043,18258,18258,2023-09-18,2023-09-29,443.37,0,0,154689262,55771573,0.0118030170704415,99.6744932431057,0
413.9,414,1792,1821,14336,18210,2023-09-18,2023-09-22,443.37,29,3874,47965757,25232076,0.03796458377588,99.5461804136647,0.212740252608457
446.77,477,60,6,181380,18138,2023-09-18,2023-12-15,443.37,-54,-163242,508084803,96118471,0.00356987650347023,99.9688193783667,-9
360.95,361,3606,3602,18030,18010,2023-09-18,2023-09-29,443.37,-4,-19.9999999999964,154689262,55771573,0.0116426956642925,99.68613593877,-0.00111049416990541
401.84,402,1096,1096,13152,17536,2023-09-18,2023-09-29,443.37,0,4384,154689262,55771573,0.0113362749122172,99.6974722136822,0.25
340.96,341,4373,4383,13119,17532,2023-09-18,2023-09-29,443.37,10,4413,154689262,55771573,0.0113336890830858,99.7088059027653,0.251711156741958
339.97,340,5831,5706,23324,17118,2023-09-18,2023-09-29,443.37,-125,-6206,154689262,55771573,0.0110660557679821,99.7198719585332,-0.362542353078631
384.75,385,672,678,13440,16950,2023-09-18,2023-10-13,443.37,6,3510,30280851,12108347,0.0559759697638617,99.6425893050364,0.207079646017699
400.96,401,4022,4236,20110,16944,2023-09-18,2023-09-22,443.37,214,-3166,47965757,25232076,0.0353252008510988,99.5815056145158,-0.186850802644004
164.98,165,8396,8398,25188,16796,2023-09-18,2023-12-15,443.37,2,-8392,508084803,96118471,0.00330574736753148,99.9721251257342,-0.499642772088593
403.61,404,348,430,11484,16770,2023-09-18,2023-10-13,443.37,82,5286,30280851,12108347,0.0553815346867233,99.6979708397231,0.31520572450805
377.91,378,1287,1827,9009,16443,2023-09-18,2023-09-29,443.37,540,7434,154689262,55771573,0.0106296971020522,99.7305016556353,0.452107279693487
405.75,406,711,648,16353,16200,2023-09-18,2023-10-06,443.37,-63,-153,42650604,18727217,0.0379830494311405,99.7761133699302,-0.00944444444444444
380.93,381,2283,2258,15981,15806,2023-09-18,2023-09-29,443.37,-25,-175,154689262,55771573,0.010217903812871,99.7407195594482,-0.0110717449069973
284.97,285,5266,5266,15798,15798,2023-09-18,2023-10-20,443.37,0,0,473926306,145207170,0.00333342964929235,99.9681553865887,0
214.93,215,2232,2232,15624,15624,2023-09-18,2023-12-15,443.37,0,0,508084803,96118471,0.00307507721304548,99.9752002029472,0
379.85,380,983,1030,11796,15450,2023-09-18,2023-10-06,443.37,47,3654,42650604,18727217,0.0362245749204396,99.8123379448507,0.236504854368932
417.92,418,2148,1918,19332,15344,2023-09-18,2023-09-22,443.37,-230,-3988,47965757,25232076,0.0319894878339979,99.6134951023498,-0.259906152241919
383.9,384,1319,1530,10552,15300,2023-09-18,2023-09-29,443.37,211,4748,154689262,55771573,0.00989079642774429,99.7506103558759,0.310326797385621
448.32,470,7,7,15176,15176,2023-09-18,2023-10-06,443.37,0,0,42650604,18727217,0.0355821455658635,99.8479200904166,0
440.16,590,1,1,14984,14984,2023-09-18,2023-12-15,443.37,0,0,508084803,96118471,0.00294911398875278,99.978149316936,0
194.95,195,2996,2996,14980,14980,2023-09-18,2023-12-15,443.37,0,0,508084803,96118471,0.00294832671860095,99.9810976436546,0
440.35,451,0,14,0,14910,2023-09-18,2023-11-17,443.37,14,14910,443991078,126746889,0.00335817558928515,99.9717825410897,1
443.44,462,34,8,46920,14848,2023-09-18,2023-10-06,443.37,-26,-32072,42650604,18727217,0.0348131060465169,99.8827331964631,-2.16002155172414
448.65,461,12,12,14820,14820,2023-09-18,2023-10-27,443.37,0,0,38114356,12392570,0.0388829867675057,99.8994657026345,0
446.03,467,5,7,11800,14679,2023-09-18,2023-09-29,443.37,2,2879,154689262,55771573,0.00948934645508878,99.760099702331,0.19613052660263
324.97,325,4829,4823,9658,14469,2023-09-18,2023-09-29,443.37,-6,4811,154689262,55771573,0.00935359042568837,99.7694532927567,0.332503974013408
444.48,473,8,5,22816,14260,2023-09-18,2023-12-15,443.37,-3,-8556,508084803,96118471,0.00280661809127167,99.9839042617459,-0.6
356.92,357,1779,1779,14232,14232,2023-09-18,2023-09-29,443.37,0,0,154689262,55771573,0.00920038004965076,99.7786536728063,0
406.94,407,1236,2283,7416,13698,2023-09-18,2023-09-22,443.37,1047,6282,47965757,25232076,0.0285578730676553,99.6420529754175,0.458607095926413
154.98,155,6770,6770,13540,13540,2023-09-18,2023-12-15,443.37,0,0,508084803,96118471,0.00266490946394238,99.9865691712098,0
451.36,485,5,4,16820,13456,2023-09-18,2023-12-15,443.37,-1,-3364,508084803,96118471,0.00264837679075396,99.9892175480005,-0.25
370.92,371,1359,1663,8154,13304,2023-09-18,2023-09-29,443.37,304,5150,154689262,55771573,0.00860046769115752,99.7872541404975,0.387101623571858
249.95,250,2664,2659,13320,13295,2023-09-18,2023-11-17,443.37,-5,-25,443991078,126746889,0.00299442954121704,99.9747769706309,-0.00188040616773223
344.96,345,3279,3299,16395,13196,2023-09-18,2023-09-29,443.37,20,-3199,154689262,55771573,0.00853065030460873,99.7957847908021,-0.242421946044256
345.96,346,3329,3299,9987,13196,2023-09-18,2023-09-29,443.37,-30,3209,154689262,55771573,0.00853065030460873,99.8043154411067,0.24317975143983
372.93,373,1844,1848,11064,12936,2023-09-18,2023-09-29,443.37,4,1872,154689262,55771573,0.00836257141106537,99.8126780125178,0.144712430426716
444.8,470,11,5,26015,12600,2023-09-18,2023-09-22,443.37,-6,-13415,47965757,25232076,0.0262687400096698,99.6683217154271,-1.06468253968254
443.54,475,0,4,0,12584,2023-09-18,2023-09-29,443.37,4,12584,154689262,55771573,0.00813501844749896,99.8208130309653,1
365.93,366,1789,1788,8945,12516,2023-09-18,2023-09-29,443.37,-1,3571,154689262,55771573,0.00809105935226454,99.8289040903175,0.285314797059764
418.91,419,1263,1378,11367,12402,2023-09-18,2023-09-22,443.37,115,1035,47965757,25232076,0.0258559455238036,99.6941776609509,0.0834542815674891
259.98,260,5830,6098,11660,12196,2023-09-18,2023-10-20,443.37,268,536,473926306,145207170,0.00257339587307061,99.9707287824618,0.0439488356838308
385.93,386,1731,1731,12117,12117,2023-09-18,2023-09-29,443.37,0,0,154689262,55771573,0.00783312289640376,99.836737213214,0
234.99,235,12066,12066,12066,12066,2023-09-18,2023-10-20,443.37,0,0,473926306,145207170,0.00254596544805428,99.9732747479099,0
369.88,370,972,1002,9720,12024,2023-09-18,2023-10-06,443.37,30,2304,42650604,18727217,0.0281918633555576,99.9109250598186,0.191616766467066
444.93,565,2,1,24014,12007,2023-09-18,2023-10-20,443.37,-1,-12007,473926306,145207170,0.00253351625516225,99.975808264165,-1
444.5,484,3,3,11850,11850,2023-09-18,2023-10-20,443.37,0,0,473926306,145207170,0.0025003887418733,99.9783086529069,0
349.8,350,590,591,10030,11820,2023-09-18,2023-10-27,443.37,1,1790,38114356,12392570,0.0310119368145693,99.930477639449,0.151438240270727
368.93,369,1682,1682,11774,11774,2023-09-18,2023-09-29,443.37,0,0,154689262,55771573,0.00761138804838309,99.8443486012623,0
446,459,12,9,12900,11700,2023-09-18,2023-10-13,443.37,-3,-1200,30280851,12108347,0.038638280013993,99.7366091197371,-0.102564102564103
214.97,215,4306,3814,12918,11442,2023-09-18,2023-11-17,443.37,-492,-1476,443991078,126746889,0.002577078812381,99.9773540494433,-0.128998426848453
416.91,417,1080,1271,8640,11439,2023-09-18,2023-09-22,443.37,191,2799,47965757,25232076,0.023848263251636,99.7180259242026,0.244689221085759
442.66,459,0,7,0,11438,2023-09-18,2023-11-17,443.37,7,11438,443991078,126746889,0.0025761778933765,99.9799302273367,1
438.87,495,3,2,16839,11226,2023-09-18,2023-11-17,443.37,-1,-5613,443991078,126746889,0.00252842918613784,99.9824586565228,-0.5
445.61,468,20,5,44780,11195,2023-09-18,2023-10-20,443.37,-15,-33585,473926306,145207170,0.00236218160044486,99.9806708345074,-3
159.98,160,5342,5594,10684,11188,2023-09-18,2023-12-15,443.37,252,504,508084803,96118471,0.00220199461466672,99.9914195426152,0.045048265999285
269.98,270,5323,5541,10646,11082,2023-09-18,2023-10-20,443.37,218,436,473926306,145207170,0.00233833823100759,99.9830091727384,0.0393430788666306
411.35,412,169,168,7605,10920,2023-09-18,2023-10-13,443.37,-1,3315,30280851,12108347,0.0360623946797268,99.7726715144168,0.303571428571429
209.98,210,5564,5413,11128,10826,2023-09-18,2023-11-17,443.37,-151,-302,443991078,126746889,0.00243833728568753,99.9848969938085,-0.0278958063920192
393.96,394,2391,2704,9564,10816,2023-09-18,2023-09-22,443.37,313,1252,47965757,25232076,0.0225494199956023,99.7405753441982,0.115754437869823
169.98,170,5405,5405,10810,10810,2023-09-18,2023-12-15,443.37,0,0,508084803,96118471,0.00212759758531884,99.9935471402005,0
342.96,343,2699,2684,8097,10736,2023-09-18,2023-09-29,443.37,-15,2639,154689262,55771573,0.00694036538877534,99.8512889666511,0.245808494783905
355.94,356,1787,1782,8935,10692,2023-09-18,2023-09-29,443.37,-5,1757,154689262,55771573,0.00691192126832954,99.8582008879194,0.164328469884025
450.31,555,1,1,10469,10469,2023-09-18,2023-12-15,443.37,0,0,508084803,96118471,0.00206048280487539,99.9956076230054,0
435.56,540,1,1,10444,10444,2023-09-18,2023-12-15,443.37,0,0,508084803,96118471,0.00205556236642646,99.9976631853718,0
447.79,465,8,6,13768,10326,2023-09-18,2023-09-22,443.37,-2,-3442,47965757,25232076,0.0215278578841151,99.7621032020823,-0.333333333333333
274.97,275,3426,3426,10278,10278,2023-09-18,2023-10-20,443.37,0,0,473926306,145207170,0.00216869160244504,99.9851778643408,0
400.84,401,634,635,6974,10160,2023-09-18,2023-09-29,443.37,1,3186,154689262,55771573,0.00656800599384849,99.8647688939133,0.313582677165354
415.92,416,1034,1225,8272,9800,2023-09-18,2023-09-22,443.37,191,1528,47965757,25232076,0.0204312422297432,99.782534444312,0.155918367346939
319.98,320,4596,4889,4596,9778,2023-09-18,2023-09-29,443.37,293,5182,154689262,55771573,0.00632105931179632,99.8710899532251,0.529965228062999
443.28,457,308,7,246400,9604,2023-09-18,2023-09-22,443.37,-301,-236796,47965757,25232076,0.0200226173851483,99.8025570616972,-24.6559766763848
405.53,406,366,204,13542,9588,2023-09-18,2023-10-13,443.37,-162,-3954,30280851,12108347,0.031663575108903,99.8043350895257,-0.412390488110138
403.71,404,218,328,6976,9512,2023-09-18,2023-10-06,443.37,110,2536,42650604,18727217,0.0223021460610499,99.9332272058797,0.266610597140454
254.98,255,4488,4488,8976,8976,2023-09-18,2023-10-20,443.37,0,0,473926306,145207170,0.00189396534574302,99.9870718296865,0
411.92,412,939,1118,7512,8944,2023-09-18,2023-09-22,443.37,179,1432,47965757,25232076,0.0186466357655942,99.8212036974628,0.160107334525939
149.99,150,8915,8922,8915,8922,2023-09-18,2023-10-20,443.37,7,7,473926306,145207170,0.00188257116919777,99.9889544008557,0.000784577449002466
264.94,265,1399,1441,8394,8646,2023-09-18,2023-11-17,443.37,42,252,443991078,126746889,0.00194733642823336,99.9868443302368,0.029146426092991
354.88,355,717,719,6453,8628,2023-09-18,2023-10-13,443.37,2,2175,30280851,12108347,0.0284932546974984,99.8328283442232,0.252086230876217
358.94,359,1411,1410,7055,8460,2023-09-18,2023-09-29,443.37,-1,1405,154689262,55771573,0.00546902861298802,99.8765589818381,0.166075650118203
174.98,175,4228,4223,8456,8446,2023-09-18,2023-12-15,443.37,-5,-10,508084803,96118471,0.00166232092558769,99.9993255062974,-0.0011839924224485
444.3,461,17,5,28390,8350,2023-09-18,2023-10-13,443.37,-12,-20040,30280851,12108347,0.0275751827450292,99.8604035269683,-2.4
443.08,459,7,5,7595,7960,2023-09-18,2023-10-27,443.37,-2,364.999999999999,38114356,12392570,0.0208845192084578,99.9513621586575,0.0458542713567838
445.18,461,1440,5,2325600,7910,2023-09-18,2023-09-29,443.37,-1435,-2317690,154689262,55771573,0.00511347710741551,99.8816724589455,-293.007585335019
371.92,372,982,987,4910,7896,2023-09-18,2023-09-29,443.37,5,2986,154689262,55771573,0.00510442670545548,99.8867768856509,0.378166160081054
407.92,408,981,984,6867,7872,2023-09-18,2023-09-22,443.37,3,1005,47965757,25232076,0.0164117080441366,99.8376154055069,0.127667682926829
357.94,358,1277,1305,10216,7830,2023-09-18,2023-09-29,443.37,28,-2386,154689262,55771573,0.00506176052478678,99.8918386461757,-0.304725415070243
169.98,170,3883,3883,7766,7766,2023-09-18,2023-10-20,443.37,0,0,473926306,145207170,0.00163865138982178,99.9905930522456,0
229.97,230,2523,2523,7569,7569,2023-09-18,2023-11-17,443.37,0,0,443991078,126746889,0.00170476398627091,99.988549094223,0
224.96,225,1861,1861,7444,7444,2023-09-18,2023-11-17,443.37,0,0,443991078,126746889,0.00167661026738019,99.9902257044904,0
401.6,402,95,186,2945,7440,2023-09-18,2023-10-13,443.37,91,4495,30280851,12108347,0.0245699831883853,99.8849735101567,0.604166666666667
443.61,468,37,3,90243,7317,2023-09-18,2023-11-17,443.37,-34,-82926,443991078,126746889,0.00164800608898722,99.9918737105794,-11.3333333333333
314.98,315,3629,3620,7258,7240,2023-09-18,2023-09-29,443.37,-9,-17.9999999999991,154689262,55771573,0.00468035072789991,99.8965189969036,-0.00248618784530374
219.98,220,3558,3533,7116,7066,2023-09-18,2023-11-17,443.37,-25,-50,443991078,126746889,0.00159147342145465,99.9934651840008,-0.00707613925842061
407.44,408,129,126,5031,7056,2023-09-18,2023-10-13,443.37,-3,2025,30280851,12108347,0.0233018550238235,99.9082753651805,0.286989795918367
404.93,405,822,989,5754,6923,2023-09-18,2023-09-22,443.37,167,1169,47965757,25232076,0.0144332132608686,99.8520486187678,0.168857431749242
446.02,463,129,4,186018,6792,2023-09-18,2023-09-29,443.37,-125,-179226,154689262,55771573,0.00439073786517903,99.9009097347688,-26.3878091872792
335.96,336,1650,1680,4950,6720,2023-09-18,2023-09-29,443.37,30,1770,154689262,55771573,0.00434419294081318,99.9052539277096,0.263392857142857
401.73,402,86,243,1720,6561,2023-09-18,2023-10-06,443.37,157,4841,42650604,18727217,0.0153831350196119,99.9486103408993,0.737844840725499
334.97,335,2083,2083,6249,6249,2023-09-18,2023-09-29,443.37,0,0,154689262,55771573,0.00403971156058654,99.9092936392702,0
234.97,235,1971,1976,5913,5928,2023-09-18,2023-11-17,443.37,5,15,443991078,126746889,0.00133516196467353,99.9948003459655,0.00253036437246964
448.59,463,35,4,50365,5764,2023-09-18,2023-09-22,443.37,-31,-44601,47965757,25232076,0.0120169061441061,99.8640655249119,-7.73785565579459
324.89,325,500,512,5000,5632,2023-09-18,2023-10-27,443.37,12,632,38114356,12392570,0.0147765844449792,99.9661387431025,0.112215909090909
199.99,200,5599,5599,5599,5599,2023-09-18,2023-10-20,443.37,0,0,473926306,145207170,0.00118140730512646,99.9917744595507,0
259.93,260,792,792,5544,5544,2023-09-18,2023-11-17,443.37,0,0,443991078,126746889,0.00124867374024124,99.9960490197058,0
352.96,353,1375,1375,5500,5500,2023-09-18,2023-09-29,443.37,0,0,154689262,55771573,0.00355551505572507,99.9128491543259,0
254.94,255,902,902,5412,5412,2023-09-18,2023-11-17,443.37,0,0,443991078,126746889,0.00121894341309264,99.9972679631188,0
325.98,326,2467,2670,4934,5340,2023-09-18,2023-09-29,443.37,203,406,154689262,55771573,0.00345208189046761,99.9163012362164,0.0760299625468165
410.95,411,900,1067,6300,5335,2023-09-18,2023-09-22,443.37,167,-965.000000000001,47965757,25232076,0.0111225180913959,99.8751880430033,-0.180880974695408
354.92,355,620,658,4960,5264,2023-09-18,2023-10-06,443.37,38,304,42650604,18727217,0.0123421464324397,99.9609524873317,0.0577507598784195
337.96,338,1302,1302,5208,5208,2023-09-18,2023-09-29,443.37,0,0,154689262,55771573,0.00336674952913021,99.9196679857455,0
294.99,295,5098,5144,5098,5144,2023-09-18,2023-09-29,443.37,46,46,154689262,55771573,0.00332537626302723,99.9229933620085,0.00894245723172628
289.99,290,5113,5113,5113,5113,2023-09-18,2023-09-29,443.37,0,0,154689262,55771573,0.0033053360872586,99.9262986980958,0
447.02,498,1,1,5098,5098,2023-09-18,2023-09-29,443.37,0,0,154689262,55771573,0.00329563922801571,99.9295943373238,0
448.71,474,3,2,7587,5058,2023-09-18,2023-09-29,443.37,-1,-2529,154689262,55771573,0.00326978093670135,99.9328641182605,-0.5
299.99,300,4983,4982,9966,4982,2023-09-18,2023-09-29,443.37,-1,-4984,154689262,55771573,0.00322065018320405,99.9360847684437,-1.00040144520273
445.73,495,1,1,5878,4927,2023-09-18,2023-10-20,443.37,0,-951,473926306,145207170,0.00103961310811897,99.9928140726588,-0.193018063730465
324.92,325,598,606,2990,4848,2023-09-18,2023-10-13,443.37,8,1858,30280851,12108347,0.016010118077593,99.924285483258,0.383250825082508
350.95,351,973,963,2919,4815,2023-09-18,2023-09-29,443.37,-10,1896,154689262,55771573,0.00311269181696658,99.9391974602607,0.393769470404985
159.99,160,4707,4707,4707,4707,2023-09-18,2023-10-20,443.37,0,0,473926306,145207170,0.000993192388860558,99.9938072650477,0
338.96,339,1147,1169,3441,4676,2023-09-18,2023-09-29,443.37,22,1235,154689262,55771573,0.00302283425464917,99.9422202945154,0.264114627887083
398.87,399,350,352,3850,4576,2023-09-18,2023-09-29,443.37,2,726.000000000001,154689262,55771573,0.00295818852636326,99.9451784830417,0.158653846153846
344.99,345,4371,4461,8742,4461,2023-09-18,2023-09-22,443.37,90,-4281,47965757,25232076,0.00930038485580453,99.8844884278591,-0.95965030262273
309.98,310,2136,2225,4272,4450,2023-09-18,2023-09-29,443.37,89,178,154689262,55771573,0.00287673490872301,99.9480552179504,0.04
398.95,399,362,885,1810,4425,2023-09-18,2023-09-22,443.37,523,2615,47965757,25232076,0.00922533131291976,99.893713759172,0.590960451977401
443.89,488,1,1,4411,4411,2023-09-18,2023-10-13,443.37,0,0,30280851,12108347,0.0145669618069849,99.938852445065,0
444.47,459,14,3,14196,4359,2023-09-18,2023-09-22,443.37,-11,-9837,47965757,25232076,0.00908773315096434,99.902801492323,-2.25671025464556
304.98,305,2050,2156,2050,4312,2023-09-18,2023-09-29,443.37,106,2262,154689262,55771573,0.00278752380368846,99.9508427417541,0.524582560296846
444.93,459,2153,3,2208978,4221,2023-09-18,2023-09-29,443.37,-2150,-2204757,154689262,55771573,0.00272869619094828,99.9535714379451,-522.330490405117
336.97,337,1339,1350,5356,4050,2023-09-18,2023-09-29,443.37,11,-1306,154689262,55771573,0.00261815199557937,99.9561895899406,-0.322469135802469
445.85,486,2,1,8030,4015,2023-09-18,2023-10-06,443.37,-1,-4015,42650604,18727217,0.00941370021395242,99.9703661875457,-1
239.96,240,999,999,3996,3996,2023-09-18,2023-11-17,443.37,0,0,443991078,126746889,0.000900018085498556,99.9981679812043,0
284.99,285,3873,3923,3873,3923,2023-09-18,2023-09-29,443.37,50,50,154689262,55771573,0.00253605192065626,99.9587256418613,0.012745347947999
348.95,349,762,773,2286,3865,2023-09-18,2023-09-29,443.37,11,1579,154689262,55771573,0.00249855739825044,99.9612241992596,0.408538163001294
402.93,403,399,548,2394,3836,2023-09-18,2023-09-22,443.37,149,1442,47965757,25232076,0.00799737195849948,99.9107988642815,0.375912408759124
447.13,485,1,1,3787,3787,2023-09-18,2023-09-29,443.37,0,0,154689262,55771573,0.00244813373018743,99.9636723329897,0
351.96,352,936,936,3744,3744,2023-09-18,2023-09-29,443.37,0,0,154689262,55771573,0.00242033606702448,99.9660926690568,0
401.94,402,401,606,2005,3636,2023-09-18,2023-09-22,443.37,205,1631,47965757,25232076,0.00758040783136186,99.9183792721128,0.448569856985699
189.99,190,3624,3624,3624,3624,2023-09-18,2023-10-20,443.37,0,0,473926306,145207170,0.000764675848147581,99.9945719408958,0
443.91,480,19,1,58159,3609,2023-09-18,2023-09-29,443.37,-18,-54550,154689262,55771573,0.00233306433383851,99.9684257333906,-15.1149903020227
403.94,404,323,595,2261,3570,2023-09-18,2023-09-22,443.37,272,1309,47965757,25232076,0.00744280966940645,99.9258220817822,0.366666666666666
396.94,397,566,578,2264,3468,2023-09-18,2023-09-22,443.37,12,1204,47965757,25232076,0.00723015796456626,99.9330522397468,0.34717416378316
444.74,462,1,2,1455,3452,2023-09-18,2023-10-27,443.37,1,1997,38114356,12392570,0.00905695481251212,99.975195697915,0.578505214368482
441.73,476,88,1,301576,3427,2023-09-18,2023-12-15,443.37,-87,-298149,508084803,96118471,0.000674493702579804,100,-87
446.19,457.5,4,3,4004,3393,2023-09-18,2023-10-13,443.37,-1,-611,30280851,12108347,0.011205101204058,99.9500575462691,-0.18007662835249
353.96,354,845,845,4225,3380,2023-09-18,2023-09-29,443.37,0,-845.000000000001,154689262,55771573,0.00218502561606377,99.9706107590067,-0.25
346.96,347,795,805,3975,3220,2023-09-18,2023-09-29,443.37,10,-755,154689262,55771573,0.00208159245080631,99.9726923514575,-0.234472049689441
327.98,328,1588,1591,3176,3182,2023-09-18,2023-09-29,443.37,3,6,154689262,55771573,0.00205702707405767,99.9747493785315,0.00188560653676933
214.99,215,3147,3147,3147,3147,2023-09-18,2023-10-20,443.37,0,0,473926306,145207170,0.00066402728866458,99.9952359681845,0
347.96,348,783,783,3915,3132,2023-09-18,2023-09-29,443.37,0,-783.000000000001,154689262,55771573,0.00202470420991471,99.9767740827414,-0.25
397.94,398,359,516,6462,3096,2023-09-18,2023-09-22,443.37,157,-3366,47965757,25232076,0.0064546046880903,99.9395068444349,-1.08720930232558
239.99,240,3023,3025,3023,3025,2023-09-18,2023-10-20,443.37,2,2,473926306,145207170,0.0006382848898031,99.9958742530743,0.000661157024793388
374.98,375,1514,1511,4542,3022,2023-09-18,2023-09-22,443.37,-3,-1520,47965757,25232076,0.00630032796104938,99.9458071723959,-0.502978160158835
446.63,476,1,1,2937,2937,2023-09-18,2023-11-17,443.37,0,0,443991078,126746889,0.000661499779056371,99.9988294809834,0
395.94,396,344,467,2752,2802,2023-09-18,2023-09-22,443.37,123,50,47965757,25232076,0.005841667421198,99.9516488398171,0.0178443968593862
328.98,329,1397,1397,2794,2794,2023-09-18,2023-09-29,443.37,0,0,154689262,55771573,0.00180620164830834,99.9785802843898,0
219.99,220,2790,2790,2790,2790,2023-09-18,2023-10-20,443.37,0,0,473926306,145207170,0.000588699121504346,99.9964629521958,0
229.99,230,2351,2754,2351,2754,2023-09-18,2023-10-20,443.37,403,403,473926306,145207170,0.000581103003807516,99.9970440551996,0.146332607116921
244.95,245,542,543,2710,2715,2023-09-18,2023-11-17,443.37,1,5,443991078,126746889,0.000611498774306451,99.9994409797577,0.00184162062615101
154.99,155,2672,2672,2672,2672,2023-09-18,2023-10-20,443.37,0,0,473926306,145207170,0.000563800735720292,99.9976078559353,0
443.46,470,9,1,23886,2654,2023-09-18,2023-10-13,443.37,-8,-21232,30280851,12108347,0.00876461497069551,99.9588221612398,-8
326.98,327,1317,1317,2634,2634,2023-09-18,2023-09-29,443.37,0,0,154689262,55771573,0.00170276848305088,99.9802830528728,0
452,478,1,1,2600,2600,2023-09-18,2023-10-06,443.37,0,0,42650604,18727217,0.00609604497042996,99.9764622325161,0
444.05,470,25,1,60500,2595,2023-09-18,2023-10-27,443.37,-24,-57905,38114356,12392570,0.00680845820928996,99.9820041561243,-22.3140655105973
380.98,381,1058,1287,5290,2574,2023-09-18,2023-09-22,443.37,229,-2716,47965757,25232076,0.00536632831626112,99.9570151681334,-1.05516705516706
264.99,265,2483,2483,2483,2483,2023-09-18,2023-09-29,443.37,0,0,154689262,55771573,0.00160515343333915,99.9818882063061,0
440.59,453,0,2,0,2482,2023-09-18,2023-11-17,443.37,2,2482,443991078,126746889,0.000559020242294148,100,1
443.64,456,83,2,59013,2472,2023-09-18,2023-09-22,443.37,-81,-56541,47965757,25232076,0.00515367661142094,99.9621688447448,-22.872572815534
324.95,325,430,492,1720,2460,2023-09-18,2023-10-06,443.37,62,740,42650604,18727217,0.00576779639509912,99.9822300289112,0.300813008130081
341.97,342,804,814,3216,2442,2023-09-18,2023-09-29,443.37,10,-774.000000000001,154689262,55771573,0.00157864868474193,99.9834668549909,-0.316953316953317
259.99,260,2349,2349,2349,2349,2023-09-18,2023-09-29,443.37,0,0,154689262,55771573,0.00151852815743603,99.9849853831483,0
332.97,333,731,732,2193,2196,2023-09-18,2023-09-29,443.37,1,3,154689262,55771573,0.00141962019315859,99.9864050033415,0.00136612021857924
363.94,364,365,365,2190,2190,2023-09-18,2023-09-29,443.37,0,0,154689262,55771573,0.00141574144946144,99.987820744791,0
445.29,467,1,1,2171,2171,2023-09-18,2023-10-06,443.37,0,0,42650604,18727217,0.00509019755030902,99.9873202264615,0
449.73,471,1,1,2127,2127,2023-09-18,2023-09-29,443.37,0,0,154689262,55771573,0.00137501464064131,99.9891957594316,0
448,469,1,1,2100,2100,2023-09-18,2023-10-06,443.37,0,0,42650604,18727217,0.00492372862996266,99.9922439550915,0
362.96,363,522,522,2610,2088,2023-09-18,2023-09-29,443.37,0,-522,154689262,55771573,0.00134980280660981,99.9905455622382,-0.25
299.99,300,2061,2060,2061,2060,2023-09-18,2023-09-22,443.37,-1,-1,47965757,25232076,0.00429473050951745,99.9664635752543,-0.000485436893203884
224.99,225,2052,2052,2052,2052,2023-09-18,2023-10-20,443.37,0,0,473926306,145207170,0.000432978708719326,99.998040834644,0
382.97,383,0,668,0,2004,2023-09-18,2023-09-22,443.37,668,2004,47965757,25232076,0.00417798055391891,99.9706415558082,1
331.98,332,939,939,2817,1878,2023-09-18,2023-09-29,443.37,0,-939,154689262,55771573,0.0012140467772094,99.9917596090154,-0.5
449.27,468,8,1,14984,1873,2023-09-18,2023-09-29,443.37,-7,-13111,154689262,55771573,0.0012108144907951,99.9929704235062,-7
344.91,345,207,207,1863,1863,2023-09-18,2023-10-13,443.37,0,0,30280851,12108347,0.00615240304838196,99.9649745642882,0
445.4,464,1,1,1860,1860,2023-09-18,2023-10-27,443.37,0,0,38114356,12392570,0.00488005097082055,99.9868842070951,0
443.42,462,224,1,322560,1858,2023-09-18,2023-09-29,443.37,-223,-320702,154689262,55771573,0.00120111763155221,99.9941715411378,-172.606027987083
279.99,280,1847,1837,1847,1837,2023-09-18,2023-09-29,443.37,-10,-10,154689262,55771573,0.00118754202861217,99.9953590831664,-0.00544365813826892
209.99,210,1836,1836,1836,1836,2023-09-18,2023-10-20,443.37,0,0,473926306,145207170,0.000387402002538344,99.9984282366466,0
446.77,465,3,1,5469,1823,2023-09-18,2023-10-13,443.37,-2,-3646,30280851,12108347,0.00602030636457344,99.9709948706528,-2
244.98,245,908,908,1816,1816,2023-09-18,2023-10-20,443.37,0,0,473926306,145207170,0.000383181937151216,99.9988114185837,0
314.99,315,1776,1776,1776,1776,2023-09-18,2023-09-22,443.37,0,0,47965757,25232076,0.00370264144898203,99.9743441972572,0
330.98,331,880,880,1760,1760,2023-09-18,2023-09-29,443.37,0,0,154689262,55771573,0.00113776481783202,99.9964968479842,0
194.99,195,1731,1731,1731,1731,2023-09-18,2023-10-20,443.37,0,0,473926306,145207170,0.000365246659255922,99.999176665243,0
354.78,355,58,78,1044,1716,2023-09-18,2023-10-27,443.37,20,672,38114356,12392570,0.0045022405730796,99.9913864476682,0.391608391608392
369.82,370,78,94,1092,1692,2023-09-18,2023-10-13,443.37,16,600,30280851,12108347,0.00558768972510053,99.9765825603779,0.354609929078014
343.97,344,561,563,1122,1689,2023-09-18,2023-09-29,443.37,2,567,154689262,55771573,0.00109186635074903,99.9975887143349,0.335701598579041
447.24,464,6,1,12276,1676,2023-09-18,2023-09-22,443.37,-5,-10600,47965757,25232076,0.00349415938541322,99.9778383566426,-6.32458233890215
446.69,462.5,6,1,10728,1581,2023-09-18,2023-10-13,443.37,-5,-9147,30280851,12108347,0.00522112142753188,99.9818036818054,-5.78557874762808
387.96,388,164,394,656,1576,2023-09-18,2023-09-22,443.37,230,920,47965757,25232076,0.00328567732184442,99.9811240339645,0.583756345177665
381.96,382,131,370,655,1480,2023-09-18,2023-09-22,443.37,239,825,47965757,25232076,0.00308553454081836,99.9842095685053,0.557432432432432
364.85,365,91,94,1183,1410,2023-09-18,2023-10-13,443.37,3,227,30280851,12108347,0.00465640810425044,99.9864600899096,0.160992907801418
449.95,464,1,1,1405,1405,2023-09-18,2023-10-13,443.37,0,0,30280851,12108347,0.00463989601877437,99.9910999859284,0
254.99,255,1229,1235,1229,1235,2023-09-18,2023-09-29,443.37,6,6,154689262,55771573,0.000798374744330993,99.9983870890793,0.0048582995951417
390.97,391,192,409,768,1227,2023-09-18,2023-09-22,443.37,217,459,47965757,25232076,0.00255807491998928,99.9867676434253,0.374083129584352
339.87,340,89,89,1157,1157,2023-09-18,2023-10-27,443.37,0,0,38114356,12392570,0.00303560159851579,99.9944220492667,0
274.99,275,1136,1141,1136,1141,2023-09-18,2023-09-29,443.37,5,5,154689262,55771573,0.000737607759742237,99.999124696839,0.00438212094653813
392.95,393,1,228,6,1140,2023-09-18,2023-09-22,443.37,227,1134,47965757,25232076,0.00237669552468441,99.98914433895,0.994736842105263
334.91,335,122,123,854,1107,2023-09-18,2023-10-13,443.37,1,253,30280851,12108347,0.00365577572440088,99.9947557616528,0.228545618789521
164.99,165,1098,1098,1098,1098,2023-09-18,2023-10-20,443.37,0,0,473926306,145207170,0.000231681589753323,99.9994083468327,0
334.94,335,104,174,416,1044,2023-09-18,2023-10-06,443.37,70,628,42650604,18727217,0.00244779651889572,99.9946917516104,0.601532567049808
349.91,350,114,114,1026,1026,2023-09-18,2023-10-13,443.37,0,0,30280851,12108347,0.00338827993968862,99.9981440415925,0
447.27,457.5,1,1,1023,1023,2023-09-18,2023-10-27,443.37,0,0,38114356,12392570,0.0026840280339513,99.9971060773007,0
269.99,270,948,948,948,948,2023-09-18,2023-09-29,443.37,0,0,154689262,55771573,0.00061284150415043,99.9997375383432,0
204.99,205,939,939,939,939,2023-09-18,2023-10-20,443.37,0,0,473926306,145207170,0.000198132069925656,99.9996064789027,0
339.95,340,162,172,648,860,2023-09-18,2023-10-06,443.37,10,212,42650604,18727217,0.00201638410560376,99.996708135716,0.246511627906977
344.83,345,39,43,585,731,2023-09-18,2023-10-27,443.37,4,146,38114356,12392570,0.00191791250519883,99.9990239898058,0.199726402188782
344.94,345,111,120,555,720,2023-09-18,2023-10-06,443.37,9,165,42650604,18727217,0.00168813553027291,99.9983962712462,0.229166666666666
174.99,175,712,712,712,712,2023-09-18,2023-10-20,443.37,0,0,473926306,145207170,0.000150234327781754,99.9997567132304,0
309.99,310,710,710,710,710,2023-09-18,2023-09-22,443.37,0,0,47965757,25232076,0.00148022265133854,99.9906245616013,0
386.98,387,100,328,400,656,2023-09-18,2023-09-22,443.37,228,256,47965757,25232076,0.00136764233701138,99.9919922039383,0.390243902439024
184.99,185,612,612,612,612,2023-09-18,2023-10-20,443.37,0,0,473926306,145207170,0.000129134000846115,99.9998858472313,0
359.98,360,305,303,610,606,2023-09-18,2023-09-22,443.37,-2,-4,47965757,25232076,0.00126340130522698,99.9932556052435,-0.0066006600660066
324.99,325,458,575,458,575,2023-09-18,2023-09-22,443.37,117,117,47965757,25232076,0.00119877186552065,99.9944543771091,0.203478260869565
179.99,180,541,541,541,541,2023-09-18,2023-10-20,443.37,0,0,473926306,145207170,0.000114152768721811,100,0
319.99,320,427,527,427,527,2023-09-18,2023-09-22,443.37,100,100,47965757,25232076,0.00109870047500762,99.9955530775841,0.189753320683112
383.98,384,0,225,0,450,2023-09-18,2023-09-22,443.37,225,450,47965757,25232076,0.000938169286059636,99.9964912468701,1
385.98,386,0,223,0,446,2023-09-18,2023-09-22,443.37,223,446,47965757,25232076,0.000929830003516884,99.9974210768737,1
334.98,335,179,210,537,420,2023-09-18,2023-09-22,443.37,31,-117,47965757,25232076,0.000875624666988994,99.9982967015406,-0.278571428571429
333.98,334,203,203,406,406,2023-09-18,2023-09-29,443.37,0,0,154689262,55771573,0.000262461656840796,100,0
349.94,350,49,64,245,384,2023-09-18,2023-10-06,443.37,15,139,42650604,18727217,0.000900338949478887,99.9992966101957,0.361979166666667
334.86,335,6,25,72,350,2023-09-18,2023-10-27,443.37,19,278,38114356,12392570,0.00091828916117591,99.999942278967,0.794285714285714
339.9,340,28,31,224,310,2023-09-18,2023-10-13,443.37,3,86,30280851,12108347,0.00102374929951605,99.999167790892,0.27741935483871
329.99,330,305,305,305,305,2023-09-18,2023-09-22,443.37,0,0,47965757,25232076,0.000635870293884865,99.9989325718345,0
329.95,330,47,60,188,300,2023-09-18,2023-10-06,443.37,13,112,42650604,18727217,0.00070338980428038,100,0.373333333333333
339.99,340,191,281,573,281,2023-09-18,2023-09-22,443.37,90,-292,47965757,25232076,0.000585834598628351,99.9995184064332,-1.03914590747331
329.93,330,36,36,252,252,2023-09-18,2023-10-13,443.37,0,0,30280851,12108347,0.000832209107993696,100,0
304.99,305,231,231,231,231,2023-09-18,2023-09-22,443.37,0,0,47965757,25232076,0.000481593566843947,100,0
329.89,330,1,2,10,22,2023-09-18,2023-10-27,443.37,1,12,38114356,12392570,5.77210329882e-05,100,0.545454545454545
445.5,457.5,66,0,79200,0,2023-09-18,2023-09-22,443.37,-66,-79200,47965757,25232076,0,100,-Inf
443.27,458,207,0,196650,0,2023-09-18,2023-09-22,443.37,-207,-196650,47965757,25232076,0,100,-Inf
449.31,461,7,0,8183,0,2023-09-18,2023-09-22,443.37,-7,-8183,47965757,25232076,0,100,-Inf
445.37,462,30,0,49890,0,2023-09-18,2023-09-22,443.37,-30,-49890,47965757,25232076,0,100,-Inf
446.2,462.5,7,0,9205,0,2023-09-18,2023-09-22,443.37,-7,-9205,47965757,25232076,0,100,-Inf
466,466,0,0,0,0,2023-09-18,2023-09-22,443.37,0,0,47965757,25232076,0,100,
449.45,467,1,0,1755,0,2023-09-18,2023-09-22,443.37,-1,-1755,47965757,25232076,0,100,-Inf
442.6,468,2,0,5080,0,2023-09-18,2023-09-22,443.37,-2,-5080,47965757,25232076,0,100,-Inf
441.94,469,29,0,78474,0,2023-09-18,2023-09-22,443.37,-29,-78474,47965757,25232076,0,100,-Inf
471,471,0,0,0,0,2023-09-18,2023-09-22,443.37,0,0,47965757,25232076,0,100,
450.04,472,1,0,2196,0,2023-09-18,2023-09-22,443.37,-1,-2196,47965757,25232076,0,100,-Inf
473,473,0,0,0,0,2023-09-18,2023-09-22,443.37,0,0,47965757,25232076,0,100,
447.97,474,0,0,0,0,2023-09-18,2023-09-22,443.37,0,0,47965757,25232076,0,100,
445.66,475,1,0,2934,0,2023-09-18,2023-09-22,443.37,-1,-2934,47965757,25232076,0,100,-Inf
442.14,476,1,0,3386,0,2023-09-18,2023-09-22,443.37,-1,-3386,47965757,25232076,0,100,-Inf
477,477,0,0,0,0,2023-09-18,2023-09-22,443.37,0,0,47965757,25232076,0,100,
446.3,478,0,0,0,0,2023-09-18,2023-09-22,443.37,0,0,47965757,25232076,0,100,
479,479,0,0,0,0,2023-09-18,2023-09-22,443.37,0,0,47965757,25232076,0,100,
445.8,480,1,0,3420,0,2023-09-18,2023-09-22,443.37,-1,-3420,47965757,25232076,0,100,-Inf
447.16,481,1,0,3384,0,2023-09-18,2023-09-22,443.37,-1,-3384,47965757,25232076,0,100,-Inf
482,482,0,0,0,0,2023-09-18,2023-09-22,443.37,0,0,47965757,25232076,0,100,
483,483,0,0,0,0,2023-09-18,2023-09-22,443.37,0,0,47965757,25232076,0,100,
484,484,0,0,0,0,2023-09-18,2023-09-22,443.37,0,0,47965757,25232076,0,100,
442.2,485,1,0,4280,0,2023-09-18,2023-09-22,443.37,-1,-4280,47965757,25232076,0,100,-Inf
486,486,0,0,0,0,2023-09-18,2023-09-22,443.37,0,0,47965757,25232076,0,100,
487,487,0,0,0,0,2023-09-18,2023-09-22,443.37,0,0,47965757,25232076,0,100,
488,488,0,0,0,0,2023-09-18,2023-09-22,443.37,0,0,47965757,25232076,0,100,
489,489,0,0,0,0,2023-09-18,2023-09-22,443.37,0,0,47965757,25232076,0,100,
450.83,490,0,0,0,0,2023-09-18,2023-09-22,443.37,0,0,47965757,25232076,0,100,
445.6,491,2,0,9080,0,2023-09-18,2023-09-22,443.37,-2,-9080,47965757,25232076,0,100,-Inf
492,492,0,0,0,0,2023-09-18,2023-09-22,443.37,0,0,47965757,25232076,0,100,
493,493,0,0,0,0,2023-09-18,2023-09-22,443.37,0,0,47965757,25232076,0,100,
494,494,0,0,0,0,2023-09-18,2023-09-22,443.37,0,0,47965757,25232076,0,100,
495,495,0,0,0,0,2023-09-18,2023-09-22,443.37,0,0,47965757,25232076,0,100,
496,496,0,0,0,0,2023-09-18,2023-09-22,443.37,0,0,47965757,25232076,0,100,
497,497,0,0,0,0,2023-09-18,2023-09-22,443.37,0,0,47965757,25232076,0,100,
498,498,0,0,0,0,2023-09-18,2023-09-22,443.37,0,0,47965757,25232076,0,100,
499,499,0,0,0,0,2023-09-18,2023-09-22,443.37,0,0,47965757,25232076,0,100,
446.12,500,2,0,10776,0,2023-09-18,2023-09-22,443.37,-2,-10776,47965757,25232076,0,100,-Inf
505,505,0,0,0,0,2023-09-18,2023-09-22,443.37,0,0,47965757,25232076,0,100,
510,510,0,0,0,0,2023-09-18,2023-09-22,443.37,0,0,47965757,25232076,0,100,
515,515,0,0,0,0,2023-09-18,2023-09-22,443.37,0,0,47965757,25232076,0,100,
437.6,520,0,0,0,0,2023-09-18,2023-09-22,443.37,0,0,47965757,25232076,0,100,
525,525,0,0,0,0,2023-09-18,2023-09-22,443.37,0,0,47965757,25232076,0,100,
530,530,0,0,0,0,2023-09-18,2023-09-22,443.37,0,0,47965757,25232076,0,100,
540,540,0,0,0,0,2023-09-18,2023-09-22,443.37,0,0,47965757,25232076,0,100,
445.5,466,88,0,180400,0,2023-09-18,2023-09-29,443.37,-88,-180400,154689262,55771573,0,100,-Inf
443.9,472,0,0,0,0,2023-09-18,2023-09-29,443.37,0,0,154689262,55771573,0,100,
445.11,473,0,0,0,0,2023-09-18,2023-09-29,443.37,0,0,154689262,55771573,0,100,
476,476,0,0,0,0,2023-09-18,2023-09-29,443.37,0,0,154689262,55771573,0,100,
444.94,477,0,0,0,0,2023-09-18,2023-09-29,443.37,0,0,154689262,55771573,0,100,
457.53,478,0,0,0,0,2023-09-18,2023-09-29,443.37,0,0,154689262,55771573,0,100,
455,479,0,0,0,0,2023-09-18,2023-09-29,443.37,0,0,154689262,55771573,0,100,
449.97,481,1,0,3103,0,2023-09-18,2023-09-29,443.37,-1,-3103,154689262,55771573,0,100,-Inf
449.97,482,1,0,3203,0,2023-09-18,2023-09-29,443.37,-1,-3203,154689262,55771573,0,100,-Inf
483,483,0,0,0,0,2023-09-18,2023-09-29,443.37,0,0,154689262,55771573,0,100,
449.8,484,1,0,3420,0,2023-09-18,2023-09-29,443.37,-1,-3420,154689262,55771573,0,100,-Inf
437.37,486,1,0,4863,0,2023-09-18,2023-09-29,443.37,-1,-4863,154689262,55771573,0,100,-Inf
488,488,0,0,0,0,2023-09-18,2023-09-29,443.37,0,0,154689262,55771573,0,100,
450.8,490,0,0,0,0,2023-09-18,2023-09-29,443.37,0,0,154689262,55771573,0,100,
492,492,0,0,0,0,2023-09-18,2023-09-29,443.37,0,0,154689262,55771573,0,100,
448.95,494,0,0,0,0,2023-09-18,2023-09-29,443.37,0,0,154689262,55771573,0,100,
451.55,495,0,0,0,0,2023-09-18,2023-09-29,443.37,0,0,154689262,55771573,0,100,
496,496,0,0,0,0,2023-09-18,2023-09-29,443.37,0,0,154689262,55771573,0,100,
446.64,500,0,0,0,0,2023-09-18,2023-09-29,443.37,0,0,154689262,55771573,0,100,
447.08,502,1,0,5492,0,2023-09-18,2023-09-29,443.37,-1,-5492,154689262,55771573,0,100,-Inf
447.21,504,2,0,11358,0,2023-09-18,2023-09-29,443.37,-2,-11358,154689262,55771573,0,100,-Inf
447.09,505,1,0,5791,0,2023-09-18,2023-09-29,443.37,-1,-5791,154689262,55771573,0,100,-Inf
447.1,510,1,0,6290,0,2023-09-18,2023-09-29,443.37,-1,-6290,154689262,55771573,0,100,-Inf
515,515,0,0,0,0,2023-09-18,2023-09-29,443.37,0,0,154689262,55771573,0,100,
435.05,520,0,0,0,0,2023-09-18,2023-09-29,443.37,0,0,154689262,55771573,0,100,
441.79,525,1,0,8321,0,2023-09-18,2023-09-29,443.37,-1,-8321,154689262,55771573,0,100,-Inf
444.11,530,2,0,17178,0,2023-09-18,2023-09-29,443.37,-2,-17178,154689262,55771573,0,100,-Inf
451.4,540,1,0,8860,0,2023-09-18,2023-09-29,443.37,-1,-8860,154689262,55771573,0,100,-Inf
449.99,550,1,0,10001,0,2023-09-18,2023-09-29,443.37,-1,-10001,154689262,55771573,0,100,-Inf
444.42,461,9,0,14922,0,2023-09-18,2023-10-06,443.37,-9,-14922,42650604,18727217,0,100,-Inf
445.85,463,0,0,0,0,2023-09-18,2023-10-06,443.37,0,0,42650604,18727217,0,100,
448.27,464,2,0,3146,0,2023-09-18,2023-10-06,443.37,-2,-3146,42650604,18727217,0,100,-Inf
444.6,465,4,0,8160,0,2023-09-18,2023-10-06,443.37,-4,-8160,42650604,18727217,0,100,-Inf
447.29,468,11,0,20559,0,2023-09-18,2023-10-06,443.37,-11,-20559,42650604,18727217,0,100,-Inf
449.65,471,0,0,0,0,2023-09-18,2023-10-06,443.37,0,0,42650604,18727217,0,100,
445.8,472,1,0,2620,0,2023-09-18,2023-10-06,443.37,-1,-2620,42650604,18727217,0,100,-Inf
449.8,474,2,0,4840,0,2023-09-18,2023-10-06,443.37,-2,-4840,42650604,18727217,0,100,-Inf
442.6,475,1,0,3240,0,2023-09-18,2023-10-06,443.37,-1,-3240,42650604,18727217,0,100,-Inf
447.17,476,1,0,2883,0,2023-09-18,2023-10-06,443.37,-1,-2883,42650604,18727217,0,100,-Inf
444.83,480,10,0,35170,0,2023-09-18,2023-10-06,443.37,-10,-35170,42650604,18727217,0,100,-Inf
482,482,0,0,0,0,2023-09-18,2023-10-06,443.37,0,0,42650604,18727217,0,100,
484,484,0,0,0,0,2023-09-18,2023-10-06,443.37,0,0,42650604,18727217,0,100,
485,485,0,0,0,0,2023-09-18,2023-10-06,443.37,0,0,42650604,18727217,0,100,
488,488,0,0,0,0,2023-09-18,2023-10-06,443.37,0,0,42650604,18727217,0,100,
444.75,490,1,0,4525,0,2023-09-18,2023-10-06,443.37,-1,-4525,42650604,18727217,0,100,-Inf
492,492,0,0,0,0,2023-09-18,2023-10-06,443.37,0,0,42650604,18727217,0,100,
445.1,494,0,0,0,0,2023-09-18,2023-10-06,443.37,0,0,42650604,18727217,0,100,
446.24,495,0,0,0,0,2023-09-18,2023-10-06,443.37,0,0,42650604,18727217,0,100,
500,500,0,0,0,0,2023-09-18,2023-10-06,443.37,0,0,42650604,18727217,0,100,
505,505,0,0,0,0,2023-09-18,2023-10-06,443.37,0,0,42650604,18727217,0,100,
510,510,0,0,0,0,2023-09-18,2023-10-06,443.37,0,0,42650604,18727217,0,100,
446.23,515,0,0,0,0,2023-09-18,2023-10-06,443.37,0,0,42650604,18727217,0,100,
520,520,0,0,0,0,2023-09-18,2023-10-06,443.37,0,0,42650604,18727217,0,100,
525,525,0,0,0,0,2023-09-18,2023-10-06,443.37,0,0,42650604,18727217,0,100,
530,530,0,0,0,0,2023-09-18,2023-10-06,443.37,0,0,42650604,18727217,0,100,
446.11,540,1,0,9389,0,2023-09-18,2023-10-06,443.37,-1,-9389,42650604,18727217,0,100,-Inf
445.85,463,1,0,1715,0,2023-09-18,2023-10-13,443.37,-1,-1715,30280851,12108347,0,100,-Inf
443.82,466,11,0,25267,0,2023-09-18,2023-10-13,443.37,-11,-25267,30280851,12108347,0,100,-Inf
447,467,2,0,4000,0,2023-09-18,2023-10-13,443.37,-2,-4000,30280851,12108347,0,100,-Inf
468,468,0,0,0,0,2023-09-18,2023-10-13,443.37,0,0,30280851,12108347,0,100,
449.61,469,3,0,5817,0,2023-09-18,2023-10-13,443.37,-3,-5817,30280851,12108347,0,100,-Inf
471,471,0,0,0,0,2023-09-18,2023-10-13,443.37,0,0,30280851,12108347,0,100,
443.8,472,1,0,2743,0,2023-09-18,2023-10-13,443.37,-1,-2743,30280851,12108347,0,100,-Inf
447.37,474,0,0,0,0,2023-09-18,2023-10-13,443.37,0,0,30280851,12108347,0,100,
446.41,475,0,0,0,0,2023-09-18,2023-10-13,443.37,0,0,30280851,12108347,0,100,
476,476,0,0,0,0,2023-09-18,2023-10-13,443.37,0,0,30280851,12108347,0,100,
446.5,478,1,0,3150,0,2023-09-18,2023-10-13,443.37,-1,-3150,30280851,12108347,0,100,-Inf
446.48,480,1,0,3352,0,2023-09-18,2023-10-13,443.37,-1,-3352,30280851,12108347,0,100,-Inf
482,482,0,0,0,0,2023-09-18,2023-10-13,443.37,0,0,30280851,12108347,0,100,
446.38,484,0,0,0,0,2023-09-18,2023-10-13,443.37,0,0,30280851,12108347,0,100,
485,485,0,0,0,0,2023-09-18,2023-10-13,443.37,0,0,30280851,12108347,0,100,
486,486,0,0,0,0,2023-09-18,2023-10-13,443.37,0,0,30280851,12108347,0,100,
443.93,490,1,0,4607,0,2023-09-18,2023-10-13,443.37,-1,-4607,30280851,12108347,0,100,-Inf
495,495,0,0,0,0,2023-09-18,2023-10-13,443.37,0,0,30280851,12108347,0,100,
443.38,500,3,0,16554,0,2023-09-18,2023-10-13,443.37,-3,-16554,30280851,12108347,0,100,-Inf
505,505,0,0,0,0,2023-09-18,2023-10-13,443.37,0,0,30280851,12108347,0,100,
510,510,0,0,0,0,2023-09-18,2023-10-13,443.37,0,0,30280851,12108347,0,100,
515,515,0,0,0,0,2023-09-18,2023-10-13,443.37,0,0,30280851,12108347,0,100,
444.71,520,1,0,7529,0,2023-09-18,2023-10-13,443.37,-1,-7529,30280851,12108347,0,100,-Inf
525,525,0,0,0,0,2023-09-18,2023-10-13,443.37,0,0,30280851,12108347,0,100,
530,530,0,0,0,0,2023-09-18,2023-10-13,443.37,0,0,30280851,12108347,0,100,
444.75,540,0,0,0,0,2023-09-18,2023-10-13,443.37,0,0,30280851,12108347,0,100,
438.6,476,0,0,0,0,2023-09-18,2023-10-20,443.37,0,0,473926306,145207170,0,100,
449.25,478,5,0,14375,0,2023-09-18,2023-10-20,443.37,-5,-14375,473926306,145207170,0,100,-Inf
456.58,486,0,0,0,0,2023-09-18,2023-10-20,443.37,0,0,473926306,145207170,0,100,
446.52,488,0,0,0,0,2023-09-18,2023-10-20,443.37,0,0,473926306,145207170,0,100,
492,492,0,0,0,0,2023-09-18,2023-10-20,443.37,0,0,473926306,145207170,0,100,
494,494,0,0,0,0,2023-09-18,2023-10-20,443.37,0,0,473926306,145207170,0,100,
496,496,0,0,0,0,2023-09-18,2023-10-20,443.37,0,0,473926306,145207170,0,100,
438.16,498,0,0,0,0,2023-09-18,2023-10-20,443.37,0,0,473926306,145207170,0,100,
502,502,0,0,0,0,2023-09-18,2023-10-20,443.37,0,0,473926306,145207170,0,100,
451.26,504,0,0,0,0,2023-09-18,2023-10-20,443.37,0,0,473926306,145207170,0,100,
449.21,505,0,0,0,0,2023-09-18,2023-10-20,443.37,0,0,473926306,145207170,0,100,
506,506,0,0,0,0,2023-09-18,2023-10-20,443.37,0,0,473926306,145207170,0,100,
442.77,510,0,0,0,0,2023-09-18,2023-10-20,443.37,0,0,473926306,145207170,0,100,
444.62,515,1,0,7038,0,2023-09-18,2023-10-20,443.37,-1,-7038,473926306,145207170,0,100,-Inf
455.07,520,0,0,0,0,2023-09-18,2023-10-20,443.37,0,0,473926306,145207170,0,100,
444.6,525,1,0,8040,0,2023-09-18,2023-10-20,443.37,-1,-8040,473926306,145207170,0,100,-Inf
445.68,530,0,0,0,0,2023-09-18,2023-10-20,443.37,0,0,473926306,145207170,0,100,
438.84,535,0,0,0,0,2023-09-18,2023-10-20,443.37,0,0,473926306,145207170,0,100,
445.83,540,0,0,0,0,2023-09-18,2023-10-20,443.37,0,0,473926306,145207170,0,100,
456.29,545,0,0,0,0,2023-09-18,2023-10-20,443.37,0,0,473926306,145207170,0,100,
451,550,0,0,0,0,2023-09-18,2023-10-20,443.37,0,0,473926306,145207170,0,100,
450.59,555,0,0,0,0,2023-09-18,2023-10-20,443.37,0,0,473926306,145207170,0,100,
443.34,560,0,0,0,0,2023-09-18,2023-10-20,443.37,0,0,473926306,145207170,0,100,
444.99,570,0,0,0,0,2023-09-18,2023-10-20,443.37,0,0,473926306,145207170,0,100,
445.25,575,0,0,0,0,2023-09-18,2023-10-20,443.37,0,0,473926306,145207170,0,100,
452.56,580,0,0,0,0,2023-09-18,2023-10-20,443.37,0,0,473926306,145207170,0,100,
446.3,585,0,0,0,0,2023-09-18,2023-10-20,443.37,0,0,473926306,145207170,0,100,
446.27,590,0,0,0,0,2023-09-18,2023-10-20,443.37,0,0,473926306,145207170,0,100,
456.13,595,0,0,0,0,2023-09-18,2023-10-20,443.37,0,0,473926306,145207170,0,100,
443.65,600,2,0,31126,0,2023-09-18,2023-10-20,443.37,-2,-31126,473926306,145207170,0,100,-Inf
463,463,0,0,0,0,2023-09-18,2023-10-27,443.37,0,0,38114356,12392570,0,100,
443.52,465,4,0,6928,0,2023-09-18,2023-10-27,443.37,-4,-6928,38114356,12392570,0,100,-Inf
466,466,0,0,0,0,2023-09-18,2023-10-27,443.37,0,0,38114356,12392570,0,100,
467,467,0,0,0,0,2023-09-18,2023-10-27,443.37,0,0,38114356,12392570,0,100,
468,468,0,0,0,0,2023-09-18,2023-10-27,443.37,0,0,38114356,12392570,0,100,
469,469,0,0,0,0,2023-09-18,2023-10-27,443.37,0,0,38114356,12392570,0,100,
472,472,0,0,0,0,2023-09-18,2023-10-27,443.37,0,0,38114356,12392570,0,100,
474,474,0,0,0,0,2023-09-18,2023-10-27,443.37,0,0,38114356,12392570,0,100,
445.74,475,0,0,0,0,2023-09-18,2023-10-27,443.37,0,0,38114356,12392570,0,100,
476,476,0,0,0,0,2023-09-18,2023-10-27,443.37,0,0,38114356,12392570,0,100,
478,478,0,0,0,0,2023-09-18,2023-10-27,443.37,0,0,38114356,12392570,0,100,
480,480,0,0,0,0,2023-09-18,2023-10-27,443.37,0,0,38114356,12392570,0,100,
444.4,482,0,0,0,0,2023-09-18,2023-10-27,443.37,0,0,38114356,12392570,0,100,
484,484,0,0,0,0,2023-09-18,2023-10-27,443.37,0,0,38114356,12392570,0,100,
485,485,0,0,0,0,2023-09-18,2023-10-27,443.37,0,0,38114356,12392570,0,100,
444.46,490,0,0,0,0,2023-09-18,2023-10-27,443.37,0,0,38114356,12392570,0,100,
495,495,0,0,0,0,2023-09-18,2023-10-27,443.37,0,0,38114356,12392570,0,100,
500,500,0,0,0,0,2023-09-18,2023-10-27,443.37,0,0,38114356,12392570,0,100,
505,505,0,0,0,0,2023-09-18,2023-10-27,443.37,0,0,38114356,12392570,0,100,
510,510,0,0,0,0,2023-09-18,2023-10-27,443.37,0,0,38114356,12392570,0,100,
515,515,0,0,0,0,2023-09-18,2023-10-27,443.37,0,0,38114356,12392570,0,100,
520,520,0,0,0,0,2023-09-18,2023-10-27,443.37,0,0,38114356,12392570,0,100,
525,525,0,0,0,0,2023-09-18,2023-10-27,443.37,0,0,38114356,12392570,0,100,
530,530,0,0,0,0,2023-09-18,2023-10-27,443.37,0,0,38114356,12392570,0,100,
540,540,0,0,0,0,2023-09-18,2023-10-27,443.37,0,0,38114356,12392570,0,100,
474,474,0,0,0,0,2023-09-18,2023-11-17,443.37,0,0,443991078,126746889,0,100,
448.11,478,2,0,5978,0,2023-09-18,2023-11-17,443.37,-2,-5978,443991078,126746889,0,100,-Inf
449.76,482,39,0,125736,0,2023-09-18,2023-11-17,443.37,-39,-125736,443991078,126746889,0,100,-Inf
484,484,0,0,0,0,2023-09-18,2023-11-17,443.37,0,0,443991078,126746889,0,100,
437.31,485,1,0,4769,0,2023-09-18,2023-11-17,443.37,-1,-4769,443991078,126746889,0,100,-Inf
488,488,0,0,0,0,2023-09-18,2023-11-17,443.37,0,0,443991078,126746889,0,100,
444.95,490,0,0,0,0,2023-09-18,2023-11-17,443.37,0,0,443991078,126746889,0,100,
492,492,0,0,0,0,2023-09-18,2023-11-17,443.37,0,0,443991078,126746889,0,100,
494,494,0,0,0,0,2023-09-18,2023-11-17,443.37,0,0,443991078,126746889,0,100,
496,496,0,0,0,0,2023-09-18,2023-11-17,443.37,0,0,443991078,126746889,0,100,
440.45,505,0,0,0,0,2023-09-18,2023-11-17,443.37,0,0,443991078,126746889,0,100,
449.9,510,1,0,6010,0,2023-09-18,2023-11-17,443.37,-1,-6010,443991078,126746889,0,100,-Inf
444.16,515,1,0,7084,0,2023-09-18,2023-11-17,443.37,-1,-7084,443991078,126746889,0,100,-Inf
520,520,0,0,0,0,2023-09-18,2023-11-17,443.37,0,0,443991078,126746889,0,100,
525,525,0,0,0,0,2023-09-18,2023-11-17,443.37,0,0,443991078,126746889,0,100,
448.8,530,1,0,8120,0,2023-09-18,2023-11-17,443.37,-1,-8120,443991078,126746889,0,100,-Inf
535,535,0,0,0,0,2023-09-18,2023-11-17,443.37,0,0,443991078,126746889,0,100,
439.89,540,0,0,0,0,2023-09-18,2023-11-17,443.37,0,0,443991078,126746889,0,100,
545,545,0,0,0,0,2023-09-18,2023-11-17,443.37,0,0,443991078,126746889,0,100,
434.33,550,0,0,0,0,2023-09-18,2023-11-17,443.37,0,0,443991078,126746889,0,100,
443.66,560,0,0,0,0,2023-09-18,2023-11-17,443.37,0,0,443991078,126746889,0,100,
474,474,0,0,0,0,2023-09-18,2023-12-15,443.37,0,0,508084803,96118471,0,100,
436,478,0,0,0,0,2023-09-18,2023-12-15,443.37,0,0,508084803,96118471,0,100,
449,481,1,0,3200,0,2023-09-18,2023-12-15,443.37,-1,-3200,508084803,96118471,0,100,-Inf
482,482,0,0,0,0,2023-09-18,2023-12-15,443.37,0,0,508084803,96118471,0,100,
483,483,0,0,0,0,2023-09-18,2023-12-15,443.37,0,0,508084803,96118471,0,100,
457.21,484,0,0,0,0,2023-09-18,2023-12-15,443.37,0,0,508084803,96118471,0,100,
486,486,0,0,0,0,2023-09-18,2023-12-15,443.37,0,0,508084803,96118471,0,100,
443.49,487,1,0,4330,0,2023-09-18,2023-12-15,443.37,-1,-4330,508084803,96118471,0,100,-Inf
454.85,488,0,0,0,0,2023-09-18,2023-12-15,443.37,0,0,508084803,96118471,0,100,
445.13,489,1,0,4387,0,2023-09-18,2023-12-15,443.37,-1,-4387,508084803,96118471,0,100,-Inf
443.85,491,19,0,89585,0,2023-09-18,2023-12-15,443.37,-19,-89585,508084803,96118471,0,100,-Inf
444.92,492,2,0,9416,0,2023-09-18,2023-12-15,443.37,-2,-9416,508084803,96118471,0,100,-Inf
493,493,0,0,0,0,2023-09-18,2023-12-15,443.37,0,0,508084803,96118471,0,100,
494,494,0,0,0,0,2023-09-18,2023-12-15,443.37,0,0,508084803,96118471,0,100,
449.13,495,1,0,4587,0,2023-09-18,2023-12-15,443.37,-1,-4587,508084803,96118471,0,100,-Inf
496,496,0,0,0,0,2023-09-18,2023-12-15,443.37,0,0,508084803,96118471,0,100,
497,497,0,0,0,0,2023-09-18,2023-12-15,443.37,0,0,508084803,96118471,0,100,
450.44,498,0,0,0,0,2023-09-18,2023-12-15,443.37,0,0,508084803,96118471,0,100,
499,499,0,0,0,0,2023-09-18,2023-12-15,443.37,0,0,508084803,96118471,0,100,
501,501,0,0,0,0,2023-09-18,2023-12-15,443.37,0,0,508084803,96118471,0,100,
450.54,505,0,0,0,0,2023-09-18,2023-12-15,443.37,0,0,508084803,96118471,0,100,
443.32,515,1,0,7168,0,2023-09-18,2023-12-15,443.37,-1,-7168,508084803,96118471,0,100,-Inf
450,520,2,0,14000,0,2023-09-18,2023-12-15,443.37,-2,-14000,508084803,96118471,0,100,-Inf
441.04,530,0,0,0,0,2023-09-18,2023-12-15,443.37,0,0,508084803,96118471,0,100,
440.46,535,0,0,0,0,2023-09-18,2023-12-15,443.37,0,0,508084803,96118471,0,100,
545,545,0,0,0,0,2023-09-18,2023-12-15,443.37,0,0,508084803,96118471,0,100,
454.85,550,0,0,0,0,2023-09-18,2023-12-15,443.37,0,0,508084803,96118471,0,100,
450.28,560,0,0,0,0,2023-09-18,2023-12-15,443.37,0,0,508084803,96118471,0,100,
565,565,0,0,0,0,2023-09-18,2023-12-15,443.37,0,0,508084803,96118471,0,100,
451.5,570,1,0,11850,0,2023-09-18,2023-12-15,443.37,-1,-11850,508084803,96118471,0,100,-Inf
575,575,0,0,0,0,2023-09-18,2023-12-15,443.37,0,0,508084803,96118471,0,100,
580,580,0,0,0,0,2023-09-18,2023-12-15,443.37,0,0,508084803,96118471,0,100,
585,585,0,0,0,0,2023-09-18,2023-12-15,443.37,0,0,508084803,96118471,0,100,
450.23,595,0,0,0,0,2023-09-18,2023-12-15,443.37,0,0,508084803,96118471,0,100,
452.7,600,1,0,14730,0,2023-09-18,2023-12-15,443.37,-1,-14730,508084803,96118471,0,100,-Inf
605,605,0,0,0,0,2023-09-18,2023-12-15,443.37,0,0,508084803,96118471,0,100,
610,610,0,0,0,0,2023-09-18,2023-12-15,443.37,0,0,508084803,96118471,0,100,
615,615,0,0,0,0,2023-09-18,2023-12-15,443.37,0,0,508084803,96118471,0,100,
620,620,0,0,0,0,2023-09-18,2023-12-15,443.37,0,0,508084803,96118471,0,100,
625,625,0,0,0,0,2023-09-18,2023-12-15,443.37,0,0,508084803,96118471,0,100,
630,630,0,0,0,0,2023-09-18,2023-12-15,443.37,0,0,508084803,96118471,0,100,
635,635,0,0,0,0,2023-09-18,2023-12-15,443.37,0,0,508084803,96118471,0,100,
640,640,0,0,0,0,2023-09-18,2023-12-15,443.37,0,0,508084803,96118471,0,100,
645,645,0,0,0,0,2023-09-18,2023-12-15,443.37,0,0,508084803,96118471,0,100,
650,650,0,0,0,0,2023-09-18,2023-12-15,443.37,0,0,508084803,96118471,0,100,
655,655,0,0,0,0,2023-09-18,2023-12-15,443.37,0,0,508084803,96118471,0,100,
660,660,0,0,0,0,2023-09-18,2023-12-15,443.37,0,0,508084803,96118471,0,100,
665,665,0,0,0,0,2023-09-18,2023-12-15,443.37,0,0,508084803,96118471,0,100,
445.5,670,1,0,22450,0,2023-09-18,2023-12-15,443.37,-1,-22450,508084803,96118471,0,100,-Inf
675,675,0,0,0,0,2023-09-18,2023-12-15,443.37,0,0,508084803,96118471,0,100,
680,680,0,0,0,0,2023-09-18,2023-12-15,443.37,0,0,508084803,96118471,0,100,
445.94,685,1,0,23906,0,2023-09-18,2023-12-15,443.37,-1,-23906,508084803,96118471,0,100,-Inf
690,690,0,0,0,0,2023-09-18,2023-12-15,443.37,0,0,508084803,96118471,0,100,
695,695,0,0,0,0,2023-09-18,2023-12-15,443.37,0,0,508084803,96118471,0,100,
451.18,700,0,0,0,0,2023-09-18,2023-12-15,443.37,0,0,508084803,96118471,0,100,
705,705,0,0,0,0,2023-09-18,2023-12-15,443.37,0,0,508084803,96118471,0,100,
710,710,0,0,0,0,2023-09-18,2023-12-15,443.37,0,0,508084803,96118471,0,100,
442.92,715,0,0,0,0,2023-09-18,2023-12-15,443.37,0,0,508084803,96118471,0,100,
