Watch,strike,open_interest.yt,open_interest.td,OI_Dollar.yt,OI_Dollar.td,Date.td,expiry,stkClose,diff_oi,diff_oi_d,totalOI,totalOIdiff,OI_pct,cum_sep_OI,pct
493.15,500,226936,223276,93043760,152944060,2024-09-04,2024-12-20,552.08,-3660,59900300,769049161,290977996,19.8874230356257,19.8874230356257,0.391648423613183
526.63,540,63046,63038,53589100,84281806,2024-09-04,2024-12-20,552.08,-8,30692706,769049161,290977996,10.9592221504289,30.8466451860546,0.364167635420627
539.65,550,65424,60554,35917776,62673390,2024-09-04,2024-10-18,552.08,-4870,26755614,526522587,265443300,11.9032671242269,11.9032671242269,0.426905485725282
518.52,530,36003,35900,25382115,41213200,2024-09-04,2024-12-20,552.08,-103,15831085,769049161,290977996,5.35898120562412,36.2056263916788,0.384126566245766
512.98,520,57198,55175,22879200,38732850,2024-09-04,2024-11-15,552.08,-2023,15853650,416800800,184114755,9.29289243206827,9.29289243206827,0.409307603236013
543.31,550,58806,56023,15877620,37479387,2024-09-04,2024-09-20,552.08,-2783,21601767,482984077,286009246,7.7599632751454,7.7599632751454,0.576363935728191
540.1,560,19117,18612,25521195,37037880,2024-09-04,2024-12-20,552.08,-505,11516685,769049161,290977996,4.81606142731362,41.0216878189924,0.310943417927808
542.39,560,20633,19919,22716933,35077359,2024-09-04,2024-11-15,552.08,-714,12360426,416800800,184114755,8.41585692733795,17.7087493594062,0.35237618658805
535.99,540,89107,86323,13811585,34615523,2024-09-04,2024-09-20,552.08,-2784,20803938,482984077,286009246,7.16701122219398,14.9269744973394,0.601000250667887
536,550,23704,24088,19698024,33723200,2024-09-04,2024-11-15,552.08,384,14025176,416800800,184114755,8.09096335707609,25.7997127164823,0.415891018645917
532.44,540,40397,43798,15633639,33111288,2024-09-04,2024-10-18,552.08,3401,17477649,526522587,265443300,6.28867380384576,18.1919409280727,0.527845639831347
539.61,555,19109,19761,18440185,30412179,2024-09-04,2024-11-15,552.08,652,11971994,416800800,184114755,7.29657404688283,33.0962867633651,0.39365788291592
484.25,490,48747,48948,17061450,28145100,2024-09-04,2024-12-20,552.08,201,11083650,769049161,290977996,3.65972702751574,44.6814148465081,0.393803894816505
495.28,500,41990,55390,11043370,26144080,2024-09-04,2024-11-15,552.08,13400,15100710,416800800,184114755,6.27255993750492,39.3688467008701,0.577595769290792
545.65,560,18075,18139,14514225,26029465,2024-09-04,2024-10-18,552.08,64,11515240,526522587,265443300,4.94365591195426,23.1355968400269,0.44239249634981
470.07,475,50731,51223,13697370,25252939,2024-09-04,2024-12-20,552.08,492,11555569,769049161,290977996,3.2836573109531,47.9650721574612,0.457593035012677
546.26,555,31785,28869,11633310,25231506,2024-09-04,2024-09-20,552.08,-2916,13598196,482984077,286009246,5.22408650751441,20.1510610048538,0.538937152621806
520.06,525,35903,48603,8903944,24009882,2024-09-04,2024-10-18,552.08,12700,15105938,526522587,265443300,4.56008585249924,27.6956826925262,0.629155028750246
514.33,525,21595,21278,13799205,22703626,2024-09-04,2024-12-20,552.08,-317,8904421,769049161,290977996,2.95216835949451,50.9172405169557,0.392202593541666
533.84,550,14292,13879,15192396,22428464,2024-09-04,2024-12-20,552.08,-413,7236068,769049161,290977996,2.91638885228561,53.8336293692413,0.322628780999002
486.1,490,57372,57248,12392352,22326720,2024-09-04,2024-11-15,552.08,-124,9934368,416800800,184114755,5.35668837487836,44.7255350757484,0.444954207335426
510.72,520,21132,22129,12404484,20535712,2024-09-04,2024-12-20,552.08,997,8131228,769049161,290977996,2.6702729866186,56.5039023558599,0.395955494506351
536.19,545,17924,23307,8173344,20533467,2024-09-04,2024-10-18,552.08,5383,12360123,526522587,265443300,3.89982642852889,31.5955091210551,0.601950123668838
527.5,530,80598,80062,7818006,20015500,2024-09-04,2024-09-20,552.08,-536,12197494,482984077,286009246,4.14413247830528,24.2951934831591,0.609402413129824
497.76,505,26983,27197,12088384,19690628,2024-09-04,2024-12-20,552.08,214,7602244,769049161,290977996,2.56038612335213,59.0642884792121,0.38608438491652
530.36,545,13603,13317,13167704,19496088,2024-09-04,2024-12-20,552.08,-286,6328384,769049161,290977996,2.53508995116113,61.5993784303732,0.324597632099322
542.78,555,13272,15737,8772792,19230614,2024-09-04,2024-10-18,552.08,2465,10457822,526522587,265443300,3.65238158339445,35.2478907044495,0.543811133643471
521.39,530,20978,21006,10614868,18086166,2024-09-04,2024-11-15,552.08,28,7471298,416800800,184114755,4.33928293803659,49.064818013785,0.413094627131035
539.85,545,35575,34685,7221725,17862775,2024-09-04,2024-09-20,552.08,-890,10641050,482984077,286009246,3.69841902676224,27.9936125099213,0.59571091277811
522.11,535,13051,13096,10597412,16880744,2024-09-04,2024-12-20,552.08,45,6283332,769049161,290977996,2.19501494261431,63.7943933729875,0.372218902200045
518.32,520,96103,95973,6246695,16123464,2024-09-04,2024-09-20,552.08,-130,9876769,482984077,286009246,3.33830135770708,31.3319138676284,0.612571157165731
548.6,560,14897,13986,7508088,15944040,2024-09-04,2024-09-20,552.08,-911,8435952,482984077,286009246,3.30115230693206,34.6330661745604,0.529097518571203
501.97,510,19806,19829,9665328,15922687,2024-09-04,2024-12-20,552.08,23,6257359,769049161,290977996,2.07043812118534,65.8648314941729,0.392983860073366
547.17,565,8311,8566,8186335,15273178,2024-09-04,2024-10-18,552.08,255,7086843,526522587,265443300,2.90076406541701,38.1486547698665,0.46400578844822
536.65,555,8165,8305,9798000,15239675,2024-09-04,2024-12-20,552.08,140,5441675,769049161,290977996,1.98162559337348,67.8464570875463,0.357072903457587
497.29,500,54896,55743,7246272,15106353,2024-09-04,2024-10-18,552.08,847,7860081,526522587,265443300,2.86907976466354,41.01773453453,0.52031625369803
515.69,520,31658,32516,6743154,14014396,2024-09-04,2024-10-18,552.08,858,7271242,526522587,265443300,2.66168942150244,43.6794239560325,0.518840911873762
531.84,535,47147,43769,5704787,13831004,2024-09-04,2024-09-20,552.08,-3378,8126217,482984077,286009246,2.86365631055783,37.4967224851183,0.587536306113425
525.32,535,13977,14245,7897005,13789160,2024-09-04,2024-11-15,552.08,268,5892155,416800800,184114755,3.30833338131789,52.3731513951029,0.427303403543073
499.86,505,26504,26135,7659656,13433390,2024-09-04,2024-11-15,552.08,-369,5773734,416800800,184114755,3.22297605954691,55.5961274546498,0.429804688168809
523.52,529,16703,24474,4660137,13411752,2024-09-04,2024-10-18,552.08,7771,8751615,526522587,265443300,2.54723203356136,46.2266559895939,0.652533315557878
525.61,532,38869,20694,11544093,13223466,2024-09-04,2024-10-18,552.08,-18175,1679373,526522587,265443300,2.51147174432614,48.73812773392,0.12699945687462
487.77,490,55443,59006,5821515,13158338,2024-09-04,2024-10-18,552.08,3563,7336823,526522587,265443300,2.49910228447616,51.2372300183962,0.557579764252902
398.14,400,70028,69956,7352940,13011816,2024-09-04,2024-12-20,552.08,-72,5658876,769049161,290977996,1.69193553024369,69.53839261779,0.434902860599935
536.85,541,29648,31073,4714032,12895295,2024-09-04,2024-09-20,552.08,1425,8181263,482984077,286009246,2.66992135229336,40.1666438374116,0.634437831782833
488.44,495,20055,19566,7841505,12835296,2024-09-04,2024-12-20,552.08,-489,4993791,769049161,290977996,1.66898251124937,71.2073751290394,0.389067069431044
532.81,545,10566,10513,7744878,12815347,2024-09-04,2024-11-15,552.08,-53,5070469,416800800,184114755,3.07469347467663,58.6708209293264,0.395656005256822
529.32,536,18979,18996,6471839,12689328,2024-09-04,2024-10-18,552.08,17,6217489,526522587,265443300,2.41002538415318,53.6472554025493,0.489977798666722
475.11,480,25541,25706,7560136,12570234,2024-09-04,2024-12-20,552.08,165,5010098,769049161,290977996,1.63451631410076,72.8418914431402,0.398568395783245
438.12,440,65377,65387,6341569,12292756,2024-09-04,2024-11-15,552.08,10,5951187,416800800,184114755,2.94931199748177,61.6201329268082,0.484121461452582
506.63,510,36103,36445,5956995,12281965,2024-09-04,2024-10-18,552.08,342,6324970,526522587,265443300,2.33265681344835,55.9799122159977,0.514980298348025
506.52,515,10862,14040,5789446,11905920,2024-09-04,2024-12-20,552.08,3178,6116474,769049161,290977996,1.54813510029952,74.3900265434397,0.513733839972048
528.51,535,17413,18189,5711464,11804661,2024-09-04,2024-10-18,552.08,776,6093197,526522587,265443300,2.24200467206168,58.2219168880594,0.51616874046616
529.18,540,11381,10859,7340745,11749438,2024-09-04,2024-11-15,552.08,-522,4408693,416800800,184114755,2.81895764115616,64.4390905679644,0.375225861866755
541.95,548,19047,19323,4552233,11690415,2024-09-04,2024-09-20,552.08,276,7138182,482984077,286009246,2.42045557125064,42.5870994086623,0.610601248971914
458.68,460,86245,85962,5433435,11346984,2024-09-04,2024-10-18,552.08,-283,5913549,526522587,265443300,2.15508019601826,60.3769970840776,0.521156018198316
524.4,530,19777,19995,5596891,11197200,2024-09-04,2024-10-18,552.08,218,5600309,526522587,265443300,2.12663241358723,62.5036294976648,0.500152627442575
504.26,510,18832,18789,6007408,10784886,2024-09-04,2024-11-15,552.08,-43,4777478,416800800,184114755,2.5875396592329,67.0266302271973,0.442978998572632
409.3,410,151899,152503,4556970,10675210,2024-09-04,2024-10-18,552.08,604,6118240,526522587,265443300,2.0274932668748,64.5311227645396,0.573125961924871
499.06,500,114413,112363,4576520,10562122,2024-09-04,2024-09-20,552.08,-2050,5985602,482984077,286009246,2.18684683470424,44.7739462433665,0.566704493661406
388.96,390,101166,101265,5159466,10531560,2024-09-04,2024-11-15,552.08,99,5372094,416800800,184114755,2.52676098510368,69.5533912123009,0.510094800770256
446.66,450,31538,31406,6055296,10489604,2024-09-04,2024-12-20,552.08,-132,4434308,769049161,290977996,1.36397054075975,75.7539970841994,0.422733594137586
522.95,525,46091,48670,3595098,9977350,2024-09-04,2024-09-20,552.08,2579,6382252,482984077,286009246,2.06577203579322,46.8397182791598,0.639674061749863
513.57,515,71435,69360,4000360,9918480,2024-09-04,2024-09-20,552.08,-2075,5918120,482984077,286009246,2.05358322816924,48.893301507329,0.596676103596519
535.01,540,22552,19810,4826128,9885190,2024-09-04,2024-09-27,552.08,-2742,5059062,91156178,55503910,10.844234825203,10.844234825203,0.511781968783605
501.99,505,28956,32620,4198620,9818620,2024-09-04,2024-10-18,552.08,3664,5620000,526522587,265443300,1.8648050895488,66.3959278540884,0.57238186221689
508.67,515,15442,15360,5451026,9722880,2024-09-04,2024-11-15,552.08,-82,4271854,416800800,184114755,2.33274024426057,71.8861314565615,0.439360971234861
451.54,455,27422,27427,5648932,9489742,2024-09-04,2024-12-20,552.08,5,3840810,769049161,290977996,1.23395778595746,76.9879548701569,0.40473281570774
546.04,561,5868,6154,4700268,9206384,2024-09-04,2024-10-18,552.08,286,4506116,526522587,265443300,1.74852593740675,68.1444537914952,0.489455577781679
481.15,485,9965,23319,1893350,8977815,2024-09-04,2024-11-15,552.08,13354,7084465,416800800,184114755,2.15398219005338,74.0401136466149,0.789107928822325
508.8,510,76867,73716,3766483,8845920,2024-09-04,2024-09-20,552.08,-3151,5079437,482984077,286009246,1.83151379543305,50.724815302762,0.574212405267061
511.19,515,24372,23113,4557564,8806053,2024-09-04,2024-10-18,552.08,-1259,4248489,526522587,265443300,1.67249292194183,69.816946713437,0.482450991380588
547.7,558,8383,8503,3688520,8758090,2024-09-04,2024-09-20,552.08,120,5069570,482984077,286009246,1.81332893092457,52.5381442336866,0.578844245720243
537.21,547,7761,8340,3686475,8164860,2024-09-04,2024-10-18,552.08,579,4478385,526522587,265443300,1.55071410070391,71.3676608141409,0.548495013999015
546.75,556,7255,8710,2778665,8056750,2024-09-04,2024-09-20,552.08,1455,5278085,482984077,286009246,1.66811917486878,54.2062634085554,0.655113414217892
399.4,400,129371,129156,3363646,7749360,2024-09-04,2024-10-18,552.08,-215,4385714,526522587,265443300,1.47180010721933,72.8394609213602,0.565945316774547
494.19,495,96056,95050,3458016,7699050,2024-09-04,2024-09-20,552.08,-1006,4241034,482984077,286009246,1.59405876231402,55.8003221708694,0.55085159857385
548.49,568,3864,3910,5096616,7628410,2024-09-04,2024-10-18,552.08,46,2531794,526522587,265443300,1.44882863306299,74.2882895544233,0.33189013175747
544.1,570,2889,2940,4937301,7614600,2024-09-04,2024-12-20,552.08,51,2677299,769049161,290977996,0.990131760900523,77.9780866310574,0.351600740682373
469.25,470,101448,101448,3347784,7608600,2024-09-04,2024-09-27,552.08,0,4260816,91156178,55503910,8.34677381932358,19.1910086445265,0.56
419.63,420,201334,201313,3221344,7448581,2024-09-04,2024-09-27,552.08,-21,4227237,91156178,55503910,8.1712300399431,27.3622386844696,0.567522458304474
456.27,460,19516,19478,4332552,7265294,2024-09-04,2024-12-20,552.08,-38,2932742,769049161,290977996,0.944711257542091,78.9227978885995,0.403664600496553
517.18,525,9206,9289,4059846,7263998,2024-09-04,2024-11-15,552.08,83,3204152,416800800,184114755,1.74279847831386,75.7829121249288,0.441100341712649
448.83,450,61631,61453,3328074,7190001,2024-09-04,2024-10-18,552.08,-178,3861927,526522587,265443300,1.36556363915305,75.6538531935763,0.537124681901991
479.39,480,117394,116903,3287032,7131083,2024-09-04,2024-09-20,552.08,-491,3844051,482984077,286009246,1.47646337417455,57.276785545044,0.539055708649023
479.43,485,11992,12726,3981344,7088382,2024-09-04,2024-12-20,552.08,734,3107038,769049161,290977996,0.921707266513746,79.8445051551132,0.438328239081923
546.57,562,4208,4507,3618880,6954301,2024-09-04,2024-10-18,552.08,299,3335421,526522587,265443300,1.32079822816794,76.9746514217442,0.479619878403308
542.19,550,8478,8730,2899476,6818130,2024-09-04,2024-09-27,552.08,252,3918654,91156178,55503910,7.47961372404183,34.8418524085115,0.574740288026189
465.78,470,15853,16079,4026662,6785338,2024-09-04,2024-12-20,552.08,226,2758676,769049161,290977996,0.882302243354245,80.7268073984675,0.406564271374543
530.13,533,22929,22718,2590977,6520066,2024-09-04,2024-09-20,552.08,-211,3929089,482984077,286009246,1.34995464871195,58.6267401937559,0.602614912180337
540.66,558,3737,3721,3942535,6452214,2024-09-04,2024-11-15,552.08,-16,2509679,416800800,184114755,1.5480330172111,77.3309451421399,0.388964005223633
462.14,465,20984,21135,2853824,6044610,2024-09-04,2024-11-15,552.08,151,3190786,416800800,184114755,1.45023953888764,78.7811846810275,0.527872931421547
535.12,544,6620,6737,2892940,5982456,2024-09-04,2024-10-18,552.08,117,3089516,526522587,265443300,1.13622020169858,78.1108716234428,0.516429372819458
545.13,553,7293,7592,2297295,5974904,2024-09-04,2024-09-20,552.08,299,3677609,482984077,286009246,1.23708094832286,59.8638211420788,0.615509303580442
546.43,563,3376,3540,3058656,5865780,2024-09-04,2024-10-18,552.08,164,2807124,526522587,265443300,1.11406046859676,79.2249320920396,0.478559373177992
437,440,19357,19332,3716544,5799600,2024-09-04,2024-12-20,552.08,-25,2083056,769049161,290977996,0.754126042145178,81.4809334406126,0.359172356714256
542.81,556,4540,4386,3073580,5785134,2024-09-04,2024-10-18,552.08,-154,2711554,526522587,265443300,1.09874374677111,80.3236758388107,0.468710664264648
417.65,420,24205,24305,3219265,5711675,2024-09-04,2024-12-20,552.08,100,2492410,769049161,290977996,0.742693092932196,82.2236265335449,0.436371117054104
542.69,549,8556,8985,2087664,5669535,2024-09-04,2024-09-20,552.08,429,3581871,482984077,286009246,1.17385546853132,61.0376766106101,0.63177509266633
547.03,550,20459,18462,900196,5483214,2024-09-04,2024-09-06,552.08,-1997,4583018,65864122,49955284,8.32503923759889,8.32503923759889,0.835826943832577
528.03,543,3686,3646,3534874,5458062,2024-09-04,2024-12-20,552.08,-40,1923188,769049161,290977996,0.709715617256879,82.9333421508017,0.352357301914123
429.69,430,175530,175540,2457420,5441740,2024-09-04,2024-09-20,552.08,10,2984320,482984077,286009246,1.12669138779911,62.1643679984092,0.548412823839434
441.83,445,16976,17013,3225440,5393121,2024-09-04,2024-12-20,552.08,37,2167681,769049161,290977996,0.701271293630603,83.6346134444323,0.40193442720829
503.96,505,51666,51741,2221638,5381064,2024-09-04,2024-09-20,552.08,75,3159426,482984077,286009246,1.11412865480449,63.2784966532137,0.587137785389655
545.36,554,4773,6178,1637139,5337792,2024-09-04,2024-09-20,552.08,1405,3700653,482984077,286009246,1.10516935323315,64.3836660064468,0.693292844681846
540.59,546,8062,9669,1701082,5230929,2024-09-04,2024-09-20,552.08,1607,3529847,482984077,286009246,1.08304377910165,65.4667097855485,0.674803079911809
476.67,480,15276,15219,2703852,5067927,2024-09-04,2024-11-15,552.08,-57,2364075,416800800,184114755,1.21591105391352,79.997095734941,0.466477713668725
444.61,445,129304,129005,2198168,5031195,2024-09-04,2024-09-20,552.08,-299,2833027,482984077,286009246,1.04168962075327,66.5083994063018,0.563092267344041
460.89,465,11659,11667,2786501,4795137,2024-09-04,2024-12-20,552.08,8,2008636,769049161,290977996,0.623515016096611,84.2581284605289,0.418890221488979
432.1,435,16468,16469,2667816,4776010,2024-09-04,2024-12-20,552.08,1,2108194,769049161,290977996,0.621027918916096,84.879156379445,0.441413229871797
549.51,562,3744,3790,2156544,4733710,2024-09-04,2024-09-20,552.08,46,2577166,482984077,286009246,0.980096492911919,67.4884958992137,0.544428365911727
548.3,559,3721,4327,1763754,4629890,2024-09-04,2024-09-20,552.08,606,2866136,482984077,286009246,0.958600960254845,68.4470968594685,0.619050560596472
522.71,528,8632,8645,2244320,4573205,2024-09-04,2024-10-18,552.08,13,2328885,526522587,265443300,0.868567676470829,81.1922435152815,0.509245704052191
492.57,495,17395,18668,2035215,4536324,2024-09-04,2024-10-18,552.08,1273,2501109,526522587,265443300,0.86156303870018,82.0538065539817,0.551351490766533
543.28,558,2925,3036,2146950,4468992,2024-09-04,2024-10-18,552.08,111,2322042,526522587,265443300,0.848774983322796,82.9025815373045,0.519589652431689
537.82,548,1596,4376,796404,4454768,2024-09-04,2024-10-18,552.08,2780,3658364,526522587,265443300,0.846073484782905,83.7486550220874,0.821224360056461
549.13,559,4352,4471,1366528,4412877,2024-09-04,2024-09-13,552.08,119,3046349,70051475,47265620,6.29947763412548,6.29947763412548,0.690331726898348
482.96,485,21299,21548,2023405,4395792,2024-09-04,2024-10-18,552.08,249,2372387,526522587,265443300,0.83487244584248,84.5835274679299,0.539695008317045
550.15,565,3029,2918,2132416,4333230,2024-09-04,2024-09-20,552.08,-111,2200814,482984077,286009246,0.897178645498079,69.3442755049666,0.507892265123245
447.68,450,18054,18499,2003994,4291768,2024-09-04,2024-11-15,552.08,445,2287774,416800800,184114755,1.02969284128053,81.0267885762216,0.533060966948819
541.24,547,6678,7428,1509228,4278528,2024-09-04,2024-09-20,552.08,750,2769300,482984077,286009246,0.885852806282059,70.2301283112487,0.647255317716748
548.05,561,3693,3296,1990527,4268320,2024-09-04,2024-09-20,552.08,-397,2277793,482984077,286009246,0.883739279048738,71.1138675902974,0.533650944633954
547.23,557,3424,4320,1427808,4220640,2024-09-04,2024-09-20,552.08,896,2792832,482984077,286009246,0.873867317990278,71.9877349082877,0.661708176958945
520.21,522,24072,23563,1660968,4217777,2024-09-04,2024-09-20,552.08,-509,2556809,482984077,286009246,0.873274544825212,72.8610094531129,0.606198241395882
454.57,455,96685,97062,1933700,4173666,2024-09-04,2024-09-20,552.08,377,2239966,482984077,286009246,0.864141531522995,73.7251509846359,0.536690286189647
422.42,425,16130,16110,2661450,4156380,2024-09-04,2024-12-20,552.08,-20,1494930,769049161,290977996,0.540456996870711,85.4196133763158,0.359671156150304
549.6,563,3564,3097,2198988,4149980,2024-09-04,2024-09-20,552.08,-467,1950992,482984077,286009246,0.859237436102889,74.5843884207388,0.470120819859373
543.5,563,2159,2119,2554097,4132050,2024-09-04,2024-11-15,552.08,-40,1577953,416800800,184114755,0.991372857249794,82.0181614334713,0.381881390593047
549.21,567,2325,2321,1869300,4129059,2024-09-04,2024-09-20,552.08,-4,2259759,482984077,286009246,0.854905823323861,75.4392942440626,0.547281838307469
544.56,552,5248,5526,1584896,4111344,2024-09-04,2024-09-20,552.08,278,2526448,482984077,286009246,0.851238000543857,76.2905322446065,0.614506594437245
548.73,553,9209,9567,672257,4085109,2024-09-04,2024-09-06,552.08,358,3412852,65864122,49955284,6.20232818103914,14.527367418638,0.835437193964714
521.12,523,21389,21502,1540008,4042376,2024-09-04,2024-09-20,552.08,113,2502368,482984077,286009246,0.836958440764498,77.127490685371,0.61903395428827
551.5,560,6723,4747,1472337,4034950,2024-09-04,2024-09-06,552.08,-1976,2562613,65864122,49955284,6.12617291095143,20.6535403295895,0.63510402855054
474.42,475,69637,69437,1810562,4027346,2024-09-04,2024-09-20,552.08,-200,2216784,482984077,286009246,0.833846536932521,77.9613372223035,0.550432965034541
378.53,380,27533,27358,2450437,4021626,2024-09-04,2024-12-20,552.08,-175,1571189,769049161,290977996,0.522934840052442,85.9425482163682,0.390685011485404
489.27,490,55425,54212,1773600,3957476,2024-09-04,2024-09-20,552.08,-1213,2183876,482984077,286009246,0.819380221514011,78.7807174438175,0.551835563879604
534.02,543,4112,4386,1718816,3938628,2024-09-04,2024-10-18,552.08,274,2219812,526522587,265443300,0.74804540151665,85.3315728694465,0.563600319705238
541.67,565,1728,1684,2595456,3928772,2024-09-04,2024-12-20,552.08,-44,1333316,769049161,290977996,0.510860969523898,86.4534091858921,0.339372200779277
546.28,564,2119,2205,2008812,3907260,2024-09-04,2024-10-18,552.08,86,1898448,526522587,265443300,0.742087822340659,86.0736606917872,0.485877059627463
546.5,559,3223,3111,1698521,3888750,2024-09-04,2024-09-27,552.08,-112,2190229,91156178,55503910,4.26603010933609,39.1078825178476,0.563221857923497
550.85,575,1593,1599,3490263,3861585,2024-09-04,2024-12-20,552.08,6,371322.000000001,769049161,290977996,0.502124596947581,86.9555337828397,0.0961579247899504
478.16,480,22669,20880,1949534,3841920,2024-09-04,2024-10-18,552.08,-1789,1892386,526522587,265443300,0.729678098311099,86.8033387900983,0.492562572880227
550.31,560,3525,3933,1226700,3811077,2024-09-04,2024-09-13,552.08,408,2584377,70051475,47265620,5.44039508090301,11.7398727150285,0.678122483486951
547.81,560,3129,3108,1774143,3788652,2024-09-04,2024-09-27,552.08,-21,2014509,91156178,55503910,4.15622076651788,43.2641032843654,0.531721836684921
534.8,539,5338,8993,790024,3777060,2024-09-04,2024-09-20,552.08,3655,2987036,482984077,286009246,0.782025780945155,79.5627432247627,0.790836258889189
550.42,557,4433,5729,629486,3769682,2024-09-04,2024-09-06,552.08,1296,3140196,65864122,49955284,5.72342253343937,26.3769628630288,0.833013500873549
549.6,555,8784,6953,895968,3754620,2024-09-04,2024-09-06,552.08,-1831,2858652,65864122,49955284,5.70055424104796,32.0775171040768,0.761369193154034
548.5,565,332,2267,245016,3740550,2024-09-04,2024-09-27,552.08,1935,3495534,91156178,55503910,4.10345198983661,47.367555274202,0.934497333279865
545,570,1462,1457,2187152,3642500,2024-09-04,2024-11-15,552.08,-5,1455348,416800800,184114755,0.873918668102365,82.8920801015737,0.399546465339739
527.06,539,3012,3031,1891536,3619014,2024-09-04,2024-11-15,552.08,19,1727478,416800800,184114755,0.868283842065562,83.7603639436393,0.477333881548952
545.25,550,8619,7538,1232517,3580550,2024-09-04,2024-09-13,552.08,-1081,2348033,70051475,47265620,5.11131278820325,16.8511855032317,0.655774392202315
529.24,532,11058,12925,1127916,3567300,2024-09-04,2024-09-20,552.08,1867,2439384,482984077,286009246,0.738595777765154,80.3013390025278,0.683818013623749
467.01,470,11895,11929,1772355,3566771,2024-09-04,2024-11-15,552.08,34,1794416,416800800,184114755,0.855749557102578,84.6161135007418,0.503092573086413
548.19,555,6205,5201,1371305,3541881,2024-09-04,2024-09-13,552.08,-1004,2170576,70051475,47265620,5.05611195196104,21.9072974551928,0.612831430530839
523.85,526,16086,16302,1302966,3504930,2024-09-04,2024-09-20,552.08,216,2201964,482984077,286009246,0.725682308570185,81.027021311098,0.628247639753148
504.57,505,80933,81158,1375861,3489794,2024-09-04,2024-09-13,552.08,225,2113933,70051475,47265620,4.98175662967839,26.8890540848712,0.605747216024786
550.82,558,5945,4843,969035,3477274,2024-09-04,2024-09-06,552.08,-1102,2508239,65864122,49955284,5.27946611054802,37.3569832146248,0.721323369973146
388.35,390,20990,20999,1952070,3464835,2024-09-04,2024-12-20,552.08,9,1512765,769049161,290977996,0.450534917103954,87.4060686999436,0.436605206308526
514.49,516,23101,22920,1362959,3460920,2024-09-04,2024-09-20,552.08,-181,2097961,482984077,286009246,0.716570206930445,81.7435915180285,0.606185927441258
542.98,547,4369,8562,489328,3441924,2024-09-04,2024-09-13,552.08,4193,2952596,70051475,47265620,4.91342116636373,31.8024752512349,0.857833002704301
549.25,570,2174,1647,2665324,3417525,2024-09-04,2024-10-18,552.08,-527,752201,526522587,265443300,0.649074718612214,87.4524135087105,0.220101096553793
525.71,528,14059,14637,1251251,3351873,2024-09-04,2024-09-20,552.08,578,2100622,482984077,286009246,0.693992443978645,82.4375839620071,0.626700951975209
427.26,430,12190,12201,1950400,3343074,2024-09-04,2024-12-20,552.08,11,1392674,769049161,290977996,0.434702249158295,87.8407709491019,0.416584855734572
530.9,535,8011,8125,1393914,3331250,2024-09-04,2024-09-27,552.08,114,1937336,91156178,55503910,3.65444237910019,51.0219976533022,0.581564277673546
543.96,551,4114,4722,1147806,3324288,2024-09-04,2024-09-20,552.08,608,2176482,482984077,286009246,0.68828107556846,83.1258650375756,0.65472125158831
540.5,548,3627,4415,1077219,3311250,2024-09-04,2024-09-27,552.08,788,2234031,91156178,55503910,3.63250201209621,54.6544996653984,0.674679048697622
505.73,507,25916,25973,1192136,3298571,2024-09-04,2024-09-20,552.08,57,2106435,482984077,286009246,0.682956469391019,83.8088215069666,0.63859016525641
534.27,552,1799,1830,2299122,3244590,2024-09-04,2024-12-20,552.08,31,945468.000000001,769049161,290977996,0.421896305794162,88.2626672548961,0.29139829685723
551.89,563,3257,2904,1071553,3226344,2024-09-04,2024-09-06,552.08,-353,2154791,65864122,49955284,4.89848479267666,42.2554680073015,0.667873915490723
545.21,565,1434,1608,1849860,3182232,2024-09-04,2024-11-15,552.08,174,1332372,416800800,184114755,0.763489897332251,85.3796033980741,0.41869103195493
550.15,556,5151,5391,618120,3153735,2024-09-04,2024-09-06,552.08,240,2535615,65864122,49955284,4.78824419765286,47.0437122049543,0.804003824037213
520.53,533,2445,2507,2012235,3126229,2024-09-04,2024-12-20,552.08,62,1113994,769049161,290977996,0.406505742225236,88.6691729971213,0.356337939415187
339.39,340,51181,51213,1330706,3123993,2024-09-04,2024-11-15,552.08,32,1793287,416800800,184114755,0.74951703547594,86.12912043355,0.574036817624111
407.9,410,14851,14851,1752418,3118710,2024-09-04,2024-12-20,552.08,0,1366292,769049161,290977996,0.405528041399164,89.0747010385205,0.438095238095238
545.26,555,2553,3197,1108002,3113878,2024-09-04,2024-09-27,552.08,644,2005876,91156178,55503910,3.41598130628074,58.0704809716792,0.644172957322027
471.95,475,10080,10153,1622880,3096665,2024-09-04,2024-11-15,552.08,73,1473785,416800800,184114755,0.742960426179604,86.8720808597296,0.475926520950765
529.83,542,2548,2542,2392572,3093614,2024-09-04,2024-12-20,552.08,-6,701042,769049161,290977996,0.402264790976087,89.4769658294966,0.226609396000923
551.78,562,3240,3021,929880,3087462,2024-09-04,2024-09-06,552.08,-219,2157582,65864122,49955284,4.68762340747517,51.7313356124295,0.698820584674403
540.89,552,2633,2711,1535039,3011921,2024-09-04,2024-10-18,552.08,78,1476882,526522587,265443300,0.572040226642737,88.0244537353532,0.490345530311054
530.13,537,4363,4382,1500872,3010434,2024-09-04,2024-10-18,552.08,19,1509562,526522587,265443300,0.571757807609496,88.5962115429627,0.501443313489019
545.09,559,1923,2155,1484556,2997605,2024-09-04,2024-10-18,552.08,232,1513049,526522587,265443300,0.569321254968308,89.1655327979311,0.504752627514299
551.58,561,3322,3132,833822,2950344,2024-09-04,2024-09-06,552.08,-190,2116522,65864122,49955284,4.4794402633956,56.2107758758251,0.71738143077553
404.79,405,139505,139163,1395050,2922423,2024-09-04,2024-09-20,552.08,-342,1527373,482984077,286009246,0.605076469218674,84.4138979761853,0.522639262009641
403.02,405,14748,14752,1622280,2920896,2024-09-04,2024-12-20,552.08,4,1298616,769049161,290977996,0.379806148699511,89.8567719781961,0.444595083152567
551.66,590,761,761,2335509,2917674,2024-09-04,2024-12-20,552.08,0,582165,769049161,290977996,0.379387189787208,90.2361591679833,0.199530516431925
539.22,547,3561,3724,1264155,2897272,2024-09-04,2024-10-04,552.08,163,1633117,16648106,10098331,17.4030126910533,17.4030126910533,0.563674035437474
548.2,552,6966,7623,431892,2896740,2024-09-04,2024-09-06,552.08,657,2464848,65864122,49955284,4.39805452807828,60.6088304039034,0.850904119803641
442.83,445,10917,13331,1124451,2892827,2024-09-04,2024-11-15,552.08,2414,1768376,416800800,184114755,0.694055049798369,87.566135909528,0.611296838697924
538.5,549,2813,2745,1468386,2882250,2024-09-04,2024-10-18,552.08,-68,1413864,526522587,265443300,0.54741241328741,89.7129452112185,0.490541764246682
526.65,530,8539,8536,1203999,2859560,2024-09-04,2024-09-27,552.08,-3,1655561,91156178,55503910,3.13698979349485,61.207470765174,0.578956552756368
537.58,542,5943,6468,1022196,2858856,2024-09-04,2024-09-20,552.08,525,1836660,482984077,286009246,0.591915165766428,85.0058131419517,0.642445789504613
484.33,485,42170,41959,1222930,2811253,2024-09-04,2024-09-20,552.08,-211,1588323,482984077,286009246,0.58205914726253,85.5878722892142,0.564987569599748
544.77,564,1408,1454,2088064,2796042,2024-09-04,2024-12-20,552.08,46,707978,769049161,290977996,0.363571295801726,90.599730463785,0.253207212194953
538.39,543,5296,6041,953280,2784901,2024-09-04,2024-09-20,552.08,745,1831621,482984077,286009246,0.576603066771495,86.1644753559857,0.657696988151464
490.72,495,6377,6452,1587873,2761456,2024-09-04,2024-11-15,552.08,75,1173583,416800800,184114755,0.662536156360544,88.2286720658886,0.424987035824579
412.7,415,11923,11922,1502298,2742060,2024-09-04,2024-12-20,552.08,-1,1239762,769049161,290977996,0.356551978606216,90.9562824423912,0.452127962189011
539.07,544,5177,5556,993984,2739108,2024-09-04,2024-09-20,552.08,379,1745124,482984077,286009246,0.567121801822879,86.7315971578086,0.637113980171647
530.95,538,3197,3842,1128541,2708610,2024-09-04,2024-10-18,552.08,645,1580069,526522587,265443300,0.514433771100498,90.227378982319,0.583350500810379
521.49,531,2842,2841,1449420,2701791,2024-09-04,2024-11-15,552.08,-1,1252371,416800800,184114755,0.648221164642678,88.8768932305312,0.46353363380069
537.73,540,12755,11669,829075,2648863,2024-09-04,2024-09-13,552.08,-1086,1819788,70051475,47265620,3.78130938713282,35.5837846383677,0.687007217813832
539.47,561,1068,1217,1443936,2620201,2024-09-04,2024-12-20,552.08,149,1176265,769049161,290977996,0.340706567652052,91.2969890100433,0.448921666696563
469.48,470,49332,50203,1183968,2610556,2024-09-04,2024-09-20,552.08,871,1426588,482984077,286009246,0.540505603459056,87.2721027612676,0.546469028053794
536.93,546,2542,2817,1194740,2555019,2024-09-04,2024-10-18,552.08,275,1360279,526522587,265443300,0.485262942765265,90.7126419250842,0.532394866730932
521.43,527,4264,4469,1112904,2489233,2024-09-04,2024-10-18,552.08,205,1376329,526522587,265443300,0.47276851201827,91.1854104371025,0.55291288521404
549.7,558,2838,2994,820182,2485020,2024-09-04,2024-09-13,552.08,156,1664838,70051475,47265620,3.54741995082902,39.1312045891967,0.669949537629476
319.22,320,31793,31790,1335306,2479620,2024-09-04,2024-12-20,552.08,-3,1144314,769049161,290977996,0.322426721950484,91.6194157319938,0.461487647300796
517.4,519,15363,15291,967869,2446560,2024-09-04,2024-09-20,552.08,-72,1478691,482984077,286009246,0.50655086088894,87.7786536221566,0.604395968216598
542.12,563,1176,1170,1696968,2442960,2024-09-04,2024-12-20,552.08,-6,745992,769049161,290977996,0.317659796523723,91.9370755285175,0.30536398467433
348.9,350,22175,22145,1352675,2435950,2024-09-04,2024-12-20,552.08,-30,1083275,769049161,290977996,0.316748281323462,92.2538238098409,0.444703298507769
542.81,557,1820,1696,1286740,2406624,2024-09-04,2024-10-18,552.08,-124,1119884,526522587,265443300,0.457078966680683,91.6424894037832,0.465334011461699
551.3,559,3864,3085,730296,2375450,2024-09-04,2024-09-06,552.08,-779,1645154,65864122,49955284,3.60659176478508,64.2154221686885,0.692565198172978
549.6,566,1292,1444,972876,2368160,2024-09-04,2024-09-20,552.08,152,1395284,482984077,286009246,0.490318441698855,88.2689720638554,0.58918485237484
522.18,525,8250,8266,948750,2331012,2024-09-04,2024-09-27,552.08,16,1382262,91156178,55503910,2.55716293853391,63.7646337037079,0.592987938286032
541.64,554,1627,1872,1002232,2313792,2024-09-04,2024-10-18,552.08,245,1311560,526522587,265443300,0.439447814230237,92.0819372180134,0.566844383591957
547.61,561,2170,1727,1332380,2312453,2024-09-04,2024-09-27,552.08,-443,980073.000000001,91156178,55503910,2.53680337497257,66.3014370786805,0.423823965287078
540.25,557,1354,1378,1798112,2308150,2024-09-04,2024-12-20,552.08,24,510038,769049161,290977996,0.300130357986308,92.5539541678273,0.220972640426315
454.85,455,153599,153500,1228792,2302500,2024-09-04,2024-09-13,552.08,-99,1073708,70051475,47265620,3.28686869191548,42.4180732811122,0.466322692725299
533.31,551,1245,1291,1547535,2283779,2024-09-04,2024-12-20,552.08,46,736244,769049161,290977996,0.296961379820035,92.8509155476473,0.322379704866364
549.91,564,1368,1601,901512,2255809,2024-09-04,2024-09-20,552.08,233,1354297,482984077,286009246,0.467056598224045,88.7360286620795,0.600359782233336
502.81,504,18853,18850,810679,2243150,2024-09-04,2024-09-20,552.08,-3,1432471,482984077,286009246,0.46443560084487,89.2004642629244,0.638597953770368
551.5,570,1214,1209,1187292,2236650,2024-09-04,2024-09-20,552.08,-5,1049358,482984077,286009246,0.463089800784468,89.6635540637088,0.469165045939239
383.45,385,14523,14359,1321593,2225645,2024-09-04,2024-12-20,552.08,-164,904052,769049161,290977996,0.289402175162116,93.1403177228094,0.406197753909541
499.99,501,21684,21634,889044,2185034,2024-09-04,2024-09-20,552.08,-50,1295990,482984077,286009246,0.452402906027894,90.1159569697367,0.59312120543662
533.58,537,5755,6353,759660,2172726,2024-09-04,2024-09-20,552.08,598,1413066,482984077,286009246,0.449854581851981,90.5658115515887,0.650365485569741
526.6,529,7994,9015,743442,2163600,2024-09-04,2024-09-20,552.08,1021,1420158,482984077,286009246,0.447965078567176,91.0137766301559,0.656386577925679
550.2,562.5,1824,1740,804384,2140200,2024-09-04,2024-09-13,552.08,-84,1335816,70051475,47265620,3.05518192157981,45.473255202692,0.624154751892347
543.69,553,495,2292,188100,2133852,2024-09-04,2024-09-27,552.08,1797,1945752,91156178,55503910,2.34087480060869,68.6423118792892,0.911849556576557
540.36,551,1835,1945,1027600,2069480,2024-09-04,2024-10-18,552.08,110,1041880,526522587,265443300,0.393046765912058,92.4749839839255,0.503450142064673
525.25,531,3673,3588,1076189,2063100,2024-09-04,2024-10-18,552.08,-85,986911,526522587,265443300,0.391835042016915,92.8668190259424,0.478363142843294
368.63,370,15038,15041,1127850,2060617,2024-09-04,2024-12-20,552.08,3,932767,769049161,290977996,0.267943468961147,93.4082611917706,0.452663935122344
533.9,548,1416,1441,1097400,2031810,2024-09-04,2024-11-15,552.08,25,934410,416800800,184114755,0.487477471252454,89.3643707017837,0.459890442511849
520.14,529,2188,2277,1080872,2017422,2024-09-04,2024-11-15,552.08,89,936550,416800800,184114755,0.484025462523105,89.8483961643068,0.464231083035676
537.09,551,1427,1446,1202961,2011386,2024-09-04,2024-11-15,552.08,19,808425,416800800,184114755,0.482577288719216,90.330973453026,0.401924344705591
549.27,574,811,811,1385188,2005603,2024-09-04,2024-11-15,552.08,0,620415,416800800,184114755,0.481189815374635,90.8121632684006,0.309340881520421
453.62,455,13760,14516,866880,2003208,2024-09-04,2024-10-18,552.08,756,1136328,526522587,265443300,0.380460031432612,93.247279057375,0.567254124384487
541.64,553,1664,1762,998400,2001632,2024-09-04,2024-10-18,552.08,98,1003232,526522587,265443300,0.380160709040959,93.6274397664159,0.501207015075698
517.79,527,2168,2171,1452560,1999491,2024-09-04,2024-12-20,552.08,3,546931.000000001,769049161,290977996,0.259995212451704,93.6682564042223,0.273535114686688
516.43,518,12632,12711,770552,1995627,2024-09-04,2024-09-20,552.08,79,1225075,482984077,286009246,0.413186913406257,91.4269635435621,0.613879748069153
534.31,538,4365,5399,598005,1992231,2024-09-04,2024-09-20,552.08,1034,1394226,482984077,286009246,0.412483784636238,91.8394473281984,0.699831495444053
449.6,450,48582,49516,923058,1980640,2024-09-04,2024-09-20,552.08,934,1057582,482984077,286009246,0.410083912559295,92.2495312407577,0.533959730188222
468.39,470,13299,12285,944229,1977885,2024-09-04,2024-10-18,552.08,-1014,1033656,526522587,265443300,0.375650551150999,94.003090317567,0.52260672384896
547.66,551,4215,5914,219180,1975276,2024-09-04,2024-09-06,552.08,1699,1756096,65864122,49955284,2.99901667253683,67.2144388412253,0.889038291357765
546.38,549,10250,7467,379250,1956354,2024-09-04,2024-09-06,552.08,-2783,1577104,65864122,49955284,2.9702878298446,70.1847266710699,0.806144491232159
359.75,360,78126,78146,1171890,1953650,2024-09-04,2024-10-18,552.08,20,781760,526522587,265443300,0.371047709677838,94.3741380272448,0.400153558723415
537.98,556,1021,1079,1234389,1944358,2024-09-04,2024-12-20,552.08,58,709969,769049161,290977996,0.252826229921601,93.9210826341439,0.365143147506786
547.41,564,1199,1156,881265,1917804,2024-09-04,2024-09-27,552.08,-43,1036539,91156178,55503910,2.10386618008491,70.7461780593741,0.540482239060926
369.81,370,100591,100690,804728,1913110,2024-09-04,2024-09-27,552.08,99,1108382,91156178,55503910,2.09871677594907,72.8448948353232,0.579361354025644
546.42,567,575,917,974050,1887186,2024-09-04,2024-12-20,552.08,342,913136,769049161,290977996,0.245392114796157,94.16647474894,0.483861156240031
550.7,561,1827,1807,692433,1861210,2024-09-04,2024-09-13,552.08,-20,1168777,70051475,47265620,2.65691764520305,48.1301728478951,0.627966215526459
393.35,395,11236,11239,1179780,1854435,2024-09-04,2024-12-20,552.08,3,674655,769049161,290977996,0.241133479371938,94.4076082283119,0.363806226694384
549.19,554,3716,3843,319576,1848483,2024-09-04,2024-09-06,552.08,127,1528907,65864122,49955284,2.80650974137331,72.9912364124432,0.82711445006527
512.65,514,13669,13518,738126,1824930,2024-09-04,2024-09-20,552.08,-151,1086804,482984077,286009246,0.377844754496948,92.6273759952546,0.595531883414706
528.05,531,4551,6166,450549,1818970,2024-09-04,2024-09-20,552.08,1615,1368421,482984077,286009246,0.376610759364641,93.0039867546192,0.752305425598003
536.47,542,397,3275,93295,1811075,2024-09-04,2024-09-27,552.08,2878,1717780,91156178,55503910,1.98678250858653,74.8316773439097,0.948486396201151
533.87,542,1883,2202,758849,1790226,2024-09-04,2024-10-18,552.08,319,1031377,526522587,265443300,0.340009345126157,94.714147372371,0.576115529547666
349.66,350,52274,52220,575014,1775480,2024-09-04,2024-10-18,552.08,-54,1200466,526522587,265443300,0.3372087055403,95.0513560779112,0.676136030819835
521.49,531,1843,1838,1319588,1747938,2024-09-04,2024-12-20,552.08,-5,428350,769049161,290977996,0.227285600016408,94.6348938283284,0.24506017948005
525.38,536,1690,1640,1035970,1741680,2024-09-04,2024-11-15,552.08,-50,705710,416800800,184114755,0.417868679714626,91.2300319481153,0.405189242570392
524.11,525,19116,19430,535248,1729270,2024-09-04,2024-09-13,552.08,314,1194022,70051475,47265620,2.46857043338488,50.59874328128,0.690477484718986
545.96,557,1509,1566,724320,1728864,2024-09-04,2024-09-27,552.08,57,1004544,91156178,55503910,1.89659553299832,76.728272876908,0.58104281192737
499.64,500,46872,47777,703080,1719972,2024-09-04,2024-09-13,552.08,905,1016892,70051475,47265620,2.45529733670847,53.0540406179884,0.591225903677502
527.7,534,2382,2692,769386,1695960,2024-09-04,2024-10-18,552.08,310,926574,526522587,265443300,0.322105839687367,95.3734619175986,0.546341894856011
537.97,558,645,844,808185,1690532,2024-09-04,2024-12-20,552.08,199,882347,769049161,290977996,0.219821057707389,94.8547148860358,0.521934515288678
551.56,565,1422,1257,597240,1689408,2024-09-04,2024-09-06,552.08,-165,1092168,65864122,49955284,2.5649897830567,75.5562261954999,0.646479713603819
473.15,475,9145,9120,731600,1687200,2024-09-04,2024-10-18,552.08,-25,955600,526522587,265443300,0.32044209339874,95.6939040109974,0.56638217164533
373.57,375,11690,11715,923510,1675245,2024-09-04,2024-12-20,552.08,25,751735,769049161,290977996,0.217833278411183,95.0725481644469,0.448731379589254
547.25,562,1201,1124,783052,1657900,2024-09-04,2024-09-27,552.08,-77,874848,91156178,55503910,1.81874672279481,78.5470195997028,0.52768442004946
459.57,460,37591,37497,789411,1612371,2024-09-04,2024-09-20,552.08,-94,822960,482984077,286009246,0.333835229106321,93.3378219837256,0.510403622987513
544.59,549,3321,3642,441693,1606122,2024-09-04,2024-09-13,552.08,321,1164429,70051475,47265620,2.29277399226783,55.3468146102563,0.72499411626265
535.6,549,1225,1184,1003275,1586560,2024-09-04,2024-11-15,552.08,-41,583285,416800800,184114755,0.380651860553051,91.6106838086683,0.367641312020976
553.82,568,1017,1103,915300,1564054,2024-09-04,2024-09-20,552.08,86,648754,482984077,286009246,0.323831379641942,93.6616533633675,0.414790026431312
492.14,493,18151,18185,635285,1563910,2024-09-04,2024-09-20,552.08,34,928625,482984077,286009246,0.32380156499445,93.985454928362,0.593784169165745
538.77,545,1211,2497,325759,1555631,2024-09-04,2024-09-27,552.08,1286,1229872,91156178,55503910,1.70655575313831,80.2535753528411,0.790593656207674
496.11,497,17483,17473,699320,1555097,2024-09-04,2024-09-20,552.08,-10,855777,482984077,286009246,0.321976867158708,94.3074317955207,0.550304579071273
517.69,526,1850,1854,836200,1540674,2024-09-04,2024-11-15,552.08,4,704474,416800800,184114755,0.36964276460122,91.9803265732695,0.457250528015661
550.64,557.5,2102,2228,319504,1528408,2024-09-04,2024-09-06,552.08,126,1208904,65864122,49955284,2.32054714097608,77.876773336476,0.790956341500437
414.9,415,150974,151165,603896,1511650,2024-09-04,2024-09-13,552.08,191,907754,70051475,47265620,2.15791316314182,57.5047277733981,0.600505407997883
541.9,559,767,882,817622,1508220,2024-09-04,2024-11-15,552.08,115,690598,416800800,184114755,0.361856311216293,92.3421828844858,0.457889432576149
398.83,400,12188,12495,706904,1461915,2024-09-04,2024-11-15,552.08,307,755011,416800800,184114755,0.350746687626319,92.6929295721122,0.516453418974427
552,564,1676,1197,623472,1436400,2024-09-04,2024-09-06,552.08,-479,812928,65864122,49955284,2.18085348499749,80.0576268214735,0.565948203842941
531.04,534,4290,4760,480480,1408960,2024-09-04,2024-09-20,552.08,470,928480,482984077,286009246,0.291719762016088,94.5991515575368,0.658982511923688
463.49,465,7734,9323,572316,1407773,2024-09-04,2024-10-18,552.08,1589,835457,526522587,265443300,0.267371815522892,95.9612758265202,0.593460025160306
541.56,562,568,687,789520,1404228,2024-09-04,2024-12-20,552.08,119,614708,769049161,290977996,0.182592748449796,95.2551409128967,0.437755122387533
550.3,565,927,952,491310,1399440,2024-09-04,2024-09-13,552.08,25,908130,70051475,47265620,1.99773095427327,59.5024587276713,0.648923855256388
547.3,569,538,642,1069544,1393140,2024-09-04,2024-12-20,552.08,104,323596,769049161,290977996,0.181150968058855,95.4362918809556,0.232278162998694
532.17,544,1139,1164,929424,1377012,2024-09-04,2024-11-15,552.08,25,447588,416800800,184114755,0.330376525189011,93.0233060973012,0.325042919015956
464.82,465,76264,76277,686376,1372986,2024-09-04,2024-09-13,552.08,13,686610,70051475,47265620,1.95996729547808,61.4624260231494,0.50008521572689
550.95,562,1212,1242,504192,1372410,2024-09-04,2024-09-13,552.08,30,868218,70051475,47265620,1.95914504298446,63.4215710661339,0.632622904234157
533.1,541,1477,1717,589323,1356430,2024-09-04,2024-10-18,552.08,240,767107,526522587,265443300,0.257620476973004,96.2188963034933,0.565533790907013
526.77,533,1925,2173,579425,1353779,2024-09-04,2024-10-18,552.08,248,774354,526522587,265443300,0.257116984802781,96.476013288296,0.571994394949249
532.66,536,3260,4051,400980,1353034,2024-09-04,2024-09-20,552.08,791,952054,482984077,286009246,0.280140498296386,94.8792920558331,0.703643810872454
299.38,300,21754,21767,739636,1349554,2024-09-04,2024-12-20,552.08,13,609918,769049161,290977996,0.175483450010551,95.6117753309661,0.451940418834667
542.11,566,563,563,982998,1345007,2024-09-04,2024-12-20,552.08,0,362009,769049161,290977996,0.174892200422022,95.7866675313882,0.269150272080368
543.2,561,760,748,865640,1331440,2024-09-04,2024-11-15,552.08,-12,465800,416800800,184114755,0.319442764985096,93.3427488622863,0.349846782431052
524.33,527,4844,4969,426272,1326723,2024-09-04,2024-09-20,552.08,125,900451,482984077,286009246,0.27469290669804,95.1539849625312,0.678703090245666
428.19,430,7230,7231,621780,1308811,2024-09-04,2024-11-15,552.08,1,687031,416800800,184114755,0.314013552757096,93.6567624150434,0.524927586947237
519.75,532,1161,1067,1014714,1307075,2024-09-04,2024-12-20,552.08,-94,292361,769049161,290977996,0.169959875946084,95.9566274073342,0.223675764588872
518.55,527,1536,1538,711168,1299610,2024-09-04,2024-11-15,552.08,2,588442,416800800,184114755,0.311806023404945,93.9685684384483,0.452783527365902
539.77,559,645,671,828180,1290333,2024-09-04,2024-12-20,552.08,26,462153,769049161,290977996,0.167782901982777,96.124410309317,0.358165682812111
363.71,365,9984,9997,718848,1289613,2024-09-04,2024-12-20,552.08,13,570765,769049161,290977996,0.167689279879469,96.2920995891965,0.442586264251368
543.52,545,9312,8706,176928,1288488,2024-09-04,2024-09-06,552.08,-606,1111560,65864122,49955284,1.95628205595757,82.013908877431,0.86268556633822
541.72,545,2980,3888,277140,1275264,2024-09-04,2024-09-13,552.08,908,998124,70051475,47265620,1.82046702085859,65.2420380869925,0.782680292080699
547.05,553,1652,2127,294056,1265565,2024-09-04,2024-09-13,552.08,475,971509,70051475,47265620,1.80662148798437,67.0486595749768,0.767648441605133
536.98,552,822,841,713496,1263182,2024-09-04,2024-11-15,552.08,19,549686,416800800,184114755,0.30306611695563,94.2716345554039,0.435159779034217
329.19,330,15448,15433,741504,1250073,2024-09-04,2024-12-20,552.08,-15,508569,769049161,290977996,0.162547866039477,96.454647455236,0.406831441043843
535.02,553,686,689,811538,1238822,2024-09-04,2024-12-20,552.08,3,427284,769049161,290977996,0.161084890644592,96.6157323458805,0.344911536927823
531.74,539,1687,1684,627564,1222584,2024-09-04,2024-10-18,552.08,-3,595020,526522587,265443300,0.232199725175323,96.7082130134714,0.486690485070965
548.62,556,2044,1648,494648,1216224,2024-09-04,2024-09-13,552.08,-396,721576,70051475,47265620,1.73618614026329,68.7848457152401,0.593292025153261
358.96,360,11660,11660,792880,1212640,2024-09-04,2024-12-20,552.08,0,419760,769049161,290977996,0.157680426882359,96.7734127727629,0.346153846153846
543.66,548,2386,2794,274390,1212596,2024-09-04,2024-09-13,552.08,408,938206,70051475,47265620,1.73100709157088,70.515852806811,0.773716885096108
520.98,526,1432,2408,380912,1208816,2024-09-04,2024-10-18,552.08,976,827904,526522587,265443300,0.229584832606621,96.937797846078,0.684888353562494
496.98,498,11756,11741,434972,1197582,2024-09-04,2024-09-20,552.08,-15,762610,482984077,286009246,0.247954758144128,95.4019397206753,0.636791468141639
538.33,553,752,814,679056,1194138,2024-09-04,2024-11-15,552.08,62,515082,416800800,184114755,0.286500889633609,94.5581354450375,0.431342106188732
522.07,524,5734,6185,441518,1193705,2024-09-04,2024-09-20,552.08,451,752187,482984077,286009246,0.247152040169639,95.6490917608449,0.630128046711709
379.86,380,84992,84992,509952,1189888,2024-09-04,2024-09-20,552.08,0,679936,482984077,286009246,0.246361744964938,95.8954535058099,0.571428571428571
419.18,420,14425,14416,504875,1182112,2024-09-04,2024-10-18,552.08,-9,677237,526522587,265443300,0.224513065381562,97.1623109114595,0.57290425949487
548.47,552.5,1963,2907,135447,1171521,2024-09-04,2024-09-06,552.08,944,1036074,65864122,49955284,1.77869371734736,83.7926025947784,0.884383634608343
528.83,530,9751,9997,321783,1169649,2024-09-04,2024-09-13,552.08,246,847866,70051475,47265620,1.66969931753757,72.1855521243486,0.72488926165029
547.37,554,1365,1764,277095,1169532,2024-09-04,2024-09-13,552.08,399,892437,70051475,47265620,1.6695322974998,73.8550844218484,0.763071895424837
524.46,534,1138,1221,621348,1164834,2024-09-04,2024-11-15,552.08,83,543486,416800800,184114755,0.279470192955484,94.837605637993,0.466578070351655
439.67,440,34495,35115,551920,1158795,2024-09-04,2024-09-20,552.08,620,606875,482984077,286009246,0.239924058614462,96.1353775644243,0.523712131999189
501.81,503,9552,9604,401184,1142876,2024-09-04,2024-09-20,552.08,52,741692,482984077,286009246,0.236628090743455,96.3720056551678,0.648969791998432
547.19,566,466,607,466000,1141767,2024-09-04,2024-10-18,552.08,141,675767,526522587,265443300,0.216850526110478,97.37916143757,0.591860686111965
542.37,562,526,577,611212,1132651,2024-09-04,2024-11-15,552.08,51,521439,416800800,184114755,0.271748758639619,95.1093543966326,0.460370405358756
544.3,564,469,567,585312,1116990,2024-09-04,2024-11-15,552.08,98,531678,416800800,184114755,0.267991328231616,95.3773457248643,0.475991727768378
527.72,532,2586,2590,387900,1108520,2024-09-04,2024-09-27,552.08,4,720620,91156178,55503910,1.21606678156252,81.4696421344037,0.650073972503879
548.1,557,1086,1234,286704,1098260,2024-09-04,2024-09-13,552.08,148,811556,70051475,47265620,1.56778997158875,75.4228743934371,0.738947061715805
434.68,435,33752,33864,506280,1083648,2024-09-04,2024-09-20,552.08,112,577368,482984077,286009246,0.224365160593069,96.5963708157609,0.53280031892275
546.54,560,681,804,452865,1082184,2024-09-04,2024-10-04,552.08,123,629319,16648106,10098331,6.50034304202532,23.9033557330786,0.581526801357255
536.74,554,549,617,708210,1064942,2024-09-04,2024-12-20,552.08,68,356732,769049161,290977996,0.138475152695733,96.9118879254587,0.334977867339254
394.82,395,59092,59113,472736,1064034,2024-09-04,2024-09-20,552.08,21,591298,482984077,286009246,0.220304157149264,96.8166749729101,0.55571344524705
540.16,556,612,666,656676,1054944,2024-09-04,2024-11-15,552.08,54,398268,416800800,184114755,0.253105080412514,95.6304508052768,0.377525252525253
545.68,548,4018,4510,124558,1046320,2024-09-04,2024-09-06,552.08,492,921762,65864122,49955284,1.5886038836136,85.381206478392,0.880956112852665
418.5,420,6340,6975,456480,1046250,2024-09-04,2024-11-15,552.08,635,589770,416800800,184114755,0.251019191901743,95.8814699971785,0.563698924731183
498.66,500,7971,7761,438405,1039974,2024-09-04,2024-09-27,552.08,-210,601569,91156178,55503910,1.14087056172978,82.6105126961335,0.578446191924029
464.5,465,20848,20783,479504,1039150,2024-09-04,2024-09-20,552.08,-65,559646,482984077,286009246,0.215152020425717,97.0318269933358,0.538561324159169
353.85,355,8964,9007,573696,1035805,2024-09-04,2024-12-20,552.08,43,462109,769049161,290977996,0.13468644821784,97.0465743736765,0.44613513161261
523.35,533,1049,1071,570656,1033515,2024-09-04,2024-11-15,552.08,22,462859,416800800,184114755,0.247963775501391,96.1294337726799,0.447849329714615
526.88,531,2504,2502,360576,1030824,2024-09-04,2024-09-27,552.08,-2,670248,91156178,55503910,1.13083284382546,83.7413455399589,0.65020604875323
546.45,558,937,873,489114,1008315,2024-09-04,2024-09-27,552.08,-64,519201,91156178,55503910,1.10614005778083,84.8474855977397,0.514919444816352
544.27,546,5193,5810,119439,1005130,2024-09-04,2024-09-06,552.08,617,885691,65864122,49955284,1.52606604245024,86.9072725208422,0.881170594848428
457.48,460,3879,3937,504270,992124,2024-09-04,2024-11-15,552.08,58,487854,416800800,184114755,0.238033132374026,96.3674669050539,0.491726840596538
274.53,275,20908,20948,522700,984556,2024-09-04,2024-12-20,552.08,40,461856,769049161,290977996,0.128022504922803,97.1745968785993,0.469100792641556
546.53,552,1262,1786,214540,976942,2024-09-04,2024-09-13,552.08,524,762402,70051475,47265620,1.39460589516495,76.8174802886021,0.780396379723668
548.03,567,499,513,571854,973161,2024-09-04,2024-10-18,552.08,14,401307,526522587,265443300,0.184827968263401,97.5639894058334,0.412374725251012
518.26,529,995,899,685555,965526,2024-09-04,2024-12-20,552.08,-96,279971,769049161,290977996,0.125548020720095,97.3001448993194,0.289967333867757
544.75,556,908,843,414048,948375,2024-09-04,2024-09-27,552.08,-65,534327,91156178,55503910,1.04038477786991,85.8878703756097,0.563413206801107
452.5,455,3410,3720,395560,930000,2024-09-04,2024-11-15,552.08,310,534440,416800800,184114755,0.223128170579327,96.5905950756333,0.574666666666667
539.27,540,7209,12634,79299,922282,2024-09-04,2024-09-06,552.08,5425,842983,65864122,49955284,1.40027980635649,88.3075523271987,0.914018705775457
542.72,544,9993,7195,179874,920960,2024-09-04,2024-09-06,552.08,-2798,741086,65864122,49955284,1.39827264379232,89.705824970991,0.804688585823489
551.19,563,848,777,385840,917637,2024-09-04,2024-09-13,552.08,-71,531797,70051475,47265620,1.30994672132171,78.1274270099238,0.579528724321273
525.62,536,877,877,701600,910326,2024-09-04,2024-12-20,552.08,0,208726,769049161,290977996,0.118370326133156,97.4185152254525,0.229287090558767
441.91,443,8328,8329,466368,907861,2024-09-04,2024-10-18,552.08,1,441493,526522587,265443300,0.172425841248858,97.7364152470823,0.486300215561633
541.83,551,1002,987,435870,905079,2024-09-04,2024-10-04,552.08,-15,469209,16648106,10098331,5.43652833541545,29.339884068494,0.51841772928109
511.69,513,6420,6674,333840,874294,2024-09-04,2024-09-20,552.08,254,540454,482984077,286009246,0.181019218155302,97.2128462114912,0.618160481485633
533.97,540,1351,1444,374227,870732,2024-09-04,2024-10-04,552.08,93,496505,16648106,10098331,5.23021657839036,34.5701006468844,0.570215634661411
533.17,549,502,547,614950,865901,2024-09-04,2024-12-20,552.08,45,250951,769049161,290977996,0.112593712328359,97.5311089377809,0.289814886459307
339.17,340,10423,10424,552419,865192,2024-09-04,2024-12-20,552.08,1,312773,769049161,290977996,0.112501520562741,97.6436104583436,0.361507041211662
514.98,526,804,778,592548,857356,2024-09-04,2024-12-20,552.08,-26,264808,769049161,290977996,0.111482600005073,97.7550930583487,0.30886586202231
526.85,538,640,754,391040,840710,2024-09-04,2024-11-15,552.08,114,449670,416800800,184114755,0.201705466976071,96.7923005426093,0.534869336632132
521.97,532,749,834,390229,836502,2024-09-04,2024-11-15,552.08,85,446273,416800800,184114755,0.200695871984891,96.9929964145942,0.533499023313752
539.34,542,2984,3111,220816,827526,2024-09-04,2024-09-13,552.08,127,606710,70051475,47265620,1.1813113142871,79.3087383242109,0.733161254147906
525.56,530,455,1839,88270,816516,2024-09-04,2024-10-04,552.08,1384,728246,16648106,10098331,4.90455791187298,39.4746585587574,0.891894341323379
423.31,425,4714,4799,377120,811031,2024-09-04,2024-11-15,552.08,85,433911,416800800,184114755,0.194584799261422,97.1875812138556,0.535011608680803
526.04,537,749,739,444906,809944,2024-09-04,2024-11-15,552.08,-10,365038,416800800,184114755,0.194324003216884,97.3819052170725,0.45069535671602
519.27,521,4635,4671,301275,808083,2024-09-04,2024-09-20,552.08,36,506808,482984077,286009246,0.167310484647716,97.3801566961389,0.627173198792698
532.36,547,548,548,572112,802272,2024-09-04,2024-12-20,552.08,0,230160,769049161,290977996,0.104319988979222,97.8594130473279,0.286885245901639
545.86,551,1290,1540,197370,791560,2024-09-04,2024-09-13,552.08,250,594190,70051475,47265620,1.12996906917378,80.4387073933846,0.75065693061802
549,563,574,564,391468,789600,2024-09-04,2024-09-27,552.08,-10,398132,91156178,55503910,0.866205689317075,86.7540760649267,0.504219858156028
538.56,541,3320,3234,222440,789096,2024-09-04,2024-09-13,552.08,-86,566656,70051475,47265620,1.12645165572888,81.5651590491135,0.718107809442704
503.5,505,5177,5202,320974,780300,2024-09-04,2024-09-27,552.08,25,459326,91156178,55503910,0.856003418660225,87.6100794835869,0.588653082147892
533.41,535,3681,4835,165645,768765,2024-09-04,2024-09-13,552.08,1154,603120,70051475,47265620,1.09742871224339,82.6625877613569,0.784531033540809
550.93,575,315,314,417375,755798,2024-09-04,2024-09-20,552.08,-1,338423,482984077,286009246,0.156485076008003,97.5366417721469,0.447769112911122
531.42,548,451,451,477158,747758,2024-09-04,2024-12-20,552.08,0,270600,769049161,290977996,0.0972314954518233,97.9566445427798,0.361881785283474
538.92,554,448,494,421568,744952,2024-09-04,2024-11-15,552.08,46,323384,416800800,184114755,0.17873094293485,97.5606361600074,0.434100452109666
550.2,575,293,298,442430,739040,2024-09-04,2024-10-18,552.08,5,296610,526522587,265443300,0.140362449446067,97.8767776965283,0.401344988092661
542.28,546,909,1986,86355,738792,2024-09-04,2024-09-13,552.08,1077,652437,70051475,47265620,1.05464160462003,83.717229365977,0.883113244323165
539.83,557,389,423,400281,726291,2024-09-04,2024-11-15,552.08,34,326010,416800800,184114755,0.174253744234656,97.734889904242,0.448869667943015
545.03,547,1296,3563,34992,701911,2024-09-04,2024-09-06,552.08,2267,666919,65864122,49955284,1.06569552388476,90.7715204948758,0.950147525825924
534.38,547,579,555,497361,700410,2024-09-04,2024-11-15,552.08,-24,203049,416800800,184114755,0.168044303177921,97.90293420742,0.289900201310661
526.5,538,619,609,594859,700350,2024-09-04,2024-12-20,552.08,-10,105491,769049161,290977996,0.0910670000717939,98.0477115428516,0.150626115513672
550.98,577,268,269,584776,699938,2024-09-04,2024-12-20,552.08,1,115162,769049161,290977996,0.0910134274237899,98.1387249702753,0.164531715666245
424.14,425,8179,8134,327160,699524,2024-09-04,2024-10-18,552.08,-45,372364,526522587,265443300,0.132857358311202,98.0096350548395,0.532310542597538
504.87,506,5687,6142,250228,694046,2024-09-04,2024-09-20,552.08,455,443818,482984077,286009246,0.143699561341854,97.6803413334887,0.639464819334742
512.96,515,397,3388,33348,691152,2024-09-04,2024-09-27,552.08,2991,657804,91156178,55503910,0.758206426776691,88.3682859103636,0.951750121536218
334,335,6834,6860,341700,686000,2024-09-04,2024-12-20,552.08,26,344300,769049161,290977996,0.0892010595405877,98.2279260298159,0.501895043731778
419.72,420,24298,24423,291576,683844,2024-09-04,2024-09-20,552.08,125,392268,482984077,286009246,0.141587276385511,97.8219286098742,0.573622054152702
536.31,544,873,877,280233,674413,2024-09-04,2024-10-04,552.08,4,394180,16648106,10098331,4.0509893437728,43.5256479025302,0.584478650322577
530.6,543,540,542,400680,672080,2024-09-04,2024-11-15,552.08,2,271400,416800800,184114755,0.161247291271994,98.064181498692,0.403820973693608
543.84,555,480,601,252000,670716,2024-09-04,2024-10-04,552.08,121,418716,16648106,10098331,4.02878261346966,47.5544305159998,0.62428211046106
399.8,400,33159,33198,298431,663960,2024-09-04,2024-09-20,552.08,39,365529,482984077,286009246,0.137470370477659,97.9593989803519,0.550528646303994
549.15,568,352,352,663520,663520,2024-09-04,2024-12-20,552.08,0,0,769049161,290977996,0.0862779694261964,98.3142039992421,0
532.7,546,378,496,322434,659680,2024-09-04,2024-11-15,552.08,118,337246,416800800,184114755,0.158272248997603,98.2224537476895,0.511226655348048
546.47,558,513,569,294975,656057,2024-09-04,2024-10-04,552.08,56,361082,16648106,10098331,3.94073055517547,51.4951610711753,0.550382055217763
550.96,579,208,233,450528,653332,2024-09-04,2024-12-20,552.08,25,202804,769049161,290977996,0.0849532166643895,98.3991572159065,0.310414919214121
354.9,355,65371,65205,261484,652050,2024-09-04,2024-09-20,552.08,-166,390566,482984077,286009246,0.135004450674675,98.0944034310266,0.598981673184572
343.93,345,6086,6090,359074,651630,2024-09-04,2024-12-20,552.08,4,292556,769049161,290977996,0.0847319044146256,98.4838891203211,0.448960299556497
552.35,571,338,338,630370,630370,2024-09-04,2024-12-20,552.08,0,0,769049161,290977996,0.0819674517530616,98.5658565720742,0
515.25,517,3479,3598,215698,629650,2024-09-04,2024-09-20,552.08,119,413952,482984077,286009246,0.130366616620365,98.2247700476469,0.657431906614786
408.7,410,4726,4797,307190,623610,2024-09-04,2024-11-15,552.08,71,316420,416800800,184114755,0.149618234897822,98.3720719825874,0.507400458619971
506.65,508,3897,4537,183159,612495,2024-09-04,2024-09-20,552.08,640,429336,482984077,286009246,0.126814739691719,98.3515847873387,0.700962456836382
548.91,557.5,583,709,157410,609031,2024-09-04,2024-09-13,552.08,126,451621,70051475,47265620,0.869404962565028,84.586634328542,0.741540250003694
510.6,512,4259,4347,212950,608580,2024-09-04,2024-09-20,552.08,88,395630,482984077,286009246,0.12600415396303,98.4775889413017,0.650087087975287
551.74,569,276,352,253920,607552,2024-09-04,2024-09-20,552.08,76,353632,482984077,286009246,0.125791310507323,98.603380251809,0.582060465606236
537.3,543,1051,1061,249087,604770,2024-09-04,2024-09-27,552.08,10,355683,91156178,55503910,0.663443787649807,89.0317296980135,0.588129371496602
531.79,546,421,425,412159,603925,2024-09-04,2024-12-20,552.08,4,191766,769049161,290977996,0.0785287899169817,98.6443853619912,0.317532806225939
519.72,528,726,728,349932,602784,2024-09-04,2024-11-15,552.08,2,252852,416800800,184114755,0.144621603413429,98.5166935860008,0.419473642299729
529.2,541,502,502,440254,592360,2024-09-04,2024-12-20,552.08,0,152106,769049161,290977996,0.0770249848825984,98.7214103468738,0.256779661016949
523.13,524,1049,6745,31470,586815,2024-09-04,2024-09-13,552.08,5696,555345,70051475,47265620,0.837691140693326,85.4243254692353,0.946371514020603
542.47,553,390,557,179400,586521,2024-09-04,2024-10-04,552.08,167,407121,16648106,10098331,3.52304940874355,55.0182104799189,0.694128598975996
543.49,552,664,684,241032,582084,2024-09-04,2024-09-27,552.08,20,341052,91156178,55503910,0.638556829357194,89.6702865273706,0.585915434885687
547.58,566,304,315,410400,580230,2024-09-04,2024-11-15,552.08,11,169830,416800800,184114755,0.139210385392734,98.6559039713935,0.292694276407631
529.99,535,697,1151,160310,576651,2024-09-04,2024-10-04,552.08,454,416341,16648106,10098331,3.46376338545658,58.4819738653754,0.721998227697515
508.9,511,2875,2708,207000,568680,2024-09-04,2024-09-27,552.08,-167,361680,91156178,55503910,0.623852395391128,90.2941389227618,0.635999155940072
532.27,540,201,731,65727,565063,2024-09-04,2024-10-11,552.08,530,499336,4571203,3254681,12.3613630810095,12.3613630810095,0.883681996520742
531.7,544,458,449,503342,552270,2024-09-04,2024-12-20,552.08,-9,48928.0000000001,769049161,290977996,0.0718120541581347,98.7932224010319,0.0885943469679688
539.41,546,682,830,191642,546970,2024-09-04,2024-09-27,552.08,148,355328,91156178,55503910,0.600036127008309,90.8941750497701,0.649629778598461
551.6,571,277,277,283925,537380,2024-09-04,2024-09-20,552.08,0,253455,482984077,286009246,0.111262467147545,98.7146427189566,0.471649484536082
324.4,325,8723,8869,392535,532140,2024-09-04,2024-12-20,552.08,146,139605,769049161,290977996,0.0691945361864844,98.8624169372184,0.262346375014094
543.55,547.5,1287,1332,144144,526140,2024-09-04,2024-09-13,552.08,45,381996,70051475,47265620,0.75107626213438,86.1754017313697,0.726034895655149
549.87,580,95,173,207860,521249,2024-09-04,2024-12-20,552.08,78,313389,769049161,290977996,0.0677783718432533,98.9301953090617,0.60122705271377
507.98,510,2862,2552,211788,515504,2024-09-04,2024-09-27,552.08,-310,303716,91156178,55503910,0.565517347600949,91.459692397371,0.589163226667494
526.17,537,470,474,419240,513342,2024-09-04,2024-12-20,552.08,4,94102.0000000001,769049161,290977996,0.0667502191059539,98.9969455281676,0.183312489529398
550.4,580,175,173,358750,512080,2024-09-04,2024-10-18,552.08,-2,153330,526522587,265443300,0.0972569862420736,98.1068920410816,0.299425870957663
552.01,600,77,106,299453,508694,2024-09-04,2024-12-20,552.08,29,209241,769049161,290977996,0.0661458364168217,99.0630913645844,0.411329797481394
553.1,569,319,319,507210,507210,2024-09-04,2024-11-15,552.08,0,0,416800800,184114755,0.121691225160796,98.7775951965543,0
541.67,549,679,681,218638,499173,2024-09-04,2024-09-27,552.08,2,280535,91156178,55503910,0.547601940923851,92.0072943382949,0.561999547251153
518.12,528,499,504,344310,497952,2024-09-04,2024-12-20,552.08,5,153642,769049161,290977996,0.0647490466477474,99.1278404112322,0.308547811837286
534.31,542,953,637,281135,489853,2024-09-04,2024-10-04,552.08,-316,208718,16648106,10098331,2.94239476851,61.4243686338855,0.426082926918892
541.36,550,472,564,195880,487296,2024-09-04,2024-10-04,552.08,92,291416,16648106,10098331,2.92703566399685,64.3514042978823,0.598026661413186
550.38,567,110,290,69190,481980,2024-09-04,2024-09-13,552.08,180,412790,70051475,47265620,0.688036904290738,86.8634386356604,0.856446325573675
552,580,167,170,285570,476000,2024-09-04,2024-09-20,552.08,3,190430,482984077,286009246,0.0985539736540838,98.8131966926106,0.400063025210084
534.3,536,2727,2774,122715,471580,2024-09-04,2024-09-13,552.08,47,348865,70051475,47265620,0.673190678711619,87.536629314372,0.739779040671784
536.08,538,2353,2445,122356,469440,2024-09-04,2024-09-13,552.08,92,347084,70051475,47265620,0.670135782294377,88.2067650966664,0.739357532379005
504.92,505,57500,57659,172500,461272,2024-09-04,2024-09-06,552.08,159,288772,65864122,49955284,0.700338797501924,91.4718592923777,0.626034097018679
294.67,295,14431,13912,187603,459096,2024-09-04,2024-11-15,552.08,-519,271493,416800800,184114755,0.110147581290631,98.887742777845,0.59136433338561
379.59,380,11147,11148,222940,457068,2024-09-04,2024-10-18,552.08,1,234128,526522587,265443300,0.0868088114897908,98.1937008525714,0.512238879116455
543.44,555,262,395,154580,456620,2024-09-04,2024-10-11,552.08,133,302040,4571203,3254681,9.98905539745227,22.3504184784618,0.661469055231922
404.94,405,75443,75481,226329,452886,2024-09-04,2024-09-13,552.08,38,226557,70051475,47265620,0.646504588233153,88.8532696848996,0.500251718975636
552.22,566,355,319,168270,439582,2024-09-04,2024-09-06,552.08,-36,271312,65864122,49955284,0.667407363298641,92.1392666556764,0.617204526117994
527.41,539,364,372,345072,431148,2024-09-04,2024-12-20,552.08,8,86075.9999999999,769049161,290977996,0.0560624758291622,99.1839028870614,0.199643741824153
548.44,567,231,231,377916,428736,2024-09-04,2024-11-15,552.08,0,50820,416800800,184114755,0.102863526173654,98.9906063040186,0.118534482758621
512.22,515,792,1541,92664,428398,2024-09-04,2024-10-04,552.08,749,335734,16648106,10098331,2.57325367822622,66.9246579761085,0.783696469171191
528.52,533,958,942,163818,422016,2024-09-04,2024-09-27,552.08,-16,258198,91156178,55503910,0.462959296077552,92.4702536343724,0.611820404913558
529.87,541,371,377,258216,419601,2024-09-04,2024-11-15,552.08,6,161385,416800800,184114755,0.100671831723931,99.0912781357425,0.384615384615385
531.88,537,687,800,126408,409600,2024-09-04,2024-09-27,552.08,113,283192,91156178,55503910,0.449338716241482,92.9195923506139,0.69138671875
374.64,375,11364,11368,295464,409248,2024-09-04,2024-10-18,552.08,4,113784,526522587,265443300,0.0777265800374866,98.2714274326089,0.278031902416139
537.86,545,384,569,127872,406266,2024-09-04,2024-10-04,552.08,185,278394,16648106,10098331,2.44031363087188,69.3649716069804,0.685250550132179
547,562,279,268,205065,402000,2024-09-04,2024-10-04,552.08,-11,196935,16648106,10098331,2.41468909436305,71.7796607013435,0.489888059701493
549.49,561,300,347,209400,399397,2024-09-04,2024-10-04,552.08,47,189997,16648106,10098331,2.39905368214258,74.178714383486,0.475709632270648
426.12,427,4526,4526,171988,398288,2024-09-04,2024-10-18,552.08,0,226300,526522587,265443300,0.0756449979229476,98.3470724305318,0.568181818181818
535.36,541,665,701,143640,395364,2024-09-04,2024-09-27,552.08,36,251724,91156178,55503910,0.43372156300805,93.353313913622,0.636689228154308
519.33,520,6029,5809,144696,389203,2024-09-04,2024-09-13,552.08,-220,244507,70051475,47265620,0.555595724429785,89.4088654093294,0.62822485952061
526,527,3640,3880,105560,388000,2024-09-04,2024-09-13,552.08,240,282440,70051475,47265620,0.553878415836355,89.9627438251657,0.727938144329897
541.9,543,2619,3512,39285,386320,2024-09-04,2024-09-06,552.08,893,347035,65864122,49955284,0.586540878811077,92.7258075344874,0.898309691447505
509.56,511,2687,2679,158533,385776,2024-09-04,2024-09-20,552.08,-8,227243,482984077,286009246,0.0798734406310459,98.8930701332417,0.589054269835345
525.05,530,173,777,41347,384615,2024-09-04,2024-10-11,552.08,604,343268,4571203,3254681,8.41386829681377,30.7642867752756,0.892497692497692
540.17,541,3038,4618,39494,383294,2024-09-04,2024-09-06,552.08,1580,343800,65864122,49955284,0.581946571761786,93.3077541062492,0.896961601277349
249.72,250,13514,13592,256766,380576,2024-09-04,2024-12-20,552.08,78,123810,769049161,290977996,0.0494865633173742,99.2333894503787,0.325322668796771
541.03,542,3115,3854,43610,373838,2024-09-04,2024-09-06,552.08,739,330228,65864122,49955284,0.567589741802069,93.8753438480513,0.883345192302548
549.91,564,369,262,183024,369158,2024-09-04,2024-09-13,552.08,-107,186134,70051475,47265620,0.526981052147724,90.4897248773134,0.504212288505193
534.62,535,5680,9569,45440,363622,2024-09-04,2024-09-06,552.08,3889,318182,65864122,49955284,0.55207902110955,94.4274228691608,0.875035063885024
269.55,270,8063,8054,193512,362430,2024-09-04,2024-12-20,552.08,-9,168918,769049161,290977996,0.0471270262526169,99.2805164766313,0.466070689512458
545.56,557,274,316,156454,361504,2024-09-04,2024-10-04,552.08,42,205050,16648106,10098331,2.17144220489706,76.3501565883831,0.56721364078959
535.62,537.5,987,1917,54285,360396,2024-09-04,2024-09-13,552.08,930,306111,70051475,47265620,0.514473107097317,91.0041979844108,0.849374021909233
551.1,578,130,132,293150,355080,2024-09-04,2024-12-20,552.08,2,61930,769049161,290977996,0.046171300614682,99.326687777246,0.174411400247831
543.55,556,211,282,129132,351090,2024-09-04,2024-10-04,552.08,71,221958,16648106,10098331,2.10888854263662,78.4590451310197,0.63219687259677
539.59,547,431,463,135334,343083,2024-09-04,2024-09-27,552.08,32,207749,91156178,55503910,0.3763683466413,93.7296822602633,0.60553568669972
540.96,544,1084,1125,95392,342000,2024-09-04,2024-09-13,552.08,41,246608,70051475,47265620,0.48821241808256,91.4924104024933,0.721076023391813
526.23,527.5,2277,2655,68310,337185,2024-09-04,2024-09-13,552.08,378,268875,70051475,47265620,0.481338901143766,91.9737493036371,0.797410916855732
552.72,573,147,166,166845,336648,2024-09-04,2024-09-20,552.08,19,169803,482984077,286009246,0.0697016767283614,98.96277180997,0.504393312896557
540.21,543,1212,1200,98172,334800,2024-09-04,2024-09-13,552.08,-12,236628,70051475,47265620,0.477934261912401,92.4516835655495,0.706774193548387
443.92,445,3300,3100,165000,334800,2024-09-04,2024-10-18,552.08,-200,169800,526522587,265443300,0.0635870156886546,98.4106594462205,0.507168458781362
529.69,542,263,271,193305,333601,2024-09-04,2024-11-15,552.08,8,140296,416800800,184114755,0.0800384740144453,99.171316609757,0.420550298110617
523.55,534,316,316,270496,330220,2024-09-04,2024-12-20,552.08,0,59724,769049161,290977996,0.0429387374365785,99.3696265146826,0.180861244019139
545.83,552.5,399,486,71421,324162,2024-09-04,2024-09-13,552.08,87,252741,70051475,47265620,0.462748286170991,92.9144318517205,0.779674977326152
543.77,554,156,315,78312,322245,2024-09-04,2024-10-04,552.08,159,243933,16648106,10098331,1.93562559008214,80.3946707211019,0.756979937625099
409.75,410,12813,12771,128130,319275,2024-09-04,2024-09-20,552.08,-42,191145,482984077,286009246,0.0661046637361505,99.0288764737062,0.598684519614752
389.47,390,6062,6010,151550,318530,2024-09-04,2024-10-18,552.08,-52,166980,526522587,265443300,0.0604969298306665,98.4711563760512,0.524220638558378
264.57,265,7340,7365,176160,316695,2024-09-04,2024-12-20,552.08,25,140535,769049161,290977996,0.0411800722320793,99.4108065869147,0.443755032444466
548.74,572,137,136,253450,316336,2024-09-04,2024-12-20,552.08,-1,62886,769049161,290977996,0.0411333912111244,99.4519399781258,0.198794952202721
538.52,546,416,415,142272,310420,2024-09-04,2024-10-04,552.08,-1,168148,16648106,10098331,1.86459648923427,82.2592672103361,0.54167901552735
507.75,509,2050,2471,96350,308875,2024-09-04,2024-09-20,552.08,421,212525,482984077,286009246,0.0639513836395066,99.0928278573457,0.688061513557264
364.96,365,77173,77173,154346,308692,2024-09-04,2024-09-13,552.08,0,154346,70051475,47265620,0.440664525622052,93.3550963773425,0.5
414.73,415,11380,11384,147940,307368,2024-09-04,2024-09-20,552.08,4,159428,482984077,286009246,0.0636393650716564,99.1564672224174,0.518687696832461
438.99,440,3003,3014,138138,304414,2024-09-04,2024-10-18,552.08,11,166276,526522587,265443300,0.0578159432313205,98.5289723192825,0.546216665462167
359.27,360,4157,4167,141338,304191,2024-09-04,2024-11-15,552.08,10,162853,416800800,184114755,0.0729823455233291,99.2442989552803,0.53536429414414
545.37,547.5,1004,1389,29116,295857,2024-09-04,2024-09-06,552.08,385,266741,65864122,49955284,0.449192961230091,94.8766158303909,0.901587591302555
546.04,559,222,227,140748,294192,2024-09-04,2024-10-04,552.08,5,153444,16648106,10098331,1.76711993544491,84.026387145781,0.521577745146027
495.09,496,3282,3201,150972,291291,2024-09-04,2024-09-20,552.08,-81,140319,482984077,286009246,0.0603106839068734,99.2167779063242,0.481714162126533
523.65,527,678,860,86106,288100,2024-09-04,2024-09-27,552.08,182,201994,91156178,55503910,0.316050986692312,94.0457332469556,0.701124609510587
289.42,290,4967,4960,153977,287680,2024-09-04,2024-12-20,552.08,-7,133703,769049161,290977996,0.0374072314994698,99.4893472096253,0.464762931034483
552.24,578,111,110,211122,283360,2024-09-04,2024-10-18,552.08,-1,72238.0000000001,526522587,265443300,0.0538172543773512,98.5827895736598,0.254933653303219
516.93,520,498,903,69720,277221,2024-09-04,2024-10-04,552.08,405,207501,16648106,10098331,1.66518041151348,85.6915675572945,0.748503901219605
542.52,551,198,325,71874,275600,2024-09-04,2024-09-27,552.08,127,203726,91156178,55503910,0.302338257314825,94.3480715042704,0.739208998548621
393.83,395,2337,2352,135546,275184,2024-09-04,2024-11-15,552.08,15,139638,416800800,184114755,0.0660229059061307,99.3103218611865,0.507435025292168
536.71,539,1006,1196,59354,273884,2024-09-04,2024-09-13,552.08,190,214530,70051475,47265620,0.390975350626093,93.7460717279686,0.783287815279461
550.2,566,143,169,78221,267020,2024-09-04,2024-09-13,552.08,26,188799,70051475,47265620,0.381176841743875,94.1272485697125,0.707059396299903
553.13,568,151,179,128803,266173,2024-09-04,2024-09-13,552.08,28,137370,70051475,47265620,0.379967730872191,94.5072163005847,0.51609291701262
369.55,370,5899,5891,117980,265095,2024-09-04,2024-10-18,552.08,-8,147115,526522587,265443300,0.0503482673954119,98.6331378410553,0.554951998340218
540.06,550,104,266,50960,264404,2024-09-04,2024-10-11,552.08,162,213444,4571203,3254681,5.78412291031486,36.5484096855904,0.807264640474426
314.33,315,3224,3944,132184,264248,2024-09-04,2024-12-20,552.08,720,132064,769049161,290977996,0.0343603521595936,99.5237075617849,0.499772940570979
498,499,2667,2637,101346,263700,2024-09-04,2024-09-20,552.08,-30,162354,482984077,286009246,0.0545980732197099,99.2713759795439,0.615676905574517
517.68,520,1216,1123,119168,260536,2024-09-04,2024-09-27,552.08,-93,141368,91156178,55503910,0.285812772887428,94.6338842771578,0.542604476924494
304.82,305,14426,14473,86556,260514,2024-09-04,2024-10-18,552.08,47,173958,526522587,265443300,0.0494782192506397,98.6826160603059,0.667749142080656
424.71,425,8966,8946,107592,259434,2024-09-04,2024-09-20,552.08,-20,151842,482984077,286009246,0.0537148142877596,99.3250907938317,0.585281805777192
546.7,568,120,120,194520,255600,2024-09-04,2024-11-15,552.08,0,61080,416800800,184114755,0.0613242584947054,99.3716461196812,0.238967136150235
534.19,539,457,531,96884,255411,2024-09-04,2024-09-27,552.08,74,158527,91156178,55503910,0.280190553842659,94.9140748310005,0.620674129148705
389.82,390,14145,14133,99015,254394,2024-09-04,2024-09-20,552.08,-12,155379,482984077,286009246,0.0526713016255399,99.3777620954572,0.610780914644213
529.76,530,4149,10431,29043,250344,2024-09-04,2024-09-06,552.08,6282,221301,65864122,49955284,0.380091607385277,95.2567074377762,0.883987633016969
434.01,435,1821,2513,81945,248787,2024-09-04,2024-10-18,552.08,692,166842,526522587,265443300,0.047250964373158,98.7298670246791,0.670621857251384
531.5,533,1418,1637,58138,245550,2024-09-04,2024-09-13,552.08,219,187412,70051475,47265620,0.350527951053136,94.8577442516378,0.763233557320301
378.61,379,6276,6277,156900,244803,2024-09-04,2024-10-18,552.08,1,87903,526522587,265443300,0.0464943016775081,98.7763613263566,0.359076481905859
543.02,554,235,222,108570,243756,2024-09-04,2024-09-27,552.08,-13,135186,91156178,55503910,0.26740480497109,95.1814796359716,0.554595579185743
537.14,544,320,353,78400,242158,2024-09-04,2024-09-27,552.08,33,163758,91156178,55503910,0.265651769647473,95.4471314056191,0.676244435451234
554.97,569,166,172,122342,241316,2024-09-04,2024-09-13,552.08,6,118974,70051475,47265620,0.344483824216407,95.2022280758542,0.493021598236337
502.98,505,578,1185,52020,239370,2024-09-04,2024-10-04,552.08,607,187350,16648106,10098331,1.43782121521812,87.1293887725126,0.782679533776162
554.01,567,194,183,193806,237717,2024-09-04,2024-10-11,552.08,-11,43911,4571203,3254681,5.20031597809154,41.748725663682,0.184719645629046
309.39,310,3872,3872,147136,236192,2024-09-04,2024-12-20,552.08,0,89056,769049161,290977996,0.0307122108673622,99.5544197726522,0.377049180327869
424.89,425,21276,21288,106380,234168,2024-09-04,2024-09-13,552.08,12,127788,70051475,47265620,0.334279899174143,95.5365079750284,0.545710771753613
514.38,515,3633,3716,76293,230392,2024-09-04,2024-09-13,552.08,83,154099,70051475,47265620,0.328889577271571,95.8653975522999,0.668855689433661
433.23,435,1288,1299,113344,229923,2024-09-04,2024-11-15,552.08,11,116579,416800800,184114755,0.0551637616818394,99.426809881363,0.507034963879212
374.89,375,20808,20809,124848,228899,2024-09-04,2024-09-20,552.08,1,104051,482984077,286009246,0.0473926596963154,99.4251547551536,0.45457166697976
413.27,414,1281,3103,40992,226519,2024-09-04,2024-10-18,552.08,1822,185527,526522587,265443300,0.0430217061134359,98.81938303247,0.819035047832632
299.72,300,8124,8071,121860,225988,2024-09-04,2024-11-15,552.08,-53,104128,416800800,184114755,0.0542196656052484,99.4810295469683,0.460767828380268
501.03,502,2383,2323,100086,225331,2024-09-04,2024-09-20,552.08,-60,125245,482984077,286009246,0.0466539189862361,99.4718086741398,0.55582676151972
429.12,430,2613,2555,104520,224840,2024-09-04,2024-10-18,552.08,-58,120320,526522587,265443300,0.0427028214081156,98.8620858538781,0.535136096779932
493.2,494,2832,2783,121776,222640,2024-09-04,2024-09-20,552.08,-49,100864,482984077,286009246,0.0460967577612295,99.517905431901,0.45303629177147
548.4,563,156,149,120588,217540,2024-09-04,2024-10-04,552.08,-7,96952,16648106,10098331,1.3066951880292,88.4360839605418,0.445674358738623
304.34,305,3269,3269,166719,215754,2024-09-04,2024-12-20,552.08,0,49035,769049161,290977996,0.0280546434404081,99.5824744160926,0.227272727272727
490.18,491,2630,2625,99940,215250,2024-09-04,2024-09-20,552.08,-5,115310,482984077,286009246,0.0445666866156335,99.5624721185167,0.535702671312428
533.45,538,300,465,57600,211575,2024-09-04,2024-09-27,552.08,165,153975,91156178,55503910,0.232101657443339,95.6792330630624,0.727756114852889
259.64,260,5780,5838,115600,210168,2024-09-04,2024-12-20,552.08,58,94568,769049161,290977996,0.0273282919555776,99.6098027080482,0.449963838453047
515.37,518,592,788,52096,207244,2024-09-04,2024-09-27,552.08,196,155148,91156178,55503910,0.227350470968627,95.906583534031,0.748624809403409
454.98,455,102859,102889,205718,205778,2024-09-04,2024-09-06,552.08,30,60.0000000000582,65864122,49955284,0.312428062124627,95.5691354999008,0.000291576358989096
294.47,295,3859,3859,135065,204527,2024-09-04,2024-12-20,552.08,0,69462,769049161,290977996,0.0265947887823,99.6363974968305,0.339622641509434
521.46,525,245,576,38710,203904,2024-09-04,2024-10-04,552.08,331,165194,16648106,10098331,1.22478797287812,89.66087193342,0.810155759573133
535.18,537,1059,1119,56127,203658,2024-09-04,2024-09-13,552.08,60,147531,70051475,47265620,0.290726212403094,96.156123764703,0.724405621188463
549.66,570,99,100,99000,203400,2024-09-04,2024-09-27,552.08,1,104400,91156178,55503910,0.223133532430462,96.1297170664615,0.513274336283186
539.8,542.5,379,735,29562,198450,2024-09-04,2024-09-13,552.08,356,168888,70051475,47265620,0.283291679440012,96.439415444143,0.85103552532124
553.95,576,88,89,175560,196245,2024-09-04,2024-12-20,552.08,1,20685,769049161,290977996,0.025517874532861,99.6619153713634,0.105403959336544
552.35,572,93,99,142662,194535,2024-09-04,2024-09-20,552.08,6,51873,482984077,286009246,0.0402777253462126,99.6027498438629,0.266651245277199
553.13,605,41,37,178309,191919,2024-09-04,2024-12-20,552.08,-4,13610,769049161,290977996,0.0249553617288193,99.6868707330922,0.0709153340732287
483.62,485,1125,1384,64125,190992,2024-09-04,2024-10-04,552.08,259,126867,16648106,10098331,1.1472296007726,90.8081015341926,0.664252953003267
535.55,543,239,250,72178,186250,2024-09-04,2024-10-04,552.08,11,114072,16648106,10098331,1.11874588016198,91.9268474143545,0.61246711409396
329.93,330,26092,26094,78276,182658,2024-09-04,2024-09-20,552.08,2,104382,482984077,286009246,0.0378186380666127,99.6405684819295,0.571461419702395
548.2,575,67,68,120600,182240,2024-09-04,2024-11-15,552.08,1,61640,416800800,184114755,0.0437235245229856,99.5247530714912,0.338235294117647
528.53,535,99,280,27621,181160,2024-09-04,2024-10-11,552.08,181,153539,4571203,3254681,3.96307055276259,45.7117962164446,0.847532567895783
549.5,585,52,51,118404,181050,2024-09-04,2024-10-18,552.08,-1,62646,526522587,265443300,0.0343859892187303,98.8964718430968,0.346014913007457
384.84,385,11133,11133,66798,178128,2024-09-04,2024-09-20,552.08,0,111330,482984077,286009246,0.0368807189475938,99.6774492008771,0.625
119.96,120,44489,44295,88978,177180,2024-09-04,2024-12-20,552.08,-194,88202,769049161,290977996,0.0230388392556871,99.7099095723479,0.497810136584265
552.98,570,148,103,118400,175306,2024-09-04,2024-09-13,552.08,-45,56906,70051475,47265620,0.250253117439711,96.6896685615828,0.324609539890249
279.54,280,3808,3807,102816,175122,2024-09-04,2024-12-20,552.08,-1,72306,769049161,290977996,0.0227712360770653,99.7326808084249,0.412889300030836
542.45,552,121,182,60500,173810,2024-09-04,2024-10-04,552.08,61,113310,16648106,10098331,1.0440226654011,92.9708700797556,0.651918761866406
519.49,522.5,485,572,56745,172172,2024-09-04,2024-09-27,552.08,87,115427,91156178,55503910,0.18887584339045,96.3185929098519,0.670416792509816
199.81,200,8980,9019,89800,171361,2024-09-04,2024-12-20,552.08,39,81561,769049161,290977996,0.0222821906179805,99.7549629990429,0.475960107609083
525.8,526,8653,8527,51918,170540,2024-09-04,2024-09-06,552.08,-126,118622,65864122,49955284,0.258927007331852,95.8280625072327,0.695567022399437
532.49,534,993,1117,43692,168667,2024-09-04,2024-09-13,552.08,124,124975,70051475,47265620,0.24077580093781,96.9304443625206,0.740957033681752
309.82,310,9332,9361,55992,168498,2024-09-04,2024-10-18,552.08,29,112506,526522587,265443300,0.032002045906532,98.9284738890034,0.667699319873233
529.82,534,322,401,53452,167618,2024-09-04,2024-09-27,552.08,79,114166,91156178,55503910,0.183880021823644,96.5024729316756,0.681108234199191
537.46,538,1880,3103,18800,167562,2024-09-04,2024-09-06,552.08,1223,148762,65864122,49955284,0.254405577592001,96.0824680848247,0.887802723767919
523.83,524,4962,9789,19848,166413,2024-09-04,2024-09-06,552.08,4827,146565,65864122,49955284,0.252661076997276,96.335129161822,0.880730471778046
395.41,396,2924,2813,87720,165967,2024-09-04,2024-10-18,552.08,-111,78247,526522587,265443300,0.0315213447813588,98.9599952337847,0.471461194092801
219.75,220,6546,6599,78552,164975,2024-09-04,2024-12-20,552.08,53,86423,769049161,290977996,0.021451814573919,99.7764148136168,0.523855129565086
559.01,575,102,102,163098,163098,2024-09-04,2024-10-11,552.08,0,0,4571203,3254681,3.56794480577651,49.2797410222211,0
379.4,380,2697,2701,121365,162060,2024-09-04,2024-11-15,552.08,4,40695,416800800,184114755,0.0388818831441782,99.5636349546354,0.251110699740837
394.65,395,4613,4616,129164,161560,2024-09-04,2024-10-18,552.08,3,32396,526522587,265443300,0.0306843436519087,98.9906795774366,0.20051993067591
553.4,585,51,51,130050,161160,2024-09-04,2024-12-20,552.08,0,31110,769049161,290977996,0.0209557474570862,99.7973705610739,0.193037974683544
549.45,566,96,97,76128,160535,2024-09-04,2024-09-27,552.08,1,84407,91156178,55503910,0.176109840849185,96.6785827725248,0.525785654218706
535.58,536,3767,3813,30136,160146,2024-09-04,2024-09-06,552.08,46,130010,65864122,49955284,0.243146033283492,96.5782751951055,0.811821712687173
541.51,542.5,1335,1602,20025,158598,2024-09-04,2024-09-06,552.08,267,138573,65864122,49955284,0.240795740054046,96.8190709351595,0.873737373737374
552.52,572,120,81,113160,157788,2024-09-04,2024-09-13,552.08,-39,44628,70051475,47265620,0.225245792469038,97.1556901549896,0.282835196592897
491.41,492,2659,2671,90406,157589,2024-09-04,2024-09-20,552.08,12,67183,482984077,286009246,0.0326281978028853,99.71007739868,0.426317826751867
548.5,580,50,50,1e+05,157500,2024-09-04,2024-11-15,552.08,0,57500,416800800,184114755,0.0377878353400473,99.6014227899754,0.365079365079365
537.68,546,83,186,38512,154752,2024-09-04,2024-10-11,552.08,103,116240,4571203,3254681,3.38536704670521,52.6651080689263,0.751137303556658
552.9,590,44,41,129800,152110,2024-09-04,2024-11-15,552.08,-3,22310,416800800,184114755,0.0364946516417435,99.6379174416172,0.14667017290119
415.35,416,2305,2317,78370,150605,2024-09-04,2024-10-18,552.08,12,72235,526522587,265443300,0.0286037111642468,99.0192832886009,0.479632150327014
441.08,442,1294,1613,60818,148396,2024-09-04,2024-10-18,552.08,319,87578,526522587,265443300,0.028184166009957,99.0474674546108,0.590164155368069
538.37,539,1657,2354,14913,148302,2024-09-04,2024-09-06,552.08,697,133389,65864122,49955284,0.225163557179127,97.0442344923386,0.899441679815512
531.16,536,251,305,44176,147620,2024-09-04,2024-09-27,552.08,54,103444,91156178,55503910,0.161941848856366,96.8405246213811,0.700745156482861
474.14,475,1680,1703,60480,146458,2024-09-04,2024-09-27,552.08,23,85978,91156178,55503910,0.160667113533435,97.0011917349146,0.587048846768357
518.96,522,486,472,51030,143488,2024-09-04,2024-09-27,552.08,-14,92458,91156178,55503910,0.157408969033344,97.1586007039479,0.644360504014273
562.29,610,30,30,143130,143130,2024-09-04,2024-12-20,552.08,0,0,769049161,290977996,0.0186112939534174,99.8159818550273,0
536.24,545,109,160,43927,140160,2024-09-04,2024-10-11,552.08,51,96233,4571203,3254681,3.06615129540298,55.7312593643293,0.686593892694064
405.38,406,1753,2250,57849,139500,2024-09-04,2024-10-18,552.08,497,81651,526522587,265443300,0.0264945898702727,99.0739620444811,0.585311827956989
538.87,549,20,137,10080,138781,2024-09-04,2024-10-11,552.08,117,128701,4571203,3254681,3.03598418184447,58.7672435461737,0.927367579135472
411.36,412,2062,2166,70108,138624,2024-09-04,2024-10-18,552.08,104,68516,526522587,265443300,0.02632821524141,99.1002902597225,0.49425784856879
432.03,433,1327,1424,82274,138128,2024-09-04,2024-10-18,552.08,97,55854,526522587,265443300,0.0262340122552045,99.1265242719777,0.404364068110738
544.27,558,71,100,47570,137300,2024-09-04,2024-10-11,552.08,29,89730,4571203,3254681,3.00358570818229,61.770829254356,0.653532410779315
400.74,401,5212,5212,135512,135512,2024-09-04,2024-10-18,552.08,0,0,526522587,265443300,0.0257371674731212,99.1522614394508,0
507.48,510,743,537,78015,135324,2024-09-04,2024-10-04,552.08,-206,57309,16648106,10098331,0.812849221406928,93.7837193011626,0.423494723774053
358.78,359,6119,6119,85666,134618,2024-09-04,2024-10-18,552.08,0,48952,526522587,265443300,0.0255673741875009,99.1778288136383,0.363636363636364
349.33,350,1980,1993,61380,133531,2024-09-04,2024-11-15,552.08,13,72151,416800800,184114755,0.0320371266082023,99.6699545682254,0.540331458612607
550.67,568,158,76,93220,131708,2024-09-04,2024-09-06,552.08,-82,38488,65864122,49955284,0.199969263994744,97.2442037563334,0.292222188477541
494.68,495,2316,4066,39372,130112,2024-09-04,2024-09-13,552.08,1750,90740,70051475,47265620,0.185737702168298,97.3414278571579,0.697399163797344
549,567,75,72,65850,129600,2024-09-04,2024-09-27,552.08,-3,63750,91156178,55503910,0.142173578185781,97.3007742821337,0.491898148148148
349.91,350,14332,14321,57328,128889,2024-09-04,2024-09-20,552.08,-11,71561,482984077,286009246,0.0266859729208009,99.7367633716008,0.555214176539503
526.95,528,836,1218,25916,127890,2024-09-04,2024-09-13,552.08,382,101974,70051475,47265620,0.182565748972452,97.5239936061304,0.797357103761045
489.66,490,1572,3755,20436,127670,2024-09-04,2024-09-13,552.08,2183,107234,70051475,47265620,0.182251694200586,97.7062453003309,0.839931072295762
351.76,352,5303,5306,127272,127344,2024-09-04,2024-10-18,552.08,3,72,526522587,265443300,0.0241858570067384,99.2020146706451,0.000565397663022993
551.44,571,65,65,97500,127140,2024-09-04,2024-11-15,552.08,0,29640,416800800,184114755,0.0305037802230706,99.7004583484485,0.233128834355828
459.16,460,1247,1499,47386,125916,2024-09-04,2024-10-04,552.08,252,78530,16648106,10098331,0.756338288571685,94.5400575897342,0.623669748086026
520.49,525,77,274,15708,123574,2024-09-04,2024-10-11,552.08,197,107866,4571203,3254681,2.70331464168185,64.4741438960379,0.872885882143493
513.39,516,288,473,25632,123453,2024-09-04,2024-09-27,552.08,185,97821,91156178,55503910,0.135430206387109,97.4362044885208,0.792374425894875
549.39,565,72,79,59328,123319,2024-09-04,2024-10-04,552.08,7,63991,16648106,10098331,0.740738916486957,95.2807965062212,0.518906251267039
551,600,27,25,98550,122500,2024-09-04,2024-11-15,552.08,-2,23950,416800800,184114755,0.0293905385978146,99.7298488870463,0.195510204081633
528.31,532.5,230,292,34270,122348,2024-09-04,2024-09-27,552.08,62,88078,91156178,55503910,0.134218001110139,97.5704224896309,0.719897342008043
284.71,285,4138,4138,120002,120002,2024-09-04,2024-12-20,552.08,0,0,769049161,290977996,0.015603943946049,99.8315857989734,0
299.83,300,6925,7053,41550,119901,2024-09-04,2024-10-18,552.08,128,78351,526522587,265443300,0.022772242437531,99.2247869130826,0.653464107889008
239.72,240,3760,4272,63920,119616,2024-09-04,2024-12-20,552.08,512,55696,769049161,290977996,0.01555375209622,99.8471395510696,0.465623327982879
530.67,532,1066,886,45838,117838,2024-09-04,2024-09-13,552.08,-180,72000,70051475,47265620,0.168216300941558,97.8744616012725,0.611008333474771
550.05,567,492,69,261252,116955,2024-09-04,2024-09-06,552.08,-423,-144297,65864122,49955284,0.177570119282847,97.4217738756162,-1.23378222393228
505.63,507.5,606,617,40602,115379,2024-09-04,2024-09-27,552.08,11,74777,91156178,55503910,0.126572880227602,97.6969953698585,0.648098874145208
436.98,438,1115,1119,54635,114138,2024-09-04,2024-10-18,552.08,4,59503,526522587,265443300,0.0216777024990193,99.2464646155816,0.521325062643467
511.16,513,136,618,11696,113712,2024-09-04,2024-09-27,552.08,482,102016,91156178,55503910,0.124744150637821,97.8217395204964,0.897143661179119
540.74,552,10,100,5710,112600,2024-09-04,2024-10-11,552.08,90,106890,4571203,3254681,2.46324654582175,66.9373904418596,0.949289520426288
189.84,190,6892,6856,55136,109696,2024-09-04,2024-12-20,552.08,-36,54560,769049161,290977996,0.0142638475617555,99.8614033986314,0.497374562427071
514.52,517,444,441,42624,109368,2024-09-04,2024-09-27,552.08,-3,66744,91156178,55503910,0.119978702924557,97.9417182234209,0.61026991441738
498.19,500,385,604,30800,109324,2024-09-04,2024-10-04,552.08,219,78524,16648106,10098331,0.656675299880959,95.9374718061022,0.718268632688156
549.8,590,33,27,89661,108540,2024-09-04,2024-10-18,552.08,-6,18879,526522587,265443300,0.0206145002474509,99.2670791158291,0.173935876174682
359.89,360,9846,9844,49230,108284,2024-09-04,2024-09-20,552.08,-2,59054,482984077,286009246,0.0224197867293252,99.7591831583301,0.545362195707584
403.43,404,1897,1897,58807,108129,2024-09-04,2024-10-18,552.08,0,49322,526522587,265443300,0.0205364409181557,99.2876155567473,0.456140350877193
525.08,526,1104,1168,35328,107456,2024-09-04,2024-09-13,552.08,64,72128,70051475,47265620,0.153395770752864,98.0278573720254,0.671232876712329
398.47,399,1967,1963,60977,104039,2024-09-04,2024-10-18,552.08,-4,43062,526522587,265443300,0.0197596461327119,99.30737520288,0.413902478878113
414.19,415,788,1284,25216,104004,2024-09-04,2024-10-18,552.08,496,78788,526522587,265443300,0.0197529987445724,99.3271282016245,0.757547786623591
554.45,573,56,56,103880,103880,2024-09-04,2024-12-20,552.08,0,0,769049161,290977996,0.0135075890161461,99.8749109876475,0
204.8,205,5100,5150,51000,103000,2024-09-04,2024-12-20,552.08,50,52000,769049161,290977996,0.013393162000992,99.8883041496485,0.504854368932039
493.73,495,649,810,32450,102870,2024-09-04,2024-09-27,552.08,161,70420,91156178,55503910,0.112850277684964,98.0545685011059,0.684553319723923
488.86,490,676,900,30420,102600,2024-09-04,2024-09-27,552.08,224,72180,91156178,55503910,0.11255408273041,98.1671225838363,0.703508771929825
540.6,549,75,120,33675,100800,2024-09-04,2024-10-04,552.08,45,67125,16648106,10098331,0.6054742803776,96.5429460864797,0.665922619047619
520.4,523,410,383,47970,99580,2024-09-04,2024-09-27,552.08,-27,51610,91156178,55503910,0.109241087312809,98.2763636711491,0.518276762402089
364.91,365,11063,11062,66378,99558,2024-09-04,2024-09-20,552.08,-1,33180,482984077,286009246,0.0206131019097758,99.7797962602399,0.333273066955945
427.11,428,1174,1108,45786,98612,2024-09-04,2024-10-18,552.08,-66,52826,526522587,265443300,0.0187289211203393,99.3458571227449,0.535695452886059
529.8,531,756,818,25704,98160,2024-09-04,2024-09-13,552.08,62,72456,70051475,47265620,0.140125529119837,98.1679829011452,0.738141809290954
518.14,521,425,342,42075,97812,2024-09-04,2024-09-27,552.08,-83,55737,91156178,55503910,0.107301558869658,98.3836652300188,0.569838056680162
404.4,405,1631,1626,45668,97560,2024-09-04,2024-10-18,552.08,-5,51892,526522587,265443300,0.0185291196254036,99.3643862423703,0.53189831898319
551.23,574,42,42,95634,95634,2024-09-04,2024-12-20,552.08,0,0,769049161,290977996,0.0124353558718725,99.9007395055204,0
524.82,525,5148,5290,25740,95220,2024-09-04,2024-09-06,552.08,142,69480,65864122,49955284,0.144570362601964,97.5663442382182,0.729678638941399
533.66,534,1576,2770,9456,94180,2024-09-04,2024-09-06,552.08,1194,84724,65864122,49955284,0.14299135423076,97.709335592449,0.899596517307284
421.13,422,838,1075,34358,93525,2024-09-04,2024-10-18,552.08,237,59167,526522587,265443300,0.0177627707356076,99.3821490131059,0.632632985832665
524.47,528,229,263,29312,92839,2024-09-04,2024-09-27,552.08,34,63527,91156178,55503910,0.101846086614118,98.4855113166329,0.684270619028641
539.25,548,97,104,36763,91000,2024-09-04,2024-10-04,552.08,7,54237,16648106,10098331,0.546608725340889,97.0895548118206,0.596010989010989
364.3,365,1298,1299,46728,90930,2024-09-04,2024-11-15,552.08,1,44202,416800800,184114755,0.0218161769363207,99.7516650639826,0.486110194655229
547.9,562,64,64,51008,90240,2024-09-04,2024-10-11,552.08,0,39232,4571203,3254681,1.97409740936904,68.9114878512287,0.434751773049645
442.89,444,853,807,45209,89577,2024-09-04,2024-10-18,552.08,-46,44368,526522587,265443300,0.0170129453534726,99.3991619584594,0.49530571463657
497.6,500,65,373,7280,89520,2024-09-04,2024-10-11,552.08,308,82240,4571203,3254681,1.95834663216663,70.8698344833953,0.918677390527256
229.76,230,3620,3717,50680,89208,2024-09-04,2024-12-20,552.08,97,38528,769049161,290977996,0.0115997785998495,99.9123392841202,0.431889516635279
412.35,413,1198,1341,37138,87165,2024-09-04,2024-10-18,552.08,143,50027,526522587,265443300,0.0165548453479736,99.4157168038073,0.573934492055297
449.52,450,1804,1805,43296,86640,2024-09-04,2024-09-27,552.08,1,43344,91156178,55503910,0.0950456698612353,98.5805569864941,0.500277008310249
507.21,509,343,482,24696,86278,2024-09-04,2024-09-27,552.08,139,61582,91156178,55503910,0.0946485492184633,98.6752055357126,0.713762488699321
369.89,370,7811,7812,46866,85932,2024-09-04,2024-09-20,552.08,1,39066,482984077,286009246,0.0177918908908461,99.7975881511307,0.454615277195922
516.27,520,168,228,30576,85044,2024-09-04,2024-10-11,552.08,60,54468,4571203,3254681,1.8604293005583,72.7302637839536,0.64046846338366
509.53,510,1713,1803,30834,84741,2024-09-04,2024-09-13,552.08,90,53907,70051475,47265620,0.120969615557702,98.2889525167029,0.636138350975325
438.12,439,954,951,48654,83688,2024-09-04,2024-10-18,552.08,-3,35034,526522587,265443300,0.0158944748176587,99.431611278625,0.418626326355033
459.41,460,205,1408,6150,83072,2024-09-04,2024-09-27,552.08,1203,76922,91156178,55503910,0.0911315083877255,98.7663370441003,0.925967835130971
375.75,376,3286,3286,98580,82150,2024-09-04,2024-10-18,552.08,0,-16430,526522587,265443300,0.0156023695902717,99.4472136482153,-0.2
463.99,465,817,811,38399,81911,2024-09-04,2024-10-04,552.08,-6,43512,16648106,10098331,0.492013926388984,97.5815687382096,0.53121070430101
535.8,543,7,113,2625,81360,2024-09-04,2024-10-11,552.08,106,78735,4571203,3254681,1.77983782387262,74.5101016078262,0.96773598820059
506.1,508,357,423,25704,80370,2024-09-04,2024-09-27,552.08,66,54666,91156178,55503910,0.088167364805488,98.8545044089058,0.680179171332587
522.19,523,981,986,32373,79866,2024-09-04,2024-09-13,552.08,5,47493,70051475,47265620,0.11401044731749,98.4029629640204,0.594658553076403
299.96,300,19967,19868,39934,79472,2024-09-04,2024-09-20,552.08,-99,39538,482984077,286009246,0.0164543726769692,99.8140425238077,0.49750855647272
507.14,510,163,273,22005,78078,2024-09-04,2024-10-11,552.08,110,56073,4571203,3254681,1.70804053112496,76.2181421389512,0.71816644893568
479.74,480,2821,2994,31031,77844,2024-09-04,2024-09-13,552.08,173,46813,70051475,47265620,0.111123998459704,98.5140869624801,0.601369405477622
520.82,524,230,240,25300,76320,2024-09-04,2024-09-27,552.08,10,51020,91156178,55503910,0.0837244404871823,98.938228849393,0.668501048218029
532.68,533,2727,2371,16362,75872,2024-09-04,2024-09-06,552.08,-356,59510,65864122,49955284,0.11519473378845,97.8245303262374,0.784347321805146
528,529,745,753,23095,75300,2024-09-04,2024-09-13,552.08,8,52205,70051475,47265620,0.107492383279581,98.6215793457597,0.693293492695883
522.7,526,163,225,19234,74250,2024-09-04,2024-09-27,552.08,62,55016,91156178,55503910,0.0814536125022705,99.0196824618952,0.740956228956229
324.54,325,1391,1614,29211,74244,2024-09-04,2024-11-15,552.08,223,45033,416800800,184114755,0.0178128256951522,99.7694778896778,0.606554064974947
550.79,572,35,35,46550,74235,2024-09-04,2024-10-18,552.08,0,27685,526522587,265443300,0.0140991102438688,99.4613127584591,0.372937293729373
535.4,544,30,86,13500,73960,2024-09-04,2024-10-11,552.08,56,60460,4571203,3254681,1.61795483595894,77.8360969749101,0.817468902109248
334.92,335,9164,9173,27492,73384,2024-09-04,2024-09-20,552.08,9,45892,482984077,286009246,0.01519387563578,99.8292363994435,0.625367927613649
329.49,330,1424,1436,32752,73236,2024-09-04,2024-11-15,552.08,12,40484,416800800,184114755,0.0175709835489759,99.7870488732267,0.552788246217707
397.53,398,1547,1547,40222,72709,2024-09-04,2024-10-18,552.08,0,32487,526522587,265443300,0.0138092841209868,99.4751220425801,0.446808510638298
547.49,560,51,58,37434,72558,2024-09-04,2024-10-11,552.08,7,35124,4571203,3254681,1.58728457257313,79.4233815474832,0.484081700157116
433.07,434,732,761,30744,70773,2024-09-04,2024-10-18,552.08,29,40029,526522587,265443300,0.013441588594185,99.4885636311743,0.565597049722352
335.88,336,5883,5883,76479,70596,2024-09-04,2024-10-18,552.08,0,-5883.00000000003,526522587,265443300,0.0134079718027367,99.501971602977,-0.0833333333333338
319.93,320,10372,10027,20744,70189,2024-09-04,2024-09-20,552.08,-345,49445,482984077,286009246,0.0145323631445515,99.843768762588,0.70445511404921
391.66,392,2045,2045,47035,69530,2024-09-04,2024-10-18,552.08,0,22495,526522587,265443300,0.0132055113525453,99.5151771143296,0.323529411764706
514.91,517.5,170,267,23120,69153,2024-09-04,2024-09-27,552.08,97,46033,91156178,55503910,0.0758621099713066,99.0955445718665,0.665668879152025
520.22,521,875,884,20125,68952,2024-09-04,2024-09-13,552.08,9,48827,70051475,47265620,0.0984304755895575,98.7200098213492,0.708130293537533
553.42,578,21,28,33600,68824,2024-09-04,2024-09-20,552.08,7,35224,482984077,286009246,0.0142497451318669,99.8580185077199,0.51179820992677
528.77,529,2898,2921,14490,67183,2024-09-04,2024-09-06,552.08,23,52693,65864122,49955284,0.102002422502497,97.9265327487399,0.784320438206094
534.73,541,82,107,27306,67089,2024-09-04,2024-10-04,552.08,25,39783,16648106,10098331,0.402982777740603,97.9845515159502,0.592988418369628
344.9,345,6700,6701,20100,67010,2024-09-04,2024-09-20,552.08,1,46910,482984077,286009246,0.0138741633919331,99.8718926711118,0.700044769437397
549.41,574,27,27,41904,66393,2024-09-04,2024-10-18,552.08,0,24489,526522587,265443300,0.0126097154498711,99.5277868297794,0.368849125660838
546.88,563,40,41,32560,66092,2024-09-04,2024-10-11,552.08,1,33532,4571203,3254681,1.44583384286368,80.8692153903469,0.507353386188949
324.82,325,3686,3663,33174,65934,2024-09-04,2024-10-18,552.08,-23,32760,526522587,265443300,0.012522539702556,99.540309369482,0.496860496860497
548.5,564,34,42,26860,65100,2024-09-04,2024-10-04,552.08,8,38240,16648106,10098331,0.391035472743866,98.3755869886941,0.587403993855607
548,569,12,31,17292,65100,2024-09-04,2024-10-18,552.08,19,47808,526522587,265443300,0.0123641419394606,99.5526735114215,0.734377880184332
440.09,441,716,715,37232,65065,2024-09-04,2024-10-18,552.08,-1,27833,526522587,265443300,0.0123574945513211,99.5650310059728,0.427772227772228
483.92,485,405,598,17010,64584,2024-09-04,2024-09-27,552.08,193,47574,91156178,55503910,0.0708498331292477,99.1663944049958,0.736622073578595
536.51,537,1078,1317,10780,64533,2024-09-04,2024-09-06,552.08,239,53753,65864122,49955284,0.0979789877104868,98.0245117364504,0.832953682611997
380.72,381,2297,2297,64316,64316,2024-09-04,2024-10-18,552.08,0,0,526522587,265443300,0.0122152404451359,99.5772462464179,0
542.93,554,5,58,2755,64206,2024-09-04,2024-10-11,552.08,53,61451,4571203,3254681,1.40457555702514,82.2737909473721,0.957091237579042
417.31,418,619,926,21046,63894,2024-09-04,2024-10-18,552.08,307,42848,526522587,265443300,0.0121350919367112,99.5893813383546,0.670610698970169
494.93,495,9204,9103,27612,63721,2024-09-04,2024-09-06,552.08,-101,36109,65864122,49955284,0.0967461465591236,98.1212578830095,0.566673467145839
531.71,532,2343,2166,16401,62814,2024-09-04,2024-09-06,552.08,-177,46413,65864122,49955284,0.0953690690661602,98.2166269520757,0.738895787563282
376.75,377,2505,2505,62625,62625,2024-09-04,2024-10-18,552.08,0,0,526522587,265443300,0.0118940766353106,99.6012754149899,0
294.84,295,3875,3891,23250,62256,2024-09-04,2024-10-18,552.08,16,39006,526522587,265443300,0.0118239941717828,99.6130994091617,0.626542020046261
540.57,551,32,59,17856,61537,2024-09-04,2024-10-11,552.08,27,43681,4571203,3254681,1.34618830097898,83.619979248351,0.709833108536328
558,577,32,32,61760,60800,2024-09-04,2024-09-20,552.08,0,-960,482984077,286009246,0.012588406718841,99.8844810778306,-0.0157894736842105
214.81,215,3117,3192,34287,60648,2024-09-04,2024-12-20,552.08,75,26361,769049161,290977996,0.00788610183530257,99.9202253859555,0.434655718242976
304.74,305,2253,2331,36048,60606,2024-09-04,2024-11-15,552.08,78,24558,416800800,184114755,0.0145407590388502,99.8015896322656,0.405207405207405
543.18,556,6,47,3714,60254,2024-09-04,2024-10-11,552.08,41,56540,4571203,3254681,1.31812129104746,84.9381005393985,0.938360938692867
555.96,571,50,40,54500,60160,2024-09-04,2024-09-13,552.08,-10,5659.99999999999,70051475,47265620,0.085879704888441,98.8058895262377,0.0940824468085105
514.88,515,5007,4988,20028,59856,2024-09-04,2024-09-06,552.08,-19,39828,65864122,49955284,0.0908780048719088,98.3075049569476,0.665396952686447
169.89,170,5792,5425,28960,59675,2024-09-04,2024-12-20,552.08,-367,30715,769049161,290977996,0.00775958196513786,99.9279849679207,0.514704650188521
384.2,385,737,737,37587,58960,2024-09-04,2024-11-15,552.08,0,21373,416800800,184114755,0.0141458461692012,99.8157354784348,0.3625
525.03,529,129,147,17157,58359,2024-09-04,2024-09-27,552.08,18,41202,91156178,55503910,0.0640208938992594,99.230415298895,0.706009355883411
410.3,411,798,832,30324,58240,2024-09-04,2024-10-18,552.08,34,27916,526522587,265443300,0.0110612538641196,99.6241606630259,0.479326923076923
314.79,315,2761,2763,19327,58023,2024-09-04,2024-10-18,552.08,2,38696,526522587,265443300,0.0110200400576547,99.6351807030835,0.666907950295573
552.6,580,20,21,44700,57540,2024-09-04,2024-10-11,552.08,1,12840,4571203,3254681,1.25874961142614,86.1968501508246,0.223149113660063
129.97,130,19169,19179,57507,57537,2024-09-04,2024-12-20,552.08,10,30.0000000000073,769049161,290977996,0.00748157633059299,99.9354665442513,0.000521403618541239
428.13,429,457,659,19651,57333,2024-09-04,2024-10-18,552.08,202,37682,526522587,265443300,0.010888991548619,99.6460696946321,0.657248007255856
484.95,485,11140,11346,33420,56730,2024-09-04,2024-09-06,552.08,206,23310,65864122,49955284,0.0861318700946169,98.3936368270422,0.410893707033316
344.69,345,1822,1822,56482,56482,2024-09-04,2024-11-15,552.08,0,0,416800800,184114755,0.0135513175598511,99.8292867959946,0
339.85,340,3758,3758,45096,56370,2024-09-04,2024-10-18,552.08,0,11274,526522587,265443300,0.0107060934120952,99.6567757880442,0.2
560.63,585,23,23,56051,56051,2024-09-04,2024-09-20,552.08,0,0,482984077,286009246,0.0116051444900946,99.8960862223207,0
547,561,40,40,33800,56000,2024-09-04,2024-10-11,552.08,0,22200,4571203,3254681,1.22506044907653,87.4219105999012,0.396428571428571
550.24,570,329,28,242144,55328,2024-09-04,2024-09-06,552.08,-301,-186816,65864122,49955284,0.0840032453480516,98.4776400723903,-3.37651821862348
388.65,389,1574,1574,34628,55090,2024-09-04,2024-10-18,552.08,0,20462,526522587,265443300,0.0104629889315651,99.6672387769758,0.371428571428571
510.19,512,184,303,13432,54843,2024-09-04,2024-09-27,552.08,119,41411,91156178,55503910,0.0601637773799599,99.290579076275,0.755082690589501
519.85,520,3619,3642,10857,54630,2024-09-04,2024-09-06,552.08,23,43773,65864122,49955284,0.0829434878066089,98.5605835601969,0.801263042284459
269.9,270,5391,5461,21564,54610,2024-09-04,2024-10-18,552.08,70,33046,526522587,265443300,0.0103718247513663,99.6776106017271,0.605127266068486
430.1,431,597,606,24477,54540,2024-09-04,2024-10-18,552.08,9,30063,526522587,265443300,0.0103585299750873,99.6879691317022,0.551210121012101
279.82,280,2888,2986,31768,53748,2024-09-04,2024-11-15,552.08,98,21980,416800800,184114755,0.0128953687229007,99.8421821647175,0.408945449132991
224.78,225,2413,2433,31369,53526,2024-09-04,2024-12-20,552.08,20,22157,769049161,290977996,0.00696002319674854,99.942426567448,0.413948361543923
516.55,519,135,218,14580,53410,2024-09-04,2024-09-27,552.08,83,38830,91156178,55503910,0.0585917500841249,99.3491708263591,0.727017412469575
209.82,210,2904,2924,29040,52632,2024-09-04,2024-12-20,552.08,20,23592,769049161,290977996,0.00684377575180789,99.9492703431998,0.448244414044687
444.47,445,532,991,14896,52523,2024-09-04,2024-09-27,552.08,459,37627,91156178,55503910,0.0576186948074984,99.4067895211666,0.716390914456524
521.03,522,499,536,13972,51992,2024-09-04,2024-09-13,552.08,37,38020,70051475,47265620,0.0742197077220715,98.8801092339597,0.731266348669026
436.08,437,443,563,19935,51796,2024-09-04,2024-10-18,552.08,120,31861,526522587,265443300,0.00983737474495087,99.6978065064472,0.615124720055603
523.91,527.5,159,144,22578,51696,2024-09-04,2024-09-27,552.08,-15,29118,91156178,55503910,0.0567114606318839,99.4635009817985,0.563254410399257
387.39,388,441,840,11907,51240,2024-09-04,2024-10-18,552.08,399,39333,526522587,265443300,0.00973177623622061,99.7075382826834,0.767622950819672
556.54,573,31,31,51026,51026,2024-09-04,2024-11-15,552.08,0,0,416800800,184114755,0.0122422989591191,99.8544244636767,0
544.87,557,11,42,6908,50946,2024-09-04,2024-10-11,552.08,31,44038,4571203,3254681,1.11449874354738,88.5364093434485,0.864405448906686
404.99,405,50634,50634,50634,50634,2024-09-04,2024-09-06,552.08,0,0,65864122,49955284,0.0768764517957136,98.6374600119926,0
515.87,516,3717,3877,14868,50401,2024-09-04,2024-09-06,552.08,160,35533,65864122,49955284,0.0765226931894727,98.7139827051821,0.705005853058471
264.79,265,2377,2390,19016,50190,2024-09-04,2024-11-15,552.08,13,31174,416800800,184114755,0.0120417235283617,99.866466187205,0.621119744969117
374.18,375,606,604,26058,49528,2024-09-04,2024-11-15,552.08,-2,23470,416800800,184114755,0.0118828946585515,99.8783490818636,0.47387336456146
392.67,393,1491,1491,34293,49203,2024-09-04,2024-10-18,552.08,0,14910,526522587,265443300,0.00934489824650201,99.7168831809299,0.303030303030303
493.36,495,117,298,9009,48872,2024-09-04,2024-10-04,552.08,181,39863,16648106,10098331,0.293558918954505,98.6691459076486,0.815661319364872
518.31,519,836,702,20064,48438,2024-09-04,2024-09-13,552.08,-134,28374,70051475,47265620,0.0691462956347457,98.9492555295945,0.585779759692803
264.89,265,4341,4358,17364,47938,2024-09-04,2024-10-18,552.08,17,30574,526522587,265443300,0.00910464264660312,99.7259878235765,0.637782135258042
538.69,548,6,51,2928,47481,2024-09-04,2024-10-11,552.08,45,44553,4571203,3254681,1.03869812826077,89.5751074717093,0.938333228028053
420.13,421,320,544,11200,47328,2024-09-04,2024-10-18,552.08,224,36128,526522587,265443300,0.00898878816760049,99.7349766117441,0.763353617308993
537.15,547,42,48,17598,47280,2024-09-04,2024-10-11,552.08,6,29682,4571203,3254681,1.03430103629176,90.6094085080011,0.627791878172589
331.83,332,2806,2776,28060,47192,2024-09-04,2024-10-18,552.08,-30,19132,526522587,265443300,0.00896295831654417,99.7439395700606,0.405407696219698
413.69,415,347,357,23943,46767,2024-09-04,2024-11-15,552.08,10,22824,416800800,184114755,0.0112204679069714,99.8895695497706,0.488036435948425
369.35,370,717,719,30114,46735,2024-09-04,2024-11-15,552.08,2,16621,416800800,184114755,0.0112127903785213,99.9007823401491,0.355643521985664
139.96,140,11469,11473,22938,45892,2024-09-04,2024-12-20,552.08,4,22954,769049161,290977996,0.00596736884028666,99.9552377120401,0.500174322321973
515.33,516,674,683,14154,45761,2024-09-04,2024-09-13,552.08,9,31607,70051475,47265620,0.065324820069813,99.0145803496643,0.690697318677476
512.35,513,441,704,7938,45760,2024-09-04,2024-09-13,552.08,263,37822,70051475,47265620,0.0653233925481227,99.0799037422124,0.82652972027972
431.06,432,207,485,10764,45590,2024-09-04,2024-10-18,552.08,278,34826,526522587,265443300,0.00865869786513071,99.7525982679258,0.763895591138408
339.95,340,9045,9046,27135,45230,2024-09-04,2024-09-20,552.08,1,18095,482984077,286009246,0.00936469795876935,99.9054509202795,0.400066327658634
474.77,475,1217,1937,14604,44551,2024-09-04,2024-09-13,552.08,720,29947,70051475,47265620,0.0635975188245501,99.143501261037,0.672195910305044
555.26,580,14,18,31920,44532,2024-09-04,2024-09-27,552.08,4,12612,91156178,55503910,0.0488524211710588,99.5123534029696,0.283212072217731
329.74,330,1686,1695,25290,44070,2024-09-04,2024-10-18,552.08,9,18780,526522587,265443300,0.00837001129450122,99.7609682792203,0.426140231449966
558,577,23,23,43700,43700,2024-09-04,2024-11-15,552.08,0,0,416800800,184114755,0.0104846247895877,99.9112669649386,0
509.91,510,4793,4749,14379,42741,2024-09-04,2024-09-06,552.08,-44,28362,65864122,49955284,0.0648926892246434,98.7788753944067,0.663578297185372
304.95,305,8437,8476,16874,42380,2024-09-04,2024-09-20,552.08,39,25506,482984077,286009246,0.00877461639382368,99.9142255366733,0.601840490797546
184.85,185,2767,2795,27670,41925,2024-09-04,2024-12-20,552.08,28,14255,769049161,290977996,0.00545153705719991,99.9606892490973,0.340011926058438
356.8,357,2088,2090,43848,41800,2024-09-04,2024-10-18,552.08,2,-2047.99999999999,526522587,265443300,0.00793888069231112,99.7689071599126,-0.0489952153110046
484.72,485,1269,1489,15228,41692,2024-09-04,2024-09-13,552.08,220,26464,70051475,47265620,0.0595162343119827,99.203017495349,0.634750071956251
558.85,582,18,18,41670,41670,2024-09-04,2024-09-20,552.08,0,0,482984077,286009246,0.00862761361799511,99.9228531502913,0
406.3,407,589,589,20615,41230,2024-09-04,2024-10-18,552.08,0,20615,526522587,265443300,0.00783062322832505,99.7767377831409,0.5
532.23,532.5,1218,1526,7308,41202,2024-09-04,2024-09-06,552.08,308,33894,65864122,49955284,0.0625560604907176,98.8414314548974,0.82262996941896
274.88,275,3384,3405,13536,40860,2024-09-04,2024-10-18,552.08,21,27324,526522587,265443300,0.00776035083942182,99.7844981339803,0.668722466960352
516.33,517,441,609,9261,40803,2024-09-04,2024-09-13,552.08,168,31542,70051475,47265620,0.0582471675293061,99.2612646628783,0.773031394750386
510.32,512.5,116,187,9396,40766,2024-09-04,2024-09-27,552.08,71,31370,91156178,55503910,0.0447210500642096,99.5570744530338,0.769513810528382
343.82,344,2199,2231,43980,40158,2024-09-04,2024-10-18,552.08,32,-3822,526522587,265443300,0.0076270232258811,99.7921251572062,-0.0951740624533094
244.77,245,1702,1719,30636,39537,2024-09-04,2024-12-20,552.08,17,8901,769049161,290977996,0.00514102374789536,99.9658302728452,0.225130890052356
542.6,553,4,38,2532,39520,2024-09-04,2024-10-11,552.08,34,36988,4571203,3254681,0.864542659776868,91.4739511677779,0.935931174089069
555.83,595,0,10,0,39170,2024-09-04,2024-09-27,552.08,10,39170,91156178,55503910,0.0429702087772921,99.6000446618111,1
556.17,570,20,28,28400,38724,2024-09-04,2024-10-04,552.08,8,10324,16648106,10098331,0.232603036045061,98.9017489436937,0.266604689598182
434.93,436,450,356,27900,38092,2024-09-04,2024-10-18,552.08,-94,10192,526522587,265443300,0.00723463740027548,99.7993597946065,0.267562742833141
459.84,460,1388,2374,12492,37984,2024-09-04,2024-09-13,552.08,986,25492,70051475,47265620,0.0542229838843508,99.3154876467626,0.671124684077506
469.78,470,1655,1725,16550,37950,2024-09-04,2024-09-13,552.08,70,21400,70051475,47265620,0.0541744481468806,99.3696620949095,0.563899868247694
326.91,327,4213,4213,37917,37917,2024-09-04,2024-10-18,552.08,0,0,526522587,265443300,0.007201400459578,99.8065611950661,0
516.74,517.5,339,497,7119,37772,2024-09-04,2024-09-13,552.08,158,30653,70051475,47265620,0.0539203492860072,99.4235824441955,0.811527057079318
545.6,559,21,28,14700,37520,2024-09-04,2024-10-11,552.08,7,22820,4571203,3254681,0.820790500881278,92.2947416686592,0.608208955223881
149.96,150,9305,9310,37220,37240,2024-09-04,2024-12-20,552.08,5,20,769049161,290977996,0.00484234323220333,99.9706726160774,0.000537056928034372
537.01,537.5,516,755,4644,36995,2024-09-04,2024-09-06,552.08,239,32351,65864122,49955284,0.0561686679737415,98.8976001228711,0.874469522908501
360.77,361,1559,1558,45211,35834,2024-09-04,2024-10-18,552.08,-1,-9376.99999999999,526522587,265443300,0.00680578590259035,99.8133669809687,-0.261678852486465
511.72,514,171,154,13851,35112,2024-09-04,2024-09-27,552.08,-17,21261,91156178,55503910,0.0385185083121848,99.6385631701233,0.60551948051948
559.94,610,7,7,35042,35042,2024-09-04,2024-11-15,552.08,0,0,416800800,184114755,0.00840737349832342,99.919674338437,0
479.22,480,425,444,17000,34632,2024-09-04,2024-09-27,552.08,19,17632,91156178,55503910,0.0379919395040893,99.6765551096274,0.509124509124509
502.33,505,41,129,6191,34443,2024-09-04,2024-10-11,552.08,88,28252,4571203,3254681,0.753477804420412,93.0482194730796,0.820253752576721
254.75,255,1288,1343,27048,33575,2024-09-04,2024-12-20,552.08,55,6527,769049161,290977996,0.00436578072022629,99.9750383967976,0.194400595681311
416.32,417,493,493,18734,33524,2024-09-04,2024-10-18,552.08,0,14790,526522587,265443300,0.00636705828538368,99.8197340392541,0.441176470588235
194.83,195,1767,1972,15903,33524,2024-09-04,2024-12-20,552.08,205,17621,769049161,290977996,0.00435914915457531,99.9793975459522,0.525623433957762
516.84,517,1956,2061,9780,32976,2024-09-04,2024-09-06,552.08,105,23196,65864122,49955284,0.0500667115854061,98.9476668344566,0.703420669577875
553.6,577,11,14,18689,32760,2024-09-04,2024-10-18,552.08,3,14071,526522587,265443300,0.00622195529856728,99.8259559945526,0.429517704517704
179.86,180,2318,2338,13908,32732,2024-09-04,2024-12-20,552.08,20,18824,769049161,290977996,0.00425616484093661,99.9836537107931,0.5750947085421
554.3,576,15,15,25485,32550,2024-09-04,2024-10-18,552.08,0,7065,526522587,265443300,0.00618207096973031,99.8321380655224,0.21705069124424
259.78,260,1513,1479,13617,32538,2024-09-04,2024-11-15,552.08,-34,18921,416800800,184114755,0.00780660689710768,99.9274809453341,0.581504702194357
506.93,507,4647,4642,18588,32494,2024-09-04,2024-09-06,552.08,-5,13906,65864122,49955284,0.0493349019364443,98.997001736393,0.427955930325599
554.08,579,8,13,14280,32396,2024-09-04,2024-10-18,552.08,5,18116,526522587,265443300,0.00615282246191653,99.8382908879843,0.559204840103716
530.75,531,1431,1294,8586,32350,2024-09-04,2024-09-06,552.08,-137,23764,65864122,49955284,0.0491162700081237,99.0461180064011,0.734590417310665
319.6,320,621,784,11799,31360,2024-09-04,2024-11-15,552.08,163,19561,416800800,184114755,0.00752397788104054,99.9350049232151,0.62375637755102
563.62,720,2,2,31276,31276,2024-09-04,2024-12-20,552.08,0,0,769049161,290977996,0.00406684014313618,99.9877205509363,0
314.97,315,10293,10314,20586,30942,2024-09-04,2024-09-20,552.08,21,10356,482984077,286009246,0.00640642237984173,99.9292595726712,0.334690711654062
407.4,408,515,515,23175,30900,2024-09-04,2024-10-18,552.08,0,7725,526522587,265443300,0.00586869410029697,99.8441595820846,0.25
521.6,522.5,343,341,10976,30690,2024-09-04,2024-09-13,552.08,-2,19714,70051475,47265620,0.0438106406753034,99.4673930848708,0.642359074617139
499.93,500,4247,4379,12741,30653,2024-09-04,2024-09-06,552.08,132,17912,65864122,49955284,0.0465397534639572,99.0926577598651,0.58434737219848
549.49,573,12,13,16560,30563,2024-09-04,2024-10-18,552.08,1,14003,526522587,265443300,0.00580468924878241,99.8499642713333,0.458168373523541
511.37,515,48,84,7392,30492,2024-09-04,2024-10-11,552.08,36,23100,4571203,3254681,0.667045414522173,93.7152648876018,0.757575757575758
425.13,426,488,350,18544,30450,2024-09-04,2024-10-18,552.08,-138,11906,526522587,265443300,0.00578322768136061,99.8557474990147,0.391001642036125
399.72,400,1072,1079,13936,30212,2024-09-04,2024-09-27,552.08,7,16276,91156178,55503910,0.0331431183962101,99.7096982280236,0.538726333907057
527.8,528,1134,1499,5670,29980,2024-09-04,2024-09-06,552.08,365,24310,65864122,49955284,0.0455179528545146,99.1381757127196,0.810873915943963
560.98,620,5,5,29510,29510,2024-09-04,2024-12-20,552.08,0,0,769049161,290977996,0.00383720592863374,99.9915577568649,0
554.76,572,17,17,29308,29308,2024-09-04,2024-11-15,552.08,0,0,416800800,184114755,0.00703165636918163,99.9420365795843,0
549.17,570,10,14,11750,29162,2024-09-04,2024-10-11,552.08,4,17412,4571203,3254681,0.637950228856605,94.3532151164584,0.597078389685207
289.78,290,1189,1292,15457,28424,2024-09-04,2024-11-15,552.08,103,12967,416800800,184114755,0.00681956464574924,99.94885614423,0.456198986771742
478.8,480,198,235,10692,28200,2024-09-04,2024-10-04,552.08,37,17508,16648106,10098331,0.169388637962781,99.0711375816564,0.620851063829787
324.94,325,4696,4690,9392,28140,2024-09-04,2024-09-20,552.08,-6,18748,482984077,286009246,0.00582627903072672,99.9350858517019,0.666240227434257
497.93,498,3893,3923,11679,27461,2024-09-04,2024-09-06,552.08,30,15782,65864122,49955284,0.041693412386185,99.1798691251058,0.5747059466152
488.54,490,76,188,4864,27448,2024-09-04,2024-10-04,552.08,112,22584,16648106,10098331,0.164871607617107,99.2360091892736,0.82279218886622
419.41,420,1,464,27,27376,2024-09-04,2024-10-11,552.08,463,27349,4571203,3254681,0.598879550962843,94.9520946674212,0.999013734658095
533.45,542,15,32,5805,27360,2024-09-04,2024-10-11,552.08,17,21555,4571203,3254681,0.598529533691678,95.5506242011129,0.787828947368421
419.5,420,21,536,546,26800,2024-09-04,2024-10-04,552.08,515,26254,16648106,10098331,0.160979272957536,99.3969884622311,0.979626865671642
294.97,295,8867,8889,17734,26667,2024-09-04,2024-09-20,552.08,22,8933,482984077,286009246,0.00552130003242322,99.9406071517343,0.334983312708591
234.77,235,1144,1149,18304,26427,2024-09-04,2024-12-20,552.08,5,8123.00000000001,769049161,290977996,0.00343632128349725,99.9949940781484,0.307375033110077
522.84,523,1122,1641,4488,26256,2024-09-04,2024-09-06,552.08,519,21768,65864122,49955284,0.0398638882637804,99.2197330133695,0.829067641681901
477.96,478,6540,6540,26160,26160,2024-09-04,2024-09-06,552.08,0,0,65864122,49955284,0.0397181336449,99.2594511470145,0
408.32,409,778,383,25674,26044,2024-09-04,2024-10-18,552.08,-395,370,526522587,265443300,0.0049464164772859,99.860693915492,0.0142067270772539
547.79,565,15,15,13635,25815,2024-09-04,2024-10-11,552.08,0,12180,4571203,3254681,0.564730990944835,96.1153551920578,0.471818710052295
284.86,285,1785,1832,8925,25648,2024-09-04,2024-10-18,552.08,47,16723,526522587,265443300,0.0048712060286219,99.8655651215206,0.652019650655022
552.47,595,4,6,13272,25518,2024-09-04,2024-12-20,552.08,2,12246,769049161,290977996,0.00331812337807102,99.9983122015265,0.479896543616271
434.88,435,2124,2124,23364,25488,2024-09-04,2024-09-13,552.08,0,2124,70051475,47265620,0.0363846728423634,99.5037777577132,0.0833333333333333
556.11,574,25,14,37450,25046,2024-09-04,2024-09-13,552.08,-11,-12404,70051475,47265620,0.0357537082552509,99.5395314659684,-0.495248742314142
403.86,405,212,219,13356,24966,2024-09-04,2024-11-15,552.08,7,11610,416800800,184114755,0.00598991172761664,99.9548460559577,0.465032444124009
553.47,569,159,16,104304,24848,2024-09-04,2024-09-06,552.08,-143,-79456,65864122,49955284,0.037726153853535,99.297177300868,-3.19768190598841
526.8,527,1118,1241,5590,24820,2024-09-04,2024-09-06,552.08,123,19230,65864122,49955284,0.0376836420896949,99.3348609429577,0.77477840451249
479.95,480,5023,4951,15069,24755,2024-09-04,2024-09-06,552.08,-72,9686,65864122,49955284,0.0375849540664947,99.3724458970242,0.39127449000202
424.75,425,883,987,15894,24675,2024-09-04,2024-09-27,552.08,104,8781,91156178,55503910,0.0270689277911586,99.7367671558147,0.355866261398176
340.75,341,979,981,20559,24525,2024-09-04,2024-10-18,552.08,2,3966,526522587,265443300,0.00465791983203182,99.8702230413527,0.1617125382263
508.49,509,465,480,7905,24480,2024-09-04,2024-09-13,552.08,15,16575,70051475,47265620,0.0349457309785411,99.574477196947,0.677083333333333
279.88,280,2029,2029,10145,24348,2024-09-04,2024-10-18,552.08,0,14203,526522587,265443300,0.00462430304058352,99.8748473443932,0.583333333333333
554.8,595,5,6,16880,24120,2024-09-04,2024-11-15,552.08,1,7240,416800800,184114755,0.00578693706921868,99.9606329930269,0.30016583747927
423.15,424,321,281,11877,23885,2024-09-04,2024-10-18,552.08,-40,12008,526522587,265443300,0.00453636759176677,99.879383711985,0.502742306887168
517.37,518,384,372,9600,23436,2024-09-04,2024-09-13,552.08,-12,13836,70051475,47265620,0.0334553983338681,99.6079325952808,0.590373783922171
333.84,334,1472,1462,13248,23392,2024-09-04,2024-10-18,552.08,-10,10144,526522587,265443300,0.0044427343816876,99.8838264463667,0.433652530779754
422.12,423,267,264,9345,23232,2024-09-04,2024-10-18,552.08,-3,13887,526522587,265443300,0.00441234632162134,99.8882387926883,0.597753099173554
334.66,335,609,683,14616,23222,2024-09-04,2024-11-15,552.08,74,8606,416800800,184114755,0.00557148642708939,99.966204479454,0.370596847816726
394.89,395,2080,2095,27040,23045,2024-09-04,2024-09-27,552.08,15,-3995,91156178,55503910,0.0252807878803343,99.7620479436951,-0.173356476459102
449.86,450,1594,1614,14346,22596,2024-09-04,2024-09-13,552.08,20,8250,70051475,47265620,0.0322562801140162,99.6401888753948,0.365108868826341
354.61,355,574,574,18368,22386,2024-09-04,2024-11-15,552.08,0,4018,416800800,184114755,0.00537091099633206,99.9715753904503,0.17948717948718
554.77,575,9,11,13743,22253,2024-09-04,2024-09-27,552.08,2,8510,91156178,55503910,0.0244119493469768,99.786459893042,0.382420347818272
367.65,368,631,631,10727,22085,2024-09-04,2024-10-18,552.08,0,11358,526522587,265443300,0.00419450191602132,99.8924332946043,0.514285714285714
548.95,569,8,11,8488,22055,2024-09-04,2024-10-04,552.08,3,13567,16648106,10098331,0.132477532279047,99.5294659945101,0.615143958286103
309.62,310,584,579,11096,22002,2024-09-04,2024-11-15,552.08,-5,10906,416800800,184114755,0.00527878065493156,99.9768541711052,0.495682210708118
492.71,495,51,96,5304,21984,2024-09-04,2024-10-11,552.08,45,16680,4571203,3254681,0.480923730580331,96.5962789226381,0.758733624454148
402.71,403,754,757,20358,21953,2024-09-04,2024-10-18,552.08,3,1595,526522587,265443300,0.00416943176646665,99.8966027263708,0.0726552179656537
390.77,391,946,946,21758,21758,2024-09-04,2024-10-18,552.08,0,0,526522587,265443300,0.00413239631826089,99.9007351226891,0
401.69,402,696,696,21576,21576,2024-09-04,2024-10-18,552.08,0,0,526522587,265443300,0.00409782989993552,99.904832952589,0
550.93,564,18,16,15300,20912,2024-09-04,2024-10-11,552.08,-2,5612,4571203,3254681,0.457472573412294,97.0537514960504,0.268362662586075
384.46,385,373,387,10444,20898,2024-09-04,2024-10-18,552.08,14,10454,526522587,265443300,0.00396906049540473,99.9088020130844,0.5002392573452
551.28,566,14,14,12166,20608,2024-09-04,2024-10-04,552.08,0,8442,16648106,10098331,0.123785852877198,99.6532518473873,0.409646739130435
513.9,514,1932,2052,7728,20520,2024-09-04,2024-09-06,552.08,120,12792,65864122,49955284,0.0311550497856785,99.4036009468099,0.623391812865497
264.98,265,10057,10255,10057,20510,2024-09-04,2024-09-20,552.08,198,10453,482984077,286009246,0.00424651680597744,99.9448536685403,0.509653827401268
374.62,375,510,538,7650,20444,2024-09-04,2024-10-11,552.08,28,12794,4571203,3254681,0.447234568230726,97.5009860642811,0.625807082762669
550.62,573,18,9,18270,20142,2024-09-04,2024-09-13,552.08,-9,1872,70051475,47265620,0.0287531418860202,99.6689420172809,0.0929401251117069
520.82,521,1171,1100,5855,19800,2024-09-04,2024-09-06,552.08,-71,13945,65864122,49955284,0.0300618901440757,99.4336628369539,0.704292929292929
344.82,345,1044,1094,12528,19692,2024-09-04,2024-10-18,552.08,50,7164,526522587,265443300,0.00374001049265528,99.9125420235771,0.363802559414991
284.76,285,782,815,9384,19560,2024-09-04,2024-11-15,552.08,33,10176,416800800,184114755,0.00469288926508778,99.9815470603703,0.520245398773006
365.66,366,563,563,16890,19142,2024-09-04,2024-10-18,552.08,0,2252,526522587,265443300,0.0036355515361775,99.9161775751132,0.117647058823529
552.21,600,4,4,14640,19116,2024-09-04,2024-09-13,552.08,0,4476,70051475,47265620,0.0272885046317726,99.6962305219126,0.234149403640929
512.88,513,1594,1590,6376,19080,2024-09-04,2024-09-06,552.08,-4,12704,65864122,49955284,0.028968730502473,99.4626315674564,0.665828092243187
439.93,440,2716,2717,19012,19019,2024-09-04,2024-09-13,552.08,1,7.00000000000364,70051475,47265620,0.0271500350278135,99.7233805569405,0.000368052999632138
429.9,430,2688,1898,13440,18980,2024-09-04,2024-09-13,552.08,-790,5540,70051475,47265620,0.0270943616818918,99.7504749186223,0.291886195995785
419.9,420,1852,1897,9260,18970,2024-09-04,2024-09-13,552.08,45,9710,70051475,47265620,0.0270800864649888,99.7775550050874,0.511860832894043
558.39,590,5,6,13450,18966,2024-09-04,2024-09-27,552.08,1,5516,91156178,55503910,0.0208060500298729,99.8072659430719,0.290836233259517
289.85,290,1255,1260,5020,18900,2024-09-04,2024-10-18,552.08,5,13880,526522587,265443300,0.00358958959532727,99.9197671647086,0.734391534391534
454.48,455,331,363,8606,18876,2024-09-04,2024-09-27,552.08,32,10270,91156178,55503910,0.020707318378355,99.8279732614503,0.544077134986226
559.25,578,10,10,18750,18750,2024-09-04,2024-09-27,552.08,0,0,91156178,55503910,0.0205690940662299,99.8485423555165,0
309.97,310,6152,6172,6152,18516,2024-09-04,2024-09-20,552.08,20,12364,482984077,286009246,0.00383366675667861,99.948687335297,0.667746813566645
559.4,590,6,6,18360,18360,2024-09-04,2024-09-06,552.08,0,0,65864122,49955284,0.0278755708608702,99.4905071383173,0
377.72,378,648,648,18144,18144,2024-09-04,2024-10-18,552.08,0,0,526522587,265443300,0.00344600601151419,99.9232131707201,0
513.36,514,272,280,5984,17920,2024-09-04,2024-09-13,552.08,8,11936,70051475,47265620,0.0255811886901739,99.8031361937775,0.666071428571429
517.86,518,1260,1269,6300,17766,2024-09-04,2024-09-06,552.08,9,11466,65864122,49955284,0.0269737141565479,99.5174808524738,0.645390070921986
269.81,270,889,931,8890,17689,2024-09-04,2024-11-15,552.08,42,8799,416800800,184114755,0.00424399377352443,99.9857910541439,0.497427779976256
444.89,445,1595,1607,11165,17677,2024-09-04,2024-09-13,552.08,12,6512,70051475,47265620,0.025234300919431,99.8283704946969,0.368388301182327
319.82,320,932,977,6524,17586,2024-09-04,2024-10-18,552.08,45,11062,526522587,265443300,0.00334002765203309,99.9265531983721,0.629023086546116
521.86,522,1257,1250,5028,17500,2024-09-04,2024-09-06,552.08,-7,12472,65864122,49955284,0.0265698524000669,99.5440507048739,0.712685714285714
419.99,420,17463,17459,17463,17459,2024-09-04,2024-09-06,552.08,-4,-4,65864122,49955284,0.0265076030315868,99.5705583079055,-0.000229108196345724
249.98,250,8327,8657,8327,17314,2024-09-04,2024-09-20,552.08,330,8987,482984077,286009246,0.00358479726858573,99.9522721325656,0.519059720457433
352.76,353,721,721,10815,17304,2024-09-04,2024-10-18,552.08,0,6489,526522587,265443300,0.00328646869616631,99.9298396670683,0.375
396.75,397,688,688,17200,17200,2024-09-04,2024-10-18,552.08,0,0,526522587,265443300,0.00326671645712323,99.9331063835254,0
550.6,585,5,5,13820,17200,2024-09-04,2024-11-15,552.08,0,3380,416800800,184114755,0.00412667154189723,99.9899177256857,0.196511627906977
555.63,590,9,5,23850,17185,2024-09-04,2024-09-20,552.08,-4,-6665,482984077,286009246,0.00355808831354082,99.9558302208791,-0.38783823101542
393.66,394,505,505,14140,17170,2024-09-04,2024-10-18,552.08,0,3030,526522587,265443300,0.00326101869586081,99.9363674022213,0.176470588235294
507.15,507.5,489,489,9780,17115,2024-09-04,2024-09-13,552.08,0,7335,70051475,47265620,0.0244320337294825,99.8528025284264,0.428571428571428
551.34,568,2,10,1840,16660,2024-09-04,2024-09-27,552.08,8,14820,91156178,55503910,0.0182763257143142,99.8668186812308,0.889555822328932
557.6,576,9,9,16560,16560,2024-09-04,2024-09-20,552.08,0,0,482984077,286009246,0.00342868446157905,99.9592589053407,0
279.97,280,5342,5348,5342,16044,2024-09-04,2024-09-20,552.08,6,10702,482984077,286009246,0.00332184864139941,99.9625807539821,0.667040638244827
505.92,506,2006,2003,6018,16024,2024-09-04,2024-09-06,552.08,-3,10006,65864122,49955284,0.0243288751347813,99.5948871830403,0.624438342486271
555,595,6,4,18798,16000,2024-09-04,2024-10-18,552.08,-2,-2798,526522587,265443300,0.00303880600662627,99.9394062082279,-0.174875
518.9,519,1599,1598,7995,15980,2024-09-04,2024-09-06,552.08,-1,7985,65864122,49955284,0.0242620709344611,99.6191492539747,0.499687108886108
259.97,260,5187,5218,5187,15654,2024-09-04,2024-09-20,552.08,31,10467,482984077,286009246,0.00324110063777527,99.9658218546199,0.668646991184362
371.73,372,577,577,19618,15579,2024-09-04,2024-10-18,552.08,0,-4039,526522587,265443300,0.00295884742357691,99.9423650556515,-0.259259259259259
381.56,382,354,354,7434,15576,2024-09-04,2024-10-18,552.08,0,8142,526522587,265443300,0.00295827764745067,99.9453233332989,0.522727272727273
478.47,480,15,99,1035,15147,2024-09-04,2024-10-11,552.08,84,14112,4571203,3254681,0.331356975395755,97.8323430396769,0.931669637551991
370.58,371,361,359,11913,15078,2024-09-04,2024-10-18,552.08,-2,3165,526522587,265443300,0.00286369481049443,99.9481870281094,0.209908475925189
357.8,358,750,751,11250,15020,2024-09-04,2024-10-18,552.08,1,3770,526522587,265443300,0.00285267913872041,99.9510397072481,0.250998668442077
364.78,365,666,672,11322,14784,2024-09-04,2024-10-18,552.08,6,3462,526522587,265443300,0.00280785675012267,99.9538475639982,0.234172077922078
439.63,440,167,393,3507,14541,2024-09-04,2024-09-27,552.08,226,11034,91156178,55503910,0.0159517438302426,99.8827704250611,0.758819888590881
404.75,405,532,569,6384,14225,2024-09-04,2024-09-27,552.08,37,7841,91156178,55503910,0.0156050860315798,99.8983755110926,0.551212653778559
550.72,571,8,7,12608,14196,2024-09-04,2024-10-18,552.08,-1,1588,526522587,265443300,0.00269618062937915,99.9565437446276,0.111862496477881
418.48,419,271,268,10569,13936,2024-09-04,2024-10-18,552.08,-3,3367,526522587,265443300,0.00264680003177148,99.9591905446594,0.24160447761194
385.53,386,295,292,7670,13724,2024-09-04,2024-10-18,552.08,-3,6054,526522587,265443300,0.00260653585218368,99.9617970805116,0.441125036432527
511.89,512,1286,1244,5144,13684,2024-09-04,2024-09-06,552.08,-42,8540,65864122,49955284,0.0207761062995723,99.6399253602743,0.624086524408068
274.97,275,4559,4558,4559,13674,2024-09-04,2024-09-20,552.08,-1,9115,482984077,286009246,0.00283114923476038,99.9686530038546,0.666593535176247
510.9,511,1208,1362,4832,13620,2024-09-04,2024-09-06,552.08,154,8788,65864122,49955284,0.0206789365536521,99.6606042968279,0.645227606461087
475.96,476,3216,3405,9648,13620,2024-09-04,2024-09-06,552.08,189,3972,65864122,49955284,0.0206789365536521,99.6812832333816,0.291629955947137
559.69,572,11,11,13541,13541,2024-09-04,2024-10-11,552.08,0,0,4571203,3254681,0.296223991802596,98.1285670314795,0
458.83,460,61,114,2989,13338,2024-09-04,2024-10-11,552.08,53,10349,4571203,3254681,0.291783147674693,98.4203501791542,0.775903433798171
555.87,600,3,3,12294,13239,2024-09-04,2024-09-27,552.08,0,945.000000000002,91156178,55503910,0.0145234259382836,99.9128989370309,0.0713800135961932
511.7,512,438,438,9198,13140,2024-09-04,2024-09-13,552.08,0,3942,70051475,47265620,0.0187576350105405,99.871560163437,0.3
325.74,326,602,501,5418,13026,2024-09-04,2024-10-18,552.08,-101,7608,526522587,265443300,0.00247396794014461,99.9642710484517,0.584062643942883
159.96,160,3245,3245,16225,12980,2024-09-04,2024-12-20,552.08,0,-3245,769049161,290977996,0.00168779847352307,100,-0.25
244.98,245,6309,6429,6309,12858,2024-09-04,2024-09-20,552.08,120,6549,482984077,286009246,0.0026621995656391,99.9713152034203,0.50933271115259
149.99,150,12841,12841,12841,12841,2024-09-04,2024-09-20,552.08,0,0,482984077,286009246,0.00265867978086574,99.9739738832011,0
557.95,600,3,3,12615,12615,2024-09-04,2024-10-18,552.08,0,0,526522587,265443300,0.0023959086108494,99.9666669570626,0
552.24,566,8,9,9144,12384,2024-09-04,2024-10-11,552.08,1,3240,4571203,3254681,0.270913367881496,98.6912635470357,0.261627906976744
383.8,384,617,617,12340,12340,2024-09-04,2024-10-18,552.08,0,0,526522587,265443300,0.00234367913261051,99.9690106361952,0
489.94,490,1801,2036,5403,12216,2024-09-04,2024-09-06,552.08,235,6813,65864122,49955284,0.0185472752525267,99.6998305086341,0.557711198428291
368.59,369,295,295,5310,12095,2024-09-04,2024-10-18,552.08,0,6785,526522587,265443300,0.00229714741563404,99.9713077836108,0.560975609756098
369.96,370,2000,3005,2000,12020,2024-09-04,2024-09-13,552.08,1005,10020,70051475,47265620,0.0171588107174046,99.8887189741544,0.833610648918469
314.55,315,249,255,5727,11475,2024-09-04,2024-11-15,552.08,6,5748,416800800,184114755,0.00275311371763202,99.9926708394034,0.500915032679739
511.88,512.5,166,178,3154,11036,2024-09-04,2024-09-13,552.08,12,7882,70051475,47265620,0.0157541293741495,99.9044731035285,0.714208046393621
224.99,225,11011,11011,11011,11011,2024-09-04,2024-09-20,552.08,0,0,482984077,286009246,0.00227978530232168,99.9762536685034,0
389.96,390,2752,2752,11008,11008,2024-09-04,2024-09-06,552.08,0,0,65864122,49955284,0.0167131962982821,99.7165437049324,0
274.81,275,516,566,5160,10754,2024-09-04,2024-11-15,552.08,50,5594,416800800,184114755,0.00258012940474203,99.9952509688081,0.520178538218337
379.69,380,283,340,3396,10540,2024-09-04,2024-10-04,552.08,57,7144,16648106,10098331,0.0633105051109117,99.7165623524982,0.677798861480076
468.99,470,73,102,3285,10302,2024-09-04,2024-10-04,552.08,29,7017,16648106,10098331,0.0618809130600202,99.7784432655583,0.681129877693652
323.81,324,506,536,4554,10184,2024-09-04,2024-10-18,552.08,30,5630,526522587,265443300,0.00193420002321762,99.973241983634,0.552827965435978
487.87,490,15,47,1305,10011,2024-09-04,2024-10-11,552.08,32,8706,4571203,3254681,0.219001431351878,98.9102649783875,0.869643392268505
561,660,1,1,9900,9900,2024-09-04,2024-09-27,552.08,0,0,91156178,55503910,0.0108604816669694,99.9237594186979,0
554.21,574,5,5,6185,9895,2024-09-04,2024-09-20,552.08,0,3710,482984077,286009246,0.00204872178425874,99.9783023902877,0.374936836786256
328.79,329,465,467,4185,9807,2024-09-04,2024-10-18,552.08,2,5622,526522587,265443300,0.00186259815668649,99.9751045817907,0.573263995105537
289.96,290,2362,2449,2362,9796,2024-09-04,2024-09-20,552.08,87,7434,482984077,286009246,0.00202822421410799,99.9803306145018,0.7588811759902
507.55,508,247,217,4446,9765,2024-09-04,2024-09-13,552.08,-30,5319,70051475,47265620,0.0139397493057784,99.9184128528343,0.544700460829493
532.4,620,1,1,8760,8760,2024-09-04,2024-11-15,552.08,0,0,416800800,184114755,0.00210172341319882,99.9973526922213,0
363.62,364,226,227,4746,8626,2024-09-04,2024-10-18,552.08,1,3880,526522587,265443300,0.00163829628832238,99.976742878079,0.449802921400417
507.89,508,757,758,2271,8338,2024-09-04,2024-09-06,552.08,1,6067,65864122,49955284,0.0126593959606719,99.7292031008931,0.72763252578556
464.41,465,124,141,3968,8319,2024-09-04,2024-09-27,552.08,17,4351,91156178,55503910,0.0091260956553049,99.9328855143532,0.523019593701166
361.79,362,391,394,5865,8274,2024-09-04,2024-10-18,552.08,3,2409,526522587,265443300,0.00157144255617661,99.9783143206352,0.291153009427121
332.83,333,469,469,4690,7973,2024-09-04,2024-10-18,552.08,0,3283,526522587,265443300,0.00151427501817695,99.9798285956534,0.411764705882353
214.99,215,7954,7954,7954,7954,2024-09-04,2024-09-20,552.08,0,0,482984077,286009246,0.00164684518160627,99.9819774596834,0
560.81,600,2,2,7838,7838,2024-09-04,2024-09-20,552.08,0,0,482984077,286009246,0.00162282782668216,99.9836002875101,0
334.88,335,645,649,7740,7788,2024-09-04,2024-10-18,552.08,4,48.0000000000009,526522587,265443300,0.00147913882372533,99.9813077344771,0.00616332819722662
476.97,477,1978,2579,5934,7737,2024-09-04,2024-09-06,552.08,601,1803,65864122,49955284,0.0117469113153896,99.7409500122085,0.233036060488561
555.51,581,2,3,3770,7647,2024-09-04,2024-09-20,552.08,1,3877,482984077,286009246,0.00158328200952265,99.9851835695196,0.506996207663136
379.95,380,1515,1518,3030,7590,2024-09-04,2024-09-13,552.08,3,4560,70051475,47265620,0.0108348896293761,99.9292477424637,0.600790513833992
359.9,360,534,745,3204,7450,2024-09-04,2024-09-27,552.08,211,4246,91156178,55503910,0.00817278670898203,99.9410583010622,0.56993288590604
259.92,260,753,926,1506,7408,2024-09-04,2024-10-18,552.08,173,5902,526522587,265443300,0.00140696718106796,99.9827147016582,0.79670626349892
501.93,502,1054,1057,3162,7399,2024-09-04,2024-09-06,552.08,3,4237,65864122,49955284,0.0112337335947483,99.7521837458032,0.572644952020544
508.91,509,822,821,3288,7389,2024-09-04,2024-09-06,552.08,-1,4101,65864122,49955284,0.0112185508219483,99.7634022966252,0.555014210312627
556.4,630,2,1,15222,7360,2024-09-04,2024-09-27,552.08,-1,-7862,91156178,55503910,0.00807405505746412,99.9491323561196,-1.06820652173913
550.65,569,4,4,4220,7340,2024-09-04,2024-09-27,552.08,0,3120,91156178,55503910,0.00805211469046015,99.9571844708101,0.425068119891008
429.56,430,166,165,2822,7260,2024-09-04,2024-09-27,552.08,-1,4438,91156178,55503910,0.00796435322244423,99.9651488240325,0.61129476584022
354.77,355,315,314,5985,7222,2024-09-04,2024-10-18,552.08,-1,1237,526522587,265443300,0.00137164106124093,99.9840863427194,0.171282193298255
209.99,210,7182,7182,7182,7182,2024-09-04,2024-09-20,552.08,0,0,482984077,286009246,0.00148700554366309,99.9866705750633,0
551.5,575,5,3,6665,7050,2024-09-04,2024-09-06,552.08,-2,384.999999999999,65864122,49955284,0.010703854824027,99.7741061514492,0.0546099290780141
552.75,576,6,3,7680,6975,2024-09-04,2024-09-13,552.08,-3,-705.000000000001,70051475,47265620,0.00995696378984168,99.9392047062535,-0.101075268817204
154.99,155,6822,6822,6822,6822,2024-09-04,2024-09-20,552.08,0,0,482984077,286009246,0.00141246892493311,99.9880830439882,0
473.58,475,20,48,1280,6816,2024-09-04,2024-10-11,552.08,28,5536,4571203,3254681,0.149107357516172,99.0593723359037,0.812206572769953
350.82,351,376,376,6768,6768,2024-09-04,2024-10-18,552.08,0,0,526522587,265443300,0.00128541494080291,99.9853717576602,0
453.94,455,57,63,2964,6678,2024-09-04,2024-10-11,552.08,6,3714,4571203,3254681,0.146088458552377,99.2054607944561,0.556154537286613
448.96,450,48,63,2160,6552,2024-09-04,2024-10-11,552.08,15,4392,4571203,3254681,0.143332072541954,99.348792866998,0.67032967032967
337.83,338,379,379,4927,6443,2024-09-04,2024-10-18,552.08,0,1516,526522587,265443300,0.00122368919379331,99.986595446854,0.235294117647059
359.97,360,2084,2101,4168,6303,2024-09-04,2024-09-13,552.08,17,2135,70051475,47265620,0.00899766921396016,99.9482023754675,0.338727590036491
399.97,400,2088,2083,8352,6249,2024-09-04,2024-09-13,552.08,-5,-2103,70051475,47265620,0.00892058304268397,99.9571229585102,-0.336533845415267
362.78,363,283,283,6226,6226,2024-09-04,2024-10-18,552.08,0,0,526522587,265443300,0.00118247538732845,99.9877779222414,0
459.97,460,2032,2033,4064,6099,2024-09-04,2024-09-06,552.08,1,2035,65864122,49955284,0.00925997313074332,99.7833661245799,0.333661255943597
552.7,573,25,3,24400,6090,2024-09-04,2024-09-06,552.08,-22,-18310,65864122,49955284,0.00924630863522329,99.7926124332152,-3.00656814449918
463.83,465,35,52,1995,6084,2024-09-04,2024-10-11,552.08,17,4089,4571203,3254681,0.133094067360386,99.4818869343584,0.672090729783038
483.1,485,16,32,1200,6080,2024-09-04,2024-10-11,552.08,16,4880,4571203,3254681,0.133006563042595,99.614893497401,0.802631578947369
557.74,578,3,3,6078,6078,2024-09-04,2024-11-15,552.08,0,0,416800800,184114755,0.00145825055997973,99.9988109427813,0
468.96,469,1474,1467,2948,5868,2024-09-04,2024-09-06,552.08,-7,2920,65864122,49955284,0.00890925107906244,99.8015216842942,0.497614178595774
199.99,200,5732,5732,5732,5732,2024-09-04,2024-09-20,552.08,0,0,482984077,286009246,0.00118678860711178,99.9892698325953,0
382.68,383,176,176,4224,5632,2024-09-04,2024-10-18,552.08,0,1408,526522587,265443300,0.00106965971433245,99.9888475819557,0.25
498.95,499,1011,1104,3033,5520,2024-09-04,2024-09-06,552.08,93,2487,65864122,49955284,0.00838089058562111,99.8099025748798,0.45054347826087
284.98,285,2684,2694,2684,5388,2024-09-04,2024-09-20,552.08,10,2704,482984077,286009246,0.00111556472699202,99.9903853973223,0.501855976243504
239.99,240,5309,5309,5309,5309,2024-09-04,2024-09-20,552.08,0,0,482984077,286009246,0.00109920808010406,99.9914846054024,0
490.93,491,751,757,2253,5299,2024-09-04,2024-09-06,552.08,6,3046,65864122,49955284,0.00804535130674026,99.8179479261866,0.574825438762031
254.98,255,2642,2644,2642,5288,2024-09-04,2024-09-20,552.08,2,2646,482984077,286009246,0.00109486011067814,99.9925794655131,0.500378214826021
553.5,571,37,3,28527,5250,2024-09-04,2024-09-06,552.08,-34,-23277,65864122,49955284,0.00797095572002007,99.8259188819066,-4.43371428571429
389.87,390,400,403,4400,5239,2024-09-04,2024-09-27,552.08,3,839,91156178,55503910,0.00574727913669219,99.9708961031692,0.160145065852262
384.9,385,517,519,7238,5190,2024-09-04,2024-09-27,552.08,2,-2048,91156178,55503910,0.00569352523753245,99.9765896284068,-0.394605009633911
510.61,511,131,132,2620,5148,2024-09-04,2024-09-13,552.08,1,2528,70051475,47265620,0.0073488816616638,99.9644718401718,0.491064491064491
469.96,470,1269,1280,2538,5120,2024-09-04,2024-09-06,552.08,11,2582,65864122,49955284,0.00777357967361958,99.8336924615802,0.504296875
269.99,270,5109,5109,5109,5109,2024-09-04,2024-09-20,552.08,0,0,482984077,286009246,0.00105779884747629,99.9936372643606,0
444.98,445,2502,2547,5004,5094,2024-09-04,2024-09-06,552.08,45,90,65864122,49955284,0.00773410446433948,99.8414265660446,0.0176678445229682
468.63,470,0,37,0,5069,2024-09-04,2024-10-11,552.08,37,5069,4571203,3254681,0.110889846720874,99.7257833441219,1
503.95,504,1011,1013,5055,5065,2024-09-04,2024-09-06,552.08,2,10.0000000000009,65864122,49955284,0.00769007442321937,99.8491166404678,0.00197433366238912
327.8,328,259,249,3367,4980,2024-09-04,2024-10-18,552.08,-10,1613,526522587,265443300,0.000945828369562425,99.9897934103253,0.323895582329317
338.83,339,275,276,3575,4692,2024-09-04,2024-10-18,552.08,1,1117,526522587,265443300,0.000891129861443152,99.9906845401867,0.238064791133845
346.81,347,245,245,3185,4655,2024-09-04,2024-10-18,552.08,0,1470,526522587,265443300,0.000884102622552829,99.9915686428093,0.315789473684211
355.77,356,202,202,4646,4646,2024-09-04,2024-10-18,552.08,0,0,526522587,265443300,0.000882393294174102,99.9924510361034,0
473.92,475,31,43,1519,4644,2024-09-04,2024-10-04,552.08,12,3125,16648106,10098331,0.0278950650602537,99.8063383306185,0.6729112833764
552.65,568,0,3,0,4605,2024-09-04,2024-10-04,552.08,3,4605,16648106,10098331,0.0276608041779648,99.8339991347965,1
348.81,349,222,242,4884,4598,2024-09-04,2024-10-18,552.08,20,-286,526522587,265443300,0.000873276876154223,99.9933243129796,-0.062200956937799
500.94,501,701,760,2804,4560,2024-09-04,2024-09-06,552.08,59,1756,65864122,49955284,0.00692334439681744,99.8560399848646,0.385087719298246
557,572,90,3,75960,4500,2024-09-04,2024-09-06,552.08,-87,-71460,65864122,49955284,0.00683224776001721,99.8628722326246,-15.88
555,600,0,1,0,4500,2024-09-04,2024-10-11,552.08,1,4500,4571203,3254681,0.0984423575150786,99.824225701637,1
386.7,387,144,144,3024,4320,2024-09-04,2024-10-18,552.08,0,1296,526522587,265443300,0.000820477621789091,99.9941447906014,0.3
372.74,373,166,166,3320,4316,2024-09-04,2024-10-18,552.08,0,996,526522587,265443300,0.000819717920287435,99.9949645085217,0.230769230769231
234.99,235,4146,4210,4146,4210,2024-09-04,2024-09-20,552.08,64,64,482984077,286009246,0.000871664346814481,99.9945089287074,0.0152019002375297
174.99,175,4064,4064,4064,4064,2024-09-04,2024-09-20,552.08,0,0,482984077,286009246,0.000841435606996212,99.9953503643144,0
347.87,348,309,309,4017,4017,2024-09-04,2024-10-18,552.08,0,0,526522587,265443300,0.000762930233038607,99.9957274387547,0
409.69,410,128,129,1792,3999,2024-09-04,2024-09-27,552.08,1,2207,91156178,55503910,0.00438697638244552,99.9809766047892,0.551887971992998
341.89,342,359,359,3949,3949,2024-09-04,2024-10-18,552.08,0,0,526522587,265443300,0.000750015307510445,99.9964774540622,0
467.93,468,562,562,3934,3934,2024-09-04,2024-09-06,552.08,0,0,65864122,49955284,0.00597290281953504,99.8688451354442,0
389.98,390,1943,1943,5829,3886,2024-09-04,2024-09-13,552.08,0,-1943,70051475,47265620,0.00554734928850535,99.9700191894603,-0.5
345.88,346,319,319,3828,3828,2024-09-04,2024-10-18,552.08,0,0,526522587,265443300,0.000727034337085334,99.9972044883993,0
439.37,440,21,59,651,3717,2024-09-04,2024-10-04,552.08,38,3066,16648106,10098331,0.022326864088924,99.8563259988854,0.824858757062147
434.52,435,78,77,1638,3696,2024-09-04,2024-09-27,552.08,-1,2058,91156178,55503910,0.00405457982233524,99.9850311846115,0.556818181818182
561.88,580,2,2,3624,3624,2024-09-04,2024-09-13,552.08,0,0,70051475,47265620,0.00517333860564678,99.975192528066,0
463.96,464,892,892,2676,3568,2024-09-04,2024-09-06,552.08,0,892,65864122,49955284,0.00541721333505364,99.8742623487792,0.25
374.79,375,89,169,712,3549,2024-09-04,2024-09-27,552.08,80,2837,91156178,55503910,0.003893318124856,99.9889245027364,0.799380107072415
330.87,331,269,269,3497,3497,2024-09-04,2024-10-18,552.08,0,0,526522587,265443300,0.000664169037823253,99.9978686574371,0
179.99,180,3443,3443,3443,3443,2024-09-04,2024-09-20,552.08,0,0,482984077,286009246,0.000712859939686997,99.9960632242541,0
478.96,479,834,834,3336,3336,2024-09-04,2024-09-06,552.08,0,0,65864122,49955284,0.00506497300609276,99.8793273217853,0
491.96,492,827,826,2481,3304,2024-09-04,2024-09-06,552.08,-1,823,65864122,49955284,0.00501638813313263,99.8843437099184,0.24909200968523
556.5,573,2,2,2700,3300,2024-09-04,2024-10-04,552.08,0,600,16648106,10098331,0.019822074655219,99.8761480735406,0.181818181818182
558.96,575,2,2,3208,3208,2024-09-04,2024-10-04,552.08,0,0,16648106,10098331,0.0192694592405887,99.8954175327812,0
384.98,385,1596,1596,3192,3192,2024-09-04,2024-09-13,552.08,0,0,70051475,47265620,0.00455664923543723,99.9797491773014,0
409.91,410,306,347,1224,3123,2024-09-04,2024-09-13,552.08,41,1899,70051475,47265620,0.00445815023880653,99.9842073275402,0.60806916426513
219.99,220,3073,3073,3073,3073,2024-09-04,2024-09-20,552.08,0,0,482984077,286009246,0.000636252859325629,99.9966994771134,0
470.95,471,585,585,2925,2925,2024-09-04,2024-09-06,552.08,0,0,65864122,49955284,0.00444096104401118,99.8887846709624,0
204.98,205,1454,1454,2908,2908,2024-09-04,2024-09-20,552.08,0,0,482984077,286009246,0.000602090242407722,99.9973015673558,0
556.1,585,1,1,2200,2890,2024-09-04,2024-10-04,552.08,0,690,16648106,10098331,0.0173593320465403,99.9127768648277,0.238754325259516
496.95,497,559,564,2236,2820,2024-09-04,2024-09-06,552.08,5,584,65864122,49955284,0.00428154192961078,99.8930662128921,0.20709219858156
342.8,343,133,133,2660,2660,2024-09-04,2024-10-18,552.08,0,0,526522587,265443300,0.000505201498601617,99.9983738589357,0
336.8,337,132,132,2640,2640,2024-09-04,2024-10-18,552.08,0,0,526522587,265443300,0.000501402991093334,99.9988752619268,0
399.6,400,41,65,656,2600,2024-09-04,2024-10-04,552.08,24,1944,16648106,10098331,0.0156173921525968,99.9283942569804,0.747692307692308
553.17,579,2,1,4222,2583,2024-09-04,2024-11-15,552.08,-1,-1639,416800800,184114755,0.000619720499576776,99.9994306632809,-0.634533488192025
229.99,230,2429,2570,2429,2570,2024-09-04,2024-09-20,552.08,141,141,482984077,286009246,0.000532108639266797,99.9978336759951,0.054863813229572
394.99,395,2558,2558,2558,2558,2024-09-04,2024-09-06,552.08,0,0,65864122,49955284,0.00388375328224978,99.8969499661743,0
399.99,400,2548,2548,2548,2548,2024-09-04,2024-09-06,552.08,0,0,65864122,49955284,0.00386857050944974,99.9008185366838,0
444.16,445,25,30,1100,2520,2024-09-04,2024-10-11,552.08,5,1420,4571203,3254681,0.055127720208444,99.8793534218454,0.563492063492063
374.98,375,1224,1243,3672,2486,2024-09-04,2024-09-13,552.08,19,-1186,70051475,47265620,0.00354881892208551,99.9877561464623,-0.477071600965406
558.61,571,2,2,2478,2478,2024-09-04,2024-09-27,552.08,0,0,91156178,55503910,0.00271841147179295,99.9916429142082,0
473.96,474,285,605,570,2420,2024-09-04,2024-09-06,552.08,320,1850,65864122,49955284,0.00367423101760925,99.9044927677014,0.764462809917355
354.86,355,145,170,725,2380,2024-09-04,2024-09-27,552.08,25,1655,91156178,55503910,0.00261090367347345,99.9942538178817,0.695378151260504
414.82,415,25,132,375,2376,2024-09-04,2024-09-27,552.08,107,2001,91156178,55503910,0.00260651560007266,99.9968603334817,0.842171717171717
552.27,576,2,1,3952,2373,2024-09-04,2024-11-15,552.08,-1,-1579,416800800,184114755,0.00056933671912338,100,-0.665402444163506
366.75,367,93,93,2325,2325,2024-09-04,2024-10-18,552.08,0,0,526522587,265443300,0.000441576497837879,99.9993168384246,0
169.99,170,2271,2271,2271,2271,2024-09-04,2024-09-20,552.08,0,0,482984077,286009246,0.000470201836488287,99.9983038778316,0
555.5,578,2,1,2992,2250,2024-09-04,2024-09-06,552.08,-1,-742,65864122,49955284,0.0034161238800086,99.9079088915814,-0.329777777777778
487.96,488,510,557,3060,2228,2024-09-04,2024-09-06,552.08,47,-832,65864122,49955284,0.00338272177984852,99.9112916133612,-0.37342908438061
502.96,503,557,549,1671,2196,2024-09-04,2024-09-06,552.08,-8,525,65864122,49955284,0.0033341369068884,99.9146257502681,0.239071038251366
434.98,435,1039,1093,1039,2186,2024-09-04,2024-09-06,552.08,54,1147,65864122,49955284,0.00331895413408836,99.9179447044022,0.524702653247941
409.99,410,2174,2174,2174,2174,2024-09-04,2024-09-06,552.08,0,0,65864122,49955284,0.00330073480672831,99.9212454392089,0
488.95,489,478,431,1434,2155,2024-09-04,2024-09-06,552.08,-47,721,65864122,49955284,0.00327188753840824,99.9245173267473,0.334570765661253
449.98,450,1054,1056,2108,2112,2024-09-04,2024-09-06,552.08,2,4,65864122,49955284,0.00320660161536808,99.9277239283627,0.00189393939393939
556.69,577,1,1,1685,2031,2024-09-04,2024-09-27,552.08,0,346,91156178,55503910,0.00222804426925403,99.999088377751,0.170359428852782
354.97,355,665,665,1995,1995,2024-09-04,2024-09-06,552.08,0,0,65864122,49955284,0.00302896317360763,99.9307528915363,0
414.99,415,1983,1983,3966,1983,2024-09-04,2024-09-06,552.08,0,-1983,65864122,49955284,0.00301074384624758,99.9337636353826,-1
189.99,190,1981,1981,1981,1981,2024-09-04,2024-09-20,552.08,0,0,482984077,286009246,0.000410158449178025,99.9987140362808,0
560.25,580,1,1,1975,1975,2024-09-04,2024-10-04,552.08,0,0,16648106,10098331,0.0118632113466841,99.940257468327,0
560.38,580,1,1,1962,1962,2024-09-04,2024-09-06,552.08,0,0,65864122,49955284,0.0029788600233675,99.9367424954059,0
439.99,440,1943,1956,3886,1956,2024-09-04,2024-09-06,552.08,13,-1930,65864122,49955284,0.00296975035968748,99.9397122457656,-0.986707566462168
554.44,574,1,1,1497,1956,2024-09-04,2024-10-04,552.08,0,459,16648106,10098331,0.0117490842501844,99.9520065525772,0.234662576687117
555.65,575,26,1,30498,1935,2024-09-04,2024-09-13,552.08,-25,-28563,70051475,47265620,0.00276225447073027,99.990518400933,-14.7612403100775
486.97,487,548,635,1644,1905,2024-09-04,2024-09-06,552.08,87,261,65864122,49955284,0.00289231821840728,99.942604563984,0.137007874015748
464.97,465,594,619,1188,1857,2024-09-04,2024-09-06,552.08,25,669,65864122,49955284,0.0028194409089671,99.945424004893,0.360258481421648
559.48,578,1,1,1852,1852,2024-09-04,2024-10-04,552.08,0,0,16648106,10098331,0.0111243885640805,99.9631309411413,0
480.97,481,616,616,1848,1848,2024-09-04,2024-09-06,552.08,0,0,65864122,49955284,0.00280577641344707,99.9482297813064,0
373.78,374,83,83,1826,1826,2024-09-04,2024-10-18,552.08,0,0,526522587,265443300,0.000346803735506223,99.9996636421601,0
474.97,475,603,603,1809,1809,2024-09-04,2024-09-06,552.08,0,0,65864122,49955284,0.00274656359952692,99.950976344906,0
495.96,496,442,450,1326,1800,2024-09-04,2024-09-06,552.08,8,474,65864122,49955284,0.00273289910400688,99.95370924401,0.263333333333333
349.99,350,1786,1786,1786,1786,2024-09-04,2024-09-06,552.08,0,0,65864122,49955284,0.00271164322208683,99.9564208872321,0
364.99,365,1784,1784,1784,1784,2024-09-04,2024-09-06,552.08,0,0,65864122,49955284,0.00270860666752682,99.9591294938996,0
194.99,195,1780,1780,1780,1780,2024-09-04,2024-09-20,552.08,0,0,482984077,286009246,0.00036854217038712,99.9990825784511,0
559.2,577,1,1,1780,1780,2024-09-04,2024-10-04,552.08,0,0,16648106,10098331,0.0106919069352394,99.9738228480765,0
492.95,493,350,355,3150,1775,2024-09-04,2024-09-06,552.08,5,-1375,65864122,49955284,0.00269494217200679,99.9618244360716,-0.774647887323944
353.77,354,77,77,1771,1771,2024-09-04,2024-10-18,552.08,0,0,526522587,265443300,0.000336357839858445,100,0
482.94,483,280,290,560,1740,2024-09-04,2024-09-06,552.08,10,1180,65864122,49955284,0.00264180246720665,99.9644662385388,0.67816091954023
553.76,571,1,1,1370,1724,2024-09-04,2024-10-04,552.08,0,354,16648106,10098331,0.0103555323350296,99.9841783804116,0.205336426914153
471.97,472,562,562,1686,1686,2024-09-04,2024-09-06,552.08,0,0,65864122,49955284,0.00255981549408645,99.9670260540329,0
460.98,461,826,836,4130,1672,2024-09-04,2024-09-06,552.08,10,-2458,65864122,49955284,0.00253855961216639,99.969564613645,-1.4700956937799
184.99,185,1667,1667,1667,1667,2024-09-04,2024-09-20,552.08,0,0,482984077,286009246,0.000345145953952432,99.9994277244051,0
461.97,462,512,551,1024,1653,2024-09-04,2024-09-06,552.08,39,629,65864122,49955284,0.00250971234384632,99.9720743259889,0.380520266182698
485.97,486,219,540,657,1620,2024-09-04,2024-09-06,552.08,321,963,65864122,49955284,0.00245960919360619,99.9745339351825,0.594444444444445
481.95,482,322,322,1610,1610,2024-09-04,2024-09-06,552.08,0,0,65864122,49955284,0.00244442642080616,99.9769783616033,0
369.99,370,1587,1587,1587,1587,2024-09-04,2024-09-06,552.08,0,0,65864122,49955284,0.00240950604336607,99.9793878676467,0
394.96,395,297,362,891,1448,2024-09-04,2024-09-13,552.08,65,557,70051475,47265620,0.00206705140755423,99.9925854523406,0.384668508287293
159.99,160,1447,1447,1447,1447,2024-09-04,2024-09-20,552.08,0,0,482984077,286009246,0.000299595798061889,99.9997273202032,0
374.99,375,1415,1415,1415,1415,2024-09-04,2024-09-06,552.08,0,0,65864122,49955284,0.00214836235120541,99.9815362299979,0
354.98,355,693,694,1386,1388,2024-09-04,2024-09-13,552.08,1,2,70051475,47265620,0.00198140010613624,99.9945668524467,0.00144092219020173
558.26,572,1,1,1374,1374,2024-09-04,2024-10-04,552.08,0,0,16648106,10098331,0.00825319108371847,99.9924315714953,0
439.36,440,0,21,0,1344,2024-09-04,2024-10-11,552.08,21,1344,4571203,3254681,0.0294014507778368,99.9087548726233,1
555.56,569,1,1,1344,1344,2024-09-04,2024-10-11,552.08,0,0,4571203,3254681,0.0294014507778368,99.9381563234011,0
164.99,165,1317,1317,1317,1317,2024-09-04,2024-09-20,552.08,0,0,482984077,286009246,0.000272679796853841,100,0
554.4,567,1,1,1260,1260,2024-09-04,2024-10-04,552.08,0,0,16648106,10098331,0.00756842850472,100,0
384.99,385,1233,1233,1233,1233,2024-09-04,2024-09-06,552.08,0,0,65864122,49955284,0.00187203588624471,99.9834082658841,0
561.81,574,21,1,25599,1219,2024-09-04,2024-09-06,552.08,-20,-24380,65864122,49955284,0.00185078000432466,99.9852590458885,-20
359.99,360,1125,1125,1125,1125,2024-09-04,2024-09-06,552.08,0,0,65864122,49955284,0.0017080619400043,99.9869671078284,0
329.99,330,1121,1121,1121,1121,2024-09-04,2024-09-13,552.08,0,0,70051475,47265620,0.00160025181482617,99.9961671042615,0
299.99,300,1369,1072,1369,1072,2024-09-04,2024-09-13,552.08,-297,-297,70051475,47265620,0.00153030325200147,99.9976974075135,-0.27705223880597
434.12,435,2,12,80,1056,2024-09-04,2024-10-11,552.08,10,976,4571203,3254681,0.0231011398968718,99.961257463298,0.924242424242424
379.99,380,1034,1034,1034,1034,2024-09-04,2024-09-06,552.08,0,0,65864122,49955284,0.00156989870752395,99.988537006536,0
465.96,466,238,258,714,1032,2024-09-04,2024-09-06,552.08,20,318,65864122,49955284,0.00156686215296395,99.9901038686889,0.308139534883721
429.99,430,979,1029,979,1029,2024-09-04,2024-09-06,552.08,50,49.9999999999999,65864122,49955284,0.00156230732112393,99.9916661760101,0.0485908649173954
493.97,494,336,338,1680,1014,2024-09-04,2024-09-06,552.08,2,-666,65864122,49955284,0.00153953316192388,99.993205709172,-0.656804733727811
483.98,484,490,491,1470,982,2024-09-04,2024-09-06,552.08,1,-488,65864122,49955284,0.00149094828896375,99.994696657461,-0.496945010183299
472.97,473,237,296,474,888,2024-09-04,2024-09-06,552.08,59,414,65864122,49955284,0.0013482302246434,99.9960448876856,0.466216216216216
462.97,463,252,268,504,804,2024-09-04,2024-09-06,552.08,16,300,65864122,49955284,0.00122069493312307,99.9972655826187,0.373134328358209
339.98,340,303,369,909,738,2024-09-04,2024-09-13,552.08,66,-171,70051475,47265620,0.00105351100744131,99.998750918521,-0.231707317073171
424.23,425,0,8,0,616,2024-09-04,2024-10-11,552.08,8,616,4571203,3254681,0.0134756649398419,99.9747331282378,1
424.99,425,575,575,575,575,2024-09-04,2024-09-06,552.08,0,0,65864122,49955284,0.000873009436002199,99.9981385920547,0
466.97,467,150,182,300,546,2024-09-04,2024-09-06,552.08,32,246,65864122,49955284,0.000828979394882088,99.9989675714496,0.450549450549451
394.59,395,1,13,21,533,2024-09-04,2024-10-11,552.08,12,512,4571203,3254681,0.0116599503456749,99.9863930785835,0.960600375234522
379.91,380,55,55,550,495,2024-09-04,2024-09-27,552.08,0,-55,91156178,55503910,0.00054302408334847,99.9996314018343,-0.111111111111111
379.66,380,10,13,150,442,2024-09-04,2024-10-11,552.08,3,292,4571203,3254681,0.0096692271159255,99.9960623056994,0.660633484162896
344.99,345,425,430,425,430,2024-09-04,2024-09-06,552.08,5,5,65864122,49955284,0.000652859230401644,99.99962043068,0.0116279069767442
364.94,365,55,56,550,336,2024-09-04,2024-09-27,552.08,1,-214,91156178,55503910,0.000368598165666841,100,-0.636904761904762
349.97,350,105,104,105,312,2024-09-04,2024-09-13,552.08,-1,207,70051475,47265620,0.000445386767373564,99.9991963052884,0.663461538461538
319.99,320,300,300,300,300,2024-09-04,2024-09-13,552.08,0,0,70051475,47265620,0.000428256507089965,99.9996245617955,0
339.99,340,250,250,250,250,2024-09-04,2024-09-06,552.08,0,0,65864122,49955284,0.000379569320000956,100,0
429.55,430,1,4,35,180,2024-09-04,2024-10-11,552.08,3,145,4571203,3254681,0.00393769430060315,100,0.805555555555556
309.99,310,114,161,114,161,2024-09-04,2024-09-13,552.08,47,47,70051475,47265620,0.000229830992138281,99.9998543927876,0.291925465838509
344.98,345,51,51,102,102,2024-09-04,2024-09-13,552.08,0,0,70051475,47265620,0.000145607212410588,100,0
552.5,576,1,0,1696,0,2024-09-04,2024-09-06,552.08,-1,-1696,65864122,49955284,0,100,-Inf
552.24,577,1,0,1893,0,2024-09-04,2024-09-06,552.08,-1,-1893,65864122,49955284,0,100,-Inf
558.3,579,0,0,0,0,2024-09-04,2024-09-06,552.08,0,0,65864122,49955284,0,100,
560.7,585,0,0,0,0,2024-09-04,2024-09-06,552.08,0,0,65864122,49955284,0,100,
560.75,595,0,0,0,0,2024-09-04,2024-09-06,552.08,0,0,65864122,49955284,0,100,
563.11,600,0,0,0,0,2024-09-04,2024-09-06,552.08,0,0,65864122,49955284,0,100,
605,605,0,0,0,0,2024-09-04,2024-09-06,552.08,0,0,65864122,49955284,0,100,
610,610,0,0,0,0,2024-09-04,2024-09-06,552.08,0,0,65864122,49955284,0,100,
615,615,0,0,0,0,2024-09-04,2024-09-06,552.08,0,0,65864122,49955284,0,100,
620,620,0,0,0,0,2024-09-04,2024-09-06,552.08,0,0,65864122,49955284,0,100,
559.98,625,0,0,0,0,2024-09-04,2024-09-06,552.08,0,0,65864122,49955284,0,100,
630,630,0,0,0,0,2024-09-04,2024-09-06,552.08,0,0,65864122,49955284,0,100,
635,635,0,0,0,0,2024-09-04,2024-09-06,552.08,0,0,65864122,49955284,0,100,
640,640,0,0,0,0,2024-09-04,2024-09-06,552.08,0,0,65864122,49955284,0,100,
559.07,645,0,0,0,0,2024-09-04,2024-09-06,552.08,0,0,65864122,49955284,0,100,
560.62,650,1,0,9101,0,2024-09-04,2024-09-06,552.08,-1,-9101,65864122,49955284,0,100,-Inf
655,655,0,0,0,0,2024-09-04,2024-09-06,552.08,0,0,65864122,49955284,0,100,
660,660,0,0,0,0,2024-09-04,2024-09-06,552.08,0,0,65864122,49955284,0,100,
555.09,577,3,0,4731,0,2024-09-04,2024-09-13,552.08,-3,-4731,70051475,47265620,0,100,-Inf
556.98,578,0,0,0,0,2024-09-04,2024-09-13,552.08,0,0,70051475,47265620,0,100,
562.76,579,0,0,0,0,2024-09-04,2024-09-13,552.08,0,0,70051475,47265620,0,100,
561.92,585,0,0,0,0,2024-09-04,2024-09-13,552.08,0,0,70051475,47265620,0,100,
558.84,590,0,0,0,0,2024-09-04,2024-09-13,552.08,0,0,70051475,47265620,0,100,
595,595,0,0,0,0,2024-09-04,2024-09-13,552.08,0,0,70051475,47265620,0,100,
552.18,605,0,0,0,0,2024-09-04,2024-09-13,552.08,0,0,70051475,47265620,0,100,
552.22,610,0,0,0,0,2024-09-04,2024-09-13,552.08,0,0,70051475,47265620,0,100,
615,615,0,0,0,0,2024-09-04,2024-09-13,552.08,0,0,70051475,47265620,0,100,
620,620,0,0,0,0,2024-09-04,2024-09-13,552.08,0,0,70051475,47265620,0,100,
625,625,0,0,0,0,2024-09-04,2024-09-13,552.08,0,0,70051475,47265620,0,100,
630,630,0,0,0,0,2024-09-04,2024-09-13,552.08,0,0,70051475,47265620,0,100,
635,635,0,0,0,0,2024-09-04,2024-09-13,552.08,0,0,70051475,47265620,0,100,
640,640,0,0,0,0,2024-09-04,2024-09-13,552.08,0,0,70051475,47265620,0,100,
645,645,0,0,0,0,2024-09-04,2024-09-13,552.08,0,0,70051475,47265620,0,100,
650,650,0,0,0,0,2024-09-04,2024-09-13,552.08,0,0,70051475,47265620,0,100,
655,655,0,0,0,0,2024-09-04,2024-09-13,552.08,0,0,70051475,47265620,0,100,
660,660,0,0,0,0,2024-09-04,2024-09-13,552.08,0,0,70051475,47265620,0,100,
559.02,579,0,0,0,0,2024-09-04,2024-09-20,552.08,0,0,482984077,286009246,0,100,
559.8,595,0,0,0,0,2024-09-04,2024-09-20,552.08,0,0,482984077,286009246,0,100,
543.26,605,0,0,0,0,2024-09-04,2024-09-20,552.08,0,0,482984077,286009246,0,100,
610,610,0,0,0,0,2024-09-04,2024-09-20,552.08,0,0,482984077,286009246,0,100,
615,615,0,0,0,0,2024-09-04,2024-09-20,552.08,0,0,482984077,286009246,0,100,
620,620,0,0,0,0,2024-09-04,2024-09-20,552.08,0,0,482984077,286009246,0,100,
625,625,0,0,0,0,2024-09-04,2024-09-20,552.08,0,0,482984077,286009246,0,100,
553.85,630,0,0,0,0,2024-09-04,2024-09-20,552.08,0,0,482984077,286009246,0,100,
562.48,635,0,0,0,0,2024-09-04,2024-09-20,552.08,0,0,482984077,286009246,0,100,
553.18,640,0,0,0,0,2024-09-04,2024-09-20,552.08,0,0,482984077,286009246,0,100,
645,645,0,0,0,0,2024-09-04,2024-09-20,552.08,0,0,482984077,286009246,0,100,
650,650,0,0,0,0,2024-09-04,2024-09-20,552.08,0,0,482984077,286009246,0,100,
655,655,0,0,0,0,2024-09-04,2024-09-20,552.08,0,0,482984077,286009246,0,100,
562.83,660,0,0,0,0,2024-09-04,2024-09-20,552.08,0,0,482984077,286009246,0,100,
665,665,0,0,0,0,2024-09-04,2024-09-20,552.08,0,0,482984077,286009246,0,100,
670,670,0,0,0,0,2024-09-04,2024-09-20,552.08,0,0,482984077,286009246,0,100,
675,675,0,0,0,0,2024-09-04,2024-09-20,552.08,0,0,482984077,286009246,0,100,
680,680,0,0,0,0,2024-09-04,2024-09-20,552.08,0,0,482984077,286009246,0,100,
685,685,0,0,0,0,2024-09-04,2024-09-20,552.08,0,0,482984077,286009246,0,100,
690,690,0,0,0,0,2024-09-04,2024-09-20,552.08,0,0,482984077,286009246,0,100,
695,695,0,0,0,0,2024-09-04,2024-09-20,552.08,0,0,482984077,286009246,0,100,
700,700,0,0,0,0,2024-09-04,2024-09-20,552.08,0,0,482984077,286009246,0,100,
572,572,0,0,0,0,2024-09-04,2024-09-27,552.08,0,0,91156178,55503910,0,100,
573,573,0,0,0,0,2024-09-04,2024-09-27,552.08,0,0,91156178,55503910,0,100,
557.11,574,0,0,0,0,2024-09-04,2024-09-27,552.08,0,0,91156178,55503910,0,100,
557.67,576,0,0,0,0,2024-09-04,2024-09-27,552.08,0,0,91156178,55503910,0,100,
579,579,0,0,0,0,2024-09-04,2024-09-27,552.08,0,0,91156178,55503910,0,100,
585,585,0,0,0,0,2024-09-04,2024-09-27,552.08,0,0,91156178,55503910,0,100,
605,605,0,0,0,0,2024-09-04,2024-09-27,552.08,0,0,91156178,55503910,0,100,
610,610,0,0,0,0,2024-09-04,2024-09-27,552.08,0,0,91156178,55503910,0,100,
544.51,615,0,0,0,0,2024-09-04,2024-09-27,552.08,0,0,91156178,55503910,0,100,
620,620,0,0,0,0,2024-09-04,2024-09-27,552.08,0,0,91156178,55503910,0,100,
625,625,0,0,0,0,2024-09-04,2024-09-27,552.08,0,0,91156178,55503910,0,100,
635,635,0,0,0,0,2024-09-04,2024-09-27,552.08,0,0,91156178,55503910,0,100,
640,640,0,0,0,0,2024-09-04,2024-09-27,552.08,0,0,91156178,55503910,0,100,
645,645,0,0,0,0,2024-09-04,2024-09-27,552.08,0,0,91156178,55503910,0,100,
559.68,650,0,0,0,0,2024-09-04,2024-09-27,552.08,0,0,91156178,55503910,0,100,
655,655,0,0,0,0,2024-09-04,2024-09-27,552.08,0,0,91156178,55503910,0,100,
576,576,0,0,0,0,2024-09-04,2024-10-04,552.08,0,0,16648106,10098331,0,100,
579,579,0,0,0,0,2024-09-04,2024-10-04,552.08,0,0,16648106,10098331,0,100,
590,590,0,0,0,0,2024-09-04,2024-10-04,552.08,0,0,16648106,10098331,0,100,
595,595,0,0,0,0,2024-09-04,2024-10-04,552.08,0,0,16648106,10098331,0,100,
600,600,0,0,0,0,2024-09-04,2024-10-04,552.08,0,0,16648106,10098331,0,100,
605,605,0,0,0,0,2024-09-04,2024-10-04,552.08,0,0,16648106,10098331,0,100,
610,610,0,0,0,0,2024-09-04,2024-10-04,552.08,0,0,16648106,10098331,0,100,
615,615,0,0,0,0,2024-09-04,2024-10-04,552.08,0,0,16648106,10098331,0,100,
620,620,0,0,0,0,2024-09-04,2024-10-04,552.08,0,0,16648106,10098331,0,100,
625,625,0,0,0,0,2024-09-04,2024-10-04,552.08,0,0,16648106,10098331,0,100,
630,630,0,0,0,0,2024-09-04,2024-10-04,552.08,0,0,16648106,10098331,0,100,
635,635,0,0,0,0,2024-09-04,2024-10-04,552.08,0,0,16648106,10098331,0,100,
640,640,0,0,0,0,2024-09-04,2024-10-04,552.08,0,0,16648106,10098331,0,100,
645,645,0,0,0,0,2024-09-04,2024-10-04,552.08,0,0,16648106,10098331,0,100,
650,650,0,0,0,0,2024-09-04,2024-10-04,552.08,0,0,16648106,10098331,0,100,
655,655,0,0,0,0,2024-09-04,2024-10-04,552.08,0,0,16648106,10098331,0,100,
555.8,660,5,0,49275,0,2024-09-04,2024-10-04,552.08,-5,-49275,16648106,10098331,0,100,-Inf
385,385,0,0,0,0,2024-09-04,2024-10-11,552.08,0,0,4571203,3254681,0,100,
390,390,0,0,0,0,2024-09-04,2024-10-11,552.08,0,0,4571203,3254681,0,100,
400,400,0,0,0,0,2024-09-04,2024-10-11,552.08,0,0,4571203,3254681,0,100,
405,405,0,0,0,0,2024-09-04,2024-10-11,552.08,0,0,4571203,3254681,0,100,
410,410,0,0,0,0,2024-09-04,2024-10-11,552.08,0,0,4571203,3254681,0,100,
415,415,0,0,0,0,2024-09-04,2024-10-11,552.08,0,0,4571203,3254681,0,100,
568,568,0,0,0,0,2024-09-04,2024-10-11,552.08,0,0,4571203,3254681,0,100,
571,571,0,0,0,0,2024-09-04,2024-10-11,552.08,0,0,4571203,3254681,0,100,
573,573,0,0,0,0,2024-09-04,2024-10-11,552.08,0,0,4571203,3254681,0,100,
574,574,0,0,0,0,2024-09-04,2024-10-11,552.08,0,0,4571203,3254681,0,100,
576,576,0,0,0,0,2024-09-04,2024-10-11,552.08,0,0,4571203,3254681,0,100,
577,577,0,0,0,0,2024-09-04,2024-10-11,552.08,0,0,4571203,3254681,0,100,
578,578,0,0,0,0,2024-09-04,2024-10-11,552.08,0,0,4571203,3254681,0,100,
579,579,0,0,0,0,2024-09-04,2024-10-11,552.08,0,0,4571203,3254681,0,100,
585,585,0,0,0,0,2024-09-04,2024-10-11,552.08,0,0,4571203,3254681,0,100,
590,590,0,0,0,0,2024-09-04,2024-10-11,552.08,0,0,4571203,3254681,0,100,
595,595,0,0,0,0,2024-09-04,2024-10-11,552.08,0,0,4571203,3254681,0,100,
605,605,0,0,0,0,2024-09-04,2024-10-11,552.08,0,0,4571203,3254681,0,100,
610,610,0,0,0,0,2024-09-04,2024-10-11,552.08,0,0,4571203,3254681,0,100,
615,615,0,0,0,0,2024-09-04,2024-10-11,552.08,0,0,4571203,3254681,0,100,
620,620,0,0,0,0,2024-09-04,2024-10-11,552.08,0,0,4571203,3254681,0,100,
625,625,0,0,0,0,2024-09-04,2024-10-11,552.08,0,0,4571203,3254681,0,100,
630,630,0,0,0,0,2024-09-04,2024-10-11,552.08,0,0,4571203,3254681,0,100,
635,635,0,0,0,0,2024-09-04,2024-10-11,552.08,0,0,4571203,3254681,0,100,
640,640,0,0,0,0,2024-09-04,2024-10-11,552.08,0,0,4571203,3254681,0,100,
645,645,0,0,0,0,2024-09-04,2024-10-11,552.08,0,0,4571203,3254681,0,100,
650,650,0,0,0,0,2024-09-04,2024-10-11,552.08,0,0,4571203,3254681,0,100,
655,655,0,0,0,0,2024-09-04,2024-10-11,552.08,0,0,4571203,3254681,0,100,
660,660,0,0,0,0,2024-09-04,2024-10-11,552.08,0,0,4571203,3254681,0,100,
563.04,605,0,0,0,0,2024-09-04,2024-10-18,552.08,0,0,526522587,265443300,0,100,
610,610,0,0,0,0,2024-09-04,2024-10-18,552.08,0,0,526522587,265443300,0,100,
615,615,0,0,0,0,2024-09-04,2024-10-18,552.08,0,0,526522587,265443300,0,100,
620,620,0,0,0,0,2024-09-04,2024-10-18,552.08,0,0,526522587,265443300,0,100,
625,625,0,0,0,0,2024-09-04,2024-10-18,552.08,0,0,526522587,265443300,0,100,
562,630,0,0,0,0,2024-09-04,2024-10-18,552.08,0,0,526522587,265443300,0,100,
635,635,0,0,0,0,2024-09-04,2024-10-18,552.08,0,0,526522587,265443300,0,100,
640,640,0,0,0,0,2024-09-04,2024-10-18,552.08,0,0,526522587,265443300,0,100,
645,645,0,0,0,0,2024-09-04,2024-10-18,552.08,0,0,526522587,265443300,0,100,
553.85,650,2,0,17946,0,2024-09-04,2024-10-18,552.08,-2,-17946,526522587,265443300,0,100,-Inf
555.64,655,0,0,0,0,2024-09-04,2024-10-18,552.08,0,0,526522587,265443300,0,100,
660,660,0,0,0,0,2024-09-04,2024-10-18,552.08,0,0,526522587,265443300,0,100,
665,665,0,0,0,0,2024-09-04,2024-10-18,552.08,0,0,526522587,265443300,0,100,
670,670,0,0,0,0,2024-09-04,2024-10-18,552.08,0,0,526522587,265443300,0,100,
675,675,0,0,0,0,2024-09-04,2024-10-18,552.08,0,0,526522587,265443300,0,100,
552.51,680,0,0,0,0,2024-09-04,2024-10-18,552.08,0,0,526522587,265443300,0,100,
605,605,0,0,0,0,2024-09-04,2024-11-15,552.08,0,0,416800800,184114755,0,100,
615,615,0,0,0,0,2024-09-04,2024-11-15,552.08,0,0,416800800,184114755,0,100,
625,625,1,1,0,0,2024-09-04,2024-11-15,552.08,0,0,416800800,184114755,0,100,
532.37,630,0,0,0,0,2024-09-04,2024-11-15,552.08,0,0,416800800,184114755,0,100,
635,635,0,0,0,0,2024-09-04,2024-11-15,552.08,0,0,416800800,184114755,0,100,
640,640,0,0,0,0,2024-09-04,2024-11-15,552.08,0,0,416800800,184114755,0,100,
645,645,0,0,0,0,2024-09-04,2024-11-15,552.08,0,0,416800800,184114755,0,100,
650,650,0,0,0,0,2024-09-04,2024-11-15,552.08,0,0,416800800,184114755,0,100,
655,655,0,0,0,0,2024-09-04,2024-11-15,552.08,0,0,416800800,184114755,0,100,
660,660,0,0,0,0,2024-09-04,2024-11-15,552.08,0,0,416800800,184114755,0,100,
665,665,0,0,0,0,2024-09-04,2024-11-15,552.08,0,0,416800800,184114755,0,100,
670,670,0,0,0,0,2024-09-04,2024-11-15,552.08,0,0,416800800,184114755,0,100,
675,675,0,0,0,0,2024-09-04,2024-11-15,552.08,0,0,416800800,184114755,0,100,
552.55,680,0,0,0,0,2024-09-04,2024-11-15,552.08,0,0,416800800,184114755,0,100,
555.6,615,0,0,0,0,2024-09-04,2024-12-20,552.08,0,0,769049161,290977996,0,100,
544.19,625,0,0,0,0,2024-09-04,2024-12-20,552.08,0,0,769049161,290977996,0,100,
630,630,0,0,0,0,2024-09-04,2024-12-20,552.08,0,0,769049161,290977996,0,100,
635,635,0,0,0,0,2024-09-04,2024-12-20,552.08,0,0,769049161,290977996,0,100,
557.4,640,0,0,0,0,2024-09-04,2024-12-20,552.08,0,0,769049161,290977996,0,100,
645,645,0,0,0,0,2024-09-04,2024-12-20,552.08,0,0,769049161,290977996,0,100,
559.89,650,0,0,0,0,2024-09-04,2024-12-20,552.08,0,0,769049161,290977996,0,100,
655,655,0,0,0,0,2024-09-04,2024-12-20,552.08,0,0,769049161,290977996,0,100,
555.61,660,0,0,0,0,2024-09-04,2024-12-20,552.08,0,0,769049161,290977996,0,100,
555.59,665,0,0,0,0,2024-09-04,2024-12-20,552.08,0,0,769049161,290977996,0,100,
670,670,0,0,0,0,2024-09-04,2024-12-20,552.08,0,0,769049161,290977996,0,100,
675,675,0,0,0,0,2024-09-04,2024-12-20,552.08,0,0,769049161,290977996,0,100,
680,680,0,0,0,0,2024-09-04,2024-12-20,552.08,0,0,769049161,290977996,0,100,
685,685,0,0,0,0,2024-09-04,2024-12-20,552.08,0,0,769049161,290977996,0,100,
690,690,0,0,0,0,2024-09-04,2024-12-20,552.08,0,0,769049161,290977996,0,100,
695,695,0,0,0,0,2024-09-04,2024-12-20,552.08,0,0,769049161,290977996,0,100,
700,700,0,0,0,0,2024-09-04,2024-12-20,552.08,0,0,769049161,290977996,0,100,
705,705,0,0,0,0,2024-09-04,2024-12-20,552.08,0,0,769049161,290977996,0,100,
710,710,0,0,0,0,2024-09-04,2024-12-20,552.08,0,0,769049161,290977996,0,100,
715,715,0,0,0,0,2024-09-04,2024-12-20,552.08,0,0,769049161,290977996,0,100,
560.22,725,0,0,0,0,2024-09-04,2024-12-20,552.08,0,0,769049161,290977996,0,100,
730,730,0,0,0,0,2024-09-04,2024-12-20,552.08,0,0,769049161,290977996,0,100,
735,735,0,0,0,0,2024-09-04,2024-12-20,552.08,0,0,769049161,290977996,0,100,
740,740,0,0,0,0,2024-09-04,2024-12-20,552.08,0,0,769049161,290977996,0,100,
745,745,0,0,0,0,2024-09-04,2024-12-20,552.08,0,0,769049161,290977996,0,100,
750,750,0,0,0,0,2024-09-04,2024-12-20,552.08,0,0,769049161,290977996,0,100,
755,755,0,0,0,0,2024-09-04,2024-12-20,552.08,0,0,769049161,290977996,0,100,
559.9,760,0,0,0,0,2024-09-04,2024-12-20,552.08,0,0,769049161,290977996,0,100,
765,765,0,0,0,0,2024-09-04,2024-12-20,552.08,0,0,769049161,290977996,0,100,
770,770,0,0,0,0,2024-09-04,2024-12-20,552.08,0,0,769049161,290977996,0,100,
