Watch,strike,open_interest.yt,open_interest.td,OI_Dollar.yt,OI_Dollar.td,Date.td,expiry,stkClose,diff_oi,diff_oi_d,totalOI,totalOIdiff,OI_pct,cum_sep_OI,pct
514.79,545,119200,120097,279881600,362813037,2025-04-17,2025-06-20,525.66,897,82931437,2210385665,443310327,16.414015108083,16.414015108083,0.228578988466724
501.22,535,98912,98886,275766656,334036908,2025-04-17,2025-09-19,525.66,-26,58270252,1699576882,316242446,19.6541216544978,19.6541216544978,0.174442555910618
512.5,540,62477,63411,134200596,174380250,2025-04-17,2025-06-20,525.66,934,40179654,2210385665,443310327,7.88913232478822,24.3031474328712,0.23041401764248
520.2,555,35963,36030,83398197,125384400,2025-04-17,2025-05-16,525.66,67,41986203,2098065603,598425916,5.97619063106103,5.97619063106103,0.334859862949458
520.73,580,19755,19905,85341600,117976935,2025-04-17,2025-06-20,525.66,150,32635335,2210385665,443310327,5.33739142757244,29.6405388604436,0.276624706346202
520.7,560,34796,29777,106893312,117023610,2025-04-17,2025-06-20,525.66,-5019,10130298,2210385665,443310327,5.29426207620651,34.9348009366501,0.0865662749593864
516.67,550,36876,34663,92669388,115531779,2025-04-17,2025-06-20,525.66,-2213,22862391,2210385665,443310327,5.22677018899324,40.1615711256434,0.197888331659811
504,525,51369,51698,85118433,108565800,2025-04-17,2025-06-20,525.66,329,23447367,2210385665,443310327,4.91162251543103,45.0731936410744,0.21597378732529
485.14,520,29024,29056,78509920,101289216,2025-04-17,2025-12-19,525.66,32,22779296,1076181448,187344700,9.41190876206221,9.41190876206221,0.224893595780226
520.95,550,34023,32320,66889218,93889600,2025-04-17,2025-05-16,525.66,-1703,27000382,2098065603,598425916,4.47505549234249,10.4512461234035,0.287575855046778
509.43,525,57567,58810,65914215,91567170,2025-04-17,2025-05-16,525.66,1243,25652955,2098065603,598425916,4.36436162287152,14.815607746275,0.280154502973063
493.7,510,52571,56022,66607457,91315860,2025-04-17,2025-06-20,525.66,3451,24708403,2210385665,443310327,4.13121843151295,49.2044120725874,0.270581725890771
517.61,540,40608,40776,66475296,91297464,2025-04-17,2025-05-16,525.66,168,24822168,2098065603,598425916,4.35150663875595,19.167114385031,0.2718823383747
518.86,555,29462,24495,82994454,88524930,2025-04-17,2025-06-20,525.66,-4967,5530476,2210385665,443310327,4.00495404045248,53.2093661130398,0.0624736557261327
486.53,500,58459,65352,61557327,88029144,2025-04-17,2025-06-20,525.66,6893,26471817,2210385665,443310327,3.98252419900669,57.1918903120465,0.300716510432045
511.4,560,17881,17938,67053750,87178680,2025-04-17,2025-09-19,525.66,57,20124930,1699576882,316242446,5.12943432705506,24.7835559815528,0.230846922665037
512.32,530,48158,48859,62364610,86382712,2025-04-17,2025-05-16,525.66,701,24018102,2098065603,598425916,4.11725505038938,23.2843694354204,0.278042925996581
522.81,575,16377,16529,65376984,86264851,2025-04-17,2025-06-20,525.66,152,20887867,2210385665,443310327,3.90270586558477,61.0945961776313,0.242136475724047
478.53,500,39426,39756,70217706,85356132,2025-04-17,2025-09-19,525.66,330,15138426,1699576882,316242446,5.02219893103959,29.8057549125924,0.177356045140377
522.27,570,16737,17144,54796938,81828312,2025-04-17,2025-05-16,525.66,407,27031374,2098065603,598425916,3.90017890207983,27.1845483375002,0.330342559186605
487.71,495,111044,111800,62961948,81502200,2025-04-17,2025-05-16,525.66,756,18540252,2098065603,598425916,3.8846354414972,31.0691837789974,0.227481613993242
521.92,585,12910,12907,61696890,81417356,2025-04-17,2025-06-20,525.66,-3,19720466,2210385665,443310327,3.68340047120239,64.7779966488337,0.242214522417063
513.9,550,22258,22098,63168204,79773780,2025-04-17,2025-07-18,525.66,-160,16605576,781158455,167554530,10.2122404858308,10.2122404858308,0.208158319688499
500.25,520,38702,40236,58943146,79466100,2025-04-17,2025-06-20,525.66,1534,20522954,2210385665,443310327,3.59512374959236,68.3731203984261,0.258260490951488
490.28,505,50075,51716,57035425,76125952,2025-04-17,2025-06-20,525.66,1641,19090527,2210385665,443310327,3.44401220137301,71.8171325997991,0.250775543667421
506.43,530,31153,31540,55234269,74339780,2025-04-17,2025-06-20,525.66,387,19105511,2210385665,443310327,3.36320404068491,75.180336640484,0.257002522740853
491.7,500,89093,87882,55415846,72942060,2025-04-17,2025-05-16,525.66,-1211,17526214,2098065603,598425916,3.47663390008878,34.5458176790862,0.240275829884706
508.03,540,21260,22234,53575200,71082098,2025-04-17,2025-07-18,525.66,974,17506898,781158455,167554530,9.0995748103373,19.3118152961681,0.246291239180926
519.5,570,13805,13739,48317500,69381950,2025-04-17,2025-06-20,525.66,-66,21064450,2210385665,443310327,3.13890698345621,78.3192436239402,0.303601296879087
521.5,600,8722,8668,53640300,68043800,2025-04-17,2025-09-19,525.66,-54,14403500,1699576882,316242446,4.0035729316304,33.8093278442228,0.211679829756716
509.03,550,16471,16539,54354300,67760283,2025-04-17,2025-09-19,525.66,68,13405983,1699576882,316242446,3.98689130910407,37.7962191533269,0.197844259298622
456.87,460,215290,215681,52100180,67508153,2025-04-17,2025-05-16,525.66,391,15407973,2098065603,598425916,3.21763785190849,37.7634555309947,0.228238698813164
497.4,515,37879,38035,52576052,66941600,2025-04-17,2025-06-20,525.66,156,14365548,2210385665,443310327,3.02850317299719,81.3477467969374,0.214598216953285
521.09,600,8457,8449,51097194,66671059,2025-04-17,2025-08-15,525.66,-8,15573865,650394247,116470886,10.2508685013015,10.2508685013015,0.233592584752554
515.96,555,16948,16878,50572832,65891712,2025-04-17,2025-07-18,525.66,-70,15318880,781158455,167554530,8.4351275440013,27.7469428401694,0.232485688033117
506.46,545,16707,16780,51841821,64670120,2025-04-17,2025-09-19,525.66,73,12828299,1699576882,316242446,3.80507176138443,41.6012909147113,0.198365164623167
518.1,575,11313,11314,50342850,64376660,2025-04-17,2025-09-19,525.66,1,14033810,1699576882,316242446,3.78780511089583,45.3890960256072,0.217995310722861
519.81,545,24994,25051,45139164,63103469,2025-04-17,2025-05-16,525.66,57,17964305,2098065603,598425916,3.00769761011138,40.7711531411061,0.284680149676082
514.02,565,12229,12228,48744794,62338344,2025-04-17,2025-09-19,525.66,-1,13593550,1699576882,316242446,3.66787431979202,49.0569703453992,0.218060813421672
524.71,610,7414,7293,53840468,62201997,2025-04-17,2025-12-19,525.66,-121,8361529,1076181448,187344700,5.77988006721335,15.1917888292756,0.134425410811167
499.3,510,55819,57580,44431924,61610600,2025-04-17,2025-05-16,525.66,1761,17178676,2098065603,598425916,2.93654306671363,43.7076962078197,0.278826630482417
513.84,533,31127,31299,40963132,59968884,2025-04-17,2025-05-16,525.66,172,19005752,2098065603,598425916,2.85829403590866,46.5659902437283,0.316926891619327
506.2,520,34412,41106,34962592,56726280,2025-04-17,2025-05-16,525.66,6694,21763688,2098065603,598425916,2.70374195730047,49.2697322010288,0.38366147048599
520.64,565,12734,12731,40748800,56474716,2025-04-17,2025-06-20,525.66,-3,15725916,2210385665,443310327,2.55497114798743,83.9027179449248,0.278459408277502
520.88,560,13182,13103,34325928,51258936,2025-04-17,2025-05-16,525.66,-79,16933008,2098065603,598425916,2.4431522029962,51.712884404025,0.330342557246994
509.27,555,11075,11068,38950775,50613964,2025-04-17,2025-09-19,525.66,-7,11663189,1699576882,316242446,2.97803321144492,52.0350035568441,0.230434213767568
494.91,525,16445,16554,38892425,49810986,2025-04-17,2025-09-19,525.66,109,10918561,1699576882,316242446,2.93078745230897,54.9657910091531,0.219199856834795
517.78,560,11834,11766,38578840,49676052,2025-04-17,2025-07-18,525.66,-68,11097212,781158455,167554530,6.35927982114717,34.1062226613165,0.223391585144488
515.9,525,53348,54174,34302764,49298340,2025-04-17,2025-04-25,525.66,826,14995576,186785929,41175251,26.392962394935,26.392962394935,0.30418014075119
516.98,570,9272,9269,36355512,49144238,2025-04-17,2025-07-18,525.66,-3,12788726,781158455,167554530,6.29119965167631,40.3974223129928,0.260228391373166
533.77,563,16772,16771,46777108,49021633,2025-04-17,2025-05-30,525.66,-1,2244525,542920959,126942613,9.02923937405039,9.02923937405039,0.0457864184165387
516.58,570,9138,9140,39457884,48825880,2025-04-17,2025-09-19,525.66,2,9367996,1699576882,316242446,2.87282561425191,57.838616623405,0.191865379589677
478.99,490,43821,43938,38255733,48375738,2025-04-17,2025-06-20,525.66,117,10120005,2210385665,443310327,2.18856549632935,86.0912834412542,0.209195878314042
504.15,550,10439,10429,40670344,47816965,2025-04-17,2025-12-19,525.66,-10,7146621,1076181448,187344700,4.44320658833732,19.6349954176129,0.149457854550158
504.22,540,13043,13291,39181172,47555198,2025-04-17,2025-09-19,525.66,248,8374026.00000001,1699576882,316242446,2.79806100586864,60.6366776292736,0.176090655747033
498.27,530,14779,14898,39016560,47271354,2025-04-17,2025-09-19,525.66,119,8254794,1699576882,316242446,2.78136014325947,63.4180377725331,0.174625715184718
514.88,535,23959,23245,34860345,46768940,2025-04-17,2025-05-16,525.66,-714,11908595,2098065603,598425916,2.22914573944331,53.9420301434683,0.254626147182297
473.59,500,17557,17565,37659765,46389165,2025-04-17,2025-12-19,525.66,8,8729400,1076181448,187344700,4.3105337939258,23.9455292115387,0.188177562583849
521.86,580,7863,7816,38174865,45442224,2025-04-17,2025-09-19,525.66,-47,7267359,1699576882,316242446,2.67373747438393,66.091775246917,0.159925249257167
520.46,590,6467,6467,34546714,44971518,2025-04-17,2025-09-19,525.66,0,10424804,1699576882,316242446,2.64604199293881,68.7378172398558,0.231809030773656
497.26,520,17485,19485,32679465,44308890,2025-04-17,2025-07-18,525.66,2000,11629425,781158455,167554530,5.67220257508446,46.0696248880773,0.262462566767075
471.46,490,23120,23759,34194480,44049186,2025-04-17,2025-09-19,525.66,639,9854706,1699576882,316242446,2.59177366240499,71.3295909022608,0.223720501895313
483,510,16171,15991,32988840,43175700,2025-04-17,2025-09-19,525.66,-180,10186860,1699576882,316242446,2.54037934130949,73.8699702435703,0.235939660503478
520.44,595,5732,5784,40765984,43125504,2025-04-17,2025-09-19,525.66,52,2359520,1699576882,316242446,2.53742590033653,76.4073961439068,0.0547128678194694
523,575,8034,8150,29083080,42380000,2025-04-17,2025-05-16,525.66,116,13296920,2098065603,598425916,2.01995590316153,55.9619860466298,0.313754601226994
511.67,545,12377,12660,33219868,42195780,2025-04-17,2025-07-18,525.66,283,8975912,781158455,167554530,5.40169279739794,51.4713176854752,0.212720608553746
532.5,585,7768,7766,38692408,40771500,2025-04-17,2025-09-19,525.66,-2,2079092,1699576882,316242446,2.3989206038165,78.8063167477233,0.0509937578946078
507.09,525,22865,22173,31004940,39711843,2025-04-17,2025-05-30,525.66,-692,8706903,542920959,126942613,7.31447963864663,16.343719012697,0.219252050326649
521.34,565,9764,9041,26704540,39473006,2025-04-17,2025-05-16,525.66,-723,12768466,2098065603,598425916,1.88139998785348,57.8433860344833,0.323473363037008
518.76,600,4864,4855,31484672,39442020,2025-04-17,2025-12-19,525.66,-9,7957347.99999999,1076181448,187344700,3.66499720593585,27.6105264174745,0.201747983495774
473.32,480,22573,58316,11670241,38955088,2025-04-17,2025-05-30,525.66,35743,27284847,542920959,126942613,7.17509378745498,23.518812800152,0.700418055787732
466.1,490,16016,16080,30894864,38431200,2025-04-17,2025-12-19,525.66,64,7536336,1076181448,187344700,3.57107066577122,31.1815970832458,0.196099419221882
496.69,540,8800,8847,30826400,38316357,2025-04-17,2025-12-19,525.66,47,7489957,1076181448,187344700,3.56039932403667,34.7419964072824,0.195476751612895
502.79,515,25045,31044,22615635,37904724,2025-04-17,2025-05-16,525.66,5999,15289089,2098065603,598425916,1.80665103826117,59.6500370727445,0.403355766421093
483.55,490,56725,58554,27625075,37767330,2025-04-17,2025-05-16,525.66,1829,10142255,2098065603,598425916,1.80010243464251,61.450139507387,0.268545724572004
511.78,529,21509,21701,26692669,37369122,2025-04-17,2025-05-16,525.66,192,10676453,2098065603,598425916,1.78112266587691,63.2312621732639,0.285702538047322
524.03,605,4888,4604,33658768,37278588,2025-04-17,2025-12-19,525.66,-284,3619820,1076181448,187344700,3.46396865224534,38.2059650595278,0.0971018537504693
488.71,515,13975,14115,30186000,37108335,2025-04-17,2025-09-19,525.66,140,6922335,1699576882,316242446,2.18338666482285,80.9897034125462,0.186543939521943
506.9,560,6763,6756,28343733,35874360,2025-04-17,2025-12-19,525.66,-7,7530627,1076181448,187344700,3.33348619479268,41.5394512543205,0.209916692590474
515.32,537,16047,16455,24086547,35674440,2025-04-17,2025-05-16,525.66,408,11587893,2098065603,598425916,1.70034911915955,64.9316112924235,0.32482340297423
519.71,575,6414,6447,28766790,35645463,2025-04-17,2025-07-18,525.66,33,6878673,781158455,167554530,4.56315396342987,56.0344716489051,0.192974713219463
509.28,535,12370,13816,24566820,35534752,2025-04-17,2025-06-20,525.66,1446,10967932,2210385665,443310327,1.60762678489412,87.6989102261483,0.308653680768618
514.7,580,5360,5358,28225760,34987740,2025-04-17,2025-12-19,525.66,-2,6761980,1076181448,187344700,3.25110045940877,44.7905517137292,0.193267127285158
504.16,555,6755,6757,26932185,34352588,2025-04-17,2025-12-19,525.66,2,7420403,1076181448,187344700,3.19208141562388,47.9826331293531,0.21600710257987
517.4,546,11880,11879,19934640,33973940,2025-04-17,2025-05-16,525.66,-1,14039300,2098065603,598425916,1.61929826938781,66.5509095618113,0.413237322488943
523.19,557,10055,10012,23086280,33850572,2025-04-17,2025-05-16,525.66,-43,10764292,2098065603,598425916,1.61341818633304,68.1643277481443,0.317994390168651
491.95,520,10760,11590,23725800,32509950,2025-04-17,2025-09-19,525.66,830,8784150,1699576882,316242446,1.91282608891123,82.9025295014574,0.270198816054777
503.42,530,12085,12164,25934410,32331912,2025-04-17,2025-07-18,525.66,79,6397502,781158455,167554530,4.1389697305395,60.1734413794446,0.197869584700094
475.05,480,57258,63612,21987072,31487940,2025-04-17,2025-05-16,525.66,6354,9500868,2098065603,598425916,1.50080817086824,69.6651359190125,0.301730376772822
463.45,480,19124,18772,26046888,31067660,2025-04-17,2025-09-19,525.66,-352,5020772.00000001,1699576882,316242446,1.82796437919541,84.7304938806528,0.161607665334306
476.6,505,10838,10836,24428852,30774240,2025-04-17,2025-12-19,525.66,-2,6345388,1076181448,187344700,2.85957726340586,50.842210392759,0.20619154201696
522.43,560,8106,8066,22575210,30303962,2025-04-17,2025-05-30,525.66,-40,7728752,542920959,126942613,5.58165263242306,29.1004654325751,0.255040974510198
513.72,570,5366,5378,25177272,30267384,2025-04-17,2025-12-19,525.66,12,5090112,1076181448,187344700,2.81247962936451,53.6546900221235,0.168171520868801
439.1,450,26480,26659,23222960,29058310,2025-04-17,2025-09-19,525.66,179,5835350.00000001,1699576882,316242446,1.70973789463441,86.4402317752872,0.200815188495133
524.95,560,8226,8206,19783530,28762030,2025-04-17,2025-05-02,525.66,-20,8978500,204772860,42617637,14.0458213065931,14.0458213065931,0.312165031466833
520,550,9529,9404,21916700,28212000,2025-04-17,2025-05-30,525.66,-125,6295300,542920959,126942613,5.19633650761307,34.2968019401881,0.223142634339997
520.76,580,4721,4707,21971534,27884268,2025-04-17,2025-07-18,525.66,-14,5912734,781158455,167554530,3.56960458169783,63.7430459611424,0.212045516131175
519.29,585,4214,4214,23172786,27690194,2025-04-17,2025-12-19,525.66,0,4517408,1076181448,187344700,2.57300421331924,56.2276942354427,0.163141074417897
506.3,535,9452,9609,21730148,27577830,2025-04-17,2025-07-18,525.66,157,5847682,781158455,167554530,3.53037592097752,67.2734218821199,0.212042861965572
495.55,505,31085,28947,22256860,27354915,2025-04-17,2025-05-16,525.66,-2138,5098055,2098065603,598425916,1.30381599893185,70.9689519179444,0.186367056889045
540.92,605,4245,4245,27201960,27201960,2025-04-17,2025-09-19,525.66,0,0,1699576882,316242446,1.60051365066755,88.0407454259548,0
525.57,590,4199,4206,24266021,27099258,2025-04-17,2025-12-19,525.66,7,2833237,1076181448,187344700,2.51809377037319,58.7457880058159,0.104550353371299
409.35,420,25253,25352,21843845,26999880,2025-04-17,2025-12-19,525.66,99,5156035,1076181448,187344700,2.50885945396821,61.2546474597841,0.190965107993073
518.57,580,4262,4263,19758632,26187609,2025-04-17,2025-08-15,525.66,1,6428977,650394247,116470886,4.02642076260555,14.277289263907,0.245496906571348
462.43,470,33132,34166,20144256,25863662,2025-04-17,2025-06-20,525.66,1034,5719406,2210385665,443310327,1.17009725540362,88.8690074815519,0.221136743899607
475.01,485,25516,25528,19979028,25502472,2025-04-17,2025-06-20,525.66,12,5523444,2210385665,443310327,1.15375666806996,90.0227641496218,0.216584651087942
517.3,595,3190,3188,19624880,24770760,2025-04-17,2025-12-19,525.66,-2,5145880,1076181448,187344700,2.30172709686034,63.5563745566445,0.207740093561925
441.81,445,7262,77332,1822762,24668908,2025-04-17,2025-05-30,525.66,70070,22846146,542920959,126942613,4.54373838236737,38.8405403225555,0.926110957161136
491.2,530,6251,6296,19621889,24428480,2025-04-17,2025-12-19,525.66,45,4806591,1076181448,187344700,2.26992205128591,65.8262966079304,0.196761771506045
435.27,450,15376,16095,18528080,23707935,2025-04-17,2025-12-19,525.66,719,5179855,1076181448,187344700,2.20296819314804,68.0292648010784,0.218486131331134
499.9,545,5162,5161,18578038,23276110,2025-04-17,2025-12-19,525.66,-1,4698072,1076181448,187344700,2.16284252467433,70.1921073257527,0.201840943353507
483.1,500,14674,13765,19575116,23262850,2025-04-17,2025-07-18,525.66,-909,3687734,781158455,167554530,2.97799375416093,70.2514156362809,0.158524600382154
480.02,510,7436,7747,18344612,23225506,2025-04-17,2025-12-19,525.66,311,4880894,1076181448,187344700,2.15814034363469,72.3502476693875,0.210152321331557
515.46,545,7534,7828,15369360,23123912,2025-04-17,2025-05-30,525.66,294,7754552,542920959,126942613,4.25916730910364,43.0997076316591,0.335347756037127
513,532,12161,12157,16417350,23098300,2025-04-17,2025-05-16,525.66,-4,6680950,2098065603,598425916,1.10093316276536,72.0698850807098,0.289239900771918
524.68,585,3795,3794,18697965,22885408,2025-04-17,2025-07-18,525.66,-1,4187443,781158455,167554530,2.92967551634578,73.1810911526267,0.182974365150055
519.95,565,5025,5026,18311100,22642130,2025-04-17,2025-07-18,525.66,1,4331030,781158455,167554530,2.89853228305645,76.0796234356831,0.19128191561483
524.7,590,3298,3301,17538764,21555530,2025-04-17,2025-07-18,525.66,3,4016766,781158455,167554530,2.75943118352345,78.8390546192066,0.186345035357516
449.35,455,34926,37626,16240590,21258690,2025-04-17,2025-06-20,525.66,2700,5018100,2210385665,443310327,0.961763837714719,90.9845279873366,0.236049352053207
521.33,585,3337,3319,16574879,21132073,2025-04-17,2025-08-15,525.66,-18,4557194,650394247,116470886,3.24911745414009,17.5264067180471,0.215652955580837
500.49,525,8479,8582,16661235,21034482,2025-04-17,2025-07-18,525.66,103,4373247,781158455,167554530,2.69272922354787,81.5317838427544,0.207908471432765
490.29,525,5801,6052,16950522,21006492,2025-04-17,2025-12-19,525.66,251,4055970,1076181448,187344700,1.95194704750197,74.3021947168894,0.193081738731055
514.28,565,4059,4054,18647046,20561888,2025-04-17,2025-12-19,525.66,-5,1914842,1076181448,187344700,1.91063393986327,76.2128286567527,0.0931257868927211
457.7,470,16598,16606,16515010,20425380,2025-04-17,2025-08-15,525.66,8,3910370,650394247,116470886,3.14046135774015,20.6668680757873,0.191446621800916
483.01,495,16328,16514,15723864,19800286,2025-04-17,2025-06-20,525.66,186,4076422,2210385665,443310327,0.895784220533298,91.8803122078699,0.20587692521209
515.95,565,3998,3992,15968012,19580760,2025-04-17,2025-08-15,525.66,-6,3612748,650394247,116470886,3.01059858544536,23.6774666612326,0.184504993677467
538.08,620,2383,2371,19187916,19423232,2025-04-17,2025-12-19,525.66,-12,235316,1076181448,187344700,1.80482873367652,78.0176573904292,0.0121151824783846
523.3,547.5,7969,7970,13077129,19287400,2025-04-17,2025-05-02,525.66,1,6210271,204772860,42617637,9.41892397263973,23.4647452792328,0.321985907898421
391.59,400,23988,22621,17199396,19024261,2025-04-17,2025-12-19,525.66,-1367,1824865,1076181448,187344700,1.76775589612283,79.785413286552,0.09592304268744
437.96,455,11305,11096,14436485,18907584,2025-04-17,2025-12-19,525.66,-209,4471099,1076181448,187344700,1.75691413702943,81.5423274235815,0.236471195896842
540.28,576,5246,5246,18738712,18738712,2025-04-17,2025-05-30,525.66,0,0,542920959,126942613,3.45146225972094,46.5511698913801,0
466.08,470,48618,47779,14779872,18729368,2025-04-17,2025-05-16,525.66,-839,3949496,2098065603,598425916,0.89269696682597,72.9625820475357,0.210871824398987
504.61,518,13793,13975,11613706,18712525,2025-04-17,2025-05-16,525.66,182,7098819,2098065603,598425916,0.891894179726467,73.8544762272622,0.379361897980096
500.9,530,6440,6409,14283920,18650190,2025-04-17,2025-08-15,525.66,-31,4366270,650394247,116470886,2.8675207516096,26.5449874128422,0.234113968812114
483.95,505,9125,8841,17666000,18610305,2025-04-17,2025-09-19,525.66,-284,944305,1699576882,316242446,1.09499636039413,89.1357417863489,0.0507409738851674
525.01,573,3832,3832,17113712,18389768,2025-04-17,2025-08-15,525.66,0,1276056,650394247,116470886,2.82748011453429,29.3724675273765,0.0693894561366953
459.55,475,11789,11869,14099644,18337605,2025-04-17,2025-09-19,525.66,80,4237961,1699576882,316242446,1.07895119039399,90.2146929767429,0.231107661005895
518.14,557,4579,4579,16154712,17793994,2025-04-17,2025-08-15,525.66,0,1639282,650394247,116470886,2.73587813577324,32.1083456631498,0.092125579001544
522.93,565,4239,4169,14187933,17538983,2025-04-17,2025-05-30,525.66,-70,3351050,542920959,126942613,3.23048552634712,49.7816554177272,0.191062959579812
507.06,521,9282,12531,9523332,17468214,2025-04-17,2025-05-16,525.66,3249,7944882,2098065603,598425916,0.832586644336688,74.6870628715989,0.454819365047852
494.55,535,3117,4277,10342206,17300465,2025-04-17,2025-12-19,525.66,1160,6958259,1076181448,187344700,1.60757881787979,83.1499062414613,0.402200692293531
506.3,540,4045,5044,11075210,16998280,2025-04-17,2025-08-15,525.66,999,5923070,650394247,116470886,2.61353480268407,34.7218804658338,0.348451137409197
512.8,535,7485,7534,12260430,16725480,2025-04-17,2025-05-30,525.66,49,4465050,542920959,126942613,3.08064732494514,52.8623027426723,0.266960948205971
511.15,550,4239,4291,12568635,16670535,2025-04-17,2025-08-15,525.66,52,4101900,650394247,116470886,2.5631430592897,37.2850235251235,0.246056890195786
474.01,495,8703,7938,13663710,16661862,2025-04-17,2025-09-19,525.66,-765,2998152,1699576882,316242446,0.980353532485858,91.1950465092288,0.179940993389574
521.07,590,8210,2398,42790520,16529414,2025-04-17,2025-06-20,525.66,-5812,-26261106,2210385665,443310327,0.747806786016231,92.6281189938861,-1.58874997020463
516,560,3681,3679,12865095,16187600,2025-04-17,2025-08-15,525.66,-2,3322505,650394247,116470886,2.48889040373077,39.7739139288543,0.205250006177568
513.86,575,2630,2625,14078390,16049250,2025-04-17,2025-12-19,525.66,-5,1970860,1076181448,187344700,1.49131450182739,84.6412207432887,0.122800753929311
470.76,480,15918,17019,11524632,15725556,2025-04-17,2025-06-20,525.66,1101,4200924,2210385665,443310327,0.711439467284095,93.3395584611702,0.267139934511695
524.25,580,2809,2809,11794991,15660175,2025-04-17,2025-05-30,525.66,0,3865184,542920959,126942613,2.88442999674286,55.7467327394152,0.246816143497758
500,511,14054,14099,11341578,15508900,2025-04-17,2025-05-16,525.66,45,4167322,2098065603,598425916,0.739199955321893,75.4262628269208,0.268705195081534
497.32,500,50877,54847,13075389,14698996,2025-04-17,2025-04-25,525.66,3970,1623607,186785929,41175251,7.86943431911298,34.262396714048,0.110456999920267
444.72,450,28074,27317,11931450,14423376,2025-04-17,2025-06-20,525.66,-757,2491926,2210385665,443310327,0.652527575996563,93.9920860371667,0.172769953442245
520.87,563,3381,3381,13236615,14244153,2025-04-17,2025-08-15,525.66,0,1007538,650394247,116470886,2.19007979632391,41.9639937251782,0.0707334441015903
493.95,503,6623,15702,3894324,14210310,2025-04-17,2025-05-16,525.66,9079,10315986,2098065603,598425916,0.677305322563834,76.1035681494846,0.725950806140049
475.94,490,10012,10100,11523812,14200600,2025-04-17,2025-07-18,525.66,88,2676788,781158455,167554530,1.8178898159657,83.3496736587201,0.188498232469051
521.74,595,5424,1907,30916800,13970682,2025-04-17,2025-06-20,525.66,-3517,-16946118,2210385665,443310327,0.632047258594577,94.6241332957613,-1.21297714742917
467.55,485,5641,8002,8207655,13963490,2025-04-17,2025-09-19,525.66,2361,5755835,1699576882,316242446,0.821586251724504,92.0166327609533,0.412206045909726
522.56,595,1885,1884,10424050,13647696,2025-04-17,2025-07-18,525.66,-1,3223646,781158455,167554530,1.74710981013449,85.0967834688546,0.236204411352656
479.18,485,19913,23399,8602416,13618218,2025-04-17,2025-05-16,525.66,3486,5015802,2098065603,598425916,0.649084470024553,76.7526526195092,0.368315590189553
501.3,531,4217,4575,9530420,13587750,2025-04-17,2025-08-15,525.66,358,4057330,650394247,116470886,2.08915593313973,44.0531496583179,0.298602049640301
480.87,500,5281,7045,8375666,13477085,2025-04-17,2025-08-15,525.66,1764,5101419,650394247,116470886,2.0721408687368,46.1252905270547,0.378525400707942
517.81,535,2354,7831,2768304,13461489,2025-04-17,2025-05-02,525.66,5477,10693185,204772860,42617637,6.57386384113598,30.0386091203688,0.794353804397121
458.81,480,6287,6300,11058833,13349700,2025-04-17,2025-12-19,525.66,13,2290867,1076181448,187344700,1.24046925588704,85.8816899991757,0.171604380622786
517.7,542,5117,5484,8816591,13326120,2025-04-17,2025-05-16,525.66,367,4509529,2098065603,598425916,0.635162217089167,77.3878148365983,0.338397748181766
508.21,523,8904,9009,8601264,13324311,2025-04-17,2025-05-16,525.66,105,4723047,2098065603,598425916,0.63507599480911,78.0228908314074,0.354468384894348
498.79,512,9015,9834,7374270,12990714,2025-04-17,2025-05-16,525.66,819,5616444,2098065603,598425916,0.61917577703122,78.6420666084387,0.432342979762313
413.84,425,11405,11432,11872605,12758112,2025-04-17,2025-12-19,525.66,27,885507,1076181448,187344700,1.18549822836195,87.0671882275376,0.0694073699933031
497.72,508,4613,12346,3035354,12691688,2025-04-17,2025-05-16,525.66,7733,9656334,2098065603,598425916,0.604923315164802,79.2469899236035,0.760839220125802
514.53,540,5468,4948,10170480,12602556,2025-04-17,2025-05-30,525.66,-520,2432076,542920959,126942613,2.3212505966269,58.0679833360421,0.192982756831233
494.33,520,4653,4909,9385101,12601403,2025-04-17,2025-08-15,525.66,256,3216302,650394247,116470886,1.93750222393957,48.0627927509943,0.255233643428434
434.5,445,11966,11958,10206998,12555900,2025-04-17,2025-09-19,525.66,-8,2348902,1699576882,316242446,0.738766226640167,92.7553989875934,0.187075558104158
483.65,515,3994,3981,10068874,12480435,2025-04-17,2025-12-19,525.66,-13,2411561,1076181448,187344700,1.15969616677503,88.2268843943127,0.193227319400325
435.5,440,28439,27706,10493991,12467700,2025-04-17,2025-06-20,525.66,-733,1973709,2210385665,443310327,0.564050889282256,95.1881841850436,0.158305782141052
472.62,490,7092,7146,9453636,12419748,2025-04-17,2025-08-15,525.66,54,2966112,650394247,116470886,1.90957224134241,49.9723649923367,0.238822236972924
517.29,539,5457,5694,8780313,12361674,2025-04-17,2025-05-16,525.66,237,3581361,2098065603,598425916,0.589193873743709,79.8361837973472,0.289714888129229
423.41,425,76559,76721,9187080,12198639,2025-04-17,2025-05-16,525.66,162,3011559,2098065603,598425916,0.581423144374385,80.4176069417215,0.246876639270988
466.66,475,13881,14405,9022650,12013770,2025-04-17,2025-06-20,525.66,524,2991120,2210385665,443310327,0.543514654036629,95.7316988390802,0.248974301988468
467.03,470,36999,39793,8916759,11818521,2025-04-17,2025-05-09,525.66,2794,2901762,114289278,33592363,10.3408834204027,10.3408834204027,0.245526661077135
455.56,470,7629,8162,9139542,11785928,2025-04-17,2025-09-19,525.66,533,2646386,1699576882,316242446,0.693462480269251,93.4488614678627,0.224537770805998
519.45,558,3090,2988,7103910,11518740,2025-04-17,2025-05-16,525.66,-102,4414830,2098065603,598425916,0.549017151014224,80.9666240927358,0.38327369139333
524.27,572,2394,2391,9906372,11412243,2025-04-17,2025-08-15,525.66,-3,1505871,650394247,116470886,1.75466542833673,51.7270304206735,0.131952237610082
394.08,400,7433,18947,3671902,11216624,2025-04-17,2025-09-19,525.66,11514,7544722,1699576882,316242446,0.659965672562025,94.1088271404247,0.672637506615181
525.01,570,2787,2451,8812494,11027049,2025-04-17,2025-05-30,525.66,-336,2214555,542920959,126942613,2.0310597366347,60.0990430726768,0.20082934246506
451.5,465,8134,8164,9118214,11021400,2025-04-17,2025-09-19,525.66,30,1903186,1699576882,316242446,0.6484790489166,94.7573061893413,0.172680966120456
520.18,568,2235,2291,10584960,10955562,2025-04-17,2025-05-16,525.66,56,370602,2098065603,598425916,0.522174425067299,81.4887985178031,0.0338277488640017
438.46,440,70755,71098,8066070,10949092,2025-04-17,2025-05-09,525.66,343,2883022,114289278,33592363,9.58015676676162,19.9210401871644,0.263311514781317
526.07,590,1741,1710,8692813,10932030,2025-04-17,2025-05-16,525.66,-31,2239217,2098065603,598425916,0.521052820482277,82.0098513382854,0.204830850262943
469.06,475,18104,18039,7965760,10715166,2025-04-17,2025-05-30,525.66,-65,2749406,542920959,126942613,1.9736143581077,62.0726574307845,0.256590145220335
451.23,470,5680,5670,9042560,10642590,2025-04-17,2025-12-19,525.66,-10,1600030,1076181448,187344700,0.988921526177433,89.2158059204901,0.150342162950936
490.16,510,5190,5340,7925130,10594560,2025-04-17,2025-07-18,525.66,150,2669430,781158455,167554530,1.35626260359686,86.4530460724515,0.251962327836173
446.14,460,7555,7607,7562555,10543302,2025-04-17,2025-09-19,525.66,52,2980747,1699576882,316242446,0.620348635690609,95.3776548250319,0.282714751033405
523.97,575,2025,2034,7194825,10379502,2025-04-17,2025-05-30,525.66,9,3184677,542920959,126942613,1.91178878397288,63.9844462147574,0.306823679980022
521.99,567,2241,2292,6528033,10316292,2025-04-17,2025-05-16,525.66,51,3788259,2098065603,598425916,0.491704929781455,82.5015562680668,0.367211300339308
447.46,450,47789,40199,9318855,10210546,2025-04-17,2025-05-16,525.66,-7590,891691,2098065603,598425916,0.486664763265746,82.9882210313325,0.0873303934970765
453.58,460,15082,15752,7706902,10112784,2025-04-17,2025-06-20,525.66,670,2405882,2210385665,443310327,0.45751219618048,96.1892110352607,0.237905012111403
506.28,515,3773,11534,2399628,10057648,2025-04-17,2025-05-02,525.66,7761,7658020,204772860,42617637,4.91161182199633,34.9502209423651,0.761412608593978
417.05,425,12411,12629,8005095,10040055,2025-04-17,2025-09-19,525.66,218,2034960,1699576882,316242446,0.590738501231273,95.9683933262632,0.202684148642612
505.78,545,2496,2557,6966336,10028554,2025-04-17,2025-08-15,525.66,61,3062218,650394247,116470886,1.5419192353342,53.2689496560077,0.305349903884448
462.25,465,36002,36141,7632424,9938775,2025-04-17,2025-05-09,525.66,139,2306351,114289278,33592363,8.69615695708569,28.6171971442501,0.232055862015188
500.7,515,6541,6725,7018493,9616750,2025-04-17,2025-05-30,525.66,184,2598257,542920959,126942613,1.77129835210506,65.7557445668625,0.270180362388541
532.24,578,2086,2086,9545536,9545536,2025-04-17,2025-08-15,525.66,0,0,650394247,116470886,1.46765381828477,54.7366034742924,0
490.09,498,11914,11970,7207970,9468270,2025-04-17,2025-05-16,525.66,56,2260300,2098065603,598425916,0.451285697952506,83.4395067292851,0.238723652789792
517.83,556,2476,2450,8202988,9351650,2025-04-17,2025-08-15,525.66,-26,1148662,650394247,116470886,1.43784328399817,56.1744467582906,0.122829874941855
497.25,510,7294,7314,6746950,9325350,2025-04-17,2025-05-30,525.66,20,2578400,542920959,126942613,1.71762571428008,67.4733702811425,0.276493643670211
496.68,507,8938,8989,6739252,9276648,2025-04-17,2025-05-16,525.66,51,2537396,2098065603,598425916,0.442152427776111,83.8816591570612,0.27352509225315
524.45,569,1976,2079,6416072,9261945,2025-04-17,2025-05-16,525.66,103,2845873,2098065603,598425916,0.441451639393756,84.3231107964549,0.307265158668077
428.72,430,71436,71395,7429344,9138560,2025-04-17,2025-05-09,525.66,-41,1709216,114289278,33592363,7.99599066502109,36.6131878092711,0.187033405700679
500.36,513,10675,7207,9095100,9109648,2025-04-17,2025-05-16,525.66,-3468,14548.0000000019,2098065603,598425916,0.43419271480235,84.7573035112573,0.00159698816024525
443.03,460,5362,5351,8209222,9080647,2025-04-17,2025-12-19,525.66,-11,871425,1076181448,187344700,0.843784012154798,90.0595899326449,0.0959650782592914
488.07,510,4079,4130,7179040,9057090,2025-04-17,2025-08-15,525.66,51,1878050,650394247,116470886,1.39255383050767,57.5670005887983,0.207356888360389
494.1,515,4340,4321,7143640,9030890,2025-04-17,2025-07-18,525.66,-19,1887250,781158455,167554530,1.15608938777985,87.6091354602313,0.208977188294841
518.6,530,5057,7814,3883776,8907960,2025-04-17,2025-04-25,525.66,2757,5024184,186785929,41175251,4.76907444136223,39.0314711554102,0.564010615225035
433.6,440,11537,13818,6068462,8843520,2025-04-17,2025-07-18,525.66,2281,2775058,781158455,167554530,1.13210321713794,88.7412386773693,0.313795637936026
461.68,485,3763,3753,6957787,8751996,2025-04-17,2025-12-19,525.66,-10,1794209,1076181448,187344700,0.813245388708838,90.8728353213537,0.205005692415764
447.12,465,4850,4849,7279850,8670012,2025-04-17,2025-12-19,525.66,-1,1390162,1076181448,187344700,0.805627342499961,91.6784626638537,0.160341415905768
489.72,500,7182,8356,5716872,8589968,2025-04-17,2025-05-30,525.66,1174,2873096,542920959,126942613,1.58217653188813,69.0555468130307,0.33447109465367
536.62,590,1606,1606,8572828,8572828,2025-04-17,2025-08-15,525.66,0,0,650394247,116470886,1.31809714485374,58.885097733652,0
451.37,460,9724,9898,6680388,8541974,2025-04-17,2025-07-18,525.66,174,1861586,781158455,167554530,1.09350080580002,89.8347394831693,0.217933934240493
520.63,548,3013,3075,5932597,8416275,2025-04-17,2025-05-16,525.66,62,2483678,2098065603,598425916,0.401144510827768,85.158448022085,0.29510418801667
504.09,520,4196,5243,5089748,8341613,2025-04-17,2025-05-30,525.66,1047,3251865,542920959,126942613,1.53643230413582,70.5919791171665,0.38983647407282
486.83,505,4868,4585,6834672,8330945,2025-04-17,2025-07-18,525.66,-283,1496273,781158455,167554530,1.06648592826151,90.9012254114308,0.179604234573629
509.92,530,4264,4143,6391736,8319144,2025-04-17,2025-05-30,525.66,-121,1927408,542920959,126942613,1.53229376433044,72.1242728814969,0.23168345204747
503.45,516,6419,6602,5802776,8285510,2025-04-17,2025-05-16,525.66,183,2482734,2098065603,598425916,0.394911864917505,85.5533598870026,0.299647698210491
537.39,595,1438,1438,8284318,8284318,2025-04-17,2025-08-15,525.66,0,0,650394247,116470886,1.27373789639317,60.1588356300452,0
512.61,546,2408,2436,7216776,8133804,2025-04-17,2025-08-15,525.66,28,917028.000000002,650394247,116470886,1.25059593277737,61.4094315628226,0.112742819964681
503.67,535,2040,2567,4981680,8042411,2025-04-17,2025-08-15,525.66,527,3060731,650394247,116470886,1.23654399421525,62.6459755570378,0.38057381051528
515.5,541,2672,3128,4502320,7976400,2025-04-17,2025-05-16,525.66,456,3474080,2098065603,598425916,0.380178769843738,85.9335386568463,0.435544857329121
521.25,562,1954,1949,5393040,7942175,2025-04-17,2025-05-16,525.66,-5,2549135,2098065603,598425916,0.378547505313636,86.3120861621599,0.320961827207283
489.35,497,3753,10243,2127951,7835895,2025-04-17,2025-05-16,525.66,6490,5707944,2098065603,598425916,0.373481886781593,86.6855680489415,0.728435488224383
512.65,520,5772,10650,3082248,7827750,2025-04-17,2025-04-25,525.66,4878,4745502,186785929,41175251,4.19076000098487,43.2222311563951,0.606240873814314
504.16,517,2261,6072,1971592,7796448,2025-04-17,2025-05-16,525.66,3811,5824856,2098065603,598425916,0.371601726316467,87.057169775258,0.747116635678196
517.34,554,2086,2123,6310150,7782918,2025-04-17,2025-05-30,525.66,37,1472768,542920959,126942613,1.43352690128877,73.5577997827857,0.189230825764835
402.75,410,10633,10637,5933214,7711825,2025-04-17,2025-09-19,525.66,4,1778611,1699576882,316242446,0.453749699803224,96.4221430260664,0.230634253240964
470.53,475,20008,17160,6862744,7670520,2025-04-17,2025-05-16,525.66,-2848,807776,2098065603,598425916,0.365599626104732,87.4227694013627,0.105309157658151
468.41,495,2783,2785,5663405,7405315,2025-04-17,2025-12-19,525.66,2,1741910,1076181448,187344700,0.688110263725713,92.3665729275794,0.235224294982725
467.97,480,6920,6139,6719320,7385217,2025-04-17,2025-07-18,525.66,-781,665896.999999999,781158455,167554530,0.945418557877608,91.8466439693084,0.0901662063552092
522.77,568,1618,1618,6790746,7318214,2025-04-17,2025-08-15,525.66,0,527468.000000001,650394247,116470886,1.1251966070973,63.7711721641351,0.0720760557152334
428.26,430,38932,41554,5022228,7230396,2025-04-17,2025-05-16,525.66,2622,2208168,2098065603,598425916,0.34462201704567,87.7673914184084,0.305400700044645
519.07,575,1284,1290,5654736,7214970,2025-04-17,2025-08-15,525.66,6,1560234,650394247,116470886,1.10932254294679,64.8804947070819,0.216249547815168
512.59,531,3488,3887,4199552,7155967,2025-04-17,2025-05-16,525.66,399,2956415,2098065603,598425916,0.341074511195826,88.1084659296042,0.413139831416215
468.86,485,4366,4403,5226102,7106442,2025-04-17,2025-08-15,525.66,37,1880340,650394247,116470886,1.09263604848583,65.9731307555677,0.264596544937678
496.02,525,2462,2444,5170200,7082712,2025-04-17,2025-08-15,525.66,-18,1912512,650394247,116470886,1.08898749222793,67.0621182477956,0.270025380108636
512.84,555,1669,1662,6136913,7006992,2025-04-17,2025-08-15,525.66,-7,870079,650394247,116470886,1.07734532282848,68.1394635706241,0.124172968943022
524.6,600,1818,921,10771650,6944340,2025-04-17,2025-06-20,525.66,-897,-3827310,2210385665,443310327,0.314168704129738,96.5033797393904,-0.551140929159574
496.35,506,1059,7187,769893,6935455,2025-04-17,2025-05-16,525.66,6128,6165562,2098065603,598425916,0.330564258337922,88.4390301879421,0.888991709988746
522.93,540,3555,3990,3963825,6810930,2025-04-17,2025-04-25,525.66,435,2847105,186785929,41175251,3.64638280649074,46.8686139628858,0.418020006078465
501.43,534,2011,2065,5278875,6725705,2025-04-17,2025-08-15,525.66,54,1446830,650394247,116470886,1.03409663154662,69.1735602021707,0.215119455878603
521.44,555,1926,2004,4497210,6725424,2025-04-17,2025-05-30,525.66,78,2228214,542920959,126942613,1.23874827237974,74.7965480551654,0.331312048132579
486.92,494,9585,9480,4639140,6711840,2025-04-17,2025-05-16,525.66,-105,2072700,2098065603,598425916,0.319906107340153,88.7589362952823,0.30881248659086
430.79,435,17682,15827,5622876,6663167,2025-04-17,2025-06-20,525.66,-1855,1040291,2210385665,443310327,0.301448163798149,96.8048279031886,0.156125608137992
492.6,501,1600,7893,1048000,6630120,2025-04-17,2025-05-16,525.66,6293,5582120,2098065603,598425916,0.316011090907723,89.07494738619,0.841933479333708
523.86,573,1295,1348,4203570,6624072,2025-04-17,2025-05-16,525.66,53,2420502,2098065603,598425916,0.315722825374398,89.3906702115644,0.365409977427782
522.74,566,1523,1526,3824253,6601476,2025-04-17,2025-05-02,525.66,3,2777223,204772860,42617637,3.22380417014247,38.1740251125076,0.420697280426377
531.6,566,1804,1909,5541888,6566960,2025-04-17,2025-05-16,525.66,105,1025072,2098065603,598425916,0.313000698863276,89.7036709104277,0.156095362237626
491.13,515,2818,2743,5140032,6547541,2025-04-17,2025-08-15,525.66,-75,1407509,650394247,116470886,1.00670340031467,70.1802636024854,0.214967573322565
467.96,470,37178,31927,6468972,6513108,2025-04-17,2025-05-02,525.66,-5251,44136,204772860,42617637,3.18065001387391,41.3546751263815,0.00677648827564352
458.1,465,9281,9435,5160236,6510150,2025-04-17,2025-06-20,525.66,154,1349914,2210385665,443310327,0.294525525707298,97.0993534288959,0.207355283672419
408.18,410,605,35650,87725,6488300,2025-04-17,2025-05-30,525.66,35045,6400575,542920959,126942613,1.19507266986906,75.9916207250345,0.986479509270533
454.81,475,3047,3209,5061067,6478971,2025-04-17,2025-12-19,525.66,162,1417904,1076181448,187344700,0.602033329234644,92.968606256814,0.218847097787596
514.33,549,1829,1856,6227745,6434752,2025-04-17,2025-08-15,525.66,27,207007,650394247,116470886,0.98936176475743,71.1696253672428,0.0321701597823817
525.74,577,1225,1232,5635000,6315232,2025-04-17,2025-05-30,525.66,7,680232,542920959,126942613,1.16319546985844,77.1548161948929,0.107712907459298
396.47,400,18446,17672,5478462,6238216,2025-04-17,2025-07-18,525.66,-774,759754,781158455,167554530,0.798585224299979,92.6452291936084,0.121790268243357
508.81,527,1952,3396,2318976,6177324,2025-04-17,2025-05-16,525.66,1444,3858348,2098065603,598425916,0.294429496921694,89.9981004073494,0.624598612603127
437.87,440,27119,28970,4339040,6170610,2025-04-17,2025-05-16,525.66,1851,1831570,2098065603,598425916,0.294109487862377,90.2922098952117,0.296821546005986
520.98,564,1409,1407,5435922,6052914,2025-04-17,2025-08-15,525.66,-2,616992.000000001,650394247,116470886,0.930653065878057,72.1002784331209,0.101933052410789
509.75,520,7573,5890,5672177,6037250,2025-04-17,2025-05-02,525.66,-1683,365073,204772860,42617637,2.94826667948086,44.3029418058624,0.0604700815768769
519.94,561,1469,1469,5620394,6031714,2025-04-17,2025-08-15,525.66,0,411320.000000002,650394247,116470886,0.927393504450847,73.0276719375717,0.0681928884559185
526.31,600,792,806,4909608,5939414,2025-04-17,2025-05-30,525.66,14,1029806,542920959,126942613,1.09397397568511,78.248790170578,0.173385118464549
516.43,538,2267,2704,3547855,5832528,2025-04-17,2025-05-16,525.66,437,2284673,2098065603,598425916,0.277995501745042,90.5702053969568,0.39171230725339
463.88,475,5117,5196,4431322,5777952,2025-04-17,2025-07-18,525.66,79,1346630,781158455,167554530,0.73966452811421,93.3848937217226,0.233063549160671
525.36,550,2329,2338,3726400,5760832,2025-04-17,2025-04-25,525.66,9,2034432,186785929,41175251,3.08418949480932,49.9528034576952,0.353148989590393
433.93,435,53482,53544,4492488,5729208,2025-04-17,2025-05-02,525.66,62,1236720,204772860,42617637,2.79783561161377,47.1007774174761,0.215862297197099
429.54,440,5640,5371,4517640,5618066,2025-04-17,2025-09-19,525.66,-269,1100426,1699576882,316242446,0.330556743828433,96.7526997698948,0.195872743396037
397.57,400,22792,22649,4467232,5503707,2025-04-17,2025-06-20,525.66,-143,1036475,2210385665,443310327,0.248993064294054,97.3483464931899,0.188323070250651
523.23,559,1641,1530,3857991,5472810,2025-04-17,2025-05-16,525.66,-111,1614819,2098065603,598425916,0.260850279999562,90.8310556769564,0.295062134442818
514.32,534,1852,2728,2361300,5368704,2025-04-17,2025-05-16,525.66,876,3007404,2098065603,598425916,0.255888280725033,91.0869439576814,0.560173181460554
382.05,390,6674,6679,4197946,5309805,2025-04-17,2025-12-19,525.66,5,1111859,1076181448,187344700,0.4933930992648,93.4619993560788,0.209397331917085
529.21,569,1314,1314,4107564,5228406,2025-04-17,2025-05-30,525.66,0,1120842,542920959,126942613,0.963014212903135,79.2118043834812,0.214375471223926
523.89,547,2275,2231,4331600,5155841,2025-04-17,2025-05-16,525.66,-44,824241,2098065603,598425916,0.245742601786509,91.3326865594679,0.159865480723707
494.96,523,1896,1838,4057440,5153752,2025-04-17,2025-08-15,525.66,-58,1096312,650394247,116470886,0.792404303047287,73.820076240619,0.212721139860824
494.11,505,4715,4720,3772000,5140080,2025-04-17,2025-05-23,525.66,5,1368080,27519740,10743122,18.6777927407744,18.6777927407744,0.266159281567602
488.35,496,6572,6686,3640888,5114790,2025-04-17,2025-05-16,525.66,114,1473902,2098065603,598425916,0.243785989946474,91.5764725494144,0.288164714484857
523.69,550,1952,1935,3238368,5090985,2025-04-17,2025-05-02,525.66,-17,1852617,204772860,42617637,2.48616198455205,49.5869394020282,0.36390148468322
523.07,565,1195,1213,2985110,5086109,2025-04-17,2025-05-02,525.66,18,2100999,204772860,42617637,2.48378080962487,52.0707202116531,0.413085720341424
475.18,481,8650,8708,3373500,5068056,2025-04-17,2025-05-16,525.66,58,1694556,2098065603,598425916,0.241558509550571,91.8180310589649,0.334360157030625
536.5,571,1468,1467,5519680,5061150,2025-04-17,2025-05-30,525.66,-1,-458530,542920959,126942613,0.932207518627034,80.1440119021082,-0.0905979866235934
426.88,440,3802,3806,4277250,4993472,2025-04-17,2025-12-19,525.66,4,716221.999999999,1076181448,187344700,0.463999078341295,93.9259984344201,0.143431664381016
521.87,579,861,861,5614581,4918893,2025-04-17,2025-05-30,525.66,0,-695688,542920959,126942613,0.906005362007032,81.0500172641152,-0.141431822159986
481.87,488,7641,7974,3262707,4888062,2025-04-17,2025-05-16,525.66,333,1625355,2098065603,598425916,0.232979464179319,92.0510105231443,0.332515217687501
502.56,510,5288,6563,2913688,4882872,2025-04-17,2025-05-02,525.66,1275,1969184,204772860,42617637,2.38453084065926,54.4552510523123,0.403283968942868
505.49,510,9849,10722,3594885,4835622,2025-04-17,2025-04-25,525.66,873,1240737,186785929,41175251,2.58885775062853,52.5416612083237,0.256582710559262
493.22,502,5394,5491,3096156,4821098,2025-04-17,2025-05-16,525.66,97,1724942,2098065603,598425916,0.229787762265697,92.28079828541,0.357790279309817
525.87,610,572,571,4584008,4803823,2025-04-17,2025-07-18,525.66,-1,219815,781158455,167554530,0.614961403701378,93.999855125424,0.0457583470498393
525.76,556,1679,1574,3448666,4759776,2025-04-17,2025-04-25,525.66,-105,1311110,186785929,41175251,2.5482519082045,55.0899131165282,0.275456239957511
486.29,490,9919,12786,3045133,4743606,2025-04-17,2025-05-02,525.66,2867,1698473,204772860,42617637,2.31652085144486,56.7717719037572,0.358055243205275
461.85,475,3615,3601,3882510,4735315,2025-04-17,2025-08-15,525.66,-14,852805,650394247,116470886,0.72806840187195,74.548144642491,0.180094671632193
522.34,556,1452,1400,3195852,4712400,2025-04-17,2025-05-16,525.66,-52,1516548,2098065603,598425916,0.224606894715866,92.5054051801258,0.321820728291316
519.5,552,1448,1446,4878312,4699500,2025-04-17,2025-05-30,525.66,-2,-178812,542920959,126942613,0.865595612417682,81.9156128765329,-0.0380491541653367
522.89,572,850,948,2757400,4655628,2025-04-17,2025-05-16,525.66,98,1898228,2098065603,598425916,0.221900973608402,92.7273061537342,0.407727593355827
533.15,576,1080,1080,4857840,4627800,2025-04-17,2025-08-15,525.66,0,-230039.999999999,650394247,116470886,0.711537659096176,75.2596823015872,-0.0497082847141188
523.79,563,1022,1178,2993438,4618938,2025-04-17,2025-05-16,525.66,156,1625500,2098065603,598425916,0.220152219901772,92.947458373636,0.351920722902104
513.92,551,1231,1238,4014291,4590504,2025-04-17,2025-08-15,525.66,7,576213.000000001,650394247,116470886,0.705803291030648,75.9654855926178,0.125522818409482
496.82,526,1626,1573,4065000,4590014,2025-04-17,2025-08-15,525.66,-53,525014,650394247,116470886,0.705727952110868,76.6712135447287,0.114381786199345
513.59,536,1820,2034,2695420,4558194,2025-04-17,2025-05-16,525.66,214,1862774,2098065603,598425916,0.217256981549209,93.1647153551852,0.408664922993624
421.55,430,5087,5388,3601596,4552860,2025-04-17,2025-09-19,525.66,301,951264,1699576882,316242446,0.267881968048563,97.0205817379434,0.208937678733807
516.2,535,2310,2410,3049200,4530800,2025-04-17,2025-05-09,525.66,100,1481600,114289278,33592363,3.96432638239258,40.5775141916637,0.327006268208705
482.7,489,6745,7142,3149915,4499460,2025-04-17,2025-05-16,525.66,397,1349545,2098065603,598425916,0.214457545730042,93.3791729009153,0.299934881074618
519.19,544,1700,1811,3026000,4493091,2025-04-17,2025-05-16,525.66,111,1467091,2098065603,598425916,0.214153980389144,93.5933268813044,0.326521541629137
509.2,515,7200,7708,3182400,4470640,2025-04-17,2025-04-25,525.66,508,1288240,186785929,41175251,2.39345652209166,57.4833696386198,0.288155610829769
339.97,345,8839,8836,3703541,4444508,2025-04-17,2025-12-19,525.66,-3,740967,1076181448,187344700,0.412988721210515,94.3389871556307,0.166715190972769
529.4,564,1329,1278,3921879,4421880,2025-04-17,2025-05-16,525.66,-51,500001,2098065603,598425916,0.210759853918638,93.804086735223,0.113074303237537
520.02,551,1399,1418,4960854,4392964,2025-04-17,2025-05-30,525.66,19,-567890,542920959,126942613,0.809135091798878,82.7247479683318,-0.129272627774778
484.45,491,6613,6669,3207305,4368195,2025-04-17,2025-05-16,525.66,56,1160890,2098065603,598425916,0.20820106834381,94.0122878035668,0.265759655876169
518.64,543,1807,1791,3122496,4362876,2025-04-17,2025-05-16,525.66,-16,1240380,2098065603,598425916,0.207947549102448,94.2202353526693,0.284303289848256
455.56,460,7312,9664,2508016,4290816,2025-04-17,2025-05-30,525.66,2352,1782800,542920959,126942613,0.790320566718074,83.5150685350499,0.415492064912595
442.55,455,3429,3446,3206115,4290270,2025-04-17,2025-09-19,525.66,17,1084155,1699576882,316242446,0.252431651985721,97.2730133899291,0.25270087896566
471.84,485,2807,3256,2978227,4284896,2025-04-17,2025-07-18,525.66,449,1306669,781158455,167554530,0.548530963541834,94.5483860889658,0.304947658006169
354.39,360,7607,7604,3773072,4265844,2025-04-17,2025-12-19,525.66,-3,492772,1076181448,187344700,0.396387059814843,94.7353742154455,0.115515710372906
519.43,558,1103,1104,3253850,4258128,2025-04-17,2025-05-30,525.66,1,1004278,542920959,126942613,0.784299800811337,84.2993683358612,0.235849650362789
507.55,522,2707,2943,2601427,4252635,2025-04-17,2025-05-16,525.66,236,1651208,2098065603,598425916,0.202693137617775,94.4229284902871,0.388278796557899
523.63,569,935,935,3938220,4242095,2025-04-17,2025-08-15,525.66,0,303875,650394247,116470886,0.652234397762132,77.3234479424908,0.0716332378223497
407.38,415,5888,5441,3532800,4146042,2025-04-17,2025-09-19,525.66,-447,613242,1699576882,316242446,0.243945539852313,97.5169589297814,0.147910223774868
522.71,585,4765,660,22133425,4111140,2025-04-17,2025-05-16,525.66,-4105,-18022285,2098065603,598425916,0.195949068233211,94.6188775585203,-4.38376824919609
517.54,553,1172,1140,2404944,4042440,2025-04-17,2025-05-16,525.66,-32,1637496,2098065603,598425916,0.192674623435023,94.8115521819553,0.40507614213198
493,500,3644,5742,1924032,4019400,2025-04-17,2025-05-09,525.66,2098,2095368,114289278,33592363,3.51686533534668,44.0943795270104,0.521313628899836
522.01,551,1377,1379,2627316,3997721,2025-04-17,2025-05-16,525.66,2,1370405,2098065603,598425916,0.190543183887277,95.0020953658426,0.342796558339114
481.76,490,4412,4844,2858976,3991456,2025-04-17,2025-05-30,525.66,432,1132480,542920959,126942613,0.735181785457651,85.0345501213189,0.283726038818917
437.01,440,10410,13344,2352660,3989856,2025-04-17,2025-05-30,525.66,2934,1637196,542920959,126942613,0.734887083259573,85.7694372045784,0.410339621279565
520.66,540,1807,2063,2461134,3989842,2025-04-17,2025-05-02,525.66,256,1528708,204772860,42617637,1.94842324319737,58.7201951469545,0.383150009448996
524.97,574,812,812,3005212,3981236,2025-04-17,2025-05-16,525.66,0,976024,2098065603,598425916,0.189757460124568,95.1918528259671,0.245156026922292
426.06,435,4642,4431,3476858,3961314,2025-04-17,2025-09-19,525.66,-211,484456,1699576882,316242446,0.23307648167928,97.7500354114607,0.122296793437733
503.65,538,1105,1147,3094000,3939945,2025-04-17,2025-08-15,525.66,42,845945.000000001,650394247,116470886,0.605777959779524,77.9292259022703,0.214709850010597
500.66,510,3755,4197,2662295,3919998,2025-04-17,2025-05-09,525.66,442,1257703,114289278,33592363,3.42989129741462,47.524270824425,0.320842765736105
484.76,493,4572,4745,2354580,3909880,2025-04-17,2025-05-16,525.66,173,1555300,2098065603,598425916,0.186356422526031,95.3782092484932,0.397787144362487
501.83,514,3041,3210,2669998,3906570,2025-04-17,2025-05-16,525.66,169,1236572,2098065603,598425916,0.186198658155114,95.5644079066483,0.316536501329811
522.52,554,1269,1237,2625561,3894076,2025-04-17,2025-05-16,525.66,-32,1268515,2098065603,598425916,0.185603157233592,95.7500110638819,0.325755070008906
459.7,470,3811,3771,3155508,3884130,2025-04-17,2025-07-18,525.66,-40,728622.000000001,781158455,167554530,0.497226903855249,95.045612992821,0.187589498806683
461.47,465,10886,11003,2884790,3884059,2025-04-17,2025-05-16,525.66,117,999269,2098065603,598425916,0.185125717444022,95.9351367813259,0.257274413184764
520.79,640,323,323,4299453,3850483,2025-04-17,2025-12-19,525.66,0,-448970.000000001,1076181448,187344700,0.357791244883084,95.0931654603286,-0.116600956295613
510.05,526,2260,2397,2415940,3823215,2025-04-17,2025-05-16,525.66,137,1407275,2098065603,598425916,0.182225712796265,96.1173624941222,0.368086806522783
508.89,539,1226,1260,3338398,3793860,2025-04-17,2025-08-15,525.66,34,455462,650394247,116470886,0.583316967746795,78.5125428700171,0.120052400457581
521.57,576,871,696,3267992,3788328,2025-04-17,2025-05-16,525.66,-175,520336,2098065603,598425916,0.18056289539198,96.2979253895142,0.137352415102388
524.08,553,1295,1305,2855475,3774060,2025-04-17,2025-05-30,525.66,10,918585.000000001,542920959,126942613,0.695139861049277,86.4645770656277,0.243394381647351
402.46,405,14781,14817,2926638,3763518,2025-04-17,2025-06-20,525.66,36,836880,2210385665,443310327,0.170265219305066,97.518611712495,0.222366413552426
416.67,420,10722,11189,2744832,3725937,2025-04-17,2025-06-20,525.66,467,981105.000000001,2210385665,443310327,0.168565018267977,97.687176730763,0.263317656739768
519.03,562,867,864,3283329,3712608,2025-04-17,2025-08-15,525.66,-3,429279,650394247,116470886,0.570824237318323,79.0833671073354,0.115627343366173
430.68,445,2592,2584,3079296,3700288,2025-04-17,2025-12-19,525.66,-8,620991.999999999,1076181448,187344700,0.343834955237028,95.4370004155656,0.167822612726361
524.94,600,562,492,3250046,3692952,2025-04-17,2025-07-18,525.66,-70,442906.000000001,781158455,167554530,0.472753252091472,95.5183662449125,0.119932780063212
515.92,530,2255,2620,2284315,3688960,2025-04-17,2025-05-02,525.66,365,1404645,204772860,42617637,1.80148873244238,60.5216838793969,0.38076991889313
525.76,560,1880,1072,4278880,3670528,2025-04-17,2025-04-25,525.66,-808,-608352,186785929,41175251,1.96509877358053,59.4484684122004,-0.165739642906961
516.32,532,2288,2331,2425280,3655008,2025-04-17,2025-05-02,525.66,43,1229728,204772860,42617637,1.78490841022585,62.3065922896228,0.336450152776683
519.29,538,2638,1951,2725054,3650321,2025-04-17,2025-04-25,525.66,-687,925267,186785929,41175251,1.95428050685767,61.402748919058,0.253475516262816
447.07,455,4550,4551,2957500,3608943,2025-04-17,2025-07-18,525.66,1,651443,781158455,167554530,0.461998839915264,95.9803650848278,0.180507976989384
521.89,552,1193,1181,2316806,3555991,2025-04-17,2025-05-16,525.66,-12,1239185,2098065603,598425916,0.169489028127401,96.4674144176416,0.348478103572253
508.78,524,2283,2324,2470206,3537128,2025-04-17,2025-05-16,525.66,41,1066922,2098065603,598425916,0.168589961864982,96.6360043795065,0.301635111876076
510.83,528,1358,2056,1670340,3530152,2025-04-17,2025-05-16,525.66,698,1859812,2098065603,598425916,0.168257465112258,96.8042618446188,0.526836238212972
442.63,450,4197,4787,2501412,3528019,2025-04-17,2025-07-18,525.66,590,1026607,781158455,167554530,0.451639354015569,96.4320044388433,0.290986811578963
517.77,570,679,675,2896614,3525525,2025-04-17,2025-08-15,525.66,-4,628911,650394247,116470886,0.542059683993484,79.6254267913289,0.178387899674517
525.4,610,417,416,2880636,3519360,2025-04-17,2025-06-20,525.66,-1,638724,2210385665,443310327,0.159219273619384,97.8463960043823,0.181488679759956
479.58,495,1710,2280,2108430,3515760,2025-04-17,2025-07-18,525.66,570,1407330,781158455,167554530,0.450070018124556,96.8820744569679,0.400291828793774
500.9,533,935,1090,2334695,3498900,2025-04-17,2025-08-15,525.66,155,1164205,650394247,116470886,0.537966013097284,80.1633928044262,0.33273457372317
521.55,549,1324,1274,2413652,3497130,2025-04-17,2025-05-16,525.66,-50,1083478,2098065603,598425916,0.166683539113338,96.9709453837321,0.309819194596712
527.34,561,1113,1036,3836511,3487176,2025-04-17,2025-05-16,525.66,-77,-349335.000000001,2098065603,598425916,0.166209102089741,97.1371544858219,-0.100177048706461
409.04,410,36142,36059,2457656,3461664,2025-04-17,2025-05-09,525.66,-83,1004008,114289278,33592363,3.02886155252464,50.5531323769497,0.29003623690803
484.75,490,5148,6419,2090088,3369975,2025-04-17,2025-05-09,525.66,1271,1279887,114289278,33592363,2.94863617915234,53.501768556102,0.379791244742172
398.94,400,26488,31701,2119040,3360306,2025-04-17,2025-05-16,525.66,5213,1241266,2098065603,598425916,0.160162103377279,97.2973165891992,0.369390763817343
491.15,517,930,1290,2914620,3334650,2025-04-17,2025-08-15,525.66,360,420030,650394247,116470886,0.512712099681288,80.6761049041075,0.125959246097791
538.48,610,999,466,7613379,3332832,2025-04-17,2025-09-19,525.66,-533,-4280547,1699576882,316242446,0.196097748521858,97.9461331599826,-1.28435726733301
348.66,350,25426,24744,2542600,3315696,2025-04-17,2025-06-20,525.66,-682,773096,2210385665,443310327,0.150005315927526,97.9964013203099,0.233162509470108
347.98,350,13837,16361,2352290,3304922,2025-04-17,2025-07-18,525.66,2524,952632,781158455,167554530,0.423079591451135,97.305154048419,0.288246439704175
464.57,470,5417,5999,2264306,3257457,2025-04-17,2025-05-30,525.66,582,993151,542920959,126942613,0.599987336278171,87.0645644019059,0.304885375309636
411.99,415,9765,10634,2372895,3200834,2025-04-17,2025-06-20,525.66,869,827939,2210385665,443310327,0.144808847192736,98.1412101675026,0.258663523319235
529.78,578,657,657,3168054,3168054,2025-04-17,2025-05-30,525.66,0,0,542920959,126942613,0.583520298393933,87.6480847002998,0
494.85,500,8968,6131,3676880,3157465,2025-04-17,2025-05-02,525.66,-2837,-519415,204772860,42617637,1.54193529357357,63.8485275831963,-0.16450380289251
522.92,567,715,715,2831400,3151720,2025-04-17,2025-08-15,525.66,0,320320,650394247,116470886,0.484586082139807,81.1606909862473,0.101633393829401
525.75,615,349,349,2533740,3114825,2025-04-17,2025-06-20,525.66,0,581085,2210385665,443310327,0.140917716275544,98.2821278837782,0.18655462184874
344.94,350,6833,6123,2924524,3098238,2025-04-17,2025-12-19,525.66,-710,173714,1076181448,187344700,0.287891786813259,95.7248922023789,0.0560686428866987
382.82,385,14432,14197,2265824,3094946,2025-04-17,2025-06-20,525.66,-235,829122,2210385665,443310327,0.140018370956998,98.4221462547351,0.26789546570441
440.16,445,6392,6390,2416176,3092760,2025-04-17,2025-06-20,525.66,-2,676584,2210385665,443310327,0.13991947418823,98.5620657289234,0.218763822605052
517.81,548,861,1022,2001825,3085418,2025-04-17,2025-05-30,525.66,161,1083593,542920959,126942613,0.568299666618691,88.2163843669185,0.351198119671306
480.24,487,4475,4563,2027175,3084588,2025-04-17,2025-05-16,525.66,88,1057413,2098065603,598425916,0.147020569594649,97.4443371587938,0.342805262809814
469.2,470,39339,38552,4248612,3084160,2025-04-17,2025-04-25,525.66,-787,-1164452,186785929,41175251,1.65117362775223,63.0539225468103,-0.377558881510687
422.28,435,2395,2411,2878790,3066792,2025-04-17,2025-12-19,525.66,16,188002,1076181448,187344700,0.284969788849213,96.0098619912281,0.0613024945936992
521.34,552,729,1000,1124847,3066000,2025-04-17,2025-04-25,525.66,271,1941153,186785929,41175251,1.64145126799139,64.6953738148017,0.633122309197652
512.89,525,2370,2509,2050050,3038399,2025-04-17,2025-05-02,525.66,139,988349,204772860,42617637,1.48378989285983,65.3323174760562,0.32528611285088
528.95,562,905,905,2437165,2991025,2025-04-17,2025-05-30,525.66,0,553860,542920959,126942613,0.550913526254196,88.7672978931727,0.18517397881997
421.5,425,9698,8524,2618460,2983400,2025-04-17,2025-06-20,525.66,-1174,364940,2210385665,443310327,0.134971921291391,98.6970376502148,0.122323523496682
507.74,520,2083,2395,1874700,2936270,2025-04-17,2025-05-09,525.66,312,1061570,114289278,33592363,2.56915613728875,56.0709246933908,0.361536915883076
527.5,571,627,673,2191992,2927550,2025-04-17,2025-05-16,525.66,46,735558,2098065603,598425916,0.139535674948101,97.5838728337419,0.251253778756981
521.26,547,694,1137,1270714,2926638,2025-04-17,2025-04-25,525.66,443,1655924,186785929,41175251,1.56684072278271,66.2622145375844,0.565811009082777
533.6,557,1250,1250,2925000,2925000,2025-04-17,2025-05-02,525.66,0,0,204772860,42617637,1.42841194873188,66.760729424788,0
522.17,545,971,1277,1371052,2915391,2025-04-17,2025-05-02,525.66,306,1544339,204772860,42617637,1.42371943235056,68.1844488571386,0.529719341247881
523.96,545,1469,1373,1966991,2888792,2025-04-17,2025-04-25,525.66,-96,921801,186785929,41175251,1.54657902523268,67.808793562817,0.3190956635161
424.54,430,5295,5288,2292735,2887248,2025-04-17,2025-07-18,525.66,-7,594513,781158455,167554530,0.369611054136257,97.6747651025553,0.205909918372097
451.05,455,7404,7307,2132352,2886265,2025-04-17,2025-05-30,525.66,-97,753913,542920959,126942613,0.531617899835029,89.2989157930077,0.261207131015343
514.98,553,755,752,2518680,2859104,2025-04-17,2025-08-15,525.66,-3,340424,650394247,116470886,0.439595524282059,81.6002865105294,0.119066672635903
394.21,395,36060,35994,2776620,2843526,2025-04-17,2025-05-09,525.66,-66,66906,114289278,33592363,2.4880076677009,58.5589323610917,0.0235292379953621
477.62,485,3682,3851,2117150,2842038,2025-04-17,2025-05-30,525.66,169,724888,542920959,126942613,0.523471778513528,89.8223875715213,0.255059221586763
530.55,574,651,651,5138343,2828595,2025-04-17,2025-05-30,525.66,0,-2309748,542920959,126942613,0.52099572748305,90.3433832990043,-0.816570771001151
423.3,430,4152,4200,2350032,2814000,2025-04-17,2025-08-15,525.66,48,463968,650394247,116470886,0.432660653592774,82.0329471641222,0.164878464818763
505.55,519,1972,2074,1989748,2789530,2025-04-17,2025-05-16,525.66,102,799782,2098065603,598425916,0.132957234321524,97.7168300680634,0.286708513620574
490.52,516,1044,1093,2188224,2784964,2025-04-17,2025-08-15,525.66,49,596740,650394247,116470886,0.428196284460677,82.4611434485828,0.214272069585101
522.43,566,633,631,2558586,2749267,2025-04-17,2025-08-15,525.66,-2,190681,650394247,116470886,0.422707767278267,82.8838512158611,0.0693570322562341
519.73,533,1627,2063,1399220,2737601,2025-04-17,2025-04-25,525.66,436,1338381,186785929,41175251,1.46563556187361,69.2744291246907,0.48888826384853
501.65,532,806,901,2458300,2734535,2025-04-17,2025-08-15,525.66,95,276235,650394247,116470886,0.420442679592152,83.3042938954532,0.101017174766459
485.15,492,3905,3979,2046220,2725615,2025-04-17,2025-05-16,525.66,74,679395,2098065603,598425916,0.129910856748363,97.8467409248118,0.249263010366468
495.53,522,1055,1024,2380080,2710528,2025-04-17,2025-08-15,525.66,-31,330448,650394247,116470886,0.416751533781633,83.7210454292349,0.121912778617303
521.71,565,633,625,1659726,2705625,2025-04-17,2025-05-09,525.66,-8,1045899,114289278,33592363,2.36734805516927,60.9262804162609,0.386564656964657
343.76,345,21789,21789,2069955,2701836,2025-04-17,2025-06-20,525.66,0,631881,2210385665,443310327,0.122233691739039,98.8192713419538,0.233870967741935
465.72,480,2134,1887,2462636,2694636,2025-04-17,2025-08-15,525.66,-247,232000,650394247,116470886,0.414308092734406,84.1353535219693,0.0860969719101209
446.46,450,7338,7568,2083992,2679072,2025-04-17,2025-05-30,525.66,230,595080,542920959,126942613,0.493455254506025,90.8368385535103,0.222121689898592
493.54,505,2336,2310,2060352,2647260,2025-04-17,2025-05-30,525.66,-26,586908,542920959,126942613,0.487595838052736,91.3244343915631,0.221703950499762
520.1,542,1025,1193,1240250,2612670,2025-04-17,2025-04-25,525.66,168,1372420,186785929,41175251,1.39875097336695,70.6731800980576,0.525294047851432
395.47,400,5634,5703,2174724,2583459,2025-04-17,2025-08-15,525.66,69,408735,650394247,116470886,0.397214306847951,84.5325678288172,0.158212303736967
407.2,410,9102,9172,1984236,2568160,2025-04-17,2025-06-20,525.66,70,583924,2210385665,443310327,0.11618605932282,98.9354574012766,0.227370568811912
418.29,430,2197,2192,2111317,2566832,2025-04-17,2025-12-19,525.66,-5,455515.000000001,1076181448,187344700,0.238512938944474,96.2483749301726,0.177461945308458
488.96,495,1421,4214,646555,2545256,2025-04-17,2025-05-09,525.66,2793,1898701,114289278,33592363,2.22702955565088,63.1533099719118,0.745976436162021
434.66,435,73755,74480,3982770,2532320,2025-04-17,2025-04-25,525.66,725,-1450450,186785929,41175251,1.35573381440312,72.0289139124607,-0.572775162696658
460,465,4973,4981,1840010,2490500,2025-04-17,2025-05-30,525.66,8,650490,542920959,126942613,0.458722390196028,91.7831567817591,0.261188516362176
448.68,450,15330,18569,1716960,2451108,2025-04-17,2025-05-02,525.66,3239,734148,204772860,42617637,1.19698870250677,69.3814375596454,0.299516789957848
440.19,450,2392,2490,1796392,2442690,2025-04-17,2025-08-15,525.66,98,646298,650394247,116470886,0.375570665218384,84.9081384940356,0.264584535900995
412.61,420,3234,3305,2018016,2442395,2025-04-17,2025-09-19,525.66,71,424379,1699576882,316242446,0.143706061541969,98.0898392215246,0.173755268906135
529.4,568,629,632,2983976,2439520,2025-04-17,2025-05-30,525.66,3,-544456,542920959,126942613,0.449332441409763,92.2324892231689,-0.22318160949695
519.07,559,610,609,2206980,2431737,2025-04-17,2025-08-15,525.66,-1,224757,650394247,116470886,0.373886609731958,85.2820251037676,0.0924265247434242
384.99,390,4842,4844,2135322,2426844,2025-04-17,2025-09-19,525.66,2,291522,1699576882,316242446,0.142791069100927,98.2326302906255,0.120123914021668
532.27,605,496,332,3137200,2414636,2025-04-17,2025-08-15,525.66,-164,-722564,650394247,116470886,0.371257281431642,85.6532823851992,-0.299243447045435
347.32,355,3121,3121,2396928,2396928,2025-04-17,2025-12-19,525.66,0,0,1076181448,187344700,0.222725266678264,96.4711001968508,0
347.3,350,3862,8622,849640,2327940,2025-04-17,2025-08-15,525.66,4760,1478300,650394247,116470886,0.357927520229127,86.0112099054283,0.635024957687913
516.58,542,921,913,1746216,2320846,2025-04-17,2025-05-30,525.66,-8,574630.000000001,542920959,126942613,0.427474011000559,92.6599632341694,0.247595058009019
519.45,534,1531,1586,1362590,2307630,2025-04-17,2025-04-25,525.66,55,945040.000000001,186785929,41175251,1.23544102725211,73.2643549397128,0.40952839059988
498.73,505,2656,3574,1277536,2240898,2025-04-17,2025-05-02,525.66,918,963362,204772860,42617637,1.09433349712457,70.4757710567699,0.429899977598267
481.3,502,1063,1061,1880447,2196270,2025-04-17,2025-08-15,525.66,-2,315823,650394247,116470886,0.337682876214002,86.3488927816423,0.143799714971292
515.35,543,992,791,1818336,2187115,2025-04-17,2025-05-30,525.66,-201,368779,542920959,126942613,0.402842248718565,93.062805482888,0.16861436184197
517,538,859,1040,1102956,2184000,2025-04-17,2025-05-02,525.66,181,1081044,204772860,42617637,1.06654758838647,71.5423186451564,0.494983516483516
527,560,661,661,1555333,2181300,2025-04-17,2025-05-09,525.66,0,625967,114289278,33592363,1.90857798576696,65.0618879576788,0.286969696969697
521.07,564,502,503,1609914,2159379,2025-04-17,2025-05-02,525.66,1,549465,204772860,42617637,1.05452402237289,72.5968426675293,0.254455100285777
474.57,494,1111,1110,1999800,2156730,2025-04-17,2025-08-15,525.66,-1,156930,650394247,116470886,0.331603486646462,86.6804962682888,0.0727629327732261
405.23,415,2197,2195,1823510,2144515,2025-04-17,2025-12-19,525.66,-2,321005,1076181448,187344700,0.199270764608089,96.6703709614589,0.149686525857828
519.25,547,760,769,1154440,2133975,2025-04-17,2025-05-02,525.66,9,979535,204772860,42617637,1.04211808146841,73.6389607489977,0.459018966951347
479.25,498,1135,1134,2440250,2126250,2025-04-17,2025-08-15,525.66,-1,-314000,650394247,116470886,0.326917098330361,87.0074133666192,-0.147677836566725
493,495,11064,10615,2489400,2123000,2025-04-17,2025-04-25,525.66,-449,-366400,186785929,41175251,1.13659525177617,74.400950191489,-0.172585963259538
519.6,532,596,1709,500044,2119160,2025-04-17,2025-04-25,525.66,1113,1619116,186785929,41175251,1.13453942239943,75.5354896138884,0.76403669378433
537.25,567,705,704,2097375,2094400,2025-04-17,2025-05-02,525.66,-1,-2975,204772860,42617637,1.02279178988856,74.6617525388863,-0.00142045454545455
520.7,535,1305,1463,1205820,2092090,2025-04-17,2025-04-25,525.66,158,886270,186785929,41175251,1.12004689603787,76.6555365099263,0.423629002576371
490.65,495,5161,4775,1832155,2077125,2025-04-17,2025-05-02,525.66,-386,244970,204772860,42617637,1.01435561333665,75.6761081522229,0.1179370524162
353.53,355,14073,14113,1463592,2074611,2025-04-17,2025-06-20,525.66,40,611019,2210385665,443310327,0.0938574219354612,99.0293148232121,0.29452220199353
480.49,485,4140,4595,1304100,2072345,2025-04-17,2025-05-09,525.66,455,768245,114289278,33592363,1.81324533347739,66.8751332911562,0.370712888056767
472.7,475,8550,8991,1744200,2067930,2025-04-17,2025-05-02,525.66,441,323730,204772860,42617637,1.009865272185,76.6859734244079,0.156547852200026
518.8,531,1130,1685,893830,2055700,2025-04-17,2025-04-25,525.66,555,1161870,186785929,41175251,1.10056470045985,77.7561012103862,0.565194337695189
522.75,541,491,1125,560231,2053125,2025-04-17,2025-04-25,525.66,634,1492894,186785929,41175251,1.09918611695852,78.8552873273447,0.727132541856926
400.25,410,2000,2103,1580000,2050425,2025-04-17,2025-12-19,525.66,103,470425,1076181448,187344700,0.190527815157059,96.860898776616,0.229428045405221
492.4,519,768,770,1482240,2048200,2025-04-17,2025-08-15,525.66,2,565960,650394247,116470886,0.314916684679716,87.3223300512989,0.276320671809394
338.84,340,18123,17397,1594824,2018052,2025-04-17,2025-06-20,525.66,-726,423228,2210385665,443310327,0.0912986376972364,99.1206134609093,0.209721057732903
520.82,635,175,175,2308425,1998150,2025-04-17,2025-09-19,525.66,0,-310275,1699576882,316242446,0.117567497014236,98.3501977876397,-0.155281135049921
520.28,572,432,386,1542240,1996392,2025-04-17,2025-05-30,525.66,-46,454152,542920959,126942613,0.367713194141028,93.430518677029,0.227486385439332
449.62,460,1901,1913,1651969,1985694,2025-04-17,2025-08-15,525.66,12,333725.000000001,650394247,116470886,0.305306206067964,87.6276362573668,0.168064666559903
372.87,380,2759,2763,1602979,1970019,2025-04-17,2025-12-19,525.66,4,367040,1076181448,187344700,0.183056398496845,97.0439551751128,0.186312923885506
518.62,540,941,908,1396444,1941304,2025-04-17,2025-05-09,525.66,-33,544860,114289278,33592363,1.69858803377864,68.5737213249348,0.280667015573038
503.14,537,602,572,1685600,1936792,2025-04-17,2025-08-15,525.66,-30,251192,650394247,116470886,0.297787381873936,87.9254236392408,0.129694876889206
351.66,355,5773,5775,1731900,1928850,2025-04-17,2025-09-19,525.66,2,196950,1699576882,316242446,0.113490011568656,98.4636877992084,0.102107473364958
501.3,505,3424,5190,1095680,1920300,2025-04-17,2025-04-25,525.66,1766,824620,186785929,41175251,1.0280753000404,79.8833626273851,0.429422486069885
485.24,508,887,841,1459115,1914116,2025-04-17,2025-08-15,525.66,-46,455001,650394247,116470886,0.294300881170002,88.2197245204108,0.237708163977523
534.03,579,426,422,1970676,1897734,2025-04-17,2025-08-15,525.66,-4,-72941.9999999998,650394247,116470886,0.291782101202995,88.5115066216138,-0.0384363667405441
520.8,541,951,937,1307625,1892740,2025-04-17,2025-05-02,525.66,-14,585115,204772860,42617637,0.92431194251035,77.6102853669183,0.30913648995636
530.25,564,559,556,2871024,1876500,2025-04-17,2025-05-30,525.66,-3,-994524,542920959,126942613,0.345630421683536,93.7761490987125,-0.529988808952838
513.81,548,494,544,1471626,1859936,2025-04-17,2025-08-15,525.66,50,388310,650394247,116470886,0.285970549182917,88.7974771707967,0.208776000894654
399.45,400,33109,33734,1523014,1855370,2025-04-17,2025-05-02,525.66,625,332356,204772860,42617637,0.906062453784159,78.5163478207024,0.179131925168565
496.91,505,2129,2276,1285916,1841284,2025-04-17,2025-05-09,525.66,147,555368,114289278,33592363,1.61107326270799,70.1847945876428,0.30161995650861
484.68,505,934,894,1566318,1816608,2025-04-17,2025-08-15,525.66,-40,250290,650394247,116470886,0.27930874363961,89.0767859144363,0.137778761295778
510.43,542,420,574,1188180,1812118,2025-04-17,2025-08-15,525.66,154,623938,650394247,116470886,0.27861839312979,89.3554043075661,0.344314222363003
521.37,640,152,152,1695256,1803176,2025-04-17,2025-09-19,525.66,0,107920,1699576882,316242446,0.106095582912265,98.5697833821206,0.0598499536373596
515.85,534,1010,993,1137260,1802295,2025-04-17,2025-05-09,525.66,-17,665035,114289278,33592363,1.5769589514775,71.7617535391203,0.368993422275488
378.16,380,9754,9776,1443592,1798784,2025-04-17,2025-06-20,525.66,22,355192,2210385665,443310327,0.0813787398499076,99.2019922007592,0.197462285632961
520.94,551,603,598,987111,1797588,2025-04-17,2025-04-25,525.66,-5,810477,186785929,41175251,0.962378702519931,80.845741329905,0.450869164680672
515.2,539,744,755,1331760,1796900,2025-04-17,2025-05-30,525.66,11,465140,542920959,126942613,0.330968987329148,94.1071180860417,0.258856920251544
523.92,615,197,197,1505474,1794276,2025-04-17,2025-12-19,525.66,0,288802,1076181448,187344700,0.166726159732127,97.2106813348449,0.160957400087835
520.82,630,173,163,1604575,1779634,2025-04-17,2025-09-19,525.66,-10,175059,1699576882,316242446,0.104710414624244,98.6744937967449,0.0983679790338912
526.95,600,261,242,1602540,1767810,2025-04-17,2025-05-16,525.66,-19,165270,2098065603,598425916,0.0842590430667291,97.9309999678785,0.0934885536341574
248.03,250,8938,8959,1465832,1764923,2025-04-17,2025-12-19,525.66,21,299091,1076181448,187344700,0.163998645700497,97.3746799805454,0.169464050273015
516.47,554,467,465,1584531,1745145,2025-04-17,2025-08-15,525.66,-2,160614,650394247,116470886,0.268321100324862,89.623725407891,0.0920347592893427
526.84,620,187,187,1478983,1742092,2025-04-17,2025-06-20,525.66,0,263109,2210385665,443310327,0.0788139385621649,99.2808061393214,0.151030485186775
517.03,549,525,542,1297800,1732774,2025-04-17,2025-05-30,525.66,17,434974,542920959,126942613,0.319157691607923,94.4262757776496,0.251027543118722
368.91,375,2833,2834,1529820,1725906,2025-04-17,2025-12-19,525.66,1,196086,1076181448,187344700,0.160373141834722,97.5350531223802,0.113613371759528
513.62,530,911,1048,1060404,1716624,2025-04-17,2025-05-09,525.66,137,656220,114289278,33592363,1.50199916391107,73.2637527030313,0.382273578838464
296.89,300,5525,5504,1491750,1711744,2025-04-17,2025-12-19,525.66,-21,219994,1076181448,187344700,0.159057192742092,97.6941103151223,0.128520386225977
523.82,625,169,169,1602965,1709942,2025-04-17,2025-09-19,525.66,0,106977,1699576882,316242446,0.100609864614527,98.7751036613594,0.0625617711010082
525.55,555,852,578,1503780,1702210,2025-04-17,2025-04-25,525.66,-274,198430,186785929,41175251,0.911315969630667,81.7570572995357,0.116571985830185
470.41,487,905,1021,1142110,1693839,2025-04-17,2025-08-15,525.66,116,551729,650394247,116470886,0.260432654165221,89.8841580620562,0.325726943351759
478.58,495,613,1025,839197,1683050,2025-04-17,2025-08-15,525.66,412,843853,650394247,116470886,0.258773814153987,90.1429318762102,0.501383203113395
426.18,430,4348,4391,1347880,1677362,2025-04-17,2025-06-20,525.66,43,329482,2210385665,443310327,0.0758854903268657,99.3566916296483,0.196428677888255
485.76,495,2021,1814,1416721,1676136,2025-04-17,2025-05-30,525.66,-207,259415,542920959,126942613,0.308725602173704,94.7350013798233,0.154769660695791
455.39,465,1805,1744,1357360,1675984,2025-04-17,2025-07-18,525.66,-61,318624,781158455,167554530,0.214551092582106,97.8893161951374,0.190111600110741
522.32,559,452,452,1356000,1657936,2025-04-17,2025-05-30,525.66,0,301936,542920959,126942613,0.305373364670565,95.0403747444939,0.182115594329335
505.23,543,369,436,1057923,1646772,2025-04-17,2025-08-15,525.66,67,588849,650394247,116470886,0.253195966538123,90.3961278427483,0.357577733893945
523.32,543,751,829,927485,1631472,2025-04-17,2025-04-25,525.66,78,703987,186785929,41175251,0.87344480857549,82.6305021081112,0.431504187629331
524.98,574,331,330,1447132,1617660,2025-04-17,2025-08-15,525.66,-1,170528,650394247,116470886,0.248719912185816,90.6448477549341,0.105416465759183
149.47,150,30412,30467,1520600,1614751,2025-04-17,2025-12-19,525.66,55,94151,1076181448,187344700,0.150044493240512,97.8441548083628,0.0583068225379641
524.24,555,345,524,747615,1611824,2025-04-17,2025-05-02,525.66,179,864209,204772860,42617637,0.787127747300106,79.3034755680025,0.536168340960303
531,562,512,517,1450496,1602700,2025-04-17,2025-05-02,525.66,5,152204,204772860,42617637,0.782672078711993,80.0861476467145,0.0949672427778125
519.7,557,431,429,1047330,1600170,2025-04-17,2025-05-30,525.66,-2,552840,542920959,126942613,0.294733510186701,95.3351082546806,0.345488291868989
375,380,3169,3175,1254924,1587500,2025-04-17,2025-09-19,525.66,6,332576,1699576882,316242446,0.0934056009359158,98.8685092622953,0.209496692913386
522.87,550,368,585,655040,1587105,2025-04-17,2025-05-09,525.66,217,932065,114289278,33592363,1.38867357268632,74.6524262757177,0.587273683845744
477.36,480,5196,5956,1200276,1572384,2025-04-17,2025-05-02,525.66,760,372108,204772860,42617637,0.767867382425581,80.8540150291401,0.236652115513768
490.86,499,2249,1925,1389882,1566950,2025-04-17,2025-05-16,525.66,-324,177068,2098065603,598425916,0.0746854625403246,98.0056854304188,0.11300169118351
373.28,375,9035,9106,1219725,1566232,2025-04-17,2025-06-20,525.66,71,346507,2210385665,443310327,0.0708578609063681,99.4275494905546,0.221236062090418
513.99,527,602,1165,554442,1515665,2025-04-17,2025-05-02,525.66,563,961223,204772860,42617637,0.740168887615283,81.5941839167554,0.634192252245714
530.65,567,413,410,1577660,1490350,2025-04-17,2025-05-30,525.66,-3,-87310,542920959,126942613,0.274505888066112,95.6096141427467,-0.0585835541986782
522,580,4972,256,20449836,1484800,2025-04-17,2025-05-16,525.66,-4716,-18965036,2098065603,598425916,0.0707699510385615,98.0764553814574,-12.7727882543103
478.15,484,2686,2533,977704,1481805,2025-04-17,2025-05-16,525.66,-153,504101,2098065603,598425916,0.0706272004975051,98.1470825819549,0.340193885160328
520,542,678,673,932250,1480600,2025-04-17,2025-05-02,525.66,-5,548350,204772860,42617637,0.723045036339288,82.3172289530947,0.37035661218425
476.11,480,3638,3759,1131418,1462251,2025-04-17,2025-05-09,525.66,121,330833,114289278,33592363,1.27942972918247,75.9318560049001,0.226249118653364
386.84,390,4908,4619,1285896,1459604,2025-04-17,2025-07-18,525.66,-289,173708,781158455,167554530,0.186851206775967,98.0761674019134,0.119010361714547
522.8,547,604,603,1313096,1459260,2025-04-17,2025-05-30,525.66,-1,146164,542920959,126942613,0.268779455979705,95.8783935987264,0.10016309636391
372.17,375,5115,5137,1171335,1453771,2025-04-17,2025-07-18,525.66,22,282436,781158455,167554530,0.186104495278106,98.2622718971915,0.194278190994318
431.96,440,1531,1793,969123,1441572,2025-04-17,2025-08-15,525.66,262,472449,650394247,116470886,0.221645871969098,90.8664936269032,0.32773180944136
418.5,420,13740,9610,1580100,1441500,2025-04-17,2025-05-16,525.66,-4130,-138600,2098065603,598425916,0.0687061452196164,98.2157887271745,-0.0961498439125909
520.42,561,354,354,1047486,1436532,2025-04-17,2025-05-30,525.66,0,389046,542920959,126942613,0.264593211256005,96.1429868099824,0.270823065549532
477.59,483,2599,2654,948635,1435814,2025-04-17,2025-05-16,525.66,55,487179,2098065603,598425916,0.068435133674893,98.2842238608494,0.339305091049398
512.3,537,313,580,515824,1432600,2025-04-17,2025-05-30,525.66,267,916776,542920959,126942613,0.263868980604228,96.4068557905866,0.63993857322351
464,474,1427,1427,1427000,1427000,2025-04-17,2025-08-15,525.66,0,0,650394247,116470886,0.219405384746584,91.0858990116498,0
521.69,556,408,410,757248,1406710,2025-04-17,2025-05-02,525.66,2,649462,204772860,42617637,0.686961152957477,83.0041901060521,0.461688620966653
525.11,570,337,313,1034253,1405057,2025-04-17,2025-05-09,525.66,-24,370804,114289278,33592363,1.22938653965423,77.1612425445544,0.263906731185995
530.69,556,553,553,1399643,1399643,2025-04-17,2025-05-30,525.66,0,0,542920959,126942613,0.25779866789044,96.6646544584771,0
502.44,536,462,417,1294986,1399452,2025-04-17,2025-08-15,525.66,-45,104466,650394247,116470886,0.215169799925982,91.3010688115758,0.074647790706648
418.68,425,1344,2207,716352,1394824,2025-04-17,2025-08-15,525.66,863,678472,650394247,116470886,0.214458231516307,91.5155270430921,0.48642122590377
529.74,566,284,384,1157868,1392384,2025-04-17,2025-05-30,525.66,100,234516,542920959,126942613,0.256461640855534,96.9211160993326,0.168427675124104
498.54,509,1320,1320,1053360,1380720,2025-04-17,2025-05-16,525.66,0,327360,2098065603,598425916,0.065809191000783,98.3500330518502,0.237093690248566
455.2,465,1368,1406,1310544,1377880,2025-04-17,2025-08-15,525.66,38,67336,650394247,116470886,0.2118530424209,91.727380085513,0.048869277440706
359.1,365,2259,2304,1129500,1359360,2025-04-17,2025-12-19,525.66,45,229860,1076181448,187344700,0.126313272034773,97.9704680803975,0.169094279661017
268.41,270,8514,8512,1311156,1353408,2025-04-17,2025-09-19,525.66,-2,42252,1699576882,316242446,0.079632055150536,98.9481413174459,0.0312189672293942
198.85,200,11759,11760,1128864,1352400,2025-04-17,2025-12-19,525.66,1,223536,1076181448,187344700,0.125666540945612,98.0961346213432,0.165288376220053
521.82,558,378,373,746550,1349514,2025-04-17,2025-05-02,525.66,-5,602964,204772860,42617637,0.659029717121693,83.6632198231738,0.44680084830539
521.26,560,342,344,858420,1332656,2025-04-17,2025-05-23,525.66,2,474236,27519740,10743122,4.84254575079561,23.5203384915701,0.355857775750081
489.66,514,543,547,1367274,1331398,2025-04-17,2025-08-15,525.66,4,-35876,650394247,116470886,0.204706300238846,91.9320863857518,-0.0269461122819773
377.76,385,1841,1836,1115646,1329264,2025-04-17,2025-12-19,525.66,-5,213618,1076181448,187344700,0.123516717600952,98.2196513389441,0.160703968511898
471.15,488,788,786,1029128,1324410,2025-04-17,2025-08-15,525.66,-2,295282,650394247,116470886,0.203631874991047,92.1357182607429,0.222953617082323
522.91,557,391,388,751502,1322692,2025-04-17,2025-04-25,525.66,-3,571190,186785929,41175251,0.708132570307264,83.3386346784184,0.431839007115791
479.47,486,2043,2019,907092,1318407,2025-04-17,2025-05-16,525.66,-24,411315,2098065603,598425916,0.0628391694766277,98.4128722213268,0.311978774384541
520.74,545,551,542,947720,1314892,2025-04-17,2025-05-09,525.66,-9,367172,114289278,33592363,1.15049462470137,78.3117371692557,0.279241184827347
522.25,561,338,338,893672,1309750,2025-04-17,2025-05-02,525.66,0,416078,204772860,42617637,0.639611128154385,84.3028309513282,0.317677419354839
522.69,562,572,332,1246960,1305092,2025-04-17,2025-04-25,525.66,-240,58132,186785929,41175251,0.698710018997202,84.0373446974156,0.0445424537120755
471.36,476,2761,2799,866954,1298736,2025-04-17,2025-05-16,525.66,38,431782,2098065603,598425916,0.0619015915490418,98.4747738128759,0.332463256581784
321.04,325,3265,3256,1789220,1289376,2025-04-17,2025-12-19,525.66,-9,-499844,1076181448,187344700,0.119810279427898,98.339461618372,-0.387663489936217
458.97,463,2386,3128,553552,1260584,2025-04-17,2025-05-16,525.66,742,707032,2098065603,598425916,0.060083154606677,98.5348569674825,0.560876546108788
497.38,527,359,423,866267,1252926,2025-04-17,2025-08-15,525.66,64,386659,650394247,116470886,0.192641002865451,92.3283592636083,0.308604817842395
326.6,330,3638,3662,1295128,1245080,2025-04-17,2025-12-19,525.66,24,-50048,1076181448,187344700,0.115694244898375,98.4551558632704,-0.040196613872201
517,533,696,778,760728,1244800,2025-04-17,2025-05-02,525.66,82,484072,204772860,42617637,0.607893057703057,84.9107240090313,0.388875321336761
525.72,563,333,331,902763,1233968,2025-04-17,2025-05-02,525.66,-2,331205,204772860,42617637,0.602603294206078,85.5133273032374,0.268406474073882
363.8,370,2005,1985,1066660,1230700,2025-04-17,2025-12-19,525.66,-20,164040,1076181448,187344700,0.114358038998643,98.569513902269,0.133289997562363
520.81,645,99,99,1141173,1229481,2025-04-17,2025-12-19,525.66,0,88308,1076181448,187344700,0.114244768136906,98.6837586704059,0.0718254287784846
415.2,420,2051,2557,760921,1227360,2025-04-17,2025-07-18,525.66,506,466439,781158455,167554530,0.157120491002046,98.4193923881935,0.38003438274019
494.99,504,1400,1337,842800,1204637,2025-04-17,2025-05-16,525.66,-63,361837,2098065603,598425916,0.0574165554345633,98.5922735229171,0.300370153000447
521.06,536,719,805,689521,1202670,2025-04-17,2025-04-25,525.66,86,513149,186785929,41175251,0.643876124094979,84.6812208215106,0.42667481520284
508.19,547,302,308,914154,1195348,2025-04-17,2025-08-15,525.66,6,281194,650394247,116470886,0.183788218532628,92.5121474821409,0.235240281491248
523.28,620,124,123,1249300,1189656,2025-04-17,2025-09-19,525.66,-1,-59644,1699576882,316242446,0.0699971865115073,99.0181385039574,-0.0501355013550136
358.55,360,8134,8130,1057420,1178850,2025-04-17,2025-06-20,525.66,-4,121430,2210385665,443310327,0.0533323219864439,99.4808818125411,0.103007168002715
501.23,508,1699,1732,757754,1172564,2025-04-17,2025-05-02,525.66,33,414810,204772860,42617637,0.572616898547982,86.0859442017853,0.353763206102183
454.2,466,990,990,1168200,1168200,2025-04-17,2025-08-15,525.66,0,0,650394247,116470886,0.17961413487103,92.691761617012,0
511.04,530,204,616,280296,1167936,2025-04-17,2025-05-23,525.66,412,887640,27519740,10743122,4.24399358424171,27.7643320758118,0.760007397665626
490.27,500,1040,1188,748800,1155924,2025-04-17,2025-05-23,525.66,148,407124,27519740,10743122,4.20034491604935,31.9646769918611,0.352206546451151
401.15,405,2965,3002,922115,1155770,2025-04-17,2025-07-18,525.66,37,233655,781158455,167554530,0.14795589711693,98.5673482853104,0.202163925348469
510.77,525,579,811,586527,1154053,2025-04-17,2025-05-09,525.66,232,567526,114289278,33592363,1.00976488800638,79.3215020572621,0.49176770910868
417.86,420,5432,5376,918008,1150464,2025-04-17,2025-05-30,525.66,-56,232456,542920959,126942613,0.211902668506117,97.1330187678387,0.202054127725857
536.95,573,328,318,1109952,1146390,2025-04-17,2025-05-30,525.66,-10,36438,542920959,126942613,0.21115228303426,97.344171050873,0.0317849946353335
467.31,472,2318,2438,646722,1143422,2025-04-17,2025-05-16,525.66,120,496700,2098065603,598425916,0.0544988678316366,98.6467723907487,0.4343977988879
504.23,515,855,1060,666900,1141620,2025-04-17,2025-05-09,525.66,205,474720,114289278,33592363,0.998886352226322,80.3203884094884,0.415830136122352
272.51,275,4570,4582,1032820,1140918,2025-04-17,2025-12-19,525.66,12,108098,1076181448,187344700,0.106015393790732,98.7897740641966,0.0947465111427816
532.3,567.5,369,324,2040201,1140480,2025-04-17,2025-05-02,525.66,-45,-899721,204772860,42617637,0.55694880659478,86.6428930083801,-0.78889678030303
346.3,350,2551,3065,749994,1134050,2025-04-17,2025-09-19,525.66,514,384056,1699576882,316242446,0.0667254310181891,99.0848639349755,0.338658789295005
477.05,496,592,594,822880,1125630,2025-04-17,2025-08-15,525.66,2,302750,650394247,116470886,0.173068874024035,92.864830491036,0.268960493234899
513.49,536,503,500,923005,1125500,2025-04-17,2025-05-30,525.66,-3,202495,542920959,126942613,0.207304577460602,97.5514756283336,0.179915593069747
427.47,430,4453,4425,850523,1119525,2025-04-17,2025-05-30,525.66,-28,269002,542920959,126942613,0.206204048939654,97.7576796772733,0.240282262566714
522.52,567.5,246,247,706512,1111006,2025-04-17,2025-05-09,525.66,1,404494,114289278,33592363,0.972099937493699,81.2924883469821,0.364079041877362
524.32,571,238,238,1001266,1110984,2025-04-17,2025-08-15,525.66,0,109718,650394247,116470886,0.170817009087105,93.0356475001231,0.0987574978577549
516.75,544,361,405,730303,1103625,2025-04-17,2025-05-30,525.66,44,373322,542920959,126942613,0.203275445846253,97.9609551231195,0.338268886623627
471.47,475,2572,3119,673864,1101007,2025-04-17,2025-05-09,525.66,547,427143,114289278,33592363,0.963351085304782,82.2558394322869,0.387956661492615
540.78,581,273,273,1098006,1098006,2025-04-17,2025-05-30,525.66,0,0,542920959,126942613,0.202240488564377,98.1631956116839,0
438.3,445,1554,1628,839160,1090760,2025-04-17,2025-07-18,525.66,74,251600,781158455,167554530,0.139633641935041,98.7069819272455,0.230664857530529
498.04,528,349,363,812821,1087548,2025-04-17,2025-08-15,525.66,14,274727,650394247,116470886,0.167213656181064,93.2028611563042,0.252611378992008
523.61,544,484,533,621940,1086787,2025-04-17,2025-04-25,525.66,49,464847,186785929,41175251,0.58183558355726,85.2630564050679,0.427725948138872
488.35,490,5277,6582,976245,1086030,2025-04-17,2025-04-25,525.66,1305,109785,186785929,41175251,0.581430306776481,85.8444867118443,0.101088367724648
433.09,435,5532,5656,802140,1080296,2025-04-17,2025-05-16,525.66,124,278156,2098065603,598425916,0.0514900963275551,98.6982624870763,0.257481282907648
379.8,385,2076,2077,865692,1080040,2025-04-17,2025-09-19,525.66,1,214348,1699576882,316242446,0.0635475812502844,99.1484115162258,0.198463019888152
514.22,541,371,402,690802,1076556,2025-04-17,2025-05-30,525.66,31,385754,542920959,126942613,0.198289637221392,98.3614852489053,0.358322279565578
429.05,435,1402,1802,675764,1072190,2025-04-17,2025-07-18,525.66,400,396426,781158455,167554530,0.137256403375932,98.8442383306214,0.369734841772447
537.31,562.5,422,422,1063018,1063018,2025-04-17,2025-05-02,525.66,0,0,204772860,42617637,0.519120551424637,87.1620135598048,0
483.99,506,495,482,1040490,1060882,2025-04-17,2025-08-15,525.66,-13,20392.0000000002,650394247,116470886,0.163113681416066,93.3659748377202,0.019221741909091
508.3,514,968,1858,353320,1059060,2025-04-17,2025-04-25,525.66,890,705740,186785929,41175251,0.566991317638279,86.4114780294826,0.666383396596982
526.37,577,207,209,929016,1058167,2025-04-17,2025-08-15,525.66,2,129151,650394247,116470886,0.162696242299326,93.5286710800196,0.122051623231494
524.16,555,316,343,632632,1057812,2025-04-17,2025-05-09,525.66,27,425180,114289278,33592363,0.92555663883011,83.181396071117,0.401942878318643
513.7,538,347,433,615925,1052190,2025-04-17,2025-05-30,525.66,86,436265,542920959,126942613,0.193801691122409,98.5552869400277,0.414625685475057
398.29,405,1547,1567,785876,1051457,2025-04-17,2025-09-19,525.66,20,265581,1699576882,316242446,0.0618658097280474,99.2102773259539,0.252583795628352
519.39,554,304,303,611040,1048683,2025-04-17,2025-05-02,525.66,-1,437643,204772860,42617637,0.512120112010937,87.6741336718157,0.417326303563613
524.58,548,440,444,627000,1039848,2025-04-17,2025-04-25,525.66,4,412848,186785929,41175251,0.556705746287773,86.9681837757704,0.397027257829991
521.65,558,294,286,653268,1039610,2025-04-17,2025-04-25,525.66,-8,386342,186785929,41175251,0.556578327696194,87.5247621034666,0.371622050576659
465.83,482,639,639,750825,1033263,2025-04-17,2025-08-15,525.66,0,282438,650394247,116470886,0.158867180139741,93.6875382601593,0.273345701917131
522.56,539,515,627,561350,1030788,2025-04-17,2025-04-25,525.66,112,469438,186785929,41175251,0.551855273852026,88.0766173773186,0.455416632712061
476.82,482,1968,1978,785232,1024604,2025-04-17,2025-05-16,525.66,10,239372,2098065603,598425916,0.0488356512081858,98.7470981382845,0.233623917142623
493.66,521,413,373,1096928,1019782,2025-04-17,2025-08-15,525.66,-40,-77146,650394247,116470886,0.15679443732841,93.8443326974877,-0.0756495015601374
520.79,537,523,623,530322,1009883,2025-04-17,2025-04-25,525.66,100,479561,186785929,41175251,0.54066331731016,88.6172806946288,0.474867880734699
404.66,410,2093,1879,891618,1003386,2025-04-17,2025-08-15,525.66,-214,111768,650394247,116470886,0.154273504820838,93.9986062023086,0.111390830647428
467.35,483,211,641,246026,1003165,2025-04-17,2025-08-15,525.66,430,757139,650394247,116470886,0.154239525430489,94.152845727739,0.754750215567728
524.76,553,353,351,677760,991224,2025-04-17,2025-04-25,525.66,-2,313464,186785929,41175251,0.530673806804794,89.1479545014336,0.316239316239316
442.07,445,2984,3367,644544,986531,2025-04-17,2025-05-23,525.66,383,341987,27519740,10743122,3.58481221116188,35.549489203023,0.346656111161231
514.65,533,527,537,656115,985395,2025-04-17,2025-05-09,525.66,10,329280,114289278,33592363,0.862193739643714,84.0435898107607,0.334160412829373
501.44,512,349,933,177641,985248,2025-04-17,2025-05-02,525.66,584,807607,204772860,42617637,0.481141885697157,88.1552755575129,0.819699202637306
515.82,552,273,271,878241,980478,2025-04-17,2025-08-15,525.66,-2,102237,650394247,116470886,0.150751333444682,94.3035970611837,0.104272609890278
533.62,568,285,285,979830,979830,2025-04-17,2025-05-09,525.66,0,0,114289278,33592363,0.857324516478265,84.900914327239,0
306.42,310,2712,2712,813600,970896,2025-04-17,2025-12-19,525.66,0,157296,1076181448,187344700,0.0902167568307682,98.8799908210274,0.162011173184358
521.3,543,389,447,548490,969990,2025-04-17,2025-05-02,525.66,58,421500,204772860,42617637,0.473690702957414,88.6289662604703,0.434540562273838
513.5,522,583,1140,335808,969000,2025-04-17,2025-04-25,525.66,557,633192,186785929,41175251,0.518775694286907,89.6667301957205,0.653448916408669
462.7,467,1506,2247,424692,966210,2025-04-17,2025-05-16,525.66,741,541518,2098065603,598425916,0.0460524207926781,98.7931505590772,0.560455801533828
397.79,405,1334,1329,981824,958209,2025-04-17,2025-12-19,525.66,-5,-23615,1076181448,187344700,0.0890378664100517,98.9690286874375,-0.0246449365430715
469.65,486,576,579,718848,946665,2025-04-17,2025-08-15,525.66,3,227817,650394247,116470886,0.145552486721181,94.4491495479049,0.240652184246803
530.03,554,393,392,713295,939624,2025-04-17,2025-04-25,525.66,-1,226329,186785929,41175251,0.503048599554841,90.1697787952753,0.24087188066716
516.46,526,1180,982,779980,936828,2025-04-17,2025-04-25,525.66,-198,156848,186785929,41175251,0.501551698789902,90.6713304940652,0.167424543245932
420,425,1823,1861,732846,930500,2025-04-17,2025-07-18,525.66,38,197654,781158455,167554530,0.11911795795643,98.9633562885778,0.212416980118216
442.52,445,4848,3746,848400,929008,2025-04-17,2025-05-16,525.66,-1102,80608,2098065603,598425916,0.0442792636546551,98.8374298227318,0.0867678211597747
526.86,549,373,419,490868,927666,2025-04-17,2025-04-25,525.66,46,436798,186785929,41175251,0.496646618386335,91.1679771124516,0.470856967917332
507.19,544,198,252,612810,927612,2025-04-17,2025-08-15,525.66,54,314802,650394247,116470886,0.142623032764925,94.5917725806698,0.33936818411146
452.12,455,3657,3213,771627,925344,2025-04-17,2025-05-16,525.66,-444,153717,2098065603,598425916,0.0441046265987518,98.8815344493306,0.166118762319743
507.68,517,316,985,211720,918020,2025-04-17,2025-05-02,525.66,669,706300,204772860,42617637,0.448311363136697,89.077277623607,0.769373216269798
387.06,395,1156,1154,832320,916276,2025-04-17,2025-12-19,525.66,-2,83955.9999999999,1076181448,187344700,0.0851414045189896,99.0541700919565,0.0916274135740758
526.78,625,94,93,888676,913446,2025-04-17,2025-06-20,525.66,-1,24769.9999999999,2210385665,443310327,0.041325186571005,99.5222069991121,0.0271170928549689
477.78,497,477,475,938259,912950,2025-04-17,2025-08-15,525.66,-2,-25309,650394247,116470886,0.140368707781636,94.7321412884515,-0.0277222191795827
387.87,390,4212,4252,673920,905676,2025-04-17,2025-06-20,525.66,40,231756,2210385665,443310327,0.0409736642044319,99.5631806633165,0.255892835848581
417.9,434,562,562,904820,904820,2025-04-17,2025-08-15,525.66,0,0,650394247,116470886,0.139118696724881,94.8712599851764,0
427.84,441,676,676,889616,889616,2025-04-17,2025-08-15,525.66,0,0,650394247,116470886,0.13678103767114,95.0080410228475,0
484.74,507,434,398,1199576,885948,2025-04-17,2025-08-15,525.66,-36,-313628,650394247,116470886,0.136217072043074,95.1442580948906,-0.354002717992478
365.69,370,2045,2047,728020,882257,2025-04-17,2025-09-19,525.66,2,154237,1699576882,316242446,0.0519103907180587,99.2621877166719,0.174820942197115
523.81,625,88,87,825528,880353,2025-04-17,2025-08-15,525.66,-1,54825,650394247,116470886,0.135356824581506,95.2796149194721,0.062276155133225
463.17,465,5438,4768,880956,872544,2025-04-17,2025-05-02,525.66,-670,-8412.00000000012,204772860,42617637,0.426103342015148,89.5033809656221,-0.00964077456265829
370.57,375,1949,1951,726977,864293,2025-04-17,2025-09-19,525.66,2,137316,1699576882,316242446,0.050853421763594,99.3130411384355,0.158876677237927
462.3,466,1673,2311,461748,855070,2025-04-17,2025-05-16,525.66,638,393322,2098065603,598425916,0.0407551603142125,98.9222896096448,0.45998807115207
515.02,524,165,932,103125,836936,2025-04-17,2025-04-25,525.66,767,733811,186785929,41175251,0.448072295638501,91.61604940809,0.876782693061357
520.3,552,231,264,428274,836880,2025-04-17,2025-05-02,525.66,33,408606,204772860,42617637,0.408686971505892,89.912067937128,0.488249211356467
316.07,320,2134,2121,704220,833553,2025-04-17,2025-12-19,525.66,-13,129333,1076181448,187344700,0.0774546895924562,99.1316247815489,0.155158700166636
478.89,480,4193,7376,591213,818736,2025-04-17,2025-04-25,525.66,3183,227523,186785929,41175251,0.438328520988324,92.0543779290784,0.277895438822771
520.25,569,170,167,803420,814125,2025-04-17,2025-05-09,525.66,-3,10705,114289278,33592363,0.712337162546429,85.6132514897854,0.0131490864424996
465.3,470,1567,1726,573522,811220,2025-04-17,2025-05-23,525.66,159,237698,27519740,10743122,2.94777494264117,38.4972641456642,0.293012992776312
391.63,395,2367,2392,662760,806104,2025-04-17,2025-07-18,525.66,25,143344,781158455,167554530,0.103193403955411,99.0665496925333,0.177823208915971
523.35,549,318,314,543462,805410,2025-04-17,2025-05-02,525.66,-4,261948,204772860,42617637,0.393318723975433,90.3053866611034,0.32523559429359
283.27,285,4614,4614,798222,798222,2025-04-17,2025-09-19,525.66,0,0,1699576882,316242446,0.0469659247812715,99.3600070632168,0
456.95,461,1198,1946,259966,788130,2025-04-17,2025-05-16,525.66,748,528164,2098065603,598425916,0.0375646023114369,98.9598542119562,0.670148325783817
523.81,630,74,74,661264,785806,2025-04-17,2025-08-15,525.66,0,124542,650394247,116470886,0.120819949380641,95.4004348688527,0.158489499952915
513.38,521,513,1009,282663,768858,2025-04-17,2025-04-25,525.66,496,486195,186785929,41175251,0.411625224724503,92.4660031538029,0.632359941627713
525.58,559,226,230,419230,768660,2025-04-17,2025-04-25,525.66,4,349430,186785929,41175251,0.411519221022265,92.8775223748251,0.454596310462363
520.82,635,67,67,712880,765006,2025-04-17,2025-08-15,525.66,0,52126,650394247,116470886,0.117621889112436,95.5180567579651,0.0681380276755999
462.53,472,807,805,784404,762335,2025-04-17,2025-08-15,525.66,-2,-22069.0000000001,650394247,116470886,0.117211215123187,95.6352679730883,-0.0289492152400193
329,330,7651,7612,566174,761200,2025-04-17,2025-06-20,525.66,-39,195026,2210385665,443310327,0.0344374292709684,99.5976180925875,0.256208617971624
464.62,469,873,1724,254043,755112,2025-04-17,2025-05-16,525.66,851,501069,2098065603,598425916,0.0359908669643253,98.9958450789205,0.663569112926294
319.74,320,28899,28998,606879,753948,2025-04-17,2025-05-16,525.66,99,147069,2098065603,598425916,0.0359353872882687,99.0317804662088,0.195065176908752
522.98,548,303,301,456318,753102,2025-04-17,2025-05-02,525.66,-2,296784,204772860,42617637,0.367774323218419,90.6731609843219,0.394082076531466
425.03,432,1062,1062,740214,740214,2025-04-17,2025-08-15,525.66,0,0,650394247,116470886,0.113810047277371,95.7490780203657,0
514.39,534,383,377,407895,739297,2025-04-17,2025-05-02,525.66,-6,331402,204772860,42617637,0.36103270716637,91.0341936914882,0.448266393614474
509.28,519,517,757,344322,735804,2025-04-17,2025-05-02,525.66,240,391482,204772860,42617637,0.359326914709303,91.3935206061975,0.532046577621214
451.26,454,2598,2674,493620,732676,2025-04-17,2025-05-16,525.66,76,239056,2098065603,598425916,0.034921500974629,99.0667019671834,0.326277918206683
473.3,480,594,1092,268488,731640,2025-04-17,2025-05-23,525.66,498,463152,27519740,10743122,2.65860069898916,41.1558648446533,0.633032639002788
388.9,395,1184,1186,666592,723460,2025-04-17,2025-09-19,525.66,2,56868,1699576882,316242446,0.0425670652302977,99.4025741284471,0.0786055898045504
504.47,520,448,463,507136,719039,2025-04-17,2025-05-23,525.66,15,211903,27519740,10743122,2.61281174894821,43.7686765936015,0.294703068957317
361.8,365,2217,2229,565335,713280,2025-04-17,2025-08-15,525.66,12,147945,650394247,116470886,0.10966886673584,95.8587468871015,0.207415040376851
319.14,320,8286,8277,679452,711822,2025-04-17,2025-06-20,525.66,-9,32370,2210385665,443310327,0.0322035204657374,99.6298216130532,0.0454748518590322
486.24,495,740,802,476560,702552,2025-04-17,2025-05-23,525.66,62,225992,27519740,10743122,2.55290202596391,46.3215786195655,0.321672986483563
422.37,425,2645,2658,452295,699054,2025-04-17,2025-05-30,525.66,13,246759,542920959,126942613,0.128757968984579,98.6840449090123,0.352989897776137
538.4,559,344,339,750952,698340,2025-04-17,2025-05-02,525.66,-5,-52612,204772860,42617637,0.341031521462366,91.7345521276599,-0.0753386602514534
491.85,518,322,267,795018,698205,2025-04-17,2025-08-15,525.66,-55,-96813.0000000001,650394247,116470886,0.107351041805879,95.9660979289074,-0.138659849184695
522.24,615,75,75,612750,695700,2025-04-17,2025-08-15,525.66,0,82950,650394247,116470886,0.106965890797616,96.073063819705,0.119232427770591
437.97,445,981,988,690624,694564,2025-04-17,2025-08-15,525.66,7,3940,650394247,116470886,0.106791227506045,96.1798550472111,0.00567262340115526
341.73,345,2123,2124,1152789,694548,2025-04-17,2025-09-19,525.66,1,-458241,1699576882,316242446,0.0408659359488746,99.443440064396,-0.659768655298122
520.37,539,360,372,477720,693036,2025-04-17,2025-05-02,525.66,12,215316,204772860,42617637,0.338441334461999,92.0729934621219,0.310685159212508
444.75,455,668,668,574480,684700,2025-04-17,2025-08-15,525.66,0,110220,650394247,116470886,0.105274608925008,96.2851296561361,0.160975609756098
511.98,533,333,325,485847,683150,2025-04-17,2025-05-23,525.66,-8,197303,27519740,10743122,2.48239990639446,48.8039785259599,0.288813584132328
508.06,541,160,206,419360,678564,2025-04-17,2025-08-15,525.66,46,259204,650394247,116470886,0.104331181145887,96.389460837282,0.38198902387984
510.74,522,87,599,65424,674474,2025-04-17,2025-05-02,525.66,512,609050,204772860,42617637,0.329376656652644,92.4023701187745,0.902999967381989
515.7,546,212,221,437568,669630,2025-04-17,2025-05-30,525.66,9,232062,542920959,126942613,0.123338395561922,98.8073833045742,0.346552573809417
522.84,605,388,81,2754412,665496,2025-04-17,2025-07-18,525.66,-307,-2088916,781158455,167554530,0.0851934707664401,99.1517431632997,-3.13888588361162
510.62,528,383,381,383000,662178,2025-04-17,2025-05-09,525.66,-2,279178,114289278,33592363,0.579387683243567,86.192639173029,0.421605670982727
482.64,504,345,310,540960,662160,2025-04-17,2025-08-15,525.66,-35,121200,650394247,116470886,0.101809018615135,96.4912698558971,0.1830373323668
408.77,410,5420,5353,471540,658419,2025-04-17,2025-05-16,525.66,-67,186879,2098065603,598425916,0.0313821931525179,99.098084160336,0.283829901627991
299.28,300,9042,9115,497310,656280,2025-04-17,2025-06-20,525.66,73,158970,2210385665,443310327,0.0296907462978864,99.6595123593511,0.242228926677638
525,620,68,69,761600,655500,2025-04-17,2025-08-15,525.66,1,-106100,650394247,116470886,0.10078502431772,96.5920548802148,-0.16186117467582
516.07,536,374,327,397562,651711,2025-04-17,2025-05-02,525.66,-47,254149,204772860,42617637,0.318260437442735,92.7206305562173,0.389971935413089
357.05,360,2206,2207,529440,651065,2025-04-17,2025-08-15,525.66,1,121625,650394247,116470886,0.100103130217263,96.6921580104321,0.186809304754518
517.31,558,162,160,562302,651040,2025-04-17,2025-08-15,525.66,-2,88738,650394247,116470886,0.100099286394826,96.7922572968269,0.136301916932907
439.93,454,459,459,645813,645813,2025-04-17,2025-08-15,525.66,0,0,650394247,116470886,0.0992956199995416,96.8915529168265,0
515.58,531,267,416,239499,641472,2025-04-17,2025-05-02,525.66,149,401973,204772860,42617637,0.313260263103226,93.0338908193205,0.626641536964981
504.88,513,480,789,280800,640668,2025-04-17,2025-05-02,525.66,309,359868,204772860,42617637,0.312867632947061,93.3467584522676,0.561707467830452
481.82,485,1823,2008,442989,638544,2025-04-17,2025-05-02,525.66,185,195555,204772860,42617637,0.311830386116598,93.6585888383842,0.306251409456513
521.08,562,156,156,387192,638352,2025-04-17,2025-05-09,525.66,0,251160,114289278,33592363,0.558540583308261,86.7511797563373,0.393450635386119
522.79,568,547,141,2525499,637461,2025-04-17,2025-05-02,525.66,-406,-1888038,204772860,42617637,0.311301507436093,93.9698903458203,-2.9618094283415
405.94,410,1471,1550,488372,629300,2025-04-17,2025-07-18,525.66,79,140928,781158455,167554530,0.0805598398086852,99.2323030031084,0.223944064833942
524.16,546,278,286,370296,624624,2025-04-17,2025-04-25,525.66,8,254328,186785929,41175251,0.334406345994082,93.2119287208192,0.4071697533236
399.85,400,41455,41641,1077830,624615,2025-04-17,2025-04-25,525.66,186,-453215,186785929,41175251,0.33440152764398,93.5463302484632,-0.725590964033845
498.52,529,156,203,397176,618744,2025-04-17,2025-08-15,525.66,47,221568,650394247,116470886,0.0951336828168469,96.9866865996433,0.358093169388309
452.27,464,512,527,445952,618171,2025-04-17,2025-08-15,525.66,15,172219,650394247,116470886,0.0950455824065738,97.0817321820499,0.278594434226128
440.89,452,553,553,614383,614383,2025-04-17,2025-08-15,525.66,0,0,650394247,116470886,0.0944631664308064,97.1761953484807,0
309.25,310,8093,8103,501766,607725,2025-04-17,2025-06-20,525.66,10,105959,2210385665,443310327,0.0274940708141084,99.6870064301652,0.174353531613806
520.81,650,47,47,571379,607193,2025-04-17,2025-12-19,525.66,0,35814,1076181448,187344700,0.0564210618133607,99.1880458433623,0.0589828934128029
149.7,150,20098,20230,623038,606900,2025-04-17,2025-09-19,525.66,132,-16138,1699576882,316242446,0.0357088876900833,99.4791489520861,-0.0265908716427748
522.24,610,79,69,600242,605544,2025-04-17,2025-08-15,525.66,-10,5302,650394247,116470886,0.0931041445697167,97.2692994930504,0.00875576341273301
361.55,365,1743,1743,583905,601335,2025-04-17,2025-09-19,525.66,0,17430,1699576882,316242446,0.0353814532527867,99.5145304053388,0.0289855072463768
335.24,340,1263,1263,496359,601188,2025-04-17,2025-12-19,525.66,0,104829,1076181448,187344700,0.0558630704066922,99.243908913769,0.17436974789916
514.79,528,308,453,260568,598413,2025-04-17,2025-05-02,525.66,145,337845,204772860,42617637,0.292232574179996,94.2621229200002,0.564568283108823
519.9,544,224,248,338016,597680,2025-04-17,2025-05-02,525.66,24,259664,204772860,42617637,0.291874616587374,94.5539975365876,0.434453219113907
473.27,478,1229,1261,396967,596453,2025-04-17,2025-05-16,525.66,32,199486,2098065603,598425916,0.0284287106726853,99.1265128710086,0.334453846321504
469.62,475,565,1100,205095,591800,2025-04-17,2025-05-23,525.66,535,386705,27519740,10743122,2.1504563633232,50.9544348892831,0.653438661710037
520.91,605,72,70,474336,588630,2025-04-17,2025-06-20,525.66,-2,114294,2210385665,443310327,0.0266301944190359,99.7136366245842,0.194169512257275
497.85,510,454,482,404060,585630,2025-04-17,2025-05-23,525.66,28,181570,27519740,10743122,2.12803609336425,53.0824709826474,0.310042176801052
515.74,540,99,241,161865,584666,2025-04-17,2025-05-23,525.66,142,422801,27519740,10743122,2.12453315329287,55.2070041359403,0.723149627308583
474.09,475,5906,6414,720532,583674,2025-04-17,2025-04-25,525.66,508,-136858,186785929,41175251,0.312482853031183,93.8588131014944,-0.234476779846284
456.2,460,1256,1535,378056,583300,2025-04-17,2025-05-23,525.66,279,205244,27519740,10743122,2.11956944360666,57.3265735795469,0.351866963826504
469.81,481,519,519,580761,580761,2025-04-17,2025-08-15,525.66,0,0,650394247,116470886,0.0892936865107296,97.3585931795611,0
460.03,464,1693,1462,394469,580414,2025-04-17,2025-05-16,525.66,-231,185945,2098065603,598425916,0.0276642445865407,99.1541771155952,0.32036615243602
338.2,340,3217,3216,469682,578880,2025-04-17,2025-07-18,525.66,-1,109198,781158455,167554530,0.0741053234839531,99.3064083265923,0.188636677722499
519.77,553,173,174,316590,578202,2025-04-17,2025-05-02,525.66,1,261612,204772860,42617637,0.282362613873733,94.8363601504614,0.452457791567653
513.5,526,217,460,168175,575000,2025-04-17,2025-05-02,525.66,243,406825,204772860,42617637,0.280798930092591,95.1171590805539,0.707521739130435
224.19,225,7074,7073,700326,572913,2025-04-17,2025-09-19,525.66,-1,-127413,1699576882,316242446,0.0337091546765344,99.5482395600154,-0.222395023328149
472.07,477,644,1162,230552,572866,2025-04-17,2025-05-16,525.66,518,342314,2098065603,598425916,0.0273044846253075,99.1814816002205,0.59754637210098
522.27,549,49,213,104615,569349,2025-04-17,2025-05-09,525.66,164,464734,114289278,33592363,0.498164840974846,87.2493445973121,0.816255056213324
480.15,499,304,301,464208,567385,2025-04-17,2025-08-15,525.66,-3,103177,650394247,116470886,0.0872370877536375,97.4458302673148,0.181846541589926
524.5,543,248,301,354144,556850,2025-04-17,2025-05-09,525.66,53,202706,114289278,33592363,0.487228556995522,87.7365731543076,0.364022627278441
488.58,513,263,225,486813,549450,2025-04-17,2025-08-15,525.66,-38,62637,650394247,116470886,0.084479529536798,97.5303097968516,0.113999453999454
292.02,295,1829,1833,471882,546234,2025-04-17,2025-12-19,525.66,4,74352,1076181448,187344700,0.0507566824363246,99.2946655962053,0.136117488109492
524.49,566,129,129,397191,535479,2025-04-17,2025-05-09,525.66,0,138288,114289278,33592363,0.468529515078396,88.205102669386,0.258251023849675
371.41,375,1420,1491,401860,535269,2025-04-17,2025-08-15,525.66,71,133409,650394247,116470886,0.0822991596972106,97.6126089565488,0.249237299376575
482.59,490,591,719,333324,532779,2025-04-17,2025-05-23,525.66,128,199455,27519740,10743122,1.93598849407734,59.2625620736243,0.37436723294274
495.67,524,176,188,390544,532604,2025-04-17,2025-08-15,525.66,12,142060,650394247,116470886,0.0818894082253467,97.6944983647741,0.26672724951371
448.07,450,2798,2748,439286,530364,2025-04-17,2025-05-09,525.66,-50,91077.9999999999,114289278,33592363,0.464054029635221,88.6691566990212,0.171727341976454
438.89,440,4252,4738,395436,525918,2025-04-17,2025-05-02,525.66,486,130482,204772860,42617637,0.256829933419888,95.3739890139738,0.248103316486601
520.82,640,44,44,498036,524392,2025-04-17,2025-07-18,525.66,0,26356.0000000001,781158455,167554530,0.0671300421372255,99.3735383687296,0.0502601107568385
330.6,335,1092,1180,409500,519200,2025-04-17,2025-12-19,525.66,88,109700,1076181448,187344700,0.0482446525132814,99.3429102487186,0.211286594761171
458.35,462,1484,1416,372484,516840,2025-04-17,2025-05-16,525.66,-68,144356,2098065603,598425916,0.0246341200799907,99.2061157203005,0.279305007352372
524.56,552.5,179,182,312176,508508,2025-04-17,2025-05-02,525.66,3,196332,204772860,42617637,0.24832783016265,95.6223168441365,0.38609422073989
530.62,561,167,166,442717,504308,2025-04-17,2025-05-09,525.66,-1,61591,114289278,33592363,0.441255740542871,89.1104124395641,0.122129730244216
527.64,551,215,215,341850,502240,2025-04-17,2025-05-02,525.66,0,160390,204772860,42617637,0.245266877651658,95.8675837217881,0.319349315068493
515.07,538,191,219,267400,502167,2025-04-17,2025-05-09,525.66,28,234767,114289278,33592363,0.439382423957565,89.5497948635217,0.467507821103338
426.05,431,1014,1014,843648,501930,2025-04-17,2025-08-15,525.66,0,-341718,650394247,116470886,0.077173191847129,97.7716715566213,-0.680808080808081
510.38,517,552,755,262752,499810,2025-04-17,2025-04-25,525.66,203,237058,186785929,41175251,0.26758439603874,94.1263974975331,0.474296232568376
327.19,330,1757,1775,425194,498775,2025-04-17,2025-09-19,525.66,18,73581.0000000001,1699576882,316242446,0.0293470101460229,99.5775865701614,0.147523432409403
473.39,491,284,282,408676,496602,2025-04-17,2025-08-15,525.66,-2,87926,650394247,116470886,0.0763539964091964,97.8480255530305,0.1770552675986
499.63,515,284,323,269800,496451,2025-04-17,2025-05-23,525.66,39,226651,27519740,10743122,1.80398143296412,61.0665435065884,0.456542538941406
517.15,528,303,456,217857,494760,2025-04-17,2025-04-25,525.66,153,276903,186785929,41175251,0.264880766259433,94.3912782637926,0.559671355808877
521,546,189,196,267813,490000,2025-04-17,2025-05-02,525.66,7,222187,204772860,42617637,0.239289523035426,96.1068732448236,0.453442857142857
523.81,625,48,48,576624,485712,2025-04-17,2025-07-18,525.66,0,-90912,781158455,167554530,0.0621784219182522,99.4357167906478,-0.187172645518332
336.98,340,1608,1606,414864,485012,2025-04-17,2025-09-19,525.66,-2,70148,1699576882,316242446,0.0285372203597672,99.6061237905212,0.144631473035719
508.5,518,455,509,293930,483550,2025-04-17,2025-05-02,525.66,54,189620,204772860,42617637,0.236139691558735,96.3430129363823,0.392141453831041
364.34,365,8506,7301,374264,481866,2025-04-17,2025-05-16,525.66,-1205,107602,2098065603,598425916,0.022967155998887,99.2290828762994,0.223302743916359
385.63,390,1102,1102,369170,481574,2025-04-17,2025-08-15,525.66,0,112404,650394247,116470886,0.0740433978654181,97.9220689508959,0.233409610983982
377.16,380,1677,1687,370617,479108,2025-04-17,2025-07-18,525.66,10,108491,781158455,167554530,0.0613330108550128,99.4970498015028,0.226443724588193
218.77,220,3886,3891,446890,478593,2025-04-17,2025-12-19,525.66,5,31703.0000000001,1076181448,187344700,0.0444714040452405,99.3873816527638,0.0662420887894308
523.81,640,41,41,464448,476379,2025-04-17,2025-08-15,525.66,0,11930.9999999999,650394247,116470886,0.0732446515628543,97.9953136024587,0.0250451846114122
478.41,485,549,721,279990,475139,2025-04-17,2025-05-23,525.66,172,195149,27519740,10743122,1.72653884084661,62.793082347435,0.410719810413374
471.92,489,263,278,509431,474824,2025-04-17,2025-08-15,525.66,15,-34607.0000000001,650394247,116470886,0.0730055658072265,98.068319168266,-0.0728838474887539
449.16,458,535,534,451005,472056,2025-04-17,2025-08-15,525.66,-1,21050.9999999999,650394247,116470886,0.0725799777869191,98.1408991460529,0.0445942854237632
284.46,285,3912,8720,183864,470880,2025-04-17,2025-06-20,525.66,4808,287016,2210385665,443310327,0.0213030697518571,99.7349396943361,0.609531090723751
333.8,335,3913,3912,403039,469440,2025-04-17,2025-06-20,525.66,-1,66400.9999999999,2210385665,443310327,0.0212379227495578,99.7561776170857,0.141447256305385
483.67,485,2760,3526,441600,468958,2025-04-17,2025-04-25,525.66,766,27358,186785929,41175251,0.251067091889989,94.6423453556826,0.0583378468860751
524.72,567,109,110,343677,465080,2025-04-17,2025-05-09,525.66,1,121403,114289278,33592363,0.406932310833217,89.9567271743549,0.261036810871248
532.86,578,180,103,676620,464942,2025-04-17,2025-05-16,525.66,-77,-211678,2098065603,598425916,0.0221605082002767,99.2512433844997,-0.455278292776304
481.99,503,254,220,558800,462220,2025-04-17,2025-08-15,525.66,-34,-96579.9999999999,650394247,116470886,0.0710676642870121,98.2119668103399,-0.208948119942884
526.43,544,258,263,400416,462091,2025-04-17,2025-05-09,525.66,5,61675,114289278,33592363,0.404317017384606,90.3610441917395,0.133469381572028
467.15,484,214,274,296176,461690,2025-04-17,2025-08-15,525.66,60,165514,650394247,116470886,0.0709861752513318,98.2829529855912,0.358495960492972
500.27,509,405,528,198450,460944,2025-04-17,2025-05-02,525.66,123,262494,204772860,42617637,0.22510014266539,96.5681130790477,0.569470477975633
288.42,290,2833,2915,447614,460570,2025-04-17,2025-09-19,525.66,82,12955.9999999999,1699576882,316242446,0.0270990977153101,99.6332228882365,0.0281303602058318
274.56,275,10459,10456,522950,460064,2025-04-17,2025-06-20,525.66,-3,-62885.9999999999,2210385665,443310327,0.0208137433790316,99.7769913604647,-0.136689677957849
429.7,430,13792,15308,675808,459240,2025-04-17,2025-04-25,525.66,1516,-216568,186785929,41175251,0.245864344524581,94.8882097002071,-0.471579130737741
517,527,258,459,179310,459000,2025-04-17,2025-04-25,525.66,201,279690,186785929,41175251,0.245735855188535,95.1339455553957,0.609346405228758
392.76,395,1996,2034,343312,455616,2025-04-17,2025-06-20,525.66,38,112304,2210385665,443310327,0.020612511527485,99.7976038719922,0.246488270824554
490.93,496,178,894,86330,453258,2025-04-17,2025-05-02,525.66,716,366928,204772860,42617637,0.221346715575492,96.7894597946232,0.809534525590282
276.54,280,1309,1309,452914,452914,2025-04-17,2025-12-19,525.66,0,0,1076181448,187344700,0.04208528225809,99.4294669350219,0
446.84,450,1312,1433,303072,452828,2025-04-17,2025-05-23,525.66,121,149756,27519740,10743122,1.64546612722359,64.4385484746586,0.330712765111698
458.42,460,2576,2857,360640,451406,2025-04-17,2025-05-02,525.66,281,90766.0000000001,204772860,42617637,0.220442298847611,97.0099020934708,0.201073977749521
469.72,474,970,1049,285180,448972,2025-04-17,2025-05-16,525.66,79,163792,2098065603,598425916,0.0213993308578159,99.2726427153575,0.364815623245993
447.07,457,449,449,445857,445857,2025-04-17,2025-08-15,525.66,0,0,650394247,116470886,0.0685518056250581,98.3515047912163,0
528.57,565,120,122,339600,444446,2025-04-17,2025-05-23,525.66,2,104846,27519740,10743122,1.61500799062782,66.0535564652864,0.23590267434064
535.78,557.5,204,204,443088,443088,2025-04-17,2025-05-02,525.66,0,0,204772860,42617637,0.216380237107593,97.2262823305784,0
304.3,305,6246,6291,368514,440370,2025-04-17,2025-06-20,525.66,45,71856,2210385665,443310327,0.0199227676406416,99.8175266396328,0.163171878193337
174.19,175,5382,5432,608166,439992,2025-04-17,2025-12-19,525.66,50,-168174,1076181448,187344700,0.040884555371001,99.4703514903929,-0.382220585828833
410.53,415,963,983,346680,439401,2025-04-17,2025-07-18,525.66,20,92720.9999999999,781158455,167554530,0.0562499192305356,99.5532997207334,0.211016816074611
498.44,507,525,512,296625,438272,2025-04-17,2025-05-09,525.66,-13,141647,114289278,33592363,0.383476042258312,90.7445202339978,0.323194272050234
219.11,220,4855,4833,398110,430137,2025-04-17,2025-09-19,525.66,-22,32027,1699576882,316242446,0.0253084755715099,99.658531363808,0.0744576727879722
293.89,295,3810,3811,400050,423021,2025-04-17,2025-07-18,525.66,1,22971,781158455,167554530,0.0541530335225009,99.6074527542559,0.0543022686816967
512.48,532,95,216,160645,421632,2025-04-17,2025-05-09,525.66,121,260987,114289278,33592363,0.368916496261355,91.1134367302592,0.618992391469338
525.71,610,50,50,364000,421450,2025-04-17,2025-05-16,525.66,0,57450,2098065603,598425916,0.0200875510945594,99.292730266452,0.136315102621901
466.9,471,1267,1027,392770,421070,2025-04-17,2025-05-16,525.66,-240,28300,2098065603,598425916,0.0200694391728227,99.3127997056249,0.0672097275987366
233.34,235,878,2536,171210,420976,2025-04-17,2025-12-19,525.66,1658,249766,1076181448,187344700,0.039117567096362,99.5094690574893,0.593302231006043
223.52,225,2852,2840,359352,420320,2025-04-17,2025-12-19,525.66,-12,60968,1076181448,187344700,0.0390566108327859,99.5485256683221,0.145051389417587
508,525,222,247,274614,419900,2025-04-17,2025-05-23,525.66,25,145286,27519740,10743122,1.52581383399698,67.5793702992834,0.346001428911646
522.21,615,45,45,540225,417555,2025-04-17,2025-09-19,525.66,0,-122670,1699576882,316242446,0.0245681736685331,99.6830995374765,-0.293781657506197
258.92,260,3819,3819,412452,412452,2025-04-17,2025-08-15,525.66,0,0,650394247,116470886,0.0634156900837409,98.4149204813,0
497.61,506,486,490,261468,411110,2025-04-17,2025-05-09,525.66,4,149642,114289278,33592363,0.359710033341885,91.473146763601,0.363995037824427
515.99,539,128,178,186368,409578,2025-04-17,2025-05-09,525.66,50,223210,114289278,33592363,0.358369575140723,91.8315163387418,0.544975560210754
523.81,630,38,38,380418,403522,2025-04-17,2025-07-18,525.66,0,23104,781158455,167554530,0.0516568690279362,99.6591096232838,0.0572558621339109
430.56,437,624,624,401856,401856,2025-04-17,2025-08-15,525.66,0,0,650394247,116470886,0.0617865243817263,98.4767070056817,0
317.46,320,1071,1554,245259,394716,2025-04-17,2025-09-19,525.66,483,149457,1699576882,316242446,0.0232243686167061,99.7063239060932,0.37864439242392
517.93,550,130,123,261820,394461,2025-04-17,2025-05-23,525.66,-7,132641,27519740,10743122,1.43337473391827,69.0127450332016,0.336258844347096
513.83,536,178,177,238520,392409,2025-04-17,2025-05-09,525.66,-1,153889,114289278,33592363,0.343347168576916,92.1748635073187,0.39216480763693
449.54,450,5750,8504,425500,391184,2025-04-17,2025-04-25,525.66,2754,-34316,186785929,41175251,0.209429051799721,95.3433746071954,-0.0877234242709313
398.41,400,2415,2445,292215,388755,2025-04-17,2025-05-30,525.66,30,96540,542920959,126942613,0.0716043456336708,98.8789876502079,0.248331211174133
413.44,420,595,589,280840,386384,2025-04-17,2025-08-15,525.66,-6,105544,650394247,116470886,0.0594076595514536,98.5361146652332,0.273158308832664
525.66,570,1365,86,4368000,381324,2025-04-17,2025-05-02,525.66,-1279,-3986676,204772860,42617637,0.186218036901961,97.4125003674803,-10.4548258174151
474.85,493,211,210,282740,381150,2025-04-17,2025-08-15,525.66,-1,98409.9999999999,650394247,116470886,0.0586029168858869,98.5947175821191,0.258192312737767
529.47,570,16,94,51904,380982,2025-04-17,2025-05-23,525.66,78,329078,27519740,10743122,1.38439534675836,70.39714037996,0.863762592458436
445.99,449,1163,1258,222133,378658,2025-04-17,2025-05-16,525.66,95,156525,2098065603,598425916,0.0180479580551991,99.33084766368,0.413367735529158
509.44,532,135,167,200610,376752,2025-04-17,2025-05-30,525.66,32,176142,542920959,126942613,0.0693935265814632,98.9483811767893,0.467527710536374
369.18,370,4485,4580,206310,375560,2025-04-17,2025-05-16,525.66,95,169250,2098065603,598425916,0.017900298230093,99.3487479619101,0.450660347214826
519.37,537,168,212,202440,373756,2025-04-17,2025-05-02,525.66,44,171316,204772860,42617637,0.182522234635977,97.5950226021163,0.458363210222712
503.22,511,274,480,144672,373440,2025-04-17,2025-05-02,525.66,206,228768,204772860,42617637,0.182367917310917,97.7773905194272,0.612596401028278
510.3,524,248,270,272552,369900,2025-04-17,2025-05-09,525.66,22,97348,114289278,33592363,0.323652407708797,92.4985159150275,0.263173830765072
368.38,370,2382,2262,309660,366444,2025-04-17,2025-06-20,525.66,-120,56784,2210385665,443310327,0.0165782834101035,99.8341049230429,0.154959557258408
504.64,509,702,840,222534,366240,2025-04-17,2025-04-25,525.66,138,143706,186785929,41175251,0.196074726806643,95.539449334002,0.392382044560944
499.57,506,154,569,68838,365867,2025-04-17,2025-05-02,525.66,415,297029,204772860,42617637,0.178669673315106,97.9560601927423,0.811849661215688
297.77,300,1638,1629,296478,363267,2025-04-17,2025-09-19,525.66,-9,66789,1699576882,316242446,0.021373966888307,99.7276978729816,0.183856502242152
511.99,519,407,518,207570,363118,2025-04-17,2025-04-25,525.66,111,155548,186785929,41175251,0.194403294693574,95.7338526286956,0.428367638068066
485.95,509,163,157,387614,361885,2025-04-17,2025-08-15,525.66,-6,-25729.0000000001,650394247,116470886,0.0556408673153593,98.6503584494344,-0.0710971717534578
339.49,340,7101,7086,205929,361386,2025-04-17,2025-05-16,525.66,-15,155457,2098065603,598425916,0.0172247235493141,99.3659726854595,0.430168849927778
445.65,448,1513,1534,282931,360490,2025-04-17,2025-05-16,525.66,21,77559,2098065603,598425916,0.017182017544377,99.3831547030038,0.215148825210131
494.46,497,782,1416,187680,359664,2025-04-17,2025-04-25,525.66,634,171984,186785929,41175251,0.192554118998974,95.9264067476946,0.47817963432537
516.57,542,54,141,85050,358563,2025-04-17,2025-05-09,525.66,87,273513,114289278,33592363,0.313732842025654,92.8122487570531,0.762803189397679
514.55,523,155,422,88660,356590,2025-04-17,2025-04-25,525.66,267,267930,186785929,41175251,0.190908384753115,96.1173151324477,0.751367116296026
449.32,452,350,1327,71050,355636,2025-04-17,2025-05-16,525.66,977,284586,2098065603,598425916,0.0169506615756667,99.4001053645795,0.800217075886581
238.24,240,2016,2016,306432,354816,2025-04-17,2025-12-19,525.66,0,48384,1076181448,187344700,0.0329699049039916,99.5814955732261,0.136363636363636
307.64,310,1483,1494,336641,352584,2025-04-17,2025-09-19,525.66,11,15942.9999999999,1699576882,316242446,0.0207453986774103,99.748443271659,0.0452175935379936
526.54,548,158,164,273972,351944,2025-04-17,2025-05-09,525.66,6,77972,114289278,33592363,0.307941397617369,93.1201901546705,0.221546609687905
507.5,522,247,239,224276,346550,2025-04-17,2025-05-09,525.66,-8,122274,114289278,33592363,0.303221794786384,93.4234119494569,0.352832203145289
455.94,459,1018,1132,225996,346392,2025-04-17,2025-05-16,525.66,114,120396,2098065603,598425916,0.0165100652479454,99.4166154298274,0.347571537448902
204,205,3445,3449,334165,344900,2025-04-17,2025-12-19,525.66,4,10735,1076181448,187344700,0.0320484989442041,99.6135440721703,0.0311249637576109
474.04,479,637,685,215943,339760,2025-04-17,2025-05-16,525.66,48,123817,2098065603,598425916,0.0161939645506881,99.4328093943781,0.364424888156346
428.84,436,474,474,339384,339384,2025-04-17,2025-08-15,525.66,0,0,650394247,116470886,0.0521812733684897,98.7025397228029,0
331.35,335,925,925,337625,337625,2025-04-17,2025-09-19,525.66,0,0,1699576882,316242446,0.0198652384352684,99.7683085100942,0
289.43,290,5845,5907,274715,336699,2025-04-17,2025-06-20,525.66,62,61984.0000000001,2210385665,443310327,0.0152325906438594,99.8493375136868,0.184093210850047
450.22,459,383,383,453472,336274,2025-04-17,2025-08-15,525.66,0,-117198,650394247,116470886,0.051703101857234,98.7542428246602,-0.348519362186788
403.86,405,2724,2943,220644,335502,2025-04-17,2025-05-16,525.66,219,114858,2098065603,598425916,0.0159910157013331,99.4488004100795,0.342346692419121
311.29,315,916,901,300448,334271,2025-04-17,2025-12-19,525.66,-15,33823,1076181448,187344700,0.0310608402162309,99.6446049123865,0.10118436837177
511.7,535,142,143,220242,333190,2025-04-17,2025-05-23,525.66,1,112948,27519740,10743122,1.21073091533568,71.6078712952957,0.338989765599208
248.81,250,2746,2782,282838,331058,2025-04-17,2025-09-19,525.66,36,48220,1699576882,316242446,0.0194788481478062,99.787787358242,0.145654235813664
269.5,270,6608,6614,244496,330700,2025-04-17,2025-06-20,525.66,6,86204,2210385665,443310327,0.0149611900419197,99.8642987037287,0.260671303296039
523.42,630,32,31,286720,330398,2025-04-17,2025-12-19,525.66,-1,43678,1076181448,187344700,0.0307009566661848,99.6753058690527,0.132198136792596
380.97,385,813,817,260973,329251,2025-04-17,2025-08-15,525.66,4,68278,650394247,116470886,0.0506232952580222,98.8048661199182,0.207373705774622
301.58,305,958,952,274946,325584,2025-04-17,2025-12-19,525.66,-6,50638,1076181448,187344700,0.030253634329515,99.7055595033822,0.155529755761954
356.56,360,884,942,281996,324048,2025-04-17,2025-09-19,525.66,58,42052,1699576882,316242446,0.0190663925493428,99.8068537507914,0.129770898138547
506.16,511,538,666,181306,322344,2025-04-17,2025-04-25,525.66,128,141038,186785929,41175251,0.172574027243776,96.2898891596915,0.437538778447869
444.17,447,986,1125,180438,318375,2025-04-17,2025-05-16,525.66,139,137937,2098065603,598425916,0.0151746923234793,99.463975102403,0.433253239104829
389.1,390,3246,3530,220728,317700,2025-04-17,2025-05-16,525.66,284,96972,2098065603,598425916,0.0151425198309207,99.4791176222339,0.3052313503305
493.82,506,222,260,195360,316680,2025-04-17,2025-05-23,525.66,38,121320,27519740,10743122,1.15073761598038,72.7586089112761,0.383099658961728
517.84,529,150,280,114900,312480,2025-04-17,2025-04-25,525.66,130,197580,186785929,41175251,0.167293115532273,96.4571822752237,0.632296466973886
213.9,215,2831,2833,331227,311630,2025-04-17,2025-12-19,525.66,2,-19597,1076181448,187344700,0.0289570128326539,99.7345165162148,-0.0628854731572698
528.44,558,102,103,262548,304468,2025-04-17,2025-05-09,525.66,1,41920,114289278,33592363,0.266401192944801,93.6898131424017,0.137682777828869
517.72,541,74,129,112480,300312,2025-04-17,2025-05-09,525.66,55,187832,114289278,33592363,0.262764806336426,93.9525779487381,0.625456192226751
366.64,370,822,893,223584,300048,2025-04-17,2025-08-15,525.66,71,76464,650394247,116470886,0.0461332493920414,98.8509993693102,0.254839225723884
506.98,519,82,245,64780,294490,2025-04-17,2025-05-09,525.66,163,229710,114289278,33592363,0.257670715182924,94.210248663921,0.780026486468131
304.76,305,12373,12175,197968,292200,2025-04-17,2025-05-16,525.66,-198,94232,2098065603,598425916,0.0139271145564842,99.4930447367904,0.32249144421629
334.65,335,8408,8343,235424,292005,2025-04-17,2025-05-16,525.66,-65,56581,2098065603,598425916,0.0139178202808561,99.5069625570712,0.193767230013185
515.09,529,153,208,130356,289328,2025-04-17,2025-05-02,525.66,55,158972,204772860,42617637,0.141292161471007,98.0973523542134,0.549452524470497
457.61,460,627,1205,117249,287995,2025-04-17,2025-05-09,525.66,578,170746,114289278,33592363,0.251987767391443,94.4622364313125,0.592878348582441
413.44,415,1988,1836,200788,286416,2025-04-17,2025-05-16,525.66,-152,85628.0000000001,2098065603,598425916,0.0136514320424708,99.5206139891137,0.298963745042177
518.59,551,84,88,345660,285208,2025-04-17,2025-05-09,525.66,4,-60452,114289278,33592363,0.249549218431496,94.711785649744,-0.211957588847438
374.29,375,3980,4013,210940,284923,2025-04-17,2025-05-16,525.66,33,73983,2098065603,598425916,0.0135802712552263,99.5341942603689,0.259659627337912
443.82,445,2656,2406,276224,283908,2025-04-17,2025-05-02,525.66,-250,7684,204772860,42617637,0.138645326338656,98.235997680552,0.027065105597588
349.54,350,6317,6137,221095,282302,2025-04-17,2025-05-16,525.66,-180,61207,2098065603,598425916,0.013455346658195,99.5476496070271,0.216813908509327
523.81,592,41,41,334683,279579,2025-04-17,2025-05-16,525.66,0,-55104,2098065603,598425916,0.013325560440066,99.5609751674672,-0.197096348438187
224.76,225,8524,11620,170480,278880,2025-04-17,2025-06-20,525.66,3096,108400,2210385665,443310327,0.0126168027786228,99.8769155065073,0.388697647733792
208.76,210,2242,2242,334058,278008,2025-04-17,2025-12-19,525.66,0,-56050,1076181448,187344700,0.0258328184821116,99.760349334697,-0.201612903225806
342.47,345,1072,1086,273360,274758,2025-04-17,2025-08-15,525.66,14,1398,650394247,116470886,0.0422448386140168,98.8932442079243,0.00508811390387177
454.76,458,773,848,173152,274752,2025-04-17,2025-05-16,525.66,75,101600,2098065603,598425916,0.013095491371058,99.5740706588382,0.369788027020731
420.97,428,390,390,274170,274170,2025-04-17,2025-08-15,525.66,0,0,650394247,116470886,0.042154431910281,98.9353986398345,0
459.4,460,3537,4560,307719,273600,2025-04-17,2025-04-25,525.66,1023,-34119,186785929,41175251,0.146477843092774,96.6036601183165,-0.124703947368421
449.92,453,626,888,116436,273504,2025-04-17,2025-05-16,525.66,262,157068,2098065603,598425916,0.0130360080070385,99.5871066668452,0.574280449280449
474.85,492,154,159,229922,272685,2025-04-17,2025-08-15,525.66,5,42763,650394247,116470886,0.0419261088574789,98.977324748692,0.156821974072648
532.75,585,1220,52,5673000,271700,2025-04-17,2025-05-30,525.66,-1168,-5401300,542920959,126942613,0.0500441170111467,98.9984252938005,-19.8796466691204
509.39,523,157,199,150249,270839,2025-04-17,2025-05-09,525.66,42,120590,114289278,33592363,0.236976735472946,94.9487623852169,0.44524606869764
498.86,509,252,266,217476,269724,2025-04-17,2025-05-09,525.66,14,52248,114289278,33592363,0.236001140894424,95.1847635261113,0.193709124883214
512.79,537,38,111,55290,268731,2025-04-17,2025-05-23,525.66,73,213441,27519740,10743122,0.976502684981762,73.7351115962578,0.794255221764515
532.54,552,136,138,264928,268548,2025-04-17,2025-05-09,525.66,2,3620,114289278,33592363,0.234972172980216,95.4197356990916,0.0134798993103654
521.88,579,184,47,701040,268464,2025-04-17,2025-05-16,525.66,-137,-432576,2098065603,598425916,0.0127957867292675,99.5999024535745,-1.61129983908457
430.37,449,144,144,268272,268272,2025-04-17,2025-08-15,525.66,0,0,650394247,116470886,0.0412475973207678,99.0185723460128,0
429.1,431,1018,1408,136412,267520,2025-04-17,2025-05-16,525.66,390,131108,2098065603,598425916,0.0127507929026374,99.6126532464772,0.490086722488038
523.82,635,24,24,249672,266832,2025-04-17,2025-07-18,525.66,0,17160,781158455,167554530,0.0341584986108868,99.6932681218947,0.064310127720813
480.78,482,2035,2184,368335,266448,2025-04-17,2025-04-25,525.66,149,-101887,186785929,41175251,0.142648860878594,96.7463089791951,-0.382389809643908
460.76,465,442,627,144092,265848,2025-04-17,2025-05-23,525.66,185,121756,27519740,10743122,0.966026568564965,74.7011381648228,0.457991032469682
464.25,468,674,707,169174,265125,2025-04-17,2025-05-16,525.66,33,95951,2098065603,598425916,0.0126366401327442,99.6252898866099,0.361908533710514
440.28,443,887,974,205784,264928,2025-04-17,2025-05-16,525.66,87,59144,2098065603,598425916,0.0126272505312123,99.6379171371411,0.223245561058099
409.3,415,460,464,230000,264480,2025-04-17,2025-08-15,525.66,4,34480,650394247,116470886,0.0406645663334104,99.0592369123462,0.130369026013309
419.83,427,366,362,192882,259554,2025-04-17,2025-08-15,525.66,-4,66672,650394247,116470886,0.0399071795602768,99.0991440919065,0.25687140248272
193.95,195,2448,2450,220320,257250,2025-04-17,2025-12-19,525.66,2,36930,1076181448,187344700,0.0239039615929153,99.7842532962899,0.143556851311953
462.69,477,194,179,283240,256149,2025-04-17,2025-08-15,525.66,-15,-27091,650394247,116470886,0.0393836509442557,99.1385277428507,-0.10576266157588
509.7,532,78,114,133536,254220,2025-04-17,2025-05-23,525.66,36,120684,27519740,10743122,0.923773262392741,75.6249114272155,0.474722681142318
508.83,528,48,132,68160,253044,2025-04-17,2025-05-30,525.66,84,184884,542920959,126942613,0.0466078893815555,99.045033183182,0.730639730639731
496.54,499,666,1005,173160,247230,2025-04-17,2025-04-25,525.66,339,74070,186785929,41175251,0.132360077294687,96.8786690564898,0.299599563159811
509.78,516,151,395,71725,245690,2025-04-17,2025-04-25,525.66,244,173965,186785929,41175251,0.131535604055057,97.0102046605449,0.708067076397086
184.23,185,3153,3153,318453,242781,2025-04-17,2025-12-19,525.66,0,-75672,1076181448,187344700,0.0225594857123016,99.8068127820022,-0.311688311688312
523.81,620,26,25,205712,240475,2025-04-17,2025-07-18,525.66,-1,34763,781158455,167554530,0.0307844072429582,99.7240525291376,0.144559725543196
495.51,508,35,192,29785,239808,2025-04-17,2025-05-30,525.66,157,210023,542920959,126942613,0.0441699654479539,99.08920314863,0.875796470509741
500.65,516,155,156,161355,239460,2025-04-17,2025-05-23,525.66,1,78105,27519740,10743122,0.870139034743788,76.4950504619593,0.32617138561764
391.76,395,737,737,263109,238788,2025-04-17,2025-08-15,525.66,0,-24320.9999999999,650394247,116470886,0.0367143468905868,99.1752420897413,-0.101851851851852
511.52,518,319,365,154715,236520,2025-04-17,2025-04-25,525.66,46,81805,186785929,41175251,0.126626240673622,97.1368309012185,0.345869271097582
452.58,456,567,689,127008,235638,2025-04-17,2025-05-16,525.66,122,108630,2098065603,598425916,0.0112312026689282,99.6491483398101,0.461003743029562
421.04,423,1193,1198,128844,234808,2025-04-17,2025-05-16,525.66,5,105964,2098065603,598425916,0.0111916424188191,99.6603399822289,0.451279343122892
424.13,425,2869,2695,203699,234465,2025-04-17,2025-05-02,525.66,-174,30766,204772860,42617637,0.114500036772451,98.3504977173245,0.13121787900113
453.5,455,790,1559,95590,233850,2025-04-17,2025-05-02,525.66,769,138260,204772860,42617637,0.114199704003743,98.4646974213282,0.591233696814197
514.43,531,46,141,48760,233637,2025-04-17,2025-05-09,525.66,95,184877,114289278,33592363,0.20442600048624,95.6241616995778,0.791300179338033
426.34,428,1247,1405,144652,233230,2025-04-17,2025-05-16,525.66,158,88578,2098065603,598425916,0.0111164302806598,99.6714564125095,0.379788191913562
523.81,604,29,29,306791,232551,2025-04-17,2025-05-16,525.66,0,-74240.0000000001,2098065603,598425916,0.0110840671362935,99.6825404796458,-0.319241800723283
487.37,511,147,98,357798,231574,2025-04-17,2025-08-15,525.66,-49,-126224,650394247,116470886,0.0356051734879506,99.2108472632293,-0.545069826491748
511.48,523,192,201,139392,231552,2025-04-17,2025-05-02,525.66,9,92160,204772860,42617637,0.113077484975304,98.5777749063035,0.398009950248756
491.04,493,1361,1176,261312,230496,2025-04-17,2025-04-25,525.66,-185,-30816,186785929,41175251,0.12340115833886,97.2602320595573,-0.133694294044148
451.15,455,457,596,110594,229460,2025-04-17,2025-05-23,525.66,139,118866,27519740,10743122,0.833801482136096,77.3288519440954,0.518024928092042
495,508,169,176,133341,228800,2025-04-17,2025-05-23,525.66,7,95459,27519740,10743122,0.831403203663988,78.1602551477594,0.417215909090909
497.95,504,64,378,25216,228690,2025-04-17,2025-05-02,525.66,314,203474,204772860,42617637,0.111679838822391,98.6894547451259,0.889737198828108
509.86,528,112,126,141792,228564,2025-04-17,2025-05-23,525.66,14,86772,27519740,10743122,0.830545637422447,78.9908007851818,0.379639838294745
324,325,2254,2256,247940,225600,2025-04-17,2025-06-20,525.66,2,-22340,2210385665,443310327,0.0102063636935503,99.8871218702009,-0.0990248226950355
464.33,465,3894,3364,385506,225388,2025-04-17,2025-04-25,525.66,-530,-160118,186785929,41175251,0.120666476970008,97.3808985365273,-0.710410492129129
505.2,522,110,134,131450,225120,2025-04-17,2025-05-30,525.66,24,93670,542920959,126942613,0.0414645992695965,99.1306677478996,0.416089196872779
523.81,635,20,20,189280,222380,2025-04-17,2025-12-19,525.66,0,33100,1076181448,187344700,0.0206638016677649,99.8274765836699,0.148844320532422
363.33,365,1330,1330,160930,222110,2025-04-17,2025-06-20,525.66,0,61180,2210385665,443310327,0.0100484726949222,99.8971703428958,0.275449101796407
488.01,512,283,92,531474,220708,2025-04-17,2025-08-15,525.66,-191,-310766,650394247,116470886,0.0339344945036084,99.2447817577329,-1.40804139405912
523.82,615,24,24,174672,218832,2025-04-17,2025-07-18,525.66,0,44160,781158455,167554530,0.0280137785873418,99.752066307725,0.201798640052643
189,190,2177,2178,180691,217800,2025-04-17,2025-12-19,525.66,1,37109,1076181448,187344700,0.0202382228763341,99.8477148065463,0.170381083562902
368.99,370,2058,2156,168756,217756,2025-04-17,2025-05-30,525.66,98,49000,542920959,126942613,0.0401082324029417,99.1707759803025,0.225022502250225
451.17,463,169,182,224432,215306,2025-04-17,2025-08-15,525.66,13,-9125.99999999997,650394247,116470886,0.03310392135126,99.2778856790841,-0.042386185243328
434.84,447,177,177,215232,215232,2025-04-17,2025-08-15,525.66,0,0,650394247,116470886,0.0330925436368443,99.310978222721,0
468.73,473,364,499,105560,213073,2025-04-17,2025-05-16,525.66,135,107513,2098065603,598425916,0.0101556881584317,99.6926961678042,0.504582936364532
376.13,380,537,546,160026,211302,2025-04-17,2025-08-15,525.66,9,51276,650394247,116470886,0.0324882947496305,99.3434665174706,0.242666893829685
278.88,280,1869,1885,205590,211120,2025-04-17,2025-08-15,525.66,16,5530.00000000003,650394247,116470886,0.0324603117222837,99.3759268291929,0.0261936339522548
513.75,539,38,83,64372,209575,2025-04-17,2025-05-23,525.66,45,145203,27519740,10743122,0.761544258775701,79.7523450439575,0.692845043540499
249.66,250,6226,6158,174328,209372,2025-04-17,2025-06-20,525.66,-68,35044,2210385665,443310327,0.00947219317041671,99.9066425360662,0.167376726591903
503.15,507,477,543,150255,209055,2025-04-17,2025-04-25,525.66,66,58800,186785929,41175251,0.111922242279824,97.4928207788072,0.281265695630337
483.49,501,119,119,234549,208369,2025-04-17,2025-08-15,525.66,0,-26180,650394247,116470886,0.0320373375012341,99.4079641666941,-0.125642490005711
526.18,555,71,72,164720,207504,2025-04-17,2025-05-23,525.66,1,42784,27519740,10743122,0.754018751630648,80.5063637955882,0.206183977176344
293.46,295,1345,1346,220580,207284,2025-04-17,2025-09-19,525.66,1,-13296,1699576882,316242446,0.0121962120216695,99.819049962813,-0.0641438798942512
533.2,557.5,85,85,206550,206550,2025-04-17,2025-05-09,525.66,0,0,114289278,33592363,0.180725614523525,95.8048873141013,0
149.96,150,51573,51499,206292,205996,2025-04-17,2025-06-20,525.66,-74,-296,2210385665,443310327,0.00931945964280401,99.915961995709,-0.00143692110526418
493.1,507,41,148,35752,205720,2025-04-17,2025-05-30,525.66,107,169968,542920959,126942613,0.0378913351178988,99.2086673154204,0.826210383044916
532.67,553,101,101,273811,205333,2025-04-17,2025-05-09,525.66,0,-68478,114289278,33592363,0.179660772727954,95.9845480868293,-0.333497294638465
506.9,512,253,402,99429,205020,2025-04-17,2025-04-25,525.66,149,105591,186785929,41175251,0.109762015317546,97.6025827941247,0.515027802165642
394.02,395,2231,2089,162863,204722,2025-04-17,2025-05-16,525.66,-142,41859,2098065603,598425916,0.00975765484679175,99.7024538226511,0.204467521810064
523.82,602,26,26,200902,203268,2025-04-17,2025-05-16,525.66,0,2366.00000000003,2098065603,598425916,0.0096883529146729,99.7121421755657,0.011639805576874
445.53,453,269,270,229457,201690,2025-04-17,2025-08-15,525.66,1,-27767,650394247,116470886,0.0310104218987657,99.4389745885929,-0.137671674351728
520.4,572,2,39,6722,201240,2025-04-17,2025-05-23,525.66,37,194518,27519740,10743122,0.73125690867719,81.2376207042654,0.966597097992447
357.7,360,389,862,94527,198260,2025-04-17,2025-07-18,525.66,473,103733,781158455,167554530,0.0253802539972508,99.7774465617222,0.523216987793806
502.33,506,327,537,88944,197079,2025-04-17,2025-04-25,525.66,210,108135,186785929,41175251,0.105510624411114,97.7080934185358,0.54868859695858
504.89,516,96,177,76896,196647,2025-04-17,2025-05-09,525.66,81,119751,114289278,33592363,0.17206075971536,96.1566088465447,0.608964286259134
505.87,517,104,176,79456,195888,2025-04-17,2025-05-09,525.66,72,116432,114289278,33592363,0.171396655423792,96.3280055019684,0.594380462304991
522.46,542,102,100,184314,195400,2025-04-17,2025-05-23,525.66,-2,11086,27519740,10743122,0.710035777954298,81.9476564822197,0.0567349027635619
520.59,563,292,46,647364,195086,2025-04-17,2025-04-25,525.66,-246,-452278,186785929,41175251,0.104443627549696,97.8125370460855,-2.31835190633874
511.23,533,37,89,59126,193753,2025-04-17,2025-05-30,525.66,52,134627,542920959,126942613,0.035687146865148,99.2443544622856,0.694838273471895
367.34,370,708,727,137352,193382,2025-04-17,2025-07-18,525.66,19,56030,781158455,167554530,0.024755796824858,99.8022023585471,0.289737410927594
382.01,385,589,641,174344,191659,2025-04-17,2025-07-18,525.66,52,17315,781158455,167554530,0.0245352269790129,99.8267375855261,0.0903427441445484
229.17,230,2322,2304,362232,191232,2025-04-17,2025-09-19,525.66,-18,-171000,1699576882,316242446,0.0112517416555446,99.8303017044686,-0.894201807228916
509.78,527,109,111,108019,191142,2025-04-17,2025-05-09,525.66,2,83123,114289278,33592363,0.167244034912881,96.4952495368813,0.434875642192715
441.69,444,797,825,127520,190575,2025-04-17,2025-05-16,525.66,28,63055,2098065603,598425916,0.00908336706571515,99.7212255426314,0.330867112685295
329.6,330,4758,4716,152256,188640,2025-04-17,2025-05-16,525.66,-42,36384,2098065603,598425916,0.00899113925371379,99.7302166818852,0.192875318066158
303.72,305,1350,1468,136350,187904,2025-04-17,2025-07-18,525.66,118,51554,781158455,167554530,0.0240545306521709,99.8507921161783,0.274363504768392
505.5,523,94,107,112518,187250,2025-04-17,2025-05-30,525.66,13,74732,542920959,126942613,0.0344893666188341,99.2788438289044,0.399102803738318
452.87,455,777,879,114996,187227,2025-04-17,2025-05-09,525.66,102,72231,114289278,33592363,0.163818516729102,96.6590680536104,0.385793715649986
429.28,435,324,324,212868,185328,2025-04-17,2025-08-15,525.66,0,-27540,650394247,116470886,0.0284947169897092,99.4674693055826,-0.148601398601399
520.86,605,22,22,141548,185108,2025-04-17,2025-05-16,525.66,0,43560,2098065603,598425916,0.00882279370746635,99.7390394755926,0.235322082243879
492.01,494,572,925,120120,184075,2025-04-17,2025-04-25,525.66,353,63955,186785929,41175251,0.098548643886339,97.9110856899719,0.347439902213772
436.8,440,562,574,101722,183680,2025-04-17,2025-05-23,525.66,12,81958,27519740,10743122,0.667448166298083,82.6151046485178,0.446199912891986
282.73,285,808,808,183416,183416,2025-04-17,2025-12-19,525.66,0,0,1076181448,187344700,0.0170432226220648,99.8647580291683,0
298.79,300,1419,1515,131967,183315,2025-04-17,2025-07-18,525.66,96,51348,781158455,167554530,0.0234670698149199,99.8742591859932,0.28010801080108
508.42,531,63,81,91728,182898,2025-04-17,2025-05-30,525.66,18,91170,542920959,126942613,0.0336877766400615,99.3125316055445,0.498474559590591
388.63,390,1346,1334,185748,182758,2025-04-17,2025-05-30,525.66,-12,-2989.99999999994,542920959,126942613,0.0336619901977297,99.3461935957422,-0.0163604329222247
508.58,521,50,147,45700,182574,2025-04-17,2025-05-09,525.66,97,136874,114289278,33592363,0.159747268680794,96.8188153222912,0.749690536440019
448.07,451,531,623,105669,182539,2025-04-17,2025-05-16,525.66,92,76870,2098065603,598425916,0.00870034758393587,99.7477398231766,0.421115487649215
379.65,380,376,5213,12032,182455,2025-04-17,2025-05-02,525.66,4837,170423,204772860,42617637,0.0891011631131196,98.778555908239,0.934054972458962
531.57,563,58,58,148654,182294,2025-04-17,2025-05-09,525.66,0,33640,114289278,33592363,0.159502276320269,96.9783175986115,0.184537066496977
279.46,280,3373,3375,151785,182250,2025-04-17,2025-06-20,525.66,2,30465,2210385665,443310327,0.00824516747849973,99.9242071631875,0.167160493827161
353.1,355,943,953,159367,181070,2025-04-17,2025-07-18,525.66,10,21703,781158455,167554530,0.0231796761388187,99.897438862132,0.119859722759154
505.61,522,75,110,95475,180290,2025-04-17,2025-05-23,525.66,35,84815,27519740,10743122,0.655129735964075,83.2702343844818,0.470436518941705
204.3,205,2572,2572,180040,180040,2025-04-17,2025-09-19,525.66,0,0,1699576882,316242446,0.0105932248141747,99.8408949292828,0
477.01,478,1641,1818,187074,179982,2025-04-17,2025-04-25,525.66,177,-7091.99999999997,186785929,41175251,0.0963573653345162,98.0074430553064,-0.0394039403940392
462.68,476,133,135,145369,179820,2025-04-17,2025-08-15,525.66,2,34451,650394247,116470886,0.0276478460302248,99.4951171516128,0.191586030474919
397.97,399,1725,1743,191475,179529,2025-04-17,2025-05-16,525.66,18,-11946,2098065603,598425916,0.00855688209860042,99.7562967052752,-0.0665407817121469
322.87,325,842,842,186924,179346,2025-04-17,2025-09-19,525.66,0,-7578.00000000006,1699576882,316242446,0.010552391121545,99.8514473204043,-0.0422535211267609
228.43,230,1139,1139,216410,178823,2025-04-17,2025-12-19,525.66,0,-37587,1076181448,187344700,0.0166164358558985,99.8813744650242,-0.210191082802548
243.1,245,939,939,178410,178410,2025-04-17,2025-09-19,525.66,0,0,1699576882,316242446,0.0104973185908515,99.8619446389952,0
512.23,536,56,75,81032,178275,2025-04-17,2025-05-23,525.66,19,97243,27519740,10743122,0.647807719113625,83.9180421035955,0.545466274014865
501.72,513,62,157,45880,177096,2025-04-17,2025-05-09,525.66,95,131216,114289278,33592363,0.154954168141652,97.1332717667531,0.740931472195871
508.71,521,76,143,53808,175747,2025-04-17,2025-05-02,525.66,67,121939,204772860,42617637,0.0858253383773611,98.8643812466164,0.693832611651977
523.82,670,12,12,167520,175416,2025-04-17,2025-09-19,525.66,0,7896.00000000003,1699576882,316242446,0.0103211570984407,99.8722657960936,0.0450129976741006
398.68,400,1340,1328,138020,175296,2025-04-17,2025-05-23,525.66,-12,37276,27519740,10743122,0.636982762191794,84.5550248657873,0.212646038700256
497.35,503,14,310,5348,175150,2025-04-17,2025-05-02,525.66,296,169802,204772860,42617637,0.0855337958360302,98.9499150424524,0.969466171852698
503.81,508,198,416,69300,174304,2025-04-17,2025-04-25,525.66,218,105004,186785929,41175251,0.0933175217925543,98.1007605770989,0.602418762621627
214.26,215,2345,2344,173530,173456,2025-04-17,2025-09-19,525.66,-1,-74,1699576882,316242446,0.0102058342777576,99.8824716303714,-0.000426621160409556
530.14,556,62,67,177692,173262,2025-04-17,2025-05-09,525.66,5,-4430,114289278,33592363,0.151599522747882,97.284871289501,-0.0255682146113978
497.45,513,103,111,93112,172605,2025-04-17,2025-05-23,525.66,8,79493,27519740,10743122,0.627204326785064,85.1822291925723,0.460548651545436
510.86,529,60,95,60780,172330,2025-04-17,2025-05-09,525.66,35,111550,114289278,33592363,0.150784048176418,97.4356553376774,0.647304590030755
204.84,205,1110,10751,16650,172016,2025-04-17,2025-06-20,525.66,9641,155366,2210385665,443310327,0.00778217135243682,99.93198933454,0.903206678448516
494.12,507,132,132,136356,170016,2025-04-17,2025-05-23,525.66,0,33660,27519740,10743122,0.617796534414933,85.8000257269872,0.197981366459627
286.95,290,554,555,145148,169275,2025-04-17,2025-12-19,525.66,1,24127,1076181448,187344700,0.015729224873239,99.8971036898975,0.142531383842859
430.88,433,723,796,104112,168752,2025-04-17,2025-05-16,525.66,73,64640,2098065603,598425916,0.0080432184655572,99.7643399237407,0.383047312031858
490.07,492,177,873,34515,168489,2025-04-17,2025-04-25,525.66,696,133974,186785929,41175251,0.0902043322545993,98.1909649093535,0.795149831739758
430.21,432,531,934,69030,167186,2025-04-17,2025-05-16,525.66,403,98156,2098065603,598425916,0.00796857828282122,99.7723085020235,0.587106575909466
432.52,438,303,304,181497,166592,2025-04-17,2025-08-15,525.66,1,-14905,650394247,116470886,0.0256140027019642,99.5207311543148,-0.0894700825970035
431.86,435,510,529,109650,166106,2025-04-17,2025-05-30,525.66,19,56456,542920959,126942613,0.0305948770712313,99.3767884728134,0.339879354147352
419.24,420,1624,2181,90944,165756,2025-04-17,2025-05-02,525.66,557,74812,204772860,42617637,0.0809462738372653,99.0308613162897,0.451338111440913
498.99,502,119,550,31059,165550,2025-04-17,2025-04-25,525.66,431,134491,186785929,41175251,0.0886308732602658,98.2795957826138,0.812389006342495
494.97,509,16,117,14544,164151,2025-04-17,2025-05-30,525.66,101,149607,542920959,126942613,0.0302347878229545,99.4070232606364,0.911398651241844
314.19,315,2016,2026,131040,164106,2025-04-17,2025-06-20,525.66,10,33066,2210385665,443310327,0.00742431524952909,99.9394136497895,0.201491718767138
504,514,71,164,39405,164000,2025-04-17,2025-05-02,525.66,93,124595,204772860,42617637,0.0800887383220609,99.1109500546117,0.759725609756098
528.69,559,54,54,138510,163674,2025-04-17,2025-05-09,525.66,0,25164,114289278,33592363,0.143210284345308,97.5788656220227,0.153744638733091
257.86,260,748,762,231132,163068,2025-04-17,2025-12-19,525.66,14,-68064,1076181448,187344700,0.0151524633976036,99.9122561532951,-0.417396423577894
238.79,240,1369,1345,135531,162745,2025-04-17,2025-09-19,525.66,-24,27214,1699576882,316242446,0.00957561859799409,99.8920472489694,0.167218654950997
233.33,235,972,972,162324,162324,2025-04-17,2025-09-19,525.66,0,0,1699576882,316242446,0.00955084772681675,99.9015980966962,0
436.96,439,561,786,87516,160344,2025-04-17,2025-05-16,525.66,225,72828,2098065603,598425916,0.00764246836565672,99.7799509703892,0.454198473282443
427.87,430,760,741,114000,157833,2025-04-17,2025-05-23,525.66,-19,43833,27519740,10743122,0.573526494072982,86.3735522210602,0.277717587576743
422.02,429,226,226,193004,157748,2025-04-17,2025-08-15,525.66,0,-35256,650394247,116470886,0.024254212076387,99.5449853663912,-0.22349570200573
511.84,524,81,129,69903,156864,2025-04-17,2025-05-02,525.66,48,86961,204772860,42617637,0.0766039015131204,99.1875539561249,0.55437194002448
434.08,436,599,817,88053,156864,2025-04-17,2025-05-16,525.66,218,68811,2098065603,598425916,0.0074766012929101,99.7874275716821,0.438666615667075
273.8,275,1293,1293,134472,155160,2025-04-17,2025-08-15,525.66,0,20688,650394247,116470886,0.0238562995776314,99.5688416659688,0.133333333333333
531.69,562.5,50,50,126600,154050,2025-04-17,2025-05-09,525.66,0,27450,114289278,33592363,0.134789546924953,97.7136551689477,0.178188899707887
523.39,565,1393,37,3398920,153957,2025-04-17,2025-04-25,525.66,-1356,-3244963,186785929,41175251,0.0824243029569963,98.3620200855708,-21.0770734685659
426.98,429,801,761,121752,153722,2025-04-17,2025-05-16,525.66,-40,31970,2098065603,598425916,0.00732684429791874,99.79475441598,0.2079728340771
500.68,504,207,455,61272,151060,2025-04-17,2025-04-25,525.66,248,89788,186785929,41175251,0.0808733295964708,98.4428934151673,0.594386336555011
234.73,235,5562,5578,144612,150606,2025-04-17,2025-06-20,525.66,16,5994.00000000003,2210385665,443310327,0.00681356210297356,99.9462272118924,0.0397992111868055
498.09,501,511,516,124173,150156,2025-04-17,2025-04-25,525.66,5,25983,186785929,41175251,0.0803893530973631,98.5232827682646,0.173040038360106
506.36,518,134,129,102510,150156,2025-04-17,2025-05-09,525.66,-5,47646,114289278,33592363,0.131382403168213,97.8450375721159,0.317309997602493
453.83,457,375,472,76125,149624,2025-04-17,2025-05-16,525.66,97,73499,2098065603,598425916,0.00713152152087401,99.8018859375009,0.491224669839063
523.82,557,51,45,117861,149310,2025-04-17,2025-05-09,525.66,-6,31449,114289278,33592363,0.130642176250339,97.9756797483662,0.210628892907374
509.12,531,49,68,65513,148784,2025-04-17,2025-05-23,525.66,19,83271,27519740,10743122,0.540644642718282,86.9141968637785,0.559677115818905
395.75,397,1088,1190,87040,148750,2025-04-17,2025-05-16,525.66,102,61710,2098065603,598425916,0.0070898641008796,99.8089758016018,0.414857142857143
273.62,275,1053,1071,223236,147798,2025-04-17,2025-09-19,525.66,18,-75438,1699576882,316242446,0.00869616441393794,99.9102942611101,-0.510412860796493
507.94,513,161,290,63595,146740,2025-04-17,2025-04-25,525.66,129,83145,186785929,41175251,0.0785605215476376,98.6018432898123,0.566614420062696
432.15,434,720,793,102240,146705,2025-04-17,2025-05-16,525.66,73,44465,2098065603,598425916,0.00699239336416498,99.8159681949659,0.303091237517467
511.5,526,56,101,54152,146450,2025-04-17,2025-05-09,525.66,45,92298,114289278,33592363,0.128139754282112,98.1038195026484,0.630235575281666
497.62,511,98,109,90650,145842,2025-04-17,2025-05-30,525.66,11,55192,542920959,126942613,0.0268624737325715,99.4338857343689,0.378436938604792
529.73,554,59,60,222961,145620,2025-04-17,2025-05-09,525.66,1,-77341,114289278,33592363,0.127413526927697,98.2312330295761,-0.531115231424255
332.15,335,506,506,144210,144210,2025-04-17,2025-08-15,525.66,0,0,650394247,116470886,0.0221727053498983,99.5910143713187,0
518.83,545,52,55,93912,143935,2025-04-17,2025-05-23,525.66,3,50023,27519740,10743122,0.523024563458812,87.4372214272373,0.347538819606072
522.32,625,24,14,246432,143752,2025-04-17,2025-12-19,525.66,-10,-102680,1076181448,187344700,0.0133575987829145,99.925613752078,-0.714285714285715
492.22,497,67,300,33299,143400,2025-04-17,2025-05-02,525.66,233,110101,204772860,42617637,0.0700288114352654,99.2575827675601,0.76778940027894
508.52,529,46,70,67068,143360,2025-04-17,2025-05-30,525.66,24,76292,542920959,126942613,0.0264053169478027,99.4602910513167,0.532170758928571
505.45,524,39,77,44967,142835,2025-04-17,2025-05-23,525.66,38,97868,27519740,10743122,0.519027432671966,87.9562488599093,0.685182203241503
420.17,422,762,780,100584,142740,2025-04-17,2025-05-16,525.66,18,42156,2098065603,598425916,0.00680340975972809,99.8227716047256,0.295334174022699
517.5,537,80,73,99520,142350,2025-04-17,2025-05-09,525.66,-7,42830,114289278,33592363,0.124552366145843,98.3557853957219,0.300878117316473
323.47,325,922,923,161350,141219,2025-04-17,2025-08-15,525.66,1,-20131,650394247,116470886,0.0217128304334463,99.6127272017521,-0.142551639651888
524.03,580,33,25,155595,139925,2025-04-17,2025-05-23,525.66,-8,-15670,27519740,10743122,0.508453204863127,88.4647020647724,-0.111988565302841
450.71,462,112,123,108416,138867,2025-04-17,2025-08-15,525.66,11,30451,650394247,116470886,0.0213512036185031,99.6340784053707,0.219281758805188
384.11,385,1482,1551,90402,138039,2025-04-17,2025-05-16,525.66,69,47637,2098065603,598425916,0.00657934622266433,99.8293509509483,0.345098124443092
327.67,330,552,589,98256,137237,2025-04-17,2025-08-15,525.66,37,38981,650394247,116470886,0.021100586395562,99.6551789917662,0.28404147569533
531.48,564,44,42,242528,136584,2025-04-17,2025-05-09,525.66,-2,-105944,114289278,33592363,0.119507273464445,98.4752926691863,-0.775669185263281
434.99,437,633,675,84822,135675,2025-04-17,2025-05-16,525.66,42,50853,2098065603,598425916,0.00646667100428127,99.8358176219526,0.374814814814815
499.29,514,80,91,72480,133861,2025-04-17,2025-05-23,525.66,11,61381,27519740,10743122,0.486418112961823,88.9511201777343,0.458542816802504
209.25,210,1784,1784,133800,133800,2025-04-17,2025-09-19,525.66,0,0,1699576882,316242446,0.00787254765683498,99.918166808767,0
268.06,270,687,686,156636,133084,2025-04-17,2025-12-19,525.66,-1,-23552,1076181448,187344700,0.0123663161307349,99.9379800682087,-0.176970935649665
359.32,360,1801,1956,88249,133008,2025-04-17,2025-05-16,525.66,155,44759,2098065603,598425916,0.0063395539114608,99.8421571758641,0.336513593167328
500.55,507,133,205,59850,132225,2025-04-17,2025-05-02,525.66,72,72375,204772860,42617637,0.0645715452721616,99.3221543128323,0.54736245036869
433.51,435,872,883,102024,131567,2025-04-17,2025-05-09,525.66,11,29543,114289278,33592363,0.115117535347454,98.5904102045338,0.224547188884751
440.02,442,518,658,79772,130284,2025-04-17,2025-05-16,525.66,140,50512,2098065603,598425916,0.00620972003037981,99.8483668958944,0.387706855791962
507.7,526,33,71,44946,129930,2025-04-17,2025-05-30,525.66,38,84984,542920959,126942613,0.0239316603726842,99.4842227116894,0.654075271299931
498.17,514,14,82,14980,129806,2025-04-17,2025-05-30,525.66,68,114826,542920959,126942613,0.0239088209523331,99.5081315326418,0.884597014005516
432.66,435,544,552,98464,129168,2025-04-17,2025-05-23,525.66,8,30704,27519740,10743122,0.469364899523033,89.4204850772573,0.237705933358107
434.51,442,172,172,128828,128828,2025-04-17,2025-08-15,525.66,0,0,650394247,116470886,0.0198076782804015,99.6749866700466,0
525.04,574,31,26,120125,127296,2025-04-17,2025-05-09,525.66,-5,7171,114289278,33592363,0.111380526876721,98.7017907314105,0.0563332704876823
439.64,440,3464,3516,207840,126576,2025-04-17,2025-04-25,525.66,52,-81264,186785929,41175251,0.0677652758308149,98.6696085656431,-0.642017444065226
199.86,200,8892,8921,124488,124894,2025-04-17,2025-06-20,525.66,29,405.999999999986,2210385665,443310327,0.00565032618414126,99.9518775380766,0.00325075664163199
521.74,584,1120,20,5756800,124520,2025-04-17,2025-05-30,525.66,-1100,-5632280,542920959,126942613,0.0229351985654324,99.5310667312072,-45.2319306135561
263.01,265,635,622,130175,123778,2025-04-17,2025-12-19,525.66,-13,-6397,1076181448,187344700,0.0115015920623824,99.9494816602711,-0.0516812357607976
379.24,380,1664,1621,88192,123196,2025-04-17,2025-05-16,525.66,-43,35004,2098065603,598425916,0.0058718850270384,99.8542387809215,0.284132601707848
499.51,516,55,74,55330,122026,2025-04-17,2025-05-30,525.66,19,66696,542920959,126942613,0.0224758315141781,99.5535425627214,0.546572042023831
443.27,445,449,697,56125,120581,2025-04-17,2025-05-09,525.66,248,64456,114289278,33592363,0.105505085087684,98.8072958164982,0.534545243446314
419.18,421,417,660,42951,120120,2025-04-17,2025-05-16,525.66,243,77169,2098065603,598425916,0.00572527378687501,99.8599640547084,0.642432567432567
435.7,438,273,522,47502,120060,2025-04-17,2025-05-16,525.66,249,72558,2098065603,598425916,0.00572241400975868,99.8656864687181,0.604347826086957
458.06,468,118,119,111156,118286,2025-04-17,2025-08-15,525.66,1,7129.99999999999,650394247,116470886,0.0181868152348525,99.6931734852815,0.0602776321796323
504.59,521,33,72,39270,118152,2025-04-17,2025-05-30,525.66,39,78882,542920959,126942613,0.0217622838170814,99.5753048465384,0.667631525492586
512.9,538,18,47,29952,117970,2025-04-17,2025-05-23,525.66,29,88018,27519740,10743122,0.42867410811294,89.8491591853702,0.74610494193439
499.72,503,267,358,69954,117424,2025-04-17,2025-04-25,525.66,91,47470,186785929,41175251,0.0628655491495829,98.7324741147927,0.404261479765636
515,541,40,45,71640,117000,2025-04-17,2025-05-23,525.66,5,45360,27519740,10743122,0.425149365509994,90.2743085508802,0.387692307692308
498.98,513,57,83,54948,116366,2025-04-17,2025-05-30,525.66,26,61418,542920959,126942613,0.0214333224884766,99.5967381690269,0.527800216558101
506.4,524,48,66,62688,116160,2025-04-17,2025-05-30,525.66,18,53472,542920959,126942613,0.0213953795804741,99.6181335486074,0.460330578512397
383.57,385,805,804,78085,114972,2025-04-17,2025-05-30,525.66,-1,36887,542920959,126942613,0.021176563198401,99.6393101118058,0.320834637998817
418.2,420,670,634,90450,114120,2025-04-17,2025-05-23,525.66,-36,23670,27519740,10743122,0.414684150358979,90.6889927012392,0.207413249211356
455.71,467,112,101,194320,114029,2025-04-17,2025-08-15,525.66,-11,-80291,650394247,116470886,0.017532289150153,99.7107057744316,-0.704127897289286
199.37,200,1805,1805,131765,113715,2025-04-17,2025-09-19,525.66,0,-18050,1699576882,316242446,0.00669078293570246,99.9248575917026,-0.158730158730159
460.78,479,62,62,112964,112964,2025-04-17,2025-08-15,525.66,0,0,650394247,116470886,0.0173685423143049,99.7280743167459,0
337.68,340,481,485,95238,112520,2025-04-17,2025-08-15,525.66,4,17282,650394247,116470886,0.0173002760278106,99.7453745927737,0.153590472804835
399.81,405,214,216,85814,112104,2025-04-17,2025-08-15,525.66,2,26290,650394247,116470886,0.0172363148224465,99.7626109075962,0.234514379504746
422.23,424,600,633,65400,112041,2025-04-17,2025-05-16,525.66,33,46641,2098065603,598425916,0.00534020479816236,99.8710266735163,0.41628510991512
164.43,165,1959,1960,123417,111720,2025-04-17,2025-12-19,525.66,1,-11697,1076181448,187344700,0.0103811490346375,99.9598628093058,-0.104699248120301
521.25,583,153,18,1346400,111150,2025-04-17,2025-05-30,525.66,-135,-1235250,542920959,126942613,0.0204725933227419,99.6597827051285,-11.1133603238866
522.84,569,707,24,2615900,110784,2025-04-17,2025-05-02,525.66,-683,-2505116,204772860,42617637,0.0541009194284829,99.3762552322608,-22.6126155401502
506.96,523,39,69,50973,110676,2025-04-17,2025-05-23,525.66,30,59703,27519740,10743122,0.40216949724089,91.0911621984801,0.539439444866096
412.82,415,504,507,78624,110526,2025-04-17,2025-05-30,525.66,3,31902,542920959,126942613,0.0203576594654914,99.680140364594,0.28863796753705
494.23,506,33,93,26829,109461,2025-04-17,2025-05-30,525.66,60,82632,542920959,126942613,0.0201614983148956,99.7003018629089,0.754899005125113
283.61,285,786,787,110040,109393,2025-04-17,2025-08-15,525.66,1,-647,650394247,116470886,0.0168194907172972,99.7794303983135,-0.00591445522108362
493.77,496,205,490,37720,109270,2025-04-17,2025-04-25,525.66,285,71550,186785929,41175251,0.0585001239574101,98.7909742387501,0.654800036606571
369.7,370,3721,3639,96746,109170,2025-04-17,2025-05-02,525.66,-82,12424,204772860,42617637,0.0533127290403621,99.4295679613011,0.113804158651644
239.76,240,4510,4531,108240,108744,2025-04-17,2025-06-20,525.66,21,504.000000000015,2210385665,443310327,0.00491968445696557,99.9567972225336,0.00463473846832942
324.71,325,3722,3739,93050,108431,2025-04-17,2025-05-16,525.66,17,15381,2098065603,598425916,0.0051681415416637,99.876194815058,0.141850577786795
194.36,195,1664,1664,106496,106496,2025-04-17,2025-09-19,525.66,0,0,1699576882,316242446,0.00626603015891105,99.9311236218615,0
489.17,491,225,575,42975,105225,2025-04-17,2025-04-25,525.66,350,62250,186785929,41175251,0.0563345432727965,98.8473087820229,0.591589451176051
496.01,509,66,81,50622,105219,2025-04-17,2025-05-23,525.66,15,54597,27519740,10743122,0.382340094782872,91.473502293263,0.518889174008497
533.64,571,28,28,118300,104608,2025-04-17,2025-05-09,525.66,0,-13692,114289278,33592363,0.0915291458924082,98.8988249623906,-0.130888650963597
427.38,433,185,185,103970,103970,2025-04-17,2025-08-15,525.66,0,0,650394247,116470886,0.0159856887541012,99.7954160870676,0
505.26,521,38,66,43814,103884,2025-04-17,2025-05-23,525.66,28,60070,27519740,10743122,0.377489031509745,91.8509913247727,0.578241115089908
485.6,487,343,735,58310,102900,2025-04-17,2025-04-25,525.66,392,44590,186785929,41175251,0.0550898028298481,98.9023985848527,0.433333333333333
244.69,245,1717,3315,48076,102765,2025-04-17,2025-06-20,525.66,1598,54689,2210385665,443310327,0.0046491886745022,99.9614464112081,0.53217535153019
521.83,590,292,15,1444524,102255,2025-04-17,2025-05-30,525.66,-277,-1342269,542920959,126942613,0.0188342332903011,99.7191360961992,-13.1266832917706
532.55,577,199,23,736897,102235,2025-04-17,2025-05-16,525.66,-176,-634662,2098065603,598425916,0.0048728218914516,99.8810676369494,-6.20787401574803
487.44,489,476,654,83776,102024,2025-04-17,2025-04-25,525.66,178,18248,186785929,41175251,0.0546208167532791,98.957019401606,0.178859876107583
414.33,415,506,1513,30360,101371,2025-04-17,2025-05-02,525.66,1007,71011,204772860,42617637,0.0495041188563758,99.4790720801575,0.700506061891468
429.14,430,886,1174,65564,100964,2025-04-17,2025-05-02,525.66,288,35400,204772860,42617637,0.0493053620484668,99.528377442206,0.350620022978487
523.81,650,8,8,100400,100952,2025-04-17,2025-09-19,525.66,0,552,1699576882,316242446,0.00593983132326461,99.9370634531848,0.00546794516205722
352.53,355,408,408,94656,100776,2025-04-17,2025-08-15,525.66,0,6120.00000000001,650394247,116470886,0.0154946019994547,99.810910689067,0.0607287449392714
407.45,409,681,649,65376,100595,2025-04-17,2025-05-16,525.66,-32,35219,2098065603,598425916,0.00479465465027215,99.8858622915997,0.350106864158258
314.75,315,3956,3998,75164,99950,2025-04-17,2025-05-16,525.66,42,24786,2098065603,598425916,0.0047639120462717,99.8906262036459,0.247983991995998
393.54,395,670,680,85760,99280,2025-04-17,2025-05-30,525.66,10,13520,542920959,126942613,0.0182862713907495,99.73742236759,0.136180499597099
443.52,446,252,400,42840,99200,2025-04-17,2025-05-16,525.66,148,56360,2098065603,598425916,0.00472816483231769,99.8953543684783,0.568145161290323
189.88,190,1871,8247,20581,98964,2025-04-17,2025-06-20,525.66,6376,78383,2210385665,443310327,0.00447722773301645,99.9659236389411,0.792035487652076
463.46,478,67,68,70484,98872,2025-04-17,2025-08-15,525.66,1,28388,650394247,116470886,0.0152018564825959,99.8261125455496,0.287118698923861
189.37,190,1503,1545,90180,97335,2025-04-17,2025-09-19,525.66,42,7155,1699576882,316242446,0.00572701364856527,99.9427904668334,0.0735090152565881
508.05,527,52,51,84864,96645,2025-04-17,2025-05-30,525.66,-1,11781,542920959,126942613,0.0178009337082896,99.7552233012983,0.121899736147757
410.72,412,802,746,81002,95488,2025-04-17,2025-05-16,525.66,-56,14486,2098065603,598425916,0.00455123995472128,99.899905608433,0.151704926273458
509.34,527,49,54,59192,95364,2025-04-17,2025-05-23,525.66,5,36172,27519740,10743122,0.346529436687992,92.1975207614607,0.37930455937251
497.35,512,26,65,29666,95225,2025-04-17,2025-05-23,525.66,39,65559,27519740,10743122,0.346024344706745,92.5435451061674,0.688464163822526
416.54,418,563,652,65308,95192,2025-04-17,2025-05-16,525.66,89,29884,2098065603,598425916,0.00453713172094743,99.9044427401539,0.31393394402891
444.33,451,142,142,149100,94714,2025-04-17,2025-08-15,525.66,0,-54386,650394247,116470886,0.0145625519347498,99.8406750974844,-0.574212893553223
527.27,645,8,8,81560,94184,2025-04-17,2025-07-18,525.66,0,12624,781158455,167554530,0.0120569648061993,99.9094958269382,0.134035504968997
499.47,508,56,109,34832,92977,2025-04-17,2025-05-09,525.66,53,58145,114289278,33592363,0.0813523382307131,98.9801773006213,0.625369715090829
527.27,660,7,7,93394,92911,2025-04-17,2025-09-19,525.66,0,-483.000000000015,1699576882,316242446,0.00546671356759488,99.948257180401,-0.00519852331801417
404.85,406,669,803,62886,92345,2025-04-17,2025-05-16,525.66,134,29459,2098065603,598425916,0.00440143529677799,99.9088441754507,0.319010233364015
454.42,455,1643,1588,134726,92104,2025-04-17,2025-04-25,525.66,-55,-42622,186785929,41175251,0.049309924196699,99.0063293258027,-0.462759489272996
497.28,511,40,67,35280,91924,2025-04-17,2025-05-23,525.66,27,56644,27519740,10743122,0.334029318590946,92.8775744247584,0.616204690831557
399.25,400,1304,1224,75632,91800,2025-04-17,2025-05-09,525.66,-80,16168,114289278,33592363,0.080322495343789,99.0604997959651,0.176122004357298
511.05,534,24,40,33096,91800,2025-04-17,2025-05-23,525.66,16,58704,27519740,10743122,0.333578732938611,93.211153157697,0.639477124183007
318.54,320,571,622,73659,90812,2025-04-17,2025-07-18,525.66,51,17153,781158455,167554530,0.0116252982245452,99.9211211251628,0.188884728890455
309.8,310,4484,4533,89680,90660,2025-04-17,2025-05-16,525.66,49,980,2098065603,598425916,0.0043211232227613,99.9131652986735,0.0108096183542908
502.26,512,93,93,67146,90582,2025-04-17,2025-05-09,525.66,0,23436,114289278,33592363,0.0792567785755021,99.1397565745406,0.258726899383984
404.41,405,1544,1530,77200,90270,2025-04-17,2025-05-02,525.66,-14,13070,204772860,42617637,0.04408299029471,99.5724604325007,0.144787858646283
512.52,534,49,42,75068,90216,2025-04-17,2025-05-30,525.66,-7,15148,542920959,126942613,0.0166167834386368,99.7718400847369,0.167908131595282
373.89,375,802,809,77794,89799,2025-04-17,2025-05-30,525.66,7,12005,542920959,126942613,0.0165399766782627,99.7883800614152,0.133687457544071
493.52,499,30,160,10560,87680,2025-04-17,2025-05-02,525.66,130,77120,204772860,42617637,0.0428181742443799,99.6152786067451,0.87956204379562
508.49,526,28,50,32620,87550,2025-04-17,2025-05-23,525.66,22,54930,27519740,10743122,0.318135273080342,93.5292884307773,0.627412906910337
174.47,175,1623,1625,69789,86125,2025-04-17,2025-09-19,525.66,2,16336,1699576882,316242446,0.00506743772006661,99.953324618121,0.189677793904209
164.59,165,2089,2091,144141,85731,2025-04-17,2025-09-19,525.66,2,-58410,1699576882,316242446,0.00504425547958236,99.9583688736006,-0.681317143157084
303.01,305,425,425,84575,84575,2025-04-17,2025-09-19,525.66,0,0,1699576882,316242446,0.00497623855064887,99.9633451121513,0
298.55,300,551,583,72732,84535,2025-04-17,2025-08-15,525.66,32,11803,650394247,116470886,0.0129975011909969,99.8536725986754,0.139622641509434
418.86,420,647,739,57583,84246,2025-04-17,2025-05-09,525.66,92,26663,114289278,33592363,0.0737129514458915,99.2134695259865,0.316489803670204
403.36,405,350,511,41650,83804,2025-04-17,2025-05-30,525.66,161,42154,542920959,126942613,0.0154357643798386,99.803815825795,0.503007016371534
419.77,420,3622,3641,141258,83743,2025-04-17,2025-04-25,525.66,19,-57515,186785929,41175251,0.0448336769521863,99.0511630027549,-0.68680367314283
409.31,410,691,1208,34550,83352,2025-04-17,2025-05-02,525.66,517,48802,204772860,42617637,0.040704612906222,99.6559832196513,0.585492849601689
328.31,330,487,493,65745,83317,2025-04-17,2025-07-18,525.66,6,17572,781158455,167554530,0.0106658257958688,99.9317869509586,0.210905337446139
495.55,498,222,339,44844,83055,2025-04-17,2025-04-25,525.66,117,38211,186785929,41175251,0.0444653408555202,99.0956283436104,0.4600686292216
154.7,155,2779,2765,86149,82950,2025-04-17,2025-09-19,525.66,-14,-3199,1699576882,316242446,0.00488062651819478,99.9682257386695,-0.0385654008438819
169.4,170,1384,1381,113488,82860,2025-04-17,2025-12-19,525.66,-3,-30628,1076181448,187344700,0.00769944512182299,99.9675622544276,-0.369635529809317
179.59,180,2008,2013,100400,82533,2025-04-17,2025-09-19,525.66,5,-17867,1699576882,316242446,0.00485609099971272,99.9730818296692,-0.216483103728206
501.66,517,22,53,23738,81302,2025-04-17,2025-05-30,525.66,31,57564,542920959,126942613,0.0149749238175939,99.8187907496126,0.708026862807803
378.81,380,716,681,65156,81039,2025-04-17,2025-05-30,525.66,-35,15883,542920959,126942613,0.0149264821437848,99.8337172317564,0.195992053208949
496.5,502,21,145,8463,79750,2025-04-17,2025-05-02,525.66,124,71287,204772860,42617637,0.038945590738929,99.6949288103902,0.893880877742947
515.57,543,27,29,49302,79547,2025-04-17,2025-05-23,525.66,2,30245,27519740,10743122,0.289054329728406,93.8183427605057,0.380215470099438
184.45,185,1448,1446,86880,79530,2025-04-17,2025-09-19,525.66,-2,-7350,1699576882,316242446,0.00467939996373756,99.9777612296329,-0.0924179554884949
293.78,295,651,651,95697,79422,2025-04-17,2025-08-15,525.66,0,-16275,650394247,116470886,0.0122113626260289,99.8658839613014,-0.204918032786885
484.04,486,331,403,52629,78988,2025-04-17,2025-04-25,525.66,72,26359,186785929,41175251,0.0422879819817691,99.1379163255922,0.3337089178103
425.37,427,369,480,44649,78240,2025-04-17,2025-05-16,525.66,111,33591,2098065603,598425916,0.00372914935968282,99.9168944480331,0.42933282208589
459.94,469,85,86,122740,77916,2025-04-17,2025-08-15,525.66,1,-44824,650394247,116470886,0.011979810762379,99.8778637720638,-0.575286205657374
402.65,404,449,576,39063,77760,2025-04-17,2025-05-16,525.66,127,38697,2098065603,598425916,0.00370627114275225,99.9206007191759,0.497646604938272
252.93,255,355,373,81650,77211,2025-04-17,2025-12-19,525.66,18,-4439,1076181448,187344700,0.0071745336386806,99.9747367880663,-0.0574918081620495
525.1,544,40,40,75600,75600,2025-04-17,2025-05-23,525.66,0,0,27519740,10743122,0.27471189771415,94.0930546582199,0
179.25,180,999,1001,73926,75075,2025-04-17,2025-12-19,525.66,2,1149,1076181448,187344700,0.00697605409752427,99.9817128421638,0.0153046953046953
288.56,290,521,521,61999,75024,2025-04-17,2025-08-15,525.66,0,13025,650394247,116470886,0.0115351573827805,99.8893989294466,0.173611111111111
154.43,155,1308,1314,71940,74898,2025-04-17,2025-12-19,525.66,6,2957.99999999997,1076181448,187344700,0.00695960705689474,99.9886724492207,0.0394937114475683
413.91,415,708,684,49560,74556,2025-04-17,2025-05-09,525.66,-24,24996,114289278,33592363,0.0652344658262694,99.2787039918128,0.335264767423145
294.39,295,1204,1218,114380,74298,2025-04-17,2025-06-20,525.66,14,-40082,2210385665,443310327,0.00336131387279875,99.9692849528139,-0.539476163557565
409.75,411,646,592,62662,74000,2025-04-17,2025-05-16,525.66,-54,11338,2098065603,598425916,0.00352705844346279,99.9241277776194,0.153216216216216
499.06,572.5,10,10,73440,73440,2025-04-17,2025-05-23,525.66,0,0,27519740,10743122,0.266862986350889,94.3599176445708,0
278.21,280,390,408,56940,73032,2025-04-17,2025-09-19,525.66,18,16092,1699576882,316242446,0.00429706951026885,99.9820582991432,0.220341767992113
503.1,518,35,49,35735,73010,2025-04-17,2025-05-23,525.66,14,37275,27519740,10743122,0.265300471588758,94.6252181161595,0.510546500479387
503.5,519,35,47,38605,72850,2025-04-17,2025-05-23,525.66,12,34245,27519740,10743122,0.264719070747035,94.8899371869066,0.470075497597804
494.63,501,6,114,2208,72618,2025-04-17,2025-05-02,525.66,108,70410,204772860,42617637,0.0354627073138501,99.7303915177041,0.969594315458977
501.74,511,39,78,25857,72228,2025-04-17,2025-05-09,525.66,39,46371,114289278,33592363,0.0631975293430413,99.3419015211558,0.642008639308855
159.39,160,1181,1181,55507,72041,2025-04-17,2025-12-19,525.66,0,16534,1076181448,187344700,0.00669413137848479,99.9953665805992,0.229508196721312
523.05,571,122,15,473116,71925,2025-04-17,2025-04-25,525.66,-107,-401191,186785929,41175251,0.0385066478963734,99.1764229734886,-5.57790754257908
389.28,390,974,998,50648,71856,2025-04-17,2025-05-09,525.66,24,21208,114289278,33592363,0.0628720394926285,99.4047735606484,0.295145847250056
209.82,210,3960,3985,59400,71730,2025-04-17,2025-06-20,525.66,25,12330,2210385665,443310327,0.00324513505203175,99.9725300878659,0.17189460476788
525.4,605,9,9,60345,71640,2025-04-17,2025-05-30,525.66,0,11295,542920959,126942613,0.0131952909189494,99.8469125226753,0.157663316582915
388.98,390,703,702,59755,71604,2025-04-17,2025-05-23,525.66,-1,11849,27519740,10743122,0.260191411692116,95.1501285985987,0.165479582146249
479.42,481,413,452,53690,71416,2025-04-17,2025-04-25,525.66,39,17726,186785929,41175251,0.0382341434295086,99.2146571169181,0.248207684552481
394.95,396,674,680,52572,71400,2025-04-17,2025-05-16,525.66,6,18828,2098065603,598425916,0.00340313476842221,99.9275309123878,0.263697478991597
349.26,350,307,963,14736,71262,2025-04-17,2025-05-23,525.66,656,56526,27519740,10743122,0.258948667392933,95.4090772659916,0.793213774522186
492.24,498,25,122,8200,70272,2025-04-17,2025-05-02,525.66,97,62072,204772860,42617637,0.0343170476790723,99.7647085653831,0.883310564663024
390.2,391,875,873,70000,69840,2025-04-17,2025-05-16,525.66,-2,-159.999999999985,2098065603,598425916,0.00332878056339786,99.9308596929512,-0.00229095074455878
423.74,425,484,550,46464,69300,2025-04-17,2025-05-09,525.66,66,22836,114289278,33592363,0.0606356092301152,99.4654091698786,0.32952380952381
424.22,426,388,388,43068,69064,2025-04-17,2025-05-16,525.66,0,25996,2098065603,598425916,0.00329179411269343,99.9341514870639,0.376404494382022
507.46,529,26,32,34060,68928,2025-04-17,2025-05-23,525.66,6,34868,27519740,10743122,0.250467482614298,95.6595447486059,0.505861188486537
440.38,448,90,90,65700,68580,2025-04-17,2025-08-15,525.66,0,2880,650394247,116470886,0.0105443737112269,99.8999433031578,0.041994750656168
439.22,441,396,385,87912,68530,2025-04-17,2025-05-16,525.66,-11,-19382,2098065603,598425916,0.00326634209635818,99.9374178291602,-0.282825040128411
463.38,473,62,71,62620,68302,2025-04-17,2025-08-15,525.66,9,5682.00000000001,650394247,116470886,0.0105016304057191,99.9104449335635,0.0831893648795058
444.46,445,1067,1260,69355,68040,2025-04-17,2025-04-25,525.66,193,-1314.99999999999,186785929,41175251,0.036426726769124,99.2510838436872,-0.0193268665490886
510.7,572,11,11,67430,67430,2025-04-17,2025-05-09,525.66,0,0,114289278,33592363,0.0589994102508899,99.5244085801295,0
259.66,260,1984,1983,85312,67422,2025-04-17,2025-06-20,525.66,-1,-17890,2210385665,443310327,0.0030502369368198,99.9755803248027,-0.265343656373291
169.94,170,11194,11194,190298,67164,2025-04-17,2025-06-20,525.66,0,-123134,2210385665,443310327,0.00303856476557452,99.9786188895683,-1.83333333333333
503.45,519,17,43,18649,66865,2025-04-17,2025-05-30,525.66,26,48216,542920959,126942613,0.0123157890465599,99.8592283117219,0.721094743139161
503.55,514,71,63,50623,65835,2025-04-17,2025-05-09,525.66,-8,15212,114289278,33592363,0.0576038287686094,99.5820124088981,0.231062504746715
333.25,335,351,373,50193,65275,2025-04-17,2025-07-18,525.66,22,15082,781158455,167554530,0.00835617915701879,99.9401431301157,0.231053236307928
169.57,170,1517,1517,65231,65231,2025-04-17,2025-09-19,525.66,0,0,1699576882,316242446,0.00383807291631541,99.9858963720595,0
437.02,443,109,109,103550,65182,2025-04-17,2025-08-15,525.66,0,-38368,650394247,116470886,0.0100219213654883,99.920466854929,-0.588628762541806
506.85,516,65,70,39130,64050,2025-04-17,2025-05-02,525.66,5,24920,204772860,42617637,0.0312785590824878,99.7959871244656,0.389071038251366
391.08,392,689,696,67522,64032,2025-04-17,2025-05-16,525.66,7,-3489.99999999999,2098065603,598425916,0.00305195413853796,99.9404697832988,-0.0545039980009994
522.08,580,76,11,304000,63712,2025-04-17,2025-05-02,525.66,-65,-240288,204772860,42617637,0.0311134981461899,99.8271006226118,-3.77147162230035
343.01,345,321,320,65163,63680,2025-04-17,2025-07-18,525.66,-1,-1482.99999999999,781158455,167554530,0.00815199523123641,99.9482951253469,-0.0232883165829145
525.24,595,11,9,86812,62784,2025-04-17,2025-05-16,525.66,-2,-24028,2098065603,598425916,0.00299247077451848,99.9434622540733,-0.382708970438328
403.57,405,438,438,49056,62634,2025-04-17,2025-05-23,525.66,0,13578,27519740,10743122,0.227596627003017,95.8871413756089,0.216783216783217
354.48,355,1311,1200,64239,62400,2025-04-17,2025-05-16,525.66,-111,-1839,2098065603,598425916,0.00297416820097403,99.9464364222743,-0.0294711538461538
411.67,413,473,469,43043,62377,2025-04-17,2025-05-16,525.66,-4,19334,2098065603,598425916,0.00297307195307944,99.9494094942273,0.30995398945124
417.57,419,453,424,63873,60632,2025-04-17,2025-05-16,525.66,-29,-3241.00000000001,2098065603,598425916,0.00288990010194643,99.9522993943293,-0.0534536218498484
428.63,429,305,1635,14030,60495,2025-04-17,2025-04-25,525.66,1330,46465,186785929,41175251,0.0323873432671687,99.2834711869543,0.768080006612117
525.39,610,0,7,0,59227,2025-04-17,2025-05-30,525.66,7,59227,542920959,126942613,0.0109089544284843,99.8701372661504,1
412.43,414,327,377,31719,59189,2025-04-17,2025-05-16,525.66,50,27470,2098065603,598425916,0.00282112246229891,99.9551205167916,0.464106506276504
500.07,518,15,33,16275,59169,2025-04-17,2025-05-30,525.66,18,42894,542920959,126942613,0.010898271473804,99.8810355376242,0.724940424884652
396.99,398,583,582,65296,58782,2025-04-17,2025-05-16,525.66,-1,-6513.99999999999,2098065603,598425916,0.00280172364085986,99.9579222404324,-0.110816236262801
362.52,365,253,237,54142,58776,2025-04-17,2025-07-18,525.66,-16,4633.99999999999,781158455,167554530,0.00752420966883089,99.9558193350157,0.0788417040969102
214.82,215,2581,3224,41296,58032,2025-04-17,2025-06-20,525.66,643,16736,2210385665,443310327,0.00262542419266006,99.981244313761,0.288392610973256
502.51,517,25,40,24175,57960,2025-04-17,2025-05-23,525.66,15,33785,27519740,10743122,0.210612454914182,96.0977538305231,0.582902001380262
318.37,320,354,355,63012,57865,2025-04-17,2025-08-15,525.66,1,-5147,650394247,116470886,0.00889691141440862,99.9293637663434,-0.0889484144128575
313.6,315,386,412,44004,57680,2025-04-17,2025-07-18,525.66,26,13676,781158455,167554530,0.00738390522829328,99.963203240244,0.237101248266297
415.83,417,511,490,75628,57330,2025-04-17,2025-05-16,525.66,-21,-18298,2098065603,598425916,0.00273251703464489,99.9606547574671,-0.319169719169719
359.28,360,460,795,25300,57240,2025-04-17,2025-05-23,525.66,335,31940,27519740,10743122,0.207996151126428,96.3057499816495,0.558001397624039
392.06,393,588,602,49392,56588,2025-04-17,2025-05-16,525.66,14,7196.00000000001,2098065603,598425916,0.00269715112430638,99.9633519085914,0.127164769915883
249.35,250,1083,869,59565,56485,2025-04-17,2025-07-18,525.66,-214,-3080.00000000001,781158455,167554530,0.00723092730270711,99.9704341675467,-0.0545277507302825
263.47,265,364,362,66612,55386,2025-04-17,2025-09-19,525.66,-2,-11226,1699576882,316242446,0.00325881109507819,99.9891551831546,-0.202686599501679
374.65,375,1118,1573,27950,55055,2025-04-17,2025-05-02,525.66,455,27105,204772860,42617637,0.0268858871239089,99.8539865097357,0.49232585596222
374.36,375,857,860,34280,55040,2025-04-17,2025-05-09,525.66,3,20760,114289278,33592363,0.0481584982976268,99.6301709071957,0.37718023255814
354.23,355,276,709,14076,54593,2025-04-17,2025-05-23,525.66,433,40517,27519740,10743122,0.198377600951172,96.5041275826007,0.742164746396058
194.88,195,4570,4540,77690,54480,2025-04-17,2025-06-20,525.66,-30,-23210,2210385665,443310327,0.00246472825365523,99.9837090420146,-0.426027900146843
525.67,575,8,11,34704,54263,2025-04-17,2025-05-23,525.66,3,19559,27519740,10743122,0.197178461715118,96.7013060443158,0.360448187531099
401.9,403,445,493,91670,54230,2025-04-17,2025-05-16,525.66,48,-37440,2098065603,598425916,0.00258476188363496,99.965936670475,-0.690392771528674
481.71,483,397,413,52801,53277,2025-04-17,2025-04-25,525.66,16,476,186785929,41175251,0.0285230264855764,99.3119942134399,0.00893443699908028
523.38,546,25,23,49500,52026,2025-04-17,2025-05-23,525.66,-2,2526,27519740,10743122,0.189049751196777,96.8903557955126,0.0485526467535463
537.32,574,1150,14,4218200,51352,2025-04-17,2025-05-02,525.66,-1136,-4166848,204772860,42617637,0.0250775420141126,99.8790640517498,-81.1428571428571
523,562.5,327,13,1687974,51350,2025-04-17,2025-04-25,525.66,-314,-1636624,186785929,41175251,0.0274913641915714,99.3394855776315,-31.8719376825706
525.72,589,534,8,2576550,50624,2025-04-17,2025-05-16,525.66,-526,-2525926,2098065603,598425916,0.00241288927894406,99.968349559754,-49.8958201643489
393.2,394,634,629,62766,50320,2025-04-17,2025-05-16,525.66,-5,-12446,2098065603,598425916,0.0023983997415547,99.9707479594955,-0.247337042925278
243.16,245,271,271,60704,49864,2025-04-17,2025-12-19,525.66,0,-10840,1076181448,187344700,0.00463341940085182,100,-0.217391304347826
349.14,350,534,577,30972,49622,2025-04-17,2025-05-30,525.66,43,18650,542920959,126942613,0.00913982029564639,99.8901753579198,0.375841360686792
525.41,608,6,6,51312,49554,2025-04-17,2025-05-30,525.66,0,-1758,542920959,126942613,0.00912729545222806,99.8993026533721,-0.035476449933406
159.61,160,1266,1263,53172,49257,2025-04-17,2025-09-19,525.66,-3,-3915,1699576882,316242446,0.00289819192774829,99.9920533750823,-0.0794810889822766
408.45,410,311,317,36076,49135,2025-04-17,2025-05-23,525.66,6,13059,27519740,10743122,0.178544564737894,97.0689003602505,0.265777958685255
323.8,325,409,409,50307,49080,2025-04-17,2025-07-18,525.66,0,-1227.00000000001,781158455,167554530,0.00628297622407479,99.9767171437708,-0.0250000000000002
389.54,390,738,1048,28782,48208,2025-04-17,2025-05-02,525.66,310,19426,204772860,42617637,0.0235421822989629,99.9026062340488,0.40296216395619
529.65,547,15,27,25500,46845,2025-04-17,2025-05-09,525.66,12,21345,114289278,33592363,0.0409880968886688,99.6711590040844,0.455651617034902
308.65,310,277,347,29362,46845,2025-04-17,2025-07-18,525.66,70,17483,781158455,167554530,0.00599686269797848,99.9827140064688,0.373209520759953
433.11,439,79,79,62410,46531,2025-04-17,2025-08-15,525.66,0,-15879,650394247,116470886,0.00715427607403176,99.9365180424174,-0.34125636672326
344.42,345,267,795,11748,46110,2025-04-17,2025-05-23,525.66,528,34362,27519740,10743122,0.167552455074067,97.2364528153246,0.745217957059206
264.59,265,1123,1123,50535,46043,2025-04-17,2025-06-20,525.66,0,-4492.00000000001,2210385665,443310327,0.00208303015754493,99.9857920721722,-0.0975609756097563
268.97,270,427,447,46116,46041,2025-04-17,2025-08-15,525.66,20,-75,650394247,116470886,0.00707893715425192,99.9435969795717,-0.00162898286310028
523.37,569,10,10,45630,45630,2025-04-17,2025-05-23,525.66,0,0,27519740,10743122,0.165808252548898,97.4022610678735,0
403.97,405,503,442,39737,45526,2025-04-17,2025-05-09,525.66,-61,5789,114289278,33592363,0.0398340078760494,99.7109930119604,0.127158107455081
531.59,564,688,14,1850720,45374,2025-04-17,2025-04-25,525.66,-674,-1805346,186785929,41175251,0.0242919797240187,99.3637775573555,-39.7881165425133
406,407,491,448,45663,44800,2025-04-17,2025-05-16,525.66,-43,-863.000000000007,2098065603,598425916,0.00213530024685315,99.9728832597424,-0.019263392857143
525.79,675,3,3,40437,44763,2025-04-17,2025-05-16,525.66,0,4326,2098065603,598425916,0.00213353671763142,99.97501679646,0.0966423161986462
525.63,615,5,5,38675,44685,2025-04-17,2025-05-16,525.66,0,6010,2098065603,598425916,0.0021298190073802,99.9771466154674,0.13449703479915
477.94,479,162,421,27054,44626,2025-04-17,2025-04-25,525.66,259,17572,186785929,41175251,0.0238915212933411,99.3876690786489,0.393761484336486
400.61,402,315,318,27090,44202,2025-04-17,2025-05-16,525.66,3,17112,2098065603,598425916,0.00210679780159381,99.979253413269,0.38713180399077
525.56,599,8,6,60952,44064,2025-04-17,2025-05-30,525.66,-2,-16888,542920959,126942613,0.00811609853507239,99.9074187519071,-0.383260711692084
384.25,385,273,586,18018,43950,2025-04-17,2025-05-09,525.66,313,25932,114289278,33592363,0.0384550508753761,99.7494480628358,0.590034129692833
413.39,415,256,272,30976,43792,2025-04-17,2025-05-23,525.66,16,12816,27519740,10743122,0.159129410379604,97.5613904782531,0.292656192911947
174.91,175,4860,4860,43740,43740,2025-04-17,2025-06-20,525.66,0,0,2210385665,443310327,0.00197884019483994,99.987770912367,0
468.04,469,143,450,15158,43200,2025-04-17,2025-04-25,525.66,307,28042,186785929,41175251,0.0231280804883327,99.4107971591372,0.64912037037037
486.46,488,151,279,23556,42966,2025-04-17,2025-04-25,525.66,128,19410,186785929,41175251,0.0230028033856876,99.4337999625229,0.451752548526742
523.05,584,490,7,2099650,42665,2025-04-17,2025-05-16,525.66,-483,-2056985,2098065603,598425916,0.00203353984446405,99.9812869531135,-48.2124692370796
522.64,570,869,9,2502720,42624,2025-04-17,2025-04-25,525.66,-860,-2460096,186785929,41175251,0.0228197060818216,99.4566196686047,-57.7162162162162
520.8,568,258,9,705630,42480,2025-04-17,2025-04-25,525.66,-249,-663150,186785929,41175251,0.0227426124801938,99.4793622810849,-15.6108757062147
358.97,360,410,408,28290,42024,2025-04-17,2025-05-30,525.66,-2,13734,542920959,126942613,0.00774035323252275,99.9151591051397,0.326813249571673
263.89,265,377,378,37323,41958,2025-04-17,2025-08-15,525.66,1,4635.00000000001,650394247,116470886,0.00645116407371912,99.9500481436454,0.110467610467611
406.99,408,381,413,38481,41713,2025-04-17,2025-05-16,525.66,32,3232,2098065603,598425916,0.00198816471421842,99.9832751178277,0.0774818401937046
219.8,220,2145,2065,51480,41300,2025-04-17,2025-06-20,525.66,-80,-10180,2210385665,443310327,0.00186845221872175,99.9896393645857,-0.246489104116223
462.05,471,45,46,76815,41170,2025-04-17,2025-08-15,525.66,1,-35645,650394247,116470886,0.00633000679048134,99.9563781504359,-0.865800340053437
541.38,573,52,13,164424,41106,2025-04-17,2025-05-09,525.66,-39,-123318,114289278,33592363,0.0359666284706077,99.7854146913064,-3
258.82,260,336,342,66864,40356,2025-04-17,2025-09-19,525.66,6,-26508,1699576882,316242446,0.00237447334259516,99.9944278484249,-0.656853999405293
525.63,626,0,4,0,40148,2025-04-17,2025-05-30,525.66,4,40148,542920959,126942613,0.00739481490527611,99.9225539200449,1
439.48,446,60,61,68220,39772,2025-04-17,2025-08-15,525.66,1,-28448,650394247,116470886,0.00611506023976255,99.9624932106757,-0.715277079352308
525.87,625,4,4,33244,39652,2025-04-17,2025-05-30,525.66,0,6408,542920959,126942613,0.00730345722387188,99.9298573772688,0.161605971956017
528.16,547,21,21,40194,39564,2025-04-17,2025-05-23,525.66,0,-630,27519740,10743122,0.143765893137072,97.7051563713901,-0.0159235668789809
525.56,575,103,8,375950,39552,2025-04-17,2025-04-25,525.66,-95,-336398,186785929,41175251,0.0211750425804291,99.5005373236653,-8.50520833333333
457.22,458,502,503,41666,39234,2025-04-17,2025-04-25,525.66,1,-2432,186785929,41175251,0.0210047942101677,99.5215421178755,-0.0619870520466942
364.37,365,224,613,13216,38619,2025-04-17,2025-05-23,525.66,389,25403,27519740,10743122,0.140331994415645,97.8454883658058,0.657785028094979
523.81,600,10,5,68720,38095,2025-04-17,2025-05-02,525.66,-5,-30625,204772860,42617637,0.0186035395510909,99.9212097735999,-0.803911274445465
389.8,390,1878,1878,39438,37560,2025-04-17,2025-04-25,525.66,0,-1878,186785929,41175251,0.0201085810912448,99.5416506989667,-0.05
339.36,340,475,584,24225,37376,2025-04-17,2025-05-23,525.66,109,13151,27519740,10743122,0.135815236626509,97.9813036024323,0.351856806506849
159.95,160,7452,7455,44712,37275,2025-04-17,2025-06-20,525.66,3,-7437,2210385665,443310327,0.00168635729910056,99.9913257218848,-0.199517102615694
312.81,315,169,170,34814,37230,2025-04-17,2025-09-19,525.66,1,2416,1699576882,316242446,0.00219054521124041,99.9966183936362,0.0648939027665861
524.86,548,15,16,28335,37024,2025-04-17,2025-05-23,525.66,1,8689,27519740,10743122,0.134536154774718,98.115839757207,0.234685609334486
414.93,416,251,346,38654,37022,2025-04-17,2025-05-16,525.66,95,-1632,2098065603,598425916,0.00176457780667405,99.9850396956344,-0.0440818972502836
394.5,395,402,733,16080,36650,2025-04-17,2025-05-02,525.66,331,20570,204772860,42617637,0.0178978796311191,99.939107653231,0.561255115961801
523.94,645,3,3,30441,36318,2025-04-17,2025-08-15,525.66,0,5877,650394247,116470886,0.00558399773176345,99.9680772084074,0.161820584833967
254.75,255,1415,1450,53770,36250,2025-04-17,2025-06-20,525.66,35,-17520,2210385665,443310327,0.00163998530093616,99.9929657071858,-0.483310344827586
525.48,597,5,5,36730,35760,2025-04-17,2025-05-30,525.66,0,-969.999999999993,542920959,126942613,0.00658659412704677,99.9364439713958,-0.027125279642058
284.87,285,2477,2748,27247,35724,2025-04-17,2025-05-16,525.66,271,8477,2098065603,598425916,0.00170271129505763,99.9867424069294,0.237291456723771
472.12,473,150,398,15000,35024,2025-04-17,2025-04-25,525.66,248,20024,186785929,41175251,0.0187508771070223,99.5604015760738,0.571722247601645
521.16,546,8,14,12872,34776,2025-04-17,2025-05-09,525.66,6,21904,114289278,33592363,0.0304280511772942,99.8158427424837,0.629859673337934
244.35,245,458,534,23358,34710,2025-04-17,2025-07-18,525.66,76,11352,781158455,167554530,0.004443400667026,99.9871574071358,0.327052722558341
154.95,155,6851,6880,34255,34400,2025-04-17,2025-06-20,525.66,29,145,2210385665,443310327,0.00155628949937114,99.9945219966851,0.00421511627906977
449.74,461,18,30,15462,33780,2025-04-17,2025-08-15,525.66,12,18318,650394247,116470886,0.00519377287788341,99.9732709812853,0.542273534635879
184.9,185,3318,3318,36498,33180,2025-04-17,2025-06-20,525.66,0,-3318,2210385665,443310327,0.00150109551131205,99.9960230921965,-0.1
409.76,410,1262,1349,41646,32376,2025-04-17,2025-04-25,525.66,87,-9270,186785929,41175251,0.0173332114326449,99.5777347875064,-0.286323202372127
471.01,472,286,327,28886,32373,2025-04-17,2025-04-25,525.66,41,3487,186785929,41175251,0.0173316053159443,99.5950663928224,0.107713217804961
525.85,566,425,8,1070575,32120,2025-04-17,2025-04-25,525.66,-417,-1038455,186785929,41175251,0.0171961561408622,99.6122625489632,-32.3304794520548
253.78,255,252,259,29484,31598,2025-04-17,2025-09-19,525.66,7,2114,1699576882,316242446,0.00185916861629799,99.9984775622525,0.0669029685423129
379.45,380,466,566,21902,31130,2025-04-17,2025-05-09,525.66,100,9228,114289278,33592363,0.0272379006541629,99.8430806431378,0.296434307741728
369.4,370,513,513,24624,30780,2025-04-17,2025-05-09,525.66,0,6156,114289278,33592363,0.0269316602035057,99.8700123033414,0.2
525.41,602,4,4,41016,30636,2025-04-17,2025-05-30,525.66,0,-10380,542920959,126942613,0.00564281033770148,99.9420867817336,-0.338817077947513
344.57,345,687,711,20610,30573,2025-04-17,2025-05-16,525.66,24,9963,2098065603,598425916,0.00145719942962146,99.988199606359,0.325875772740654
531.37,569,241,8,1023768,30104,2025-04-17,2025-04-25,525.66,-233,-993664,186785929,41175251,0.0161168457180733,99.6283793946813,-33.0077066170609
404.79,405,1414,1420,56560,29820,2025-04-17,2025-04-25,525.66,6,-26740,186785929,41175251,0.0159648000037519,99.644344194685,-0.896713615023474
528.85,577,6,6,28890,28890,2025-04-17,2025-05-23,525.66,0,0,27519740,10743122,0.104979189483622,98.2208189466906,0
423.03,425,158,146,26860,28762,2025-04-17,2025-05-23,525.66,-12,1902,27519740,10743122,0.104514068810243,98.3253330155009,0.0661289201029137
448.89,456,41,40,32103,28440,2025-04-17,2025-08-15,525.66,-1,-3663,650394247,116470886,0.0043727324051807,99.9776437136905,-0.12879746835443
525.66,620,3,3,24054,28302,2025-04-17,2025-05-16,525.66,0,4248,2098065603,598425916,0.0013489568657687,99.9895485632248,0.150095399618401
463.19,464,273,348,21840,28188,2025-04-17,2025-04-25,525.66,75,6348,186785929,41175251,0.0150910725186371,99.6594352672037,0.225202213707961
414.75,415,1067,1115,33077,27875,2025-04-17,2025-04-25,525.66,48,-5202,186785929,41175251,0.0149235010095434,99.6743587682132,-0.186618834080718
299.71,300,947,960,20834,27840,2025-04-17,2025-05-23,525.66,13,7006,27519740,10743122,0.101163746459814,98.4264967619607,0.251652298850575
535.52,566,9,9,40788,27432,2025-04-17,2025-05-23,525.66,0,-13356,27519740,10743122,0.0996811743134201,98.5261779362741,-0.486876640419948
527.39,582,241,5,1316101,27305,2025-04-17,2025-05-16,525.66,-236,-1288796,2098065603,598425916,0.00130143690268583,99.9908500001275,-47.2
364.43,365,503,478,22635,27246,2025-04-17,2025-05-09,525.66,-25,4611,114289278,33592363,0.0238395066245847,99.8938518099659,0.169235851134111
525.87,580,91,5,348530,27065,2025-04-17,2025-05-09,525.66,-86,-321465,114289278,33592363,0.0236811365629591,99.9175329465289,-11.8775170884907
497.13,512,8,18,8752,26766,2025-04-17,2025-05-30,525.66,10,18014,542920959,126942613,0.00492999939609994,99.9470167811297,0.673018007920496
384.58,385,462,636,16170,26712,2025-04-17,2025-05-02,525.66,174,10542,204772860,42617637,0.0130446974271883,99.9521523506582,0.394654088050315
521,554,8,8,26400,26400,2025-04-17,2025-05-23,525.66,0,0,27519740,10743122,0.0959311388843063,98.6221090751584,0
470.09,471,163,285,17930,25935,2025-04-17,2025-04-25,525.66,122,8005,186785929,41175251,0.0138848788765025,99.6882436470897,0.308656256024677
319.61,320,657,662,21024,25818,2025-04-17,2025-05-23,525.66,5,4794,27519740,10743122,0.0938162933225387,98.715925368481,0.185684406228213
229.77,230,1119,1111,25737,25553,2025-04-17,2025-06-20,525.66,-8,-184,2210385665,443310327,0.00115604260399508,99.9971791348005,-0.0072007200720072
344.29,345,355,359,19525,25489,2025-04-17,2025-05-30,525.66,4,5964,542920959,126942613,0.00469479020425881,99.9517115713339,0.233983286908078
303.38,305,154,155,21406,25110,2025-04-17,2025-08-15,525.66,1,3704.00000000001,650394247,116470886,0.00386073525647283,99.981504448947,0.147510951812027
399.94,401,274,236,19728,25016,2025-04-17,2025-05-16,525.66,-38,5288,2098065603,598425916,0.00119233640569818,99.9920423365332,0.211384713783179
373.88,375,205,219,13735,24528,2025-04-17,2025-05-23,525.66,14,10793,27519740,10743122,0.0891287490361464,98.8050541175171,0.440027723418134
542.7,573,303,8,918090,24240,2025-04-17,2025-05-02,525.66,-295,-893850,204772860,42617637,0.0118375062007729,99.963989856859,-36.875
339.28,340,270,334,13230,24048,2025-04-17,2025-05-30,525.66,64,10818,542920959,126942613,0.00442937403711467,99.956140945371,0.449850299401198
525.56,585,5,4,40705,23776,2025-04-17,2025-04-25,525.66,-1,-16929,186785929,41175251,0.0127290102243194,99.700972657314,-0.712020524899058
437.61,444,36,37,36612,23643,2025-04-17,2025-08-15,525.66,1,-12969,650394247,116470886,0.00363517975582585,99.9851396287028,-0.548534449942901
424.68,425,716,729,30072,23328,2025-04-17,2025-04-25,525.66,13,-6744,186785929,41175251,0.0124891634636997,99.7134618207777,-0.289094650205761
525.49,640,2,2,21920,22902,2025-04-17,2025-06-20,525.66,0,982,2210385665,443310327,0.0010361087824011,99.9982152435829,0.0428783512356999
475.05,476,154,241,20174,22895,2025-04-17,2025-04-25,525.66,87,2721,186785929,41175251,0.0122573472865828,99.7257191680643,0.118846909805634
473.16,474,181,269,18100,22596,2025-04-17,2025-04-25,525.66,88,4496,186785929,41175251,0.0120972709887585,99.7378164390531,0.19897326960524
482.76,484,184,182,28520,22568,2025-04-17,2025-04-25,525.66,-2,-5952,186785929,41175251,0.0120822805662197,99.7498987196193,-0.263736263736264
279.23,280,273,275,33579,21175,2025-04-17,2025-07-18,525.66,2,-12404,781158455,167554530,0.00271071763538679,99.9898681247712,-0.585785123966942
308.3,310,120,124,33360,21080,2025-04-17,2025-08-15,525.66,4,-12280,650394247,116470886,0.00324111107950806,99.9883807397823,-0.582542694497154
522.07,552,6,7,14922,20951,2025-04-17,2025-05-23,525.66,1,6029,27519740,10743122,0.0761308064683751,98.8811849239855,0.287766693713904
179.9,180,2063,2064,10315,20640,2025-04-17,2025-06-20,525.66,1,10325,2210385665,443310327,0.000933773699622686,99.9991490172825,0.500242248062015
284.23,285,265,267,27560,20559,2025-04-17,2025-07-18,525.66,2,-7001,781158455,167554530,0.00263186039508463,99.9924999851663,-0.340532127048981
299.57,300,337,475,10110,20425,2025-04-17,2025-05-30,525.66,138,10315,542920959,126942613,0.00376205774734145,99.9599030031184,0.505018359853121
466.29,467,268,285,23852,20235,2025-04-17,2025-04-25,525.66,17,-3617,186785929,41175251,0.0108332571454031,99.7607319767647,-0.178749691129232
274.16,275,139,238,9869,19992,2025-04-17,2025-07-18,525.66,99,10123,781158455,167554530,0.00255927588980651,99.9950592610561,0.506352541016407
334.5,335,290,397,14210,19850,2025-04-17,2025-05-23,525.66,107,5640,27519740,10743122,0.0721300419262682,98.9533149659118,0.284130982367758
354.27,355,264,269,19008,19637,2025-04-17,2025-05-30,525.66,5,629,542920959,126942613,0.00361691691478796,99.9635199200332,0.0320313693537709
522.59,588,313,3,1496766,19623,2025-04-17,2025-05-30,525.66,-310,-1477143,542920959,126942613,0.00361433827055478,99.9671342583037,-75.2761045711665
523.04,572,78,4,309426,19584,2025-04-17,2025-04-25,525.66,-74,-289842,186785929,41175251,0.0104847298213775,99.7712167065861,-14.7999387254902
314.6,315,477,487,16695,19480,2025-04-17,2025-05-30,525.66,10,2785,542920959,126942613,0.00358799926160154,99.9707222575653,0.142967145790554
299.82,300,1245,1060,19920,19080,2025-04-17,2025-05-16,525.66,-185,-840,2098065603,598425916,0.000909409122990136,99.9929517456562,-0.0440251572327044
467.23,468,232,247,23432,19019,2025-04-17,2025-04-25,525.66,15,-4413,186785929,41175251,0.0101822445094352,99.7813989510955,-0.232031126767969
456.27,457,261,260,31842,18980,2025-04-17,2025-04-25,525.66,-1,-12862,186785929,41175251,0.0101613649923277,99.7915603160878,-0.677660695468915
164.94,165,3129,3135,21903,18810,2025-04-17,2025-06-20,525.66,6,-3093,2210385665,443310327,0.000850982717534046,100,-0.164433811802233
525.47,588,159,3,800406,18759,2025-04-17,2025-05-16,525.66,-156,-781647,2098065603,598425916,0.000894109315417817,99.9938458549716,-41.6678394370702
324.46,325,263,346,12624,18684,2025-04-17,2025-05-30,525.66,83,6060,542920959,126942613,0.00344138491805766,99.9741636424834,0.324341682723186
393.61,395,139,128,16958,17792,2025-04-17,2025-05-23,525.66,-11,834,27519740,10743122,0.0646517735996052,99.0179667395114,0.046875
539.31,583,607,4,2767920,17476,2025-04-17,2025-05-16,525.66,-603,-2750444,2098065603,598425916,0.000832957748080483,99.9946788127197,-157.38406958114
319.57,320,393,400,16506,17200,2025-04-17,2025-05-30,525.66,7,694,542920959,126942613,0.00316804862934017,99.9773316911127,0.0403488372093023
501.74,559,3,3,17178,17178,2025-04-17,2025-05-23,525.66,0,0,27519740,10743122,0.0624206478694929,99.0803873873809,0
525.4,611,2,2,17956,17120,2025-04-17,2025-05-16,525.66,0,-836,2098065603,598425916,0.00081598973719031,99.9954948024569,-0.0488317757009346
525.05,582,498,3,2836110,17085,2025-04-17,2025-05-30,525.66,-495,-2819025,542920959,126942613,0.0031468669088533,99.9804785580216,-165
533.41,567,616,5,1520904,16795,2025-04-17,2025-04-25,525.66,-611,-1504109,186785929,41175251,0.00899157666207287,99.8005518927499,-89.5569514736529
455.37,456,236,262,17936,16506,2025-04-17,2025-04-25,525.66,26,-1430,186785929,41175251,0.00883685408658379,99.8093887468365,-0.0866351629710408
359.61,360,421,421,13472,16419,2025-04-17,2025-05-09,525.66,0,2947,114289278,33592363,0.0143661770266849,99.9318991235556,0.17948717948718
349.64,350,428,453,10272,16308,2025-04-17,2025-05-09,525.66,25,6036,114289278,33592363,0.0142690550551907,99.9461681786108,0.370125091979397
394.86,395,1114,1162,28964,16268,2025-04-17,2025-04-25,525.66,48,-12696,186785929,41175251,0.00870943549500455,99.8180981823315,-0.780427833784116
494.68,576,2,2,16264,16264,2025-04-17,2025-05-23,525.66,0,0,27519740,10743122,0.0590993955611499,99.139486782942,0
304.77,305,696,706,16008,16238,2025-04-17,2025-05-23,525.66,10,229.999999999998,27519740,10743122,0.0590049179243699,99.1984917008664,0.0141643059490084
525.97,580,3,3,11499,16209,2025-04-17,2025-04-25,525.66,0,4710,186785929,41175251,0.00867784853322651,99.8267760308647,0.290579307791967
329.58,330,213,379,7029,15918,2025-04-17,2025-05-23,525.66,166,8889,27519740,10743122,0.0578421162409238,99.2563338171073,0.558424425179043
334.35,335,176,242,8976,15730,2025-04-17,2025-05-30,525.66,66,6754,542920959,126942613,0.00289729098485586,99.9833758490064,0.429370629370629
329.49,330,297,307,13365,15657,2025-04-17,2025-05-30,525.66,10,2292,542920959,126942613,0.00288384519706855,99.9862596942035,0.1463881969726
536,567,5,5,14830,15500,2025-04-17,2025-05-23,525.66,0,669.999999999998,27519740,10743122,0.0563232065419223,99.3126570236492,0.0432258064516128
254.05,255,108,162,11016,15390,2025-04-17,2025-08-15,525.66,54,4374,650394247,116470886,0.0023662570926769,99.990746996875,0.284210526315789
530,568,5,4,15715,15200,2025-04-17,2025-05-23,525.66,-1,-515,27519740,10743122,0.0552330799636915,99.3678901036129,-0.0338815789473684
476.03,477,53,154,7844,14938,2025-04-17,2025-04-25,525.66,101,7094,186785929,41175251,0.00799739042441468,99.8347734212891,0.474896237782836
525.95,575,53,3,200181,14715,2025-04-17,2025-05-09,525.66,-50,-185466,114289278,33592363,0.0128752235183426,99.9590434021291,-12.603873598369
525.02,598,2,2,11268,14596,2025-04-17,2025-05-30,525.66,0,3328,542920959,126942613,0.00268842080196797,99.9889481150054,0.22800767333516
450.51,451,283,297,20093,14553,2025-04-17,2025-04-25,525.66,14,-5540,186785929,41175251,0.00779127211450708,99.8425646934037,-0.380677523534666
378.96,380,138,139,14214,14456,2025-04-17,2025-05-23,525.66,1,241.999999999998,27519740,10743122,0.0525295660496793,99.4204196696626,0.0167404537908134
244.24,245,147,189,11613,14364,2025-04-17,2025-08-15,525.66,42,2751,650394247,116470886,0.00220850661983177,99.9929555034948,0.191520467836257
527.23,670,1,1,14277,14277,2025-04-17,2025-08-15,525.66,0,0,650394247,116470886,0.00219513011774841,99.9951506336125,0
359.9,360,1319,1414,13190,14140,2025-04-17,2025-04-25,525.66,95,950,186785929,41175251,0.00757016338206075,99.8501348567857,0.0671852899575672
524.93,553,7,5,14833,14035,2025-04-17,2025-05-23,525.66,-2,-798.000000000002,27519740,10743122,0.0509997550848954,99.4714194247475,-0.0568578553615961
527.25,665,0,1,0,13775,2025-04-17,2025-09-19,525.66,1,13775,1699576882,316242446,0.000810495844341568,99.9992880580968,1
313.14,315,72,74,18432,13764,2025-04-17,2025-08-15,525.66,2,-4668,650394247,116470886,0.00211625488132585,99.9972668884939,-0.339145597210113
528.6,563,3,4,15978,13760,2025-04-17,2025-05-23,525.66,1,-2218,27519740,10743122,0.0500004723881839,99.5214198971357,-0.161191860465116
525.3,593,2,2,10740,13540,2025-04-17,2025-05-30,525.66,0,2800,542920959,126942613,0.00249391735123639,99.9914420323567,0.206794682422452
523.81,591,9,2,48249,13438,2025-04-17,2025-05-16,525.66,-7,-34811,2098065603,598425916,0.000640494748152067,99.996135297205,-2.59048965619884
462.33,463,178,193,14240,12931,2025-04-17,2025-04-25,525.66,15,-1309,186785929,41175251,0.00692289835172755,99.8570577551374,-0.101229603278942
383.94,385,117,120,14040,12720,2025-04-17,2025-05-23,525.66,3,-1320,27519740,10743122,0.046221366916984,99.5676412640526,-0.10377358490566
523.92,650,0,1,0,12608,2025-04-17,2025-08-15,525.66,1,12608,650394247,116470886,0.00193851653180444,99.9992054050257,1
525.45,650,1,1,12267,12455,2025-04-17,2025-05-16,525.66,0,188,2098065603,598425916,0.000593642066396339,99.9967289392714,0.0150943396226415
526.67,650,1,1,12333,12333,2025-04-17,2025-07-18,525.66,0,0,781158455,167554530,0.0015788090010496,99.9966380700571,0
524,645,1,1,12100,12100,2025-04-17,2025-09-19,525.66,0,0,1699576882,316242446,0.000711941903196586,100,0
379.87,380,851,920,12765,11960,2025-04-17,2025-04-25,525.66,69,-805,186785929,41175251,0.00640305191297359,99.8634608070504,-0.0673076923076923
465.24,466,146,155,15038,11780,2025-04-17,2025-04-25,525.66,9,-3258,186785929,41175251,0.00630668491093888,99.8697674919613,-0.276570458404075
269.11,270,21,125,2625,11125,2025-04-17,2025-07-18,525.66,104,8500,781158455,167554530,0.00142416688045705,99.9980622369376,0.764044943820225
289.82,290,593,614,7709,11052,2025-04-17,2025-05-16,525.66,21,3343,2098065603,598425916,0.000526770944826362,99.9972557102162,0.302479189287007
369.9,370,792,1098,11088,10980,2025-04-17,2025-04-25,525.66,306,-108,186785929,41175251,0.0058783871241179,99.8756458790855,-0.00983606557377049
299.87,300,730,809,7300,10517,2025-04-17,2025-05-09,525.66,79,3217,114289278,33592363,0.0092020880558892,99.968245490185,0.305885708852334
523.05,574,5,2,26400,10190,2025-04-17,2025-04-25,525.66,-3,-16210,186785929,41175251,0.00545544305963218,99.8811013221451,-1.59077526987242
453.23,454,130,130,10140,10010,2025-04-17,2025-04-25,525.66,0,-130,186785929,41175251,0.00535907605759747,99.8864603982027,-0.012987012987013
525.41,625,1,1,8572,9959,2025-04-17,2025-05-16,525.66,0,1387,2098065603,598425916,0.000474675338357378,99.9977303855546,0.139271011145697
451.5,452,190,193,14250,9650,2025-04-17,2025-04-25,525.66,3,-4600,186785929,41175251,0.00516634205352803,99.8916267402562,-0.476683937823834
458.19,459,119,119,9282,9639,2025-04-17,2025-04-25,525.66,0,357,186785929,41175251,0.00516045295895924,99.8967871932152,0.037037037037037
519.05,551,2,3,8460,9585,2025-04-17,2025-05-23,525.66,1,1125,27519740,10743122,0.0348295441744726,99.6024708082271,0.117370892018779
526.23,549,4,4,9108,9108,2025-04-17,2025-05-23,525.66,0,0,27519740,10743122,0.0330962429150857,99.6355670511422,0
324.62,325,138,236,4278,8968,2025-04-17,2025-05-23,525.66,98,4690,27519740,10743122,0.032587517178578,99.6681545683208,0.522970561998216
309.72,310,317,315,10461,8820,2025-04-17,2025-05-23,525.66,-2,-1641,27519740,10743122,0.0320497213999842,99.7002042897208,-0.186054421768707
534.63,564,2,3,14164,8811,2025-04-17,2025-05-23,525.66,1,-5353,27519740,10743122,0.0320170176026372,99.7322213073234,-0.607536034502326
314.68,315,272,272,9248,8704,2025-04-17,2025-05-23,525.66,0,-544,27519740,10743122,0.0316282057897349,99.7638495131131,-0.0625
254.5,255,173,173,10726,8650,2025-04-17,2025-07-18,525.66,0,-2076,781158455,167554530,0.00110732975424301,99.9991695666918,-0.24
519.11,562,2,2,8578,8578,2025-04-17,2025-05-23,525.66,0,0,27519740,10743122,0.031170352626878,99.79501986574,0
530.19,573,0,2,0,8562,2025-04-17,2025-05-23,525.66,2,8562,27519740,10743122,0.0311122125427057,99.8261320782827,1
354.72,355,291,304,5820,8512,2025-04-17,2025-05-02,525.66,13,2692,204772860,42617637,0.00415680085730111,99.9681466577163,0.316259398496241
525.31,610,1,1,7253,8469,2025-04-17,2025-05-02,525.66,0,1216,204772860,42617637,0.00413580198078984,99.9722824596971,0.143582477270044
374.89,375,697,746,9758,8206,2025-04-17,2025-04-25,525.66,49,-1552,186785929,41175251,0.00439326454831616,99.9011804577635,-0.1891299049476
339.77,340,133,351,2128,8073,2025-04-17,2025-05-02,525.66,218,5945,204772860,42617637,0.00394241697849998,99.9762248766756,0.736405301622693
515.25,595,1,1,7975,7975,2025-04-17,2025-05-23,525.66,0,0,27519740,10743122,0.0289791982046342,99.8551112764873,0
522.17,561,385,2,804650,7766,2025-04-17,2025-04-25,525.66,-383,-796884,186785929,41175251,0.00415770076556463,99.9053381585291,-102.611898016997
442.64,443,215,215,13115,7740,2025-04-17,2025-04-25,525.66,0,-5375,186785929,41175251,0.00414378108749294,99.9094819396166,-0.694444444444445
422.65,423,219,220,8979,7700,2025-04-17,2025-04-25,525.66,1,-1279,186785929,41175251,0.0041223661981519,99.9136043058147,-0.166103896103896
497.44,574,1,1,7656,7656,2025-04-17,2025-05-23,525.66,0,0,27519740,10743122,0.0278200302764488,99.8829313067638,0
438.63,439,172,206,14792,7622,2025-04-17,2025-04-25,525.66,34,-7170,186785929,41175251,0.00408060716393685,99.9176849129787,-0.940697979532931
432.62,433,1,200,53,7600,2025-04-17,2025-04-25,525.66,199,7547,186785929,41175251,0.00406882897479927,99.9217537419534,0.993026315789474
525.5,601,1,1,8068,7550,2025-04-17,2025-05-16,525.66,0,-518.000000000001,2098065603,598425916,0.000359855287137082,99.9980902408417,-0.0686092715231789
447.57,448,170,171,17340,7353,2025-04-17,2025-04-25,525.66,1,-9987,186785929,41175251,0.0039365920331183,99.9256903339866,-1.35822113423093
364.89,365,325,667,3575,7337,2025-04-17,2025-04-25,525.66,342,3762,186785929,41175251,0.00392802607738188,99.9296183600639,0.512743628185907
524.9,598,1,1,10131,7310,2025-04-17,2025-05-16,525.66,0,-2821,2098065603,598425916,0.000348416178671797,99.9984386570204,-0.385909712722298
324.75,325,293,291,5274,7275,2025-04-17,2025-05-09,525.66,-2,2001,114289278,33592363,0.00636542651008785,99.9746109166951,0.275051546391753
433.57,434,96,166,4800,7138,2025-04-17,2025-04-25,525.66,70,2338,186785929,41175251,0.00382148700291016,99.9334398470669,0.327542729055758
531.88,603,1,1,7797,7112,2025-04-17,2025-05-30,525.66,0,-685,542920959,126942613,0.0013099512704574,99.9927519836272,-0.0963160854893138
534.3,558,2,3,6092,7110,2025-04-17,2025-05-23,525.66,1,1018,27519740,10743122,0.0258359999040689,99.9087673066679,0.143178621659634
524.92,596,1,1,5830,7108,2025-04-17,2025-05-16,525.66,0,1278,2098065603,598425916,0.000338788262380183,99.9987774452828,0.179797411367473
540.5,609,1,1,10000,6850,2025-04-17,2025-05-30,525.66,0,-3150,542920959,126942613,0.0012616937855221,99.9940136774127,-0.45985401459854
354.53,355,174,144,6960,6768,2025-04-17,2025-05-09,525.66,-30,-192.000000000002,114289278,33592363,0.00592181534299307,99.9805327320381,-0.0283687943262414
294.79,295,332,322,4648,6762,2025-04-17,2025-05-16,525.66,-10,2114,2098065603,598425916,0.000322296881009397,99.9990997421638,0.312629399585921
525.38,593,1,1,5575,6762,2025-04-17,2025-05-16,525.66,0,1187,2098065603,598425916,0.000322296881009397,99.9994220390448,0.175539781129843
540.74,607,1,1,5217,6626,2025-04-17,2025-05-30,525.66,0,1409,542920959,126942613,0.00122043547779116,99.9952341128905,0.212647147600362
539.79,572.5,100,2,327100,6542,2025-04-17,2025-05-09,525.66,-98,-320558,114289278,33592363,0.00572407150914017,99.9862568035472,-49
522.59,587,213,1,1070751,6441,2025-04-17,2025-05-30,525.66,-212,-1064310,542920959,126942613,0.00118636053613837,99.9964204734266,-165.239869585468
531.12,552.5,3,3,6414,6414,2025-04-17,2025-05-23,525.66,0,0,27519740,10743122,0.0233069062425735,99.9320742129105,0
523.19,587,63,1,337365,6381,2025-04-17,2025-05-16,525.66,-62,-330984,2098065603,598425916,0.000304137296320758,99.9997261763411,-51.87023977433
344.8,345,299,318,4784,6360,2025-04-17,2025-05-02,525.66,19,1576,204772860,42617637,0.00310588033980675,99.9793307570154,0.247798742138365
349.81,350,323,332,5491,6308,2025-04-17,2025-05-02,525.66,9,817,204772860,42617637,0.00308048634960707,99.982411243365,0.129518072289157
460.33,461,25,94,2100,6298,2025-04-17,2025-04-25,525.66,69,4198,186785929,41175251,0.00337177432674814,99.9368116213936,0.666560812956494
461.27,462,78,84,7020,6132,2025-04-17,2025-04-25,525.66,6,-888,186785929,41175251,0.00328290253598278,99.9400945239296,-0.144814090019569
452.33,453,72,90,6336,6030,2025-04-17,2025-04-25,525.66,18,-306,186785929,41175251,0.00322829456816311,99.9433228184978,-0.0507462686567164
304.61,305,93,150,5301,5850,2025-04-17,2025-05-30,525.66,57,549,542920959,126942613,0.00107750491172326,99.9974979783383,0.0938461538461539
369.1,370,67,64,4288,5760,2025-04-17,2025-05-23,525.66,-3,1472,27519740,10743122,0.0209304303020305,99.9530046432125,0.255555555555556
523.55,581,391,1,1598799,5745,2025-04-17,2025-05-16,525.66,-390,-1593054,2098065603,598425916,0.000273823658887753,100,-277.293994778068
525.53,582,1,1,3716,5647,2025-04-17,2025-04-25,525.66,0,1931,186785929,41175251,0.00302324700272257,99.9463460655005,0.341951478661236
410.5,411,112,112,5600,5600,2025-04-17,2025-04-25,525.66,0,0,186785929,41175251,0.00299808450774683,99.9493441500082,0
520.35,576,9,1,33867,5565,2025-04-17,2025-05-09,525.66,-8,-28302,114289278,33592363,0.00486922316544864,99.9911260267127,-5.08571428571429
384.9,385,507,531,11154,5310,2025-04-17,2025-04-25,525.66,24,-5844,186785929,41175251,0.00284282656002423,99.9521869765682,-1.10056497175141
525.38,578,54,1,188244,5262,2025-04-17,2025-05-02,525.66,-53,-182982,204772860,42617637,0.00256967646982125,99.9849809198348,-34.7742303306728
533.85,586,328,1,1710520,5215,2025-04-17,2025-05-30,525.66,-327,-1705305,542920959,126942613,0.000960544976860987,99.9984585233152,-327
249.24,250,69,68,8142,5168,2025-04-17,2025-08-15,525.66,-1,-2974,650394247,116470886,0.000794594974331008,100,-0.57546439628483
299.92,300,582,617,3492,4936,2025-04-17,2025-05-02,525.66,35,1444,204772860,42617637,0.00241047568510788,99.9873913955199,0.292544570502431
309.53,310,102,103,4284,4841,2025-04-17,2025-05-30,525.66,1,557,542920959,126942613,0.000891658338060219,99.9993501816532,0.115058872133857
445.39,446,52,71,4368,4331,2025-04-17,2025-04-25,525.66,19,-37,186785929,41175251,0.00231869714340206,99.9545056737117,-0.00854306164858001
532.51,575,1767,1,6647454,4249,2025-04-17,2025-05-02,525.66,-1766,-6643205,204772860,42617637,0.00207498200689291,99.9894663775268,-1563.47493527889
431.68,432,0,131,0,4192,2025-04-17,2025-04-25,525.66,131,4192,186785929,41175251,0.00224428040294192,99.9567499541146,1
436.54,437,1,87,47,4002,2025-04-17,2025-04-25,525.66,86,3955,186785929,41175251,0.00214255967857193,99.9588925137932,0.988255872063968
370.89,371,54,358,756,3938,2025-04-17,2025-04-25,525.66,304,3182,186785929,41175251,0.00210829585562626,99.9610008096488,0.80802437785678
540.72,578,1,1,3728,3728,2025-04-17,2025-05-23,525.66,0,0,27519740,10743122,0.0135466396121475,99.9665512828246,0
435.55,436,20,82,1600,3690,2025-04-17,2025-04-25,525.66,62,2090,186785929,41175251,0.00197552354171175,99.9629763331905,0.56639566395664
259.99,260,13,3612,39,3612,2025-04-17,2025-04-25,525.66,3599,3573,186785929,41175251,0.00193376450749671,99.964910097698,0.989202657807309
427.62,428,6,95,402,3610,2025-04-17,2025-04-25,525.66,89,3208,186785929,41175251,0.00193269376302966,99.966842791461,0.888642659279778
364.28,365,45,49,3690,3528,2025-04-17,2025-05-30,525.66,4,-162,542920959,126942613,0.000649818346762332,100,-0.0459183673469388
400.85,401,86,231,2236,3465,2025-04-17,2025-04-25,525.66,145,1229,186785929,41175251,0.00185506478916835,99.9686978562502,0.354689754689755
304.9,305,336,346,2352,3460,2025-04-17,2025-05-02,525.66,10,1108,204772860,42617637,0.00168967704020933,99.991156054567,0.320231213872832
536.65,571,0,1,0,3435,2025-04-17,2025-05-23,525.66,1,3435,27519740,10743122,0.0124819493207421,99.9790332321454,1
417.75,418,90,137,3870,3425,2025-04-17,2025-04-25,525.66,47,-445,186785929,41175251,0.0018336498998273,99.97053150615,-0.12992700729927
364.64,365,64,95,1536,3420,2025-04-17,2025-05-02,525.66,31,1884,204772860,42617637,0.0016701432015942,99.9928261977686,0.550877192982456
264.26,265,44,46,3476,3404,2025-04-17,2025-07-18,525.66,2,-72.0000000000005,781158455,167554530,0.000435763061669735,99.9996053297535,-0.0211515863689778
430.59,431,25,78,1750,3198,2025-04-17,2025-04-25,525.66,53,1448,186785929,41175251,0.00171212040281685,99.9722436265528,0.452782989368355
354.96,355,478,789,7170,3156,2025-04-17,2025-04-25,525.66,311,-4014,186785929,41175251,0.00168963476900875,99.9739332613219,-1.27186311787072
540.57,572,286,1,898898,3143,2025-04-17,2025-05-02,525.66,-285,-895755,204772860,42617637,0.00153487136918437,99.9943610691378,-285
526.37,556,2,1,4806,2963,2025-04-17,2025-05-23,525.66,-1,-1843,27519740,10743122,0.0107668168376591,99.989800048983,-0.622004724940938
365.91,366,0,326,0,2934,2025-04-17,2025-04-25,525.66,326,2934,186785929,41175251,0.00157078213316593,99.975504043455,1
359.71,360,55,99,1155,2871,2025-04-17,2025-05-02,525.66,44,1716,204772860,42617637,0.00140204126660144,99.9957631104044,0.597701149425287
420.64,421,39,79,1521,2844,2025-04-17,2025-04-25,525.66,40,1323,186785929,41175251,0.00152259863214857,99.9770266420872,0.465189873417722
534.43,562.5,1,1,2807,2807,2025-04-17,2025-05-23,525.66,0,0,27519740,10743122,0.0101999510169791,100,0
407.74,408,8,98,240,2548,2025-04-17,2025-04-25,525.66,90,2308,186785929,41175251,0.00136412845102481,99.9783907705382,0.905808477237049
349.95,350,475,507,4275,2535,2025-04-17,2025-04-25,525.66,32,-1740,186785929,41175251,0.00135716861198897,99.9797479391502,-0.686390532544379
249.99,250,825,2410,1650,2410,2025-04-17,2025-04-25,525.66,1585,760,186785929,41175251,0.00129024708279819,99.981038186233,0.315352697095436
339.94,340,264,392,1584,2352,2025-04-17,2025-04-25,525.66,128,768,186785929,41175251,0.00125919549325367,99.9822973817262,0.326530612244898
309.9,310,230,230,2300,2300,2025-04-17,2025-05-02,525.66,0,0,204772860,42617637,0.00112319572037037,99.9968863061248,0
309.86,310,115,150,1610,2100,2025-04-17,2025-05-09,525.66,35,490,114289278,33592363,0.00183744270394289,99.9929634694166,0.233333333333333
368.9,369,3,210,42,2100,2025-04-17,2025-04-25,525.66,207,2058,186785929,41175251,0.00112428169040506,99.9834216634166,0.98
344.59,345,50,50,1300,2050,2025-04-17,2025-05-09,525.66,0,750,114289278,33592363,0.00179369406813472,99.9947571634848,0.365853658536585
358.96,359,200,472,2000,1888,2025-04-17,2025-04-25,525.66,272,-112,186785929,41175251,0.0010107827768975,99.9844324461935,-0.0593220338983051
319.86,320,103,123,1030,1722,2025-04-17,2025-05-02,525.66,20,692,204772860,42617637,0.000840931752381639,99.9977272378771,0.401858304297329
259.49,260,31,33,1891,1683,2025-04-17,2025-07-18,525.66,2,-208,781158455,167554530,0.000215449245825548,99.9998207789993,-0.123588829471182
448.33,449,18,24,1692,1608,2025-04-17,2025-04-25,525.66,6,-83.9999999999995,186785929,41175251,0.000860878551510162,99.985293324745,-0.052238805970149
339.74,340,53,58,1590,1508,2025-04-17,2025-05-09,525.66,5,-81.9999999999998,114289278,33592363,0.00131945885597422,99.9960766223407,-0.0543766578249335
423.65,424,38,43,1558,1505,2025-04-17,2025-04-25,525.66,5,-52.9999999999998,186785929,41175251,0.000805735211456962,99.9860990599565,-0.0352159468438537
366.91,367,0,166,0,1494,2025-04-17,2025-04-25,525.66,166,1494,186785929,41175251,0.000799846116888173,99.9868989060734,1
314.87,315,61,113,671,1469,2025-04-17,2025-05-02,525.66,52,798,204772860,42617637,0.000717380223140899,99.9984446181003,0.543226684819605
289,290,14,14,1400,1400,2025-04-17,2025-07-18,525.66,0,0,781158455,167554530,0.00017922100068673,100,0
314.78,315,55,63,825,1386,2025-04-17,2025-05-09,525.66,8,561,114289278,33592363,0.0012127121846023,99.9972893345253,0.404761904761905
329.84,330,81,86,1134,1376,2025-04-17,2025-05-02,525.66,5,242,204772860,42617637,0.000671964048360706,99.9991165821486,0.175872093023256
324.88,325,93,104,930,1248,2025-04-17,2025-05-02,525.66,11,318,204772860,42617637,0.000609455764792268,99.9997260379134,0.254807692307692
367.94,368,1,207,14,1242,2025-04-17,2025-04-25,525.66,206,1228,186785929,41175251,0.000664932314039566,99.9875638383874,0.988727858293076
355.96,356,1,302,9,1208,2025-04-17,2025-04-25,525.66,301,1199,186785929,41175251,0.000646729658099674,99.9882105680455,0.992549668874172
299.99,300,744,1154,2232,1154,2025-04-17,2025-04-25,525.66,410,-1078,186785929,41175251,0.000617819557489258,99.988828387603,-0.934142114384749
395.8,396,0,55,0,1100,2025-04-17,2025-04-25,525.66,55,1100,186785929,41175251,0.000588909456878842,99.9894172970599,1
398.8,399,1,55,35,1100,2025-04-17,2025-04-25,525.66,54,1065,186785929,41175251,0.000588909456878842,99.9900062065168,0.968181818181818
264.98,265,534,534,1068,1068,2025-04-17,2025-04-25,525.66,0,0,186785929,41175251,0.000571777545406003,99.9905779840622,0
334.81,335,57,55,1368,1045,2025-04-17,2025-05-09,525.66,-2,-323,114289278,33592363,0.000914346488390626,99.9982036810137,-0.309090909090909
378.92,379,130,130,1950,1040,2025-04-17,2025-04-25,525.66,0,-910,186785929,41175251,0.000556787122867269,99.9911347711851,-0.875
408.69,409,0,32,0,992,2025-04-17,2025-04-25,525.66,32,992,186785929,41175251,0.000531089255658011,99.9916658604407,1
319.77,320,38,42,608,966,2025-04-17,2025-05-09,525.66,4,358,114289278,33592363,0.000845223643813727,99.9990489046575,0.370600414078675
344.96,345,110,240,1100,960,2025-04-17,2025-04-25,525.66,130,-140,186785929,41175251,0.000513957344185172,99.9921798177849,-0.145833333333333
401.86,402,11,67,352,938,2025-04-17,2025-04-25,525.66,56,586,186785929,41175251,0.000502179155047595,99.9926819969399,0.624733475479744
402.72,403,0,33,0,924,2025-04-17,2025-04-25,525.66,33,924,186785929,41175251,0.000494683943778228,99.9931766808837,1
441.59,442,2,19,176,779,2025-04-17,2025-04-25,525.66,17,603,186785929,41175251,0.000417054969916926,99.9935937358536,0.774069319640565
377.93,378,1,99,14,693,2025-04-17,2025-04-25,525.66,98,679,186785929,41175251,0.000371012957833671,99.9939647488115,0.97979797979798
360.95,361,21,132,252,660,2025-04-17,2025-04-25,525.66,111,408,186785929,41175251,0.000353345674127305,99.9943180944856,0.618181818181818
393.86,394,3,41,66,574,2025-04-17,2025-04-25,525.66,38,508,186785929,41175251,0.00030730366204405,99.9946253981476,0.885017421602787
329.73,330,26,21,442,567,2025-04-17,2025-05-09,525.66,-5,125,114289278,33592363,0.000496109530064579,99.9995450141876,0.220458553791887
334.89,335,51,51,612,561,2025-04-17,2025-05-02,525.66,0,-51,204772860,42617637,0.000273962086577294,100,-0.0909090909090909
387.88,388,3,46,54,552,2025-04-17,2025-04-25,525.66,43,498,186785929,41175251,0.000295525472906474,99.9949209236205,0.902173913043478
397.87,398,0,40,0,520,2025-04-17,2025-04-25,525.66,40,520,186785929,41175251,0.000278393561433635,99.995199317182,1
304.9,305,38,52,988,520,2025-04-17,2025-05-09,525.66,14,-468,114289278,33592363,0.000454985812404905,100,-0.9
440.61,441,0,12,0,468,2025-04-17,2025-04-25,525.66,12,468,186785929,41175251,0.000250554205290271,99.9954498713873,1
304.98,305,121,229,484,458,2025-04-17,2025-04-25,525.66,108,-26,186785929,41175251,0.000245200482955009,99.9956950718702,-0.0567685589519651
396.87,397,0,31,0,403,2025-04-17,2025-04-25,525.66,31,403,186785929,41175251,0.000215755010111067,99.9959108268803,1
376.88,377,0,32,0,384,2025-04-17,2025-04-25,525.66,32,384,186785929,41175251,0.000205582937674069,99.996116409818,1
334.98,335,128,191,896,382,2025-04-17,2025-04-25,525.66,63,-514,186785929,41175251,0.000204512193207016,99.9963209220112,-1.3455497382199
388.79,389,13,18,247,378,2025-04-17,2025-04-25,525.66,5,131,186785929,41175251,0.000202370704272911,99.9965232927155,0.346560846560846
274.99,275,314,357,628,357,2025-04-17,2025-04-25,525.66,43,-271,186785929,41175251,0.000191127887368861,99.9967144206029,-0.759103641456583
294.98,295,175,175,350,350,2025-04-17,2025-04-25,525.66,0,0,186785929,41175251,0.000187380281734177,99.9969018008846,0
375.91,376,0,38,0,342,2025-04-17,2025-04-25,525.66,38,342,186785929,41175251,0.000183097303865967,99.9970848981885,1
357.93,358,0,45,0,315,2025-04-17,2025-04-25,525.66,45,315,186785929,41175251,0.000168642253560759,99.997253540442,1
446.61,447,7,8,616,312,2025-04-17,2025-04-25,525.66,1,-304,186785929,41175251,0.000167036136860181,99.9974205765789,-0.974358974358974
403.74,404,0,11,0,286,2025-04-17,2025-04-25,525.66,11,286,186785929,41175251,0.000153116458788499,99.9975736930377,1
437.53,438,0,6,0,282,2025-04-17,2025-04-25,525.66,6,282,186785929,41175251,0.000150974969854394,99.9977246680075,1
309.98,310,116,138,696,276,2025-04-17,2025-04-25,525.66,22,-420,186785929,41175251,0.000147762736453237,99.997872430744,-1.52173913043478
426.73,427,0,10,0,270,2025-04-17,2025-04-25,525.66,10,270,186785929,41175251,0.000144550503052079,99.998016981247,1
284.99,285,244,255,488,255,2025-04-17,2025-04-25,525.66,11,-233,186785929,41175251,0.000136519919549186,99.9981535011666,-0.913725490196078
443.58,444,2,6,124,252,2025-04-17,2025-04-25,525.66,4,128,186785929,41175251,0.000134913802848608,99.9982884149694,0.507936507936508
415.67,416,0,7,0,231,2025-04-17,2025-04-25,525.66,7,231,186785929,41175251,0.000123670985944557,99.9984120859554,1
319.98,320,62,114,1426,228,2025-04-17,2025-04-25,525.66,52,-1198,186785929,41175251,0.000122064869243978,99.9985341508246,-5.25438596491228
254.99,255,141,226,141,226,2025-04-17,2025-04-25,525.66,85,85,186785929,41175251,0.000120994124776926,99.9986551449494,0.376106194690266
371.93,372,0,30,0,210,2025-04-17,2025-04-25,525.66,30,210,186785929,41175251,0.000112428169040506,99.9987675731184,1
314.97,315,59,65,295,195,2025-04-17,2025-04-25,525.66,6,-100,186785929,41175251,0.000104397585537613,99.998871970704,-0.512820512820513
324.98,325,100,96,600,192,2025-04-17,2025-04-25,525.66,-4,-408,186785929,41175251,0.000102791468837034,99.9989747621728,-2.125
269.99,270,169,177,338,177,2025-04-17,2025-04-25,525.66,8,-161,186785929,41175251,9.4760885334141e-05,99.9990695230581,-0.909604519774011
416.78,417,9,8,495,176,2025-04-17,2025-04-25,525.66,-1,-319,186785929,41175251,9.42255131006148e-05,99.9991637485712,-1.8125
279.99,280,157,159,471,159,2025-04-17,2025-04-25,525.66,2,-312,186785929,41175251,8.5124185130669e-05,99.9992488727564,-1.9622641509434
373.93,374,0,19,0,133,2025-04-17,2025-04-25,525.66,19,133,186785929,41175251,7.12045070589873e-05,99.9993200772634,1
391.81,392,0,7,0,133,2025-04-17,2025-04-25,525.66,7,133,186785929,41175251,7.12045070589873e-05,99.9993912817705,1
329.98,330,34,65,204,130,2025-04-17,2025-04-25,525.66,31,-74,186785929,41175251,6.95983903584086e-05,99.9994608801608,-0.569230769230769
425.61,426,0,3,0,117,2025-04-17,2025-04-25,525.66,3,117,186785929,41175251,6.26385513225678e-05,99.9995235187122,1
289.99,290,105,105,420,105,2025-04-17,2025-04-25,525.66,0,-315,186785929,41175251,5.62140845202531e-05,99.9995797327967,-3
405.55,406,2,2,90,90,2025-04-17,2025-04-25,525.66,0,0,186785929,41175251,4.81835010173598e-05,99.9996279162977,0
383.83,384,0,5,0,85,2025-04-17,2025-04-25,525.66,5,85,186785929,41175251,4.55066398497287e-05,99.9996734229376,1
411.8,412,3,4,144,80,2025-04-17,2025-04-25,525.66,1,-64,186785929,41175251,4.28297786820976e-05,99.9997162527162,-0.8
361.91,362,1,7,18,63,2025-04-17,2025-04-25,525.66,6,45,186785929,41175251,3.37284507121519e-05,99.9997499811669,0.714285714285714
418.69,419,1,2,45,62,2025-04-17,2025-04-25,525.66,1,17,186785929,41175251,3.31930784786257e-05,99.9997831742454,0.274193548387097
390.9,391,5,6,150,60,2025-04-17,2025-04-25,525.66,1,-90,186785929,41175251,3.21223340115732e-05,99.9998152965794,-1.5
381.86,382,2,4,50,56,2025-04-17,2025-04-25,525.66,2,6.00000000000001,186785929,41175251,2.99808450774683e-05,99.9998452774245,0.107142857142857
382.9,383,4,5,104,50,2025-04-17,2025-04-25,525.66,1,-54,186785929,41175251,2.6768611676311e-05,99.9998720460362,-1.08
392.78,393,0,2,0,44,2025-04-17,2025-04-25,525.66,2,44,186785929,41175251,2.35563782751537e-05,99.9998956024145,1
363.95,364,2,8,28,40,2025-04-17,2025-04-25,525.66,6,12,186785929,41175251,2.14148893410488e-05,99.9999170173038,0.3
406.83,407,1,2,44,34,2025-04-17,2025-04-25,525.66,1,-10,186785929,41175251,1.82026559398915e-05,99.9999352199598,-0.294117647058824
362.92,363,0,4,0,32,2025-04-17,2025-04-25,525.66,4,32,186785929,41175251,1.7131911472839e-05,99.9999523518712,1
385.89,386,1,2,24,22,2025-04-17,2025-04-25,525.66,1,-2,186785929,41175251,1.17781891375768e-05,99.9999641300604,-0.0909090909090909
380.93,381,0,3,0,21,2025-04-17,2025-04-25,525.66,3,21,186785929,41175251,1.12428169040506e-05,99.9999753728773,1
412.8,413,0,1,0,20,2025-04-17,2025-04-25,525.66,1,20,186785929,41175251,1.07074446705244e-05,99.9999860803219,1
413.81,414,0,1,0,19,2025-04-17,2025-04-25,525.66,1,19,186785929,41175251,1.01720724369982e-05,99.9999962523944,1
372.93,373,0,1,0,7,2025-04-17,2025-04-25,525.66,1,7,186785929,41175251,3.74760563468354e-06,100,1
357,357,0,0,0,0,2025-04-17,2025-04-25,525.66,0,0,186785929,41175251,0,100,
387,387,0,0,0,0,2025-04-17,2025-04-25,525.66,0,0,186785929,41175251,0,100,
422,422,0,0,0,0,2025-04-17,2025-04-25,525.66,0,0,186785929,41175251,0,100,
539.16,573,272,0,1101600,0,2025-04-17,2025-04-25,525.66,-272,-1101600,186785929,41175251,0,100,-Inf
525.54,576,105,0,400050,0,2025-04-17,2025-04-25,525.66,-105,-400050,186785929,41175251,0,100,-Inf
521.1,577,22,0,122980,0,2025-04-17,2025-04-25,525.66,-22,-122980,186785929,41175251,0,100,-Inf
542.02,578,1,0,4115,0,2025-04-17,2025-04-25,525.66,-1,-4115,186785929,41175251,0,100,-Inf
525.09,579,10,0,37620,0,2025-04-17,2025-04-25,525.66,-10,-37620,186785929,41175251,0,100,-Inf
526,581,0,0,0,0,2025-04-17,2025-04-25,525.66,0,0,186785929,41175251,0,100,
525.87,583,0,0,0,0,2025-04-17,2025-04-25,525.66,0,0,186785929,41175251,0,100,
499.37,584,0,0,0,0,2025-04-17,2025-04-25,525.66,0,0,186785929,41175251,0,100,
525.54,586,0,0,0,0,2025-04-17,2025-04-25,525.66,0,0,186785929,41175251,0,100,
486.38,587,0,0,0,0,2025-04-17,2025-04-25,525.66,0,0,186785929,41175251,0,100,
538,588,0,0,0,0,2025-04-17,2025-04-25,525.66,0,0,186785929,41175251,0,100,
525.25,589,0,0,0,0,2025-04-17,2025-04-25,525.66,0,0,186785929,41175251,0,100,
520.4,590,0,0,0,0,2025-04-17,2025-04-25,525.66,0,0,186785929,41175251,0,100,
556.92,591,0,0,0,0,2025-04-17,2025-04-25,525.66,0,0,186785929,41175251,0,100,
569.69,592,0,0,0,0,2025-04-17,2025-04-25,525.66,0,0,186785929,41175251,0,100,
500.8,593,0,0,0,0,2025-04-17,2025-04-25,525.66,0,0,186785929,41175251,0,100,
565.84,594,0,0,0,0,2025-04-17,2025-04-25,525.66,0,0,186785929,41175251,0,100,
538,595,0,0,0,0,2025-04-17,2025-04-25,525.66,0,0,186785929,41175251,0,100,
537.98,596,0,0,0,0,2025-04-17,2025-04-25,525.66,0,0,186785929,41175251,0,100,
566.33,597,0,0,0,0,2025-04-17,2025-04-25,525.66,0,0,186785929,41175251,0,100,
537.8,598,0,0,0,0,2025-04-17,2025-04-25,525.66,0,0,186785929,41175251,0,100,
537.78,599,0,0,0,0,2025-04-17,2025-04-25,525.66,0,0,186785929,41175251,0,100,
538,600,0,0,0,0,2025-04-17,2025-04-25,525.66,0,0,186785929,41175251,0,100,
574.29,601,0,0,0,0,2025-04-17,2025-04-25,525.66,0,0,186785929,41175251,0,100,
521.59,602,0,0,0,0,2025-04-17,2025-04-25,525.66,0,0,186785929,41175251,0,100,
540.9,603,0,0,0,0,2025-04-17,2025-04-25,525.66,0,0,186785929,41175251,0,100,
556.86,604,0,0,0,0,2025-04-17,2025-04-25,525.66,0,0,186785929,41175251,0,100,
542.4,605,0,0,0,0,2025-04-17,2025-04-25,525.66,0,0,186785929,41175251,0,100,
534.92,610,0,0,0,0,2025-04-17,2025-04-25,525.66,0,0,186785929,41175251,0,100,
537.93,615,0,0,0,0,2025-04-17,2025-04-25,525.66,0,0,186785929,41175251,0,100,
543.01,620,0,0,0,0,2025-04-17,2025-04-25,525.66,0,0,186785929,41175251,0,100,
568.49,625,0,0,0,0,2025-04-17,2025-04-25,525.66,0,0,186785929,41175251,0,100,
563.94,630,0,0,0,0,2025-04-17,2025-04-25,525.66,0,0,186785929,41175251,0,100,
570.5,635,0,0,0,0,2025-04-17,2025-04-25,525.66,0,0,186785929,41175251,0,100,
640,640,0,0,0,0,2025-04-17,2025-04-25,525.66,0,0,186785929,41175251,0,100,
560.84,645,0,0,0,0,2025-04-17,2025-04-25,525.66,0,0,186785929,41175251,0,100,
522.81,650,0,0,0,0,2025-04-17,2025-04-25,525.66,0,0,186785929,41175251,0,100,
655,655,0,0,0,0,2025-04-17,2025-04-25,525.66,0,0,186785929,41175251,0,100,
501.13,660,0,0,0,0,2025-04-17,2025-04-25,525.66,0,0,186785929,41175251,0,100,
665,665,0,0,0,0,2025-04-17,2025-04-25,525.66,0,0,186785929,41175251,0,100,
670,670,0,0,0,0,2025-04-17,2025-04-25,525.66,0,0,186785929,41175251,0,100,
675,675,0,0,0,0,2025-04-17,2025-04-25,525.66,0,0,186785929,41175251,0,100,
680,680,0,0,0,0,2025-04-17,2025-04-25,525.66,0,0,186785929,41175251,0,100,
685,685,0,0,0,0,2025-04-17,2025-04-25,525.66,0,0,186785929,41175251,0,100,
690,690,0,0,0,0,2025-04-17,2025-04-25,525.66,0,0,186785929,41175251,0,100,
695,695,0,0,0,0,2025-04-17,2025-04-25,525.66,0,0,186785929,41175251,0,100,
700,700,0,0,0,0,2025-04-17,2025-04-25,525.66,0,0,186785929,41175251,0,100,
538.29,571,791,0,2454473,0,2025-04-17,2025-05-02,525.66,-791,-2454473,204772860,42617637,0,100,-Inf
537.62,572.5,117,0,432315,0,2025-04-17,2025-05-02,525.66,-117,-432315,204772860,42617637,0,100,-Inf
522.85,576,768,0,2955264,0,2025-04-17,2025-05-02,525.66,-768,-2955264,204772860,42617637,0,100,-Inf
522.38,577,685,0,2374895,0,2025-04-17,2025-05-02,525.66,-685,-2374895,204772860,42617637,0,100,-Inf
525.36,579,142,0,506088,0,2025-04-17,2025-05-02,525.66,-142,-506088,204772860,42617637,0,100,-Inf
525.5,581,14,0,52654,0,2025-04-17,2025-05-02,525.66,-14,-52654,204772860,42617637,0,100,-Inf
525.48,582,53,0,471329,0,2025-04-17,2025-05-02,525.66,-53,-471329,204772860,42617637,0,100,-Inf
538.45,582.5,85,0,822375,0,2025-04-17,2025-05-02,525.66,-85,-822375,204772860,42617637,0,100,-Inf
534.33,583,4,0,19468,0,2025-04-17,2025-05-02,525.66,-4,-19468,204772860,42617637,0,100,-Inf
541.5,585,15,0,75885,0,2025-04-17,2025-05-02,525.66,-15,-75885,204772860,42617637,0,100,-Inf
525.11,590,0,0,0,0,2025-04-17,2025-05-02,525.66,0,0,204772860,42617637,0,100,
530.12,595,0,0,0,0,2025-04-17,2025-05-02,525.66,0,0,204772860,42617637,0,100,
538.06,605,0,0,0,0,2025-04-17,2025-05-02,525.66,0,0,204772860,42617637,0,100,
525.29,615,0,0,0,0,2025-04-17,2025-05-02,525.66,0,0,204772860,42617637,0,100,
527.11,620,0,0,0,0,2025-04-17,2025-05-02,525.66,0,0,204772860,42617637,0,100,
542.55,625,0,0,0,0,2025-04-17,2025-05-02,525.66,0,0,204772860,42617637,0,100,
560.31,630,0,0,0,0,2025-04-17,2025-05-02,525.66,0,0,204772860,42617637,0,100,
560.33,635,0,0,0,0,2025-04-17,2025-05-02,525.66,0,0,204772860,42617637,0,100,
640,640,0,0,0,0,2025-04-17,2025-05-02,525.66,0,0,204772860,42617637,0,100,
645,645,0,0,0,0,2025-04-17,2025-05-02,525.66,0,0,204772860,42617637,0,100,
650,650,0,0,0,0,2025-04-17,2025-05-02,525.66,0,0,204772860,42617637,0,100,
541.28,577,13,0,46436,0,2025-04-17,2025-05-09,525.66,-13,-46436,114289278,33592363,0,100,-Inf
541.83,577.5,5,0,17835,0,2025-04-17,2025-05-09,525.66,-5,-17835,114289278,33592363,0,100,-Inf
540.72,578,9,0,33552,0,2025-04-17,2025-05-09,525.66,-9,-33552,114289278,33592363,0,100,-Inf
532.28,579,20,0,80740,0,2025-04-17,2025-05-09,525.66,-20,-80740,114289278,33592363,0,100,-Inf
523.18,581,8,0,33832,0,2025-04-17,2025-05-09,525.66,-8,-33832,114289278,33592363,0,100,-Inf
538.22,582,0,0,0,0,2025-04-17,2025-05-09,525.66,0,0,114289278,33592363,0,100,
524.14,582.5,9,0,47115,0,2025-04-17,2025-05-09,525.66,-9,-47115,114289278,33592363,0,100,-Inf
537.95,583,5,0,19955,0,2025-04-17,2025-05-09,525.66,-5,-19955,114289278,33592363,0,100,-Inf
538.33,585,46,0,219098,0,2025-04-17,2025-05-09,525.66,-46,-219098,114289278,33592363,0,100,-Inf
542.13,590,1,0,4847,0,2025-04-17,2025-05-09,525.66,-1,-4847,114289278,33592363,0,100,-Inf
541.81,595,0,0,0,0,2025-04-17,2025-05-09,525.66,0,0,114289278,33592363,0,100,
558.64,600,0,0,0,0,2025-04-17,2025-05-09,525.66,0,0,114289278,33592363,0,100,
605,605,0,0,0,0,2025-04-17,2025-05-09,525.66,0,0,114289278,33592363,0,100,
560.43,610,0,0,0,0,2025-04-17,2025-05-09,525.66,0,0,114289278,33592363,0,100,
615,615,0,0,0,0,2025-04-17,2025-05-09,525.66,0,0,114289278,33592363,0,100,
620,620,0,0,0,0,2025-04-17,2025-05-09,525.66,0,0,114289278,33592363,0,100,
560.06,625,0,0,0,0,2025-04-17,2025-05-09,525.66,0,0,114289278,33592363,0,100,
630,630,0,0,0,0,2025-04-17,2025-05-09,525.66,0,0,114289278,33592363,0,100,
635,635,0,0,0,0,2025-04-17,2025-05-09,525.66,0,0,114289278,33592363,0,100,
530,640,0,0,0,0,2025-04-17,2025-05-09,525.66,0,0,114289278,33592363,0,100,
552.82,645,0,0,0,0,2025-04-17,2025-05-09,525.66,0,0,114289278,33592363,0,100,
537.74,650,0,0,0,0,2025-04-17,2025-05-09,525.66,0,0,114289278,33592363,0,100,
538.46,586,119,0,474929,0,2025-04-17,2025-05-16,525.66,-119,-474929,2098065603,598425916,0,100,-Inf
525.36,594,0,0,0,0,2025-04-17,2025-05-16,525.66,0,0,2098065603,598425916,0,100,
524.9,597,0,0,0,0,2025-04-17,2025-05-16,525.66,0,0,2098065603,598425916,0,100,
524.88,599,0,0,0,0,2025-04-17,2025-05-16,525.66,0,0,2098065603,598425916,0,100,
525.48,603,0,0,0,0,2025-04-17,2025-05-16,525.66,0,0,2098065603,598425916,0,100,
508.58,606,0,0,0,0,2025-04-17,2025-05-16,525.66,0,0,2098065603,598425916,0,100,
537.75,607,0,0,0,0,2025-04-17,2025-05-16,525.66,0,0,2098065603,598425916,0,100,
512.29,608,0,0,0,0,2025-04-17,2025-05-16,525.66,0,0,2098065603,598425916,0,100,
513.87,609,0,0,0,0,2025-04-17,2025-05-16,525.66,0,0,2098065603,598425916,0,100,
525.38,612,0,0,0,0,2025-04-17,2025-05-16,525.66,0,0,2098065603,598425916,0,100,
563.89,613,0,0,0,0,2025-04-17,2025-05-16,525.66,0,0,2098065603,598425916,0,100,
527.08,614,0,0,0,0,2025-04-17,2025-05-16,525.66,0,0,2098065603,598425916,0,100,
525.61,616,0,0,0,0,2025-04-17,2025-05-16,525.66,0,0,2098065603,598425916,0,100,
525.61,617,1,0,7886,0,2025-04-17,2025-05-16,525.66,-1,-7886,2098065603,598425916,0,100,-Inf
525.59,618,0,0,0,0,2025-04-17,2025-05-16,525.66,0,0,2098065603,598425916,0,100,
537.66,619,0,0,0,0,2025-04-17,2025-05-16,525.66,0,0,2098065603,598425916,0,100,
525.64,621,0,0,0,0,2025-04-17,2025-05-16,525.66,0,0,2098065603,598425916,0,100,
580.47,622,0,0,0,0,2025-04-17,2025-05-16,525.66,0,0,2098065603,598425916,0,100,
524.48,623,0,0,0,0,2025-04-17,2025-05-16,525.66,0,0,2098065603,598425916,0,100,
574.74,624,0,0,0,0,2025-04-17,2025-05-16,525.66,0,0,2098065603,598425916,0,100,
525.39,626,0,0,0,0,2025-04-17,2025-05-16,525.66,0,0,2098065603,598425916,0,100,
537.34,627,0,0,0,0,2025-04-17,2025-05-16,525.66,0,0,2098065603,598425916,0,100,
516.66,628,0,0,0,0,2025-04-17,2025-05-16,525.66,0,0,2098065603,598425916,0,100,
597.78,629,0,0,0,0,2025-04-17,2025-05-16,525.66,0,0,2098065603,598425916,0,100,
567.6,630,0,0,0,0,2025-04-17,2025-05-16,525.66,0,0,2098065603,598425916,0,100,
567.58,631,0,0,0,0,2025-04-17,2025-05-16,525.66,0,0,2098065603,598425916,0,100,
500.15,632,0,0,0,0,2025-04-17,2025-05-16,525.66,0,0,2098065603,598425916,0,100,
526.73,633,0,0,0,0,2025-04-17,2025-05-16,525.66,0,0,2098065603,598425916,0,100,
521.53,634,0,0,0,0,2025-04-17,2025-05-16,525.66,0,0,2098065603,598425916,0,100,
560.27,635,0,0,0,0,2025-04-17,2025-05-16,525.66,0,0,2098065603,598425916,0,100,
636,636,0,0,0,0,2025-04-17,2025-05-16,525.66,0,0,2098065603,598425916,0,100,
637,637,0,0,0,0,2025-04-17,2025-05-16,525.66,0,0,2098065603,598425916,0,100,
638,638,0,0,0,0,2025-04-17,2025-05-16,525.66,0,0,2098065603,598425916,0,100,
564.17,639,0,0,0,0,2025-04-17,2025-05-16,525.66,0,0,2098065603,598425916,0,100,
573.75,640,0,0,0,0,2025-04-17,2025-05-16,525.66,0,0,2098065603,598425916,0,100,
573.01,645,0,0,0,0,2025-04-17,2025-05-16,525.66,0,0,2098065603,598425916,0,100,
525.43,655,0,0,0,0,2025-04-17,2025-05-16,525.66,0,0,2098065603,598425916,0,100,
519.69,660,0,0,0,0,2025-04-17,2025-05-16,525.66,0,0,2098065603,598425916,0,100,
665,665,0,0,0,0,2025-04-17,2025-05-16,525.66,0,0,2098065603,598425916,0,100,
610.41,670,0,0,0,0,2025-04-17,2025-05-16,525.66,0,0,2098065603,598425916,0,100,
525.78,680,0,0,0,0,2025-04-17,2025-05-16,525.66,0,0,2098065603,598425916,0,100,
525.76,685,0,0,0,0,2025-04-17,2025-05-16,525.66,0,0,2098065603,598425916,0,100,
593.46,690,0,0,0,0,2025-04-17,2025-05-16,525.66,0,0,2098065603,598425916,0,100,
695,695,0,0,0,0,2025-04-17,2025-05-16,525.66,0,0,2098065603,598425916,0,100,
521.65,700,0,0,0,0,2025-04-17,2025-05-16,525.66,0,0,2098065603,598425916,0,100,
502.42,705,0,0,0,0,2025-04-17,2025-05-16,525.66,0,0,2098065603,598425916,0,100,
521.65,710,0,0,0,0,2025-04-17,2025-05-16,525.66,0,0,2098065603,598425916,0,100,
715,715,0,0,0,0,2025-04-17,2025-05-16,525.66,0,0,2098065603,598425916,0,100,
720,720,0,0,0,0,2025-04-17,2025-05-16,525.66,0,0,2098065603,598425916,0,100,
725,725,0,0,0,0,2025-04-17,2025-05-16,525.66,0,0,2098065603,598425916,0,100,
730,730,0,0,0,0,2025-04-17,2025-05-16,525.66,0,0,2098065603,598425916,0,100,
735,735,0,0,0,0,2025-04-17,2025-05-16,525.66,0,0,2098065603,598425916,0,100,
610.03,740,0,0,0,0,2025-04-17,2025-05-16,525.66,0,0,2098065603,598425916,0,100,
610.01,745,0,0,0,0,2025-04-17,2025-05-16,525.66,0,0,2098065603,598425916,0,100,
750,750,0,0,0,0,2025-04-17,2025-05-16,525.66,0,0,2098065603,598425916,0,100,
755,755,0,0,0,0,2025-04-17,2025-05-16,525.66,0,0,2098065603,598425916,0,100,
760,760,0,0,0,0,2025-04-17,2025-05-16,525.66,0,0,2098065603,598425916,0,100,
765,765,0,0,0,0,2025-04-17,2025-05-16,525.66,0,0,2098065603,598425916,0,100,
770,770,0,0,0,0,2025-04-17,2025-05-16,525.66,0,0,2098065603,598425916,0,100,
775,775,0,0,0,0,2025-04-17,2025-05-16,525.66,0,0,2098065603,598425916,0,100,
780,780,0,0,0,0,2025-04-17,2025-05-16,525.66,0,0,2098065603,598425916,0,100,
785,785,0,0,0,0,2025-04-17,2025-05-16,525.66,0,0,2098065603,598425916,0,100,
790,790,0,0,0,0,2025-04-17,2025-05-16,525.66,0,0,2098065603,598425916,0,100,
795,795,0,0,0,0,2025-04-17,2025-05-16,525.66,0,0,2098065603,598425916,0,100,
800,800,0,0,0,0,2025-04-17,2025-05-16,525.66,0,0,2098065603,598425916,0,100,
557,557,0,0,0,0,2025-04-17,2025-05-23,525.66,0,0,27519740,10743122,0,100,
557.5,557.5,0,0,0,0,2025-04-17,2025-05-23,525.66,0,0,27519740,10743122,0,100,
561,561,0,0,0,0,2025-04-17,2025-05-23,525.66,0,0,27519740,10743122,0,100,
567.5,567.5,0,0,0,0,2025-04-17,2025-05-23,525.66,0,0,27519740,10743122,0,100,
530.83,585,15,0,76905,0,2025-04-17,2025-05-23,525.66,-15,-76905,27519740,10743122,0,100,-Inf
540.49,590,0,0,0,0,2025-04-17,2025-05-23,525.66,0,0,27519740,10743122,0,100,
540.65,600,0,0,0,0,2025-04-17,2025-05-23,525.66,0,0,27519740,10743122,0,100,
531.94,605,0,0,0,0,2025-04-17,2025-05-23,525.66,0,0,27519740,10743122,0,100,
610,610,0,0,0,0,2025-04-17,2025-05-23,525.66,0,0,27519740,10743122,0,100,
502.83,615,0,0,0,0,2025-04-17,2025-05-23,525.66,0,0,27519740,10743122,0,100,
541.02,620,0,0,0,0,2025-04-17,2025-05-23,525.66,0,0,27519740,10743122,0,100,
625,625,0,0,0,0,2025-04-17,2025-05-23,525.66,0,0,27519740,10743122,0,100,
630,630,0,0,0,0,2025-04-17,2025-05-23,525.66,0,0,27519740,10743122,0,100,
635,635,0,0,0,0,2025-04-17,2025-05-23,525.66,0,0,27519740,10743122,0,100,
640,640,0,0,0,0,2025-04-17,2025-05-23,525.66,0,0,27519740,10743122,0,100,
645,645,0,0,0,0,2025-04-17,2025-05-23,525.66,0,0,27519740,10743122,0,100,
534.06,650,0,0,0,0,2025-04-17,2025-05-23,525.66,0,0,27519740,10743122,0,100,
523.99,589,0,0,0,0,2025-04-17,2025-05-30,525.66,0,0,542920959,126942613,0,100,
494.29,591,24,0,232104,0,2025-04-17,2025-05-30,525.66,-24,-232104,542920959,126942613,0,100,-Inf
535.66,592,3,0,16902,0,2025-04-17,2025-05-30,525.66,-3,-16902,542920959,126942613,0,100,-Inf
525.28,594,29,0,162690,0,2025-04-17,2025-05-30,525.66,-29,-162690,542920959,126942613,0,100,-Inf
523.11,595,0,0,0,0,2025-04-17,2025-05-30,525.66,0,0,542920959,126942613,0,100,
541.42,596,0,0,0,0,2025-04-17,2025-05-30,525.66,0,0,542920959,126942613,0,100,
526,601,0,0,0,0,2025-04-17,2025-05-30,525.66,0,0,542920959,126942613,0,100,
525.39,604,0,0,0,0,2025-04-17,2025-05-30,525.66,0,0,542920959,126942613,0,100,
525.38,606,0,0,0,0,2025-04-17,2025-05-30,525.66,0,0,542920959,126942613,0,100,
513,611,0,0,0,0,2025-04-17,2025-05-30,525.66,0,0,542920959,126942613,0,100,
537.31,612,0,0,0,0,2025-04-17,2025-05-30,525.66,0,0,542920959,126942613,0,100,
574.57,613,0,0,0,0,2025-04-17,2025-05-30,525.66,0,0,542920959,126942613,0,100,
570.5,614,0,0,0,0,2025-04-17,2025-05-30,525.66,0,0,542920959,126942613,0,100,
569.6,615,0,0,0,0,2025-04-17,2025-05-30,525.66,0,0,542920959,126942613,0,100,
499,616,0,0,0,0,2025-04-17,2025-05-30,525.66,0,0,542920959,126942613,0,100,
563.75,617,0,0,0,0,2025-04-17,2025-05-30,525.66,0,0,542920959,126942613,0,100,
563.76,618,0,0,0,0,2025-04-17,2025-05-30,525.66,0,0,542920959,126942613,0,100,
568.24,619,0,0,0,0,2025-04-17,2025-05-30,525.66,0,0,542920959,126942613,0,100,
529.22,620,0,0,0,0,2025-04-17,2025-05-30,525.66,0,0,542920959,126942613,0,100,
542.15,621,1,0,8083,0,2025-04-17,2025-05-30,525.66,-1,-8083,542920959,126942613,0,100,-Inf
599.58,622,0,0,0,0,2025-04-17,2025-05-30,525.66,0,0,542920959,126942613,0,100,
508.88,623,0,0,0,0,2025-04-17,2025-05-30,525.66,0,0,542920959,126942613,0,100,
567.64,624,0,0,0,0,2025-04-17,2025-05-30,525.66,0,0,542920959,126942613,0,100,
627,627,0,0,0,0,2025-04-17,2025-05-30,525.66,0,0,542920959,126942613,0,100,
628,628,0,0,0,0,2025-04-17,2025-05-30,525.66,0,0,542920959,126942613,0,100,
629,629,0,0,0,0,2025-04-17,2025-05-30,525.66,0,0,542920959,126942613,0,100,
570.69,630,0,0,0,0,2025-04-17,2025-05-30,525.66,0,0,542920959,126942613,0,100,
540.72,631,0,0,0,0,2025-04-17,2025-05-30,525.66,0,0,542920959,126942613,0,100,
498.84,632,0,0,0,0,2025-04-17,2025-05-30,525.66,0,0,542920959,126942613,0,100,
633,633,0,0,0,0,2025-04-17,2025-05-30,525.66,0,0,542920959,126942613,0,100,
634,634,0,0,0,0,2025-04-17,2025-05-30,525.66,0,0,542920959,126942613,0,100,
570.62,635,0,0,0,0,2025-04-17,2025-05-30,525.66,0,0,542920959,126942613,0,100,
523.41,640,0,0,0,0,2025-04-17,2025-05-30,525.66,0,0,542920959,126942613,0,100,
501.16,645,0,0,0,0,2025-04-17,2025-05-30,525.66,0,0,542920959,126942613,0,100,
539.56,650,0,0,0,0,2025-04-17,2025-05-30,525.66,0,0,542920959,126942613,0,100,
501.17,655,0,0,0,0,2025-04-17,2025-05-30,525.66,0,0,542920959,126942613,0,100,
500.66,660,0,0,0,0,2025-04-17,2025-05-30,525.66,0,0,542920959,126942613,0,100,
665,665,0,0,0,0,2025-04-17,2025-05-30,525.66,0,0,542920959,126942613,0,100,
525.83,670,1,0,13011,0,2025-04-17,2025-05-30,525.66,-1,-13011,542920959,126942613,0,100,-Inf
525.84,675,0,0,0,0,2025-04-17,2025-05-30,525.66,0,0,542920959,126942613,0,100,
607.45,680,0,0,0,0,2025-04-17,2025-05-30,525.66,0,0,542920959,126942613,0,100,
685,685,0,0,0,0,2025-04-17,2025-05-30,525.66,0,0,542920959,126942613,0,100,
690,690,0,0,0,0,2025-04-17,2025-05-30,525.66,0,0,542920959,126942613,0,100,
593.54,695,0,0,0,0,2025-04-17,2025-05-30,525.66,0,0,542920959,126942613,0,100,
534.27,700,0,0,0,0,2025-04-17,2025-05-30,525.66,0,0,542920959,126942613,0,100,
705,705,0,0,0,0,2025-04-17,2025-05-30,525.66,0,0,542920959,126942613,0,100,
710,710,0,0,0,0,2025-04-17,2025-05-30,525.66,0,0,542920959,126942613,0,100,
521.53,715,0,0,0,0,2025-04-17,2025-05-30,525.66,0,0,542920959,126942613,0,100,
602,720,0,0,0,0,2025-04-17,2025-05-30,525.66,0,0,542920959,126942613,0,100,
531.7,630,0,0,0,0,2025-04-17,2025-06-20,525.66,0,0,2210385665,443310327,0,100,
524.34,635,0,0,0,0,2025-04-17,2025-06-20,525.66,0,0,2210385665,443310327,0,100,
525.47,645,0,0,0,0,2025-04-17,2025-06-20,525.66,0,0,2210385665,443310327,0,100,
540,650,0,0,0,0,2025-04-17,2025-06-20,525.66,0,0,2210385665,443310327,0,100,
512.41,655,0,0,0,0,2025-04-17,2025-06-20,525.66,0,0,2210385665,443310327,0,100,
574.7,660,0,0,0,0,2025-04-17,2025-06-20,525.66,0,0,2210385665,443310327,0,100,
574.68,665,0,0,0,0,2025-04-17,2025-06-20,525.66,0,0,2210385665,443310327,0,100,
598.01,670,0,0,0,0,2025-04-17,2025-06-20,525.66,0,0,2210385665,443310327,0,100,
593.4,675,0,0,0,0,2025-04-17,2025-06-20,525.66,0,0,2210385665,443310327,0,100,
564.32,680,0,0,0,0,2025-04-17,2025-06-20,525.66,0,0,2210385665,443310327,0,100,
501,685,0,0,0,0,2025-04-17,2025-06-20,525.66,0,0,2210385665,443310327,0,100,
577,690,0,0,0,0,2025-04-17,2025-06-20,525.66,0,0,2210385665,443310327,0,100,
503.51,695,0,0,0,0,2025-04-17,2025-06-20,525.66,0,0,2210385665,443310327,0,100,
510,700,0,0,0,0,2025-04-17,2025-06-20,525.66,0,0,2210385665,443310327,0,100,
564.85,705,0,0,0,0,2025-04-17,2025-06-20,525.66,0,0,2210385665,443310327,0,100,
506.98,710,0,0,0,0,2025-04-17,2025-06-20,525.66,0,0,2210385665,443310327,0,100,
715,715,0,0,0,0,2025-04-17,2025-06-20,525.66,0,0,2210385665,443310327,0,100,
720,720,0,0,0,0,2025-04-17,2025-06-20,525.66,0,0,2210385665,443310327,0,100,
725,725,0,0,0,0,2025-04-17,2025-06-20,525.66,0,0,2210385665,443310327,0,100,
730,730,0,0,0,0,2025-04-17,2025-06-20,525.66,0,0,2210385665,443310327,0,100,
735,735,0,0,0,0,2025-04-17,2025-06-20,525.66,0,0,2210385665,443310327,0,100,
505.32,740,0,0,0,0,2025-04-17,2025-06-20,525.66,0,0,2210385665,443310327,0,100,
745,745,0,0,0,0,2025-04-17,2025-06-20,525.66,0,0,2210385665,443310327,0,100,
604.99,750,0,0,0,0,2025-04-17,2025-06-20,525.66,0,0,2210385665,443310327,0,100,
604.97,755,0,0,0,0,2025-04-17,2025-06-20,525.66,0,0,2210385665,443310327,0,100,
760,760,0,0,0,0,2025-04-17,2025-06-20,525.66,0,0,2210385665,443310327,0,100,
497.76,765,0,0,0,0,2025-04-17,2025-06-20,525.66,0,0,2210385665,443310327,0,100,
770,770,0,0,0,0,2025-04-17,2025-06-20,525.66,0,0,2210385665,443310327,0,100,
537.22,775,0,0,0,0,2025-04-17,2025-06-20,525.66,0,0,2210385665,443310327,0,100,
537.22,780,0,0,0,0,2025-04-17,2025-06-20,525.66,0,0,2210385665,443310327,0,100,
785,785,0,0,0,0,2025-04-17,2025-06-20,525.66,0,0,2210385665,443310327,0,100,
790,790,0,0,0,0,2025-04-17,2025-06-20,525.66,0,0,2210385665,443310327,0,100,
795,795,0,0,0,0,2025-04-17,2025-06-20,525.66,0,0,2210385665,443310327,0,100,
574.7,800,0,0,0,0,2025-04-17,2025-06-20,525.66,0,0,2210385665,443310327,0,100,
805,805,0,0,0,0,2025-04-17,2025-06-20,525.66,0,0,2210385665,443310327,0,100,
810,810,0,0,0,0,2025-04-17,2025-06-20,525.66,0,0,2210385665,443310327,0,100,
815,815,0,0,0,0,2025-04-17,2025-06-20,525.66,0,0,2210385665,443310327,0,100,
537.22,820,0,0,0,0,2025-04-17,2025-06-20,525.66,0,0,2210385665,443310327,0,100,
500.76,825,0,0,0,0,2025-04-17,2025-06-20,525.66,0,0,2210385665,443310327,0,100,
535.22,830,0,0,0,0,2025-04-17,2025-06-20,525.66,0,0,2210385665,443310327,0,100,
527.25,655,0,0,0,0,2025-04-17,2025-07-18,525.66,0,0,781158455,167554530,0,100,
572.82,660,0,0,0,0,2025-04-17,2025-07-18,525.66,0,0,781158455,167554530,0,100,
609.47,665,0,0,0,0,2025-04-17,2025-07-18,525.66,0,0,781158455,167554530,0,100,
609.28,670,0,0,0,0,2025-04-17,2025-07-18,525.66,0,0,781158455,167554530,0,100,
675,675,0,0,0,0,2025-04-17,2025-07-18,525.66,0,0,781158455,167554530,0,100,
559.85,680,0,0,0,0,2025-04-17,2025-07-18,525.66,0,0,781158455,167554530,0,100,
685,685,0,0,0,0,2025-04-17,2025-07-18,525.66,0,0,781158455,167554530,0,100,
690,690,0,0,0,0,2025-04-17,2025-07-18,525.66,0,0,781158455,167554530,0,100,
695,695,0,0,0,0,2025-04-17,2025-07-18,525.66,0,0,781158455,167554530,0,100,
700,700,0,0,0,0,2025-04-17,2025-07-18,525.66,0,0,781158455,167554530,0,100,
705,705,0,0,0,0,2025-04-17,2025-07-18,525.66,0,0,781158455,167554530,0,100,
710,710,0,0,0,0,2025-04-17,2025-07-18,525.66,0,0,781158455,167554530,0,100,
715,715,0,0,0,0,2025-04-17,2025-07-18,525.66,0,0,781158455,167554530,0,100,
720,720,0,0,0,0,2025-04-17,2025-07-18,525.66,0,0,781158455,167554530,0,100,
725,725,0,0,0,0,2025-04-17,2025-07-18,525.66,0,0,781158455,167554530,0,100,
730,730,0,0,0,0,2025-04-17,2025-07-18,525.66,0,0,781158455,167554530,0,100,
735,735,0,0,0,0,2025-04-17,2025-07-18,525.66,0,0,781158455,167554530,0,100,
740,740,0,0,0,0,2025-04-17,2025-07-18,525.66,0,0,781158455,167554530,0,100,
745,745,0,0,0,0,2025-04-17,2025-07-18,525.66,0,0,781158455,167554530,0,100,
750,750,0,0,0,0,2025-04-17,2025-07-18,525.66,0,0,781158455,167554530,0,100,
755,755,0,0,0,0,2025-04-17,2025-07-18,525.66,0,0,781158455,167554530,0,100,
568.76,760,0,0,0,0,2025-04-17,2025-07-18,525.66,0,0,781158455,167554530,0,100,
765,765,0,0,0,0,2025-04-17,2025-07-18,525.66,0,0,781158455,167554530,0,100,
770,770,0,0,0,0,2025-04-17,2025-07-18,525.66,0,0,781158455,167554530,0,100,
775,775,0,0,0,0,2025-04-17,2025-07-18,525.66,0,0,781158455,167554530,0,100,
780,780,0,0,0,0,2025-04-17,2025-07-18,525.66,0,0,781158455,167554530,0,100,
785,785,0,0,0,0,2025-04-17,2025-07-18,525.66,0,0,781158455,167554530,0,100,
790,790,0,0,0,0,2025-04-17,2025-07-18,525.66,0,0,781158455,167554530,0,100,
795,795,0,0,0,0,2025-04-17,2025-07-18,525.66,0,0,781158455,167554530,0,100,
606.54,800,0,0,0,0,2025-04-17,2025-07-18,525.66,0,0,781158455,167554530,0,100,
543,655,0,0,0,0,2025-04-17,2025-08-15,525.66,0,0,650394247,116470886,0,100,
538.17,660,0,0,0,0,2025-04-17,2025-08-15,525.66,0,0,650394247,116470886,0,100,
601.64,665,0,0,0,0,2025-04-17,2025-08-15,525.66,0,0,650394247,116470886,0,100,
675,675,0,0,0,0,2025-04-17,2025-08-15,525.66,0,0,650394247,116470886,0,100,
680,680,0,0,0,0,2025-04-17,2025-08-15,525.66,0,0,650394247,116470886,0,100,
685,685,0,0,0,0,2025-04-17,2025-08-15,525.66,0,0,650394247,116470886,0,100,
690,690,0,0,0,0,2025-04-17,2025-08-15,525.66,0,0,650394247,116470886,0,100,
695,695,0,0,0,0,2025-04-17,2025-08-15,525.66,0,0,650394247,116470886,0,100,
550.87,700,0,0,0,0,2025-04-17,2025-08-15,525.66,0,0,650394247,116470886,0,100,
705,705,0,0,0,0,2025-04-17,2025-08-15,525.66,0,0,650394247,116470886,0,100,
710,710,0,0,0,0,2025-04-17,2025-08-15,525.66,0,0,650394247,116470886,0,100,
715,715,0,0,0,0,2025-04-17,2025-08-15,525.66,0,0,650394247,116470886,0,100,
720,720,0,0,0,0,2025-04-17,2025-08-15,525.66,0,0,650394247,116470886,0,100,
725,725,0,0,0,0,2025-04-17,2025-08-15,525.66,0,0,650394247,116470886,0,100,
730,730,0,0,0,0,2025-04-17,2025-08-15,525.66,0,0,650394247,116470886,0,100,
586.99,735,0,0,0,0,2025-04-17,2025-08-15,525.66,0,0,650394247,116470886,0,100,
740,740,0,0,0,0,2025-04-17,2025-08-15,525.66,0,0,650394247,116470886,0,100,
745,745,0,0,0,0,2025-04-17,2025-08-15,525.66,0,0,650394247,116470886,0,100,
750,750,0,0,0,0,2025-04-17,2025-08-15,525.66,0,0,650394247,116470886,0,100,
755,755,0,0,0,0,2025-04-17,2025-08-15,525.66,0,0,650394247,116470886,0,100,
760,760,0,0,0,0,2025-04-17,2025-08-15,525.66,0,0,650394247,116470886,0,100,
765,765,0,0,0,0,2025-04-17,2025-08-15,525.66,0,0,650394247,116470886,0,100,
770,770,0,0,0,0,2025-04-17,2025-08-15,525.66,0,0,650394247,116470886,0,100,
775,775,0,0,0,0,2025-04-17,2025-08-15,525.66,0,0,650394247,116470886,0,100,
780,780,0,0,0,0,2025-04-17,2025-08-15,525.66,0,0,650394247,116470886,0,100,
785,785,0,0,0,0,2025-04-17,2025-08-15,525.66,0,0,650394247,116470886,0,100,
602.96,790,0,0,0,0,2025-04-17,2025-08-15,525.66,0,0,650394247,116470886,0,100,
604.5,795,0,0,0,0,2025-04-17,2025-08-15,525.66,0,0,650394247,116470886,0,100,
553.08,800,0,0,0,0,2025-04-17,2025-08-15,525.66,0,0,650394247,116470886,0,100,
805,805,0,0,0,0,2025-04-17,2025-08-15,525.66,0,0,650394247,116470886,0,100,
810,810,0,0,0,0,2025-04-17,2025-08-15,525.66,0,0,650394247,116470886,0,100,
815,815,0,0,0,0,2025-04-17,2025-08-15,525.66,0,0,650394247,116470886,0,100,
820,820,0,0,0,0,2025-04-17,2025-08-15,525.66,0,0,650394247,116470886,0,100,
825,825,0,0,0,0,2025-04-17,2025-08-15,525.66,0,0,650394247,116470886,0,100,
830,830,0,0,0,0,2025-04-17,2025-08-15,525.66,0,0,650394247,116470886,0,100,
500.81,655,0,0,0,0,2025-04-17,2025-09-19,525.66,0,0,1699576882,316242446,0,100,
538.01,675,0,0,0,0,2025-04-17,2025-09-19,525.66,0,0,1699576882,316242446,0,100,
680,680,0,0,0,0,2025-04-17,2025-09-19,525.66,0,0,1699576882,316242446,0,100,
685,685,0,0,0,0,2025-04-17,2025-09-19,525.66,0,0,1699576882,316242446,0,100,
603.98,690,0,0,0,0,2025-04-17,2025-09-19,525.66,0,0,1699576882,316242446,0,100,
695,695,0,0,0,0,2025-04-17,2025-09-19,525.66,0,0,1699576882,316242446,0,100,
608.28,700,0,0,0,0,2025-04-17,2025-09-19,525.66,0,0,1699576882,316242446,0,100,
705,705,0,0,0,0,2025-04-17,2025-09-19,525.66,0,0,1699576882,316242446,0,100,
710,710,0,0,0,0,2025-04-17,2025-09-19,525.66,0,0,1699576882,316242446,0,100,
715,715,0,0,0,0,2025-04-17,2025-09-19,525.66,0,0,1699576882,316242446,0,100,
720,720,0,0,0,0,2025-04-17,2025-09-19,525.66,0,0,1699576882,316242446,0,100,
553.12,725,0,0,0,0,2025-04-17,2025-09-19,525.66,0,0,1699576882,316242446,0,100,
553.1,730,0,0,0,0,2025-04-17,2025-09-19,525.66,0,0,1699576882,316242446,0,100,
611,735,0,0,0,0,2025-04-17,2025-09-19,525.66,0,0,1699576882,316242446,0,100,
740,740,0,0,0,0,2025-04-17,2025-09-19,525.66,0,0,1699576882,316242446,0,100,
745,745,0,0,0,0,2025-04-17,2025-09-19,525.66,0,0,1699576882,316242446,0,100,
750,750,0,0,0,0,2025-04-17,2025-09-19,525.66,0,0,1699576882,316242446,0,100,
755,755,0,0,0,0,2025-04-17,2025-09-19,525.66,0,0,1699576882,316242446,0,100,
760,760,0,0,0,0,2025-04-17,2025-09-19,525.66,0,0,1699576882,316242446,0,100,
765,765,0,0,0,0,2025-04-17,2025-09-19,525.66,0,0,1699576882,316242446,0,100,
770,770,0,0,0,0,2025-04-17,2025-09-19,525.66,0,0,1699576882,316242446,0,100,
775,775,0,0,0,0,2025-04-17,2025-09-19,525.66,0,0,1699576882,316242446,0,100,
780,780,0,0,0,0,2025-04-17,2025-09-19,525.66,0,0,1699576882,316242446,0,100,
785,785,0,0,0,0,2025-04-17,2025-09-19,525.66,0,0,1699576882,316242446,0,100,
790,790,0,0,0,0,2025-04-17,2025-09-19,525.66,0,0,1699576882,316242446,0,100,
795,795,0,0,0,0,2025-04-17,2025-09-19,525.66,0,0,1699576882,316242446,0,100,
597.26,800,0,0,0,0,2025-04-17,2025-09-19,525.66,0,0,1699576882,316242446,0,100,
805,805,0,0,0,0,2025-04-17,2025-09-19,525.66,0,0,1699576882,316242446,0,100,
810,810,0,0,0,0,2025-04-17,2025-09-19,525.66,0,0,1699576882,316242446,0,100,
815,815,0,0,0,0,2025-04-17,2025-09-19,525.66,0,0,1699576882,316242446,0,100,
820,820,0,0,0,0,2025-04-17,2025-09-19,525.66,0,0,1699576882,316242446,0,100,
825,825,0,0,0,0,2025-04-17,2025-09-19,525.66,0,0,1699576882,316242446,0,100,
570.97,830,0,0,0,0,2025-04-17,2025-09-19,525.66,0,0,1699576882,316242446,0,100,
561.11,655,0,0,0,0,2025-04-17,2025-12-19,525.66,0,0,1076181448,187344700,0,100,
487.34,660,0,0,0,0,2025-04-17,2025-12-19,525.66,0,0,1076181448,187344700,0,100,
565.77,665,0,0,0,0,2025-04-17,2025-12-19,525.66,0,0,1076181448,187344700,0,100,
502.51,670,0,0,0,0,2025-04-17,2025-12-19,525.66,0,0,1076181448,187344700,0,100,
605,675,0,0,0,0,2025-04-17,2025-12-19,525.66,0,0,1076181448,187344700,0,100,
603.25,680,0,0,0,0,2025-04-17,2025-12-19,525.66,0,0,1076181448,187344700,0,100,
587.15,685,0,0,0,0,2025-04-17,2025-12-19,525.66,0,0,1076181448,187344700,0,100,
609.11,690,0,0,0,0,2025-04-17,2025-12-19,525.66,0,0,1076181448,187344700,0,100,
591.04,695,0,0,0,0,2025-04-17,2025-12-19,525.66,0,0,1076181448,187344700,0,100,
518.75,700,0,0,0,0,2025-04-17,2025-12-19,525.66,0,0,1076181448,187344700,0,100,
537.36,705,0,0,0,0,2025-04-17,2025-12-19,525.66,0,0,1076181448,187344700,0,100,
601.65,710,0,0,0,0,2025-04-17,2025-12-19,525.66,0,0,1076181448,187344700,0,100,
715,715,0,0,0,0,2025-04-17,2025-12-19,525.66,0,0,1076181448,187344700,0,100,
720,720,0,0,0,0,2025-04-17,2025-12-19,525.66,0,0,1076181448,187344700,0,100,
557,725,0,0,0,0,2025-04-17,2025-12-19,525.66,0,0,1076181448,187344700,0,100,
730,730,0,0,0,0,2025-04-17,2025-12-19,525.66,0,0,1076181448,187344700,0,100,
735,735,0,0,0,0,2025-04-17,2025-12-19,525.66,0,0,1076181448,187344700,0,100,
557.52,740,0,0,0,0,2025-04-17,2025-12-19,525.66,0,0,1076181448,187344700,0,100,
745,745,0,0,0,0,2025-04-17,2025-12-19,525.66,0,0,1076181448,187344700,0,100,
568,750,0,0,0,0,2025-04-17,2025-12-19,525.66,0,0,1076181448,187344700,0,100,
755,755,0,0,0,0,2025-04-17,2025-12-19,525.66,0,0,1076181448,187344700,0,100,
760,760,0,0,0,0,2025-04-17,2025-12-19,525.66,0,0,1076181448,187344700,0,100,
556.84,765,0,0,0,0,2025-04-17,2025-12-19,525.66,0,0,1076181448,187344700,0,100,
770,770,0,0,0,0,2025-04-17,2025-12-19,525.66,0,0,1076181448,187344700,0,100,
775,775,0,0,0,0,2025-04-17,2025-12-19,525.66,0,0,1076181448,187344700,0,100,
602,780,0,0,0,0,2025-04-17,2025-12-19,525.66,0,0,1076181448,187344700,0,100,
785,785,0,0,0,0,2025-04-17,2025-12-19,525.66,0,0,1076181448,187344700,0,100,
790,790,0,0,0,0,2025-04-17,2025-12-19,525.66,0,0,1076181448,187344700,0,100,
795,795,0,0,0,0,2025-04-17,2025-12-19,525.66,0,0,1076181448,187344700,0,100,
605.59,800,0,0,0,0,2025-04-17,2025-12-19,525.66,0,0,1076181448,187344700,0,100,
805,805,0,0,0,0,2025-04-17,2025-12-19,525.66,0,0,1076181448,187344700,0,100,
810,810,0,0,0,0,2025-04-17,2025-12-19,525.66,0,0,1076181448,187344700,0,100,
815,815,0,0,0,0,2025-04-17,2025-12-19,525.66,0,0,1076181448,187344700,0,100,
820,820,0,0,0,0,2025-04-17,2025-12-19,525.66,0,0,1076181448,187344700,0,100,
516.96,825,0,0,0,0,2025-04-17,2025-12-19,525.66,0,0,1076181448,187344700,0,100,
830,830,0,0,0,0,2025-04-17,2025-12-19,525.66,0,0,1076181448,187344700,0,100,
835,835,0,0,0,0,2025-04-17,2025-12-19,525.66,0,0,1076181448,187344700,0,100,
567.7,840,0,0,0,0,2025-04-17,2025-12-19,525.66,0,0,1076181448,187344700,0,100,
