Watch,strike,open_interest.yt,open_interest.td,OI_Dollar.yt,OI_Dollar.td,Date.td,expiry,stkClose,diff_oi,diff_oi_d,totalOI,totalOIdiff,OI_pct,cum_sep_OI,pct
425.75,440,120698,95283,119249624,135778275,2023-09-27,2023-10-20,425.88,-25415,16528651,1168890895,305484810,11.6159921837701,11.6159921837701,0.121732663049372
421.86,430,157045,120854,81977490,98375156,2023-09-27,2023-10-20,425.88,-36191,16397666,1168890895,305484810,8.41611106911736,20.0321032528874,0.166685031737078
416.32,425,71406,85954,44271720,74608072,2023-09-27,2023-11-17,425.88,14548,30336352,1021033106,270136960,7.30711585761256,7.30711585761256,0.40660951538863
426.39,445,40048,39353,54465280,73235933,2023-09-27,2023-10-20,425.88,-695,18770653,1168890895,305484810,6.26542077736006,26.2975240302475,0.256303869304157
426.5,450,30894,30778,54404334,72328300,2023-09-27,2023-09-29,425.88,-116,17923966,408556355,111857149,17.703383906487,17.703383906487,0.247814009177597
415.54,420,145719,161171,39198411,71882266,2023-09-27,2023-10-20,425.88,15452,32683855,1168890895,305484810,6.14961296280779,32.4471369930553,0.454685930463016
417.18,430,55580,55446,54357240,71081772,2023-09-27,2023-12-15,425.88,-134,16724532,1064176186,228355863,6.67951161989261,6.67951161989261,0.235285805761849
425.24,450,27631,27480,54212022,68040480,2023-09-27,2023-12-15,425.88,-151,13828458,1064176186,228355863,6.39372322883384,13.0732348487265,0.203238689674147
418.92,425,78106,99424,29367856,60449792,2023-09-27,2023-10-20,425.88,21318,31081936,1168890895,305484810,5.1715512763918,37.6186882694471,0.514177716277336
425,445,28121,27939,41647201,55878000,2023-09-27,2023-11-17,425.88,-182,14230799,1021033106,270136960,5.47269228310409,12.7798081407166,0.254676241096675
426.2,448,34031,25403,54449600,55378540,2023-09-27,2023-10-20,425.88,-8628,928940,1168890895,305484810,4.73769966357724,42.3563879330243,0.0167743678327381
424.07,435,57065,49948,41657450,54593164,2023-09-27,2023-10-20,425.88,-7117,12935714,1168890895,305484810,4.67050981691495,47.0268977499393,0.236947505002641
426.69,445,29925,29778,37885050,54523518,2023-09-27,2023-09-29,425.88,-147,16638468,408556355,111857149,13.3454093499537,31.0487932564407,0.305161306722725
394.96,400,102651,103596,38083521,52212384,2023-09-27,2023-12-15,425.88,945,14128863,1064176186,228355863,4.90636651025378,17.9796013589802,0.270603675174074
410.68,420,54111,55913,37985922,52110916,2023-09-27,2023-12-15,425.88,1802,14124994,1064176186,228355863,4.89683162295459,22.8764329819348,0.271056336833534
425.88,452,19736,19568,41564016,51111616,2023-09-27,2023-11-17,425.88,-168,9547600,1021033106,270136960,5.00587255199147,17.7856806927081,0.186799024315725
422.3,440,27539,27211,38086437,48163470,2023-09-27,2023-12-15,425.88,-328,10077033,1064176186,228355863,4.52589248224354,27.4023254641784,0.209225643418134
414.14,425,42771,42763,35628243,46440618,2023-09-27,2023-12-15,425.88,-8,10812375,1064176186,228355863,4.36399710977934,31.7663225739577,0.232821514132305
425.85,450,19233,18895,36561933,45631425,2023-09-27,2023-11-17,425.88,-338,9069492,1021033106,270136960,4.4691425509958,22.2548232437039,0.198755397185164
426.5,435,55060,53614,22960020,45571900,2023-09-27,2023-09-29,425.88,-1446,22611880,408556355,111857149,11.154373060725,42.2031663171657,0.496180321645575
419.5,435,29668,28191,34503884,43696050,2023-09-27,2023-12-15,425.88,-1477,9192166,1064176186,228355863,4.10609169560951,35.8724142695672,0.210366062836343
413.44,424,37552,37467,30304464,39565152,2023-09-27,2023-12-15,425.88,-85,9260688,1064176186,228355863,3.71791368013191,39.5903279496991,0.234061731899829
426.69,440,44144,29461,34520608,39212591,2023-09-27,2023-09-29,425.88,-14683,4691983,408556355,111857149,9.59784140427824,51.801007721444,0.119655010810176
423.53,440,23722,23351,28418956,38459097,2023-09-27,2023-11-17,425.88,-371,10040141,1021033106,270136960,3.76668462305472,26.0215078667586,0.261060237581761
419.63,426,50211,55223,20034189,35177051,2023-09-27,2023-10-20,425.88,5012,15142862,1168890895,305484810,3.00943836165308,50.0363361115924,0.430475596149319
425.43,454,12705,12235,30809625,34955395,2023-09-27,2023-11-17,425.88,-470,4145770,1021033106,270136960,3.42353198878548,29.4450398555441,0.118601720850244
419.5,434,24267,24038,28076919,34855100,2023-09-27,2023-12-15,425.88,-229,6778181,1064176186,228355863,3.27531290951102,42.8656408592101,0.194467409360467
403.19,410,50294,50490,25649940,34383690,2023-09-27,2023-12-15,425.88,196,8733750,1064176186,228355863,3.23101479363493,46.0966556528451,0.254008513920408
425.2,430,88624,67805,18611040,32546400,2023-09-27,2023-09-29,425.88,-20819,13935360,408556355,111857149,7.96619599761213,59.7672037190561,0.428169014084507
421.89,435,24965,24773,23916470,32477403,2023-09-27,2023-11-17,425.88,-192,8560933,1021033106,270136960,3.18083740959522,32.6258772651393,0.263596599765074
396.83,400,84557,96384,18348869,30553728,2023-09-27,2023-11-17,425.88,11827,12204859,1021033106,270136960,2.99243264693907,35.6183099120784,0.399455640895933
424.61,444,15747,15738,22612692,30515982,2023-09-27,2023-11-17,425.88,-9,7903290,1021033106,270136960,2.98873580304849,38.6070457151269,0.25898855229368
407.6,410,117907,124072,16624887,29777280,2023-09-27,2023-10-20,425.88,6165,13152393,1168890895,305484810,2.5474815594316,52.583817671024,0.441692223064027
427.3,455,11611,10466,26507913,28990820,2023-09-27,2023-11-17,425.88,-1145,2482907,1021033106,270136960,2.83936141048104,41.4464071256079,0.0856445937024203
417,426,32047,32116,20830550,28904400,2023-09-27,2023-11-17,425.88,69,8073850,1021033106,270136960,2.83089743419152,44.2773045597995,0.279329444652025
417.59,427,30669,30585,20946927,28780485,2023-09-27,2023-11-17,425.88,-84,7833558,1021033106,270136960,2.81876119695574,47.0960657567552,0.272182973983934
411.75,415,89985,84618,17367105,27500850,2023-09-27,2023-10-20,425.88,-5367,10133745,1168890895,305484810,2.35273027770483,54.9365479487288,0.368488428539481
425.7,444,11624,14945,14785728,27349350,2023-09-27,2023-10-20,425.88,3321,12563622,1168890895,305484810,2.33976927333325,57.276317222062,0.459375524464018
426,450,27265,11342,48449905,27220800,2023-09-27,2023-10-20,425.88,-15923,-21229105,1168890895,305484810,2.32877166863379,59.6050888906958,-0.779885418503497
409.18,415,46237,46007,18494800,26776074,2023-09-27,2023-11-17,425.88,-230,8281274,1021033106,270136960,2.62244914906804,49.7185149058232,0.309278873370308
414.34,422,34898,34340,19054308,26304440,2023-09-27,2023-11-17,425.88,-558,7250132,1021033106,270136960,2.57625730697904,52.2947722128023,0.275623887070016
425.11,446,12335,12335,20328080,25767815,2023-09-27,2023-11-17,425.88,0,5439735,1021033106,270136960,2.52370024522985,54.8184724580321,0.211105792245093
421.4,429,31868,33078,15615320,25139280,2023-09-27,2023-10-20,425.88,1210,9523960,1168890895,305484810,2.15069516817479,61.7557840588706,0.378847763340875
424.44,436,21228,21089,16388016,24378884,2023-09-27,2023-10-20,425.88,-139,7990868,1168890895,305484810,2.08564239008808,63.8414264489587,0.327778252687859
420.43,428,39637,30901,18233020,23392057,2023-09-27,2023-10-20,425.88,-8736,5159037,1168890895,305484810,2.00121817186368,65.8426446208224,0.220546529961003
426.53,446,11955,11922,17071740,23212134,2023-09-27,2023-10-20,425.88,-33,6140394,1168890895,305484810,1.98582554619009,67.8284701670125,0.264533799434382
419.34,430,27807,21695,21383583,23126870,2023-09-27,2023-11-17,425.88,-6112,1743287,1021033106,270136960,2.26504604641096,57.0835185044431,0.075379288247826
418.5,429,22075,21935,16379650,23031750,2023-09-27,2023-11-17,425.88,-140,6652100,1021033106,270136960,2.25572999197148,59.3392484964146,0.288823037763088
425.01,448,9687,9675,17184738,22242825,2023-09-27,2023-11-17,425.88,-12,5058087,1021033106,270136960,2.1784626638737,61.5177111602883,0.227403083915825
386.26,390,57950,59202,16573700,22141548,2023-09-27,2023-12-15,425.88,1252,5567848,1064176186,228355863,2.08062802863736,48.1772836814824,0.251466067322845
424.69,442,12773,12742,16604900,22056402,2023-09-27,2023-11-17,425.88,-31,5451502,1021033106,270136960,2.16020439204055,63.6779155523288,0.247161889776945
424.25,448,9343,9266,18704686,22006750,2023-09-27,2023-12-15,425.88,-77,3302064,1064176186,228355863,2.06796114116389,50.2452448226463,0.150047780794529
405.23,410,70664,45959,23107128,21922443,2023-09-27,2023-11-17,425.88,-24705,-1184685,1021033106,270136960,2.14708444527165,65.8249999976005,-0.0540398257621197
418.3,424,37088,37314,13203328,21268980,2023-09-27,2023-10-20,425.88,226,8065652,1168890895,305484810,1.81958642085239,69.6480565878649,0.379221382501653
425,441,18550,13202,19792850,21123200,2023-09-27,2023-10-20,425.88,-5348,1330350,1168890895,305484810,1.80711476925312,71.455171357118,0.0629805143160127
426.46,434,33928,27856,12417648,21003424,2023-09-27,2023-09-29,425.88,-6072,8585776,408556355,111857149,5.14088784642696,64.9080915654831,0.408779825613195
424.01,445,10090,9980,16789760,20948020,2023-09-27,2023-12-15,425.88,-110,4158260,1064176186,228355863,1.96847291600641,52.2137177386527,0.198503724934385
413.29,417,55669,56052,12302849,20795292,2023-09-27,2023-10-20,425.88,383,8492443,1168890895,305484810,1.77906185161961,73.2342332087376,0.408382964759524
420.13,427,25995,29107,11229840,19996509,2023-09-27,2023-10-20,425.88,3112,8766669,1168890895,305484810,1.71072502023382,74.9449582289714,0.438409974461042
423.18,439,12626,12621,14431518,19966422,2023-09-27,2023-11-17,425.88,-5,5534904,1021033106,270136960,1.95551171481799,67.7805117124185,0.277210608891268
412.95,420,23848,28159,11924000,19852095,2023-09-27,2023-11-17,425.88,4311,7928095,1021033106,270136960,1.94431452646747,69.7248262388859,0.399358103011294
415.7,424,23937,23864,14338263,19807120,2023-09-27,2023-11-17,425.88,-73,5468857,1021033106,270136960,1.93990967419229,71.6647359130782,0.276105612527212
423.83,430,42730,30320,14442740,18707440,2023-09-27,2023-10-06,425.88,-12410,4264700,162893327,54801933,11.4844729029324,11.4844729029324,0.227968123912198
426.17,442,11914,11765,13379422,18623995,2023-09-27,2023-10-20,425.88,-149,5244573,1168890895,305484810,1.59330482251725,76.5382630514887,0.281603007303213
399.15,405,31620,31504,13849560,18429840,2023-09-27,2023-12-15,425.88,-116,4580280,1064176186,228355863,1.73184104685462,53.9455587855074,0.248525217798961
415.65,428,13552,13866,12427184,17124510,2023-09-27,2023-12-15,425.88,314,4697326,1064176186,228355863,1.60917996712247,55.5547387526298,0.274304257464885
407.05,415,19986,20303,11891670,16140885,2023-09-27,2023-12-15,425.88,317,4249215,1064176186,228355863,1.51674931391483,57.0714880665447,0.263257869689301
410.57,417,23826,24860,10507266,15984980,2023-09-27,2023-11-17,425.88,1034,5477714,1021033106,270136960,1.56556921671451,73.2303051297927,0.342678814737335
425.95,443,9297,9253,11816487,15776365,2023-09-27,2023-10-20,425.88,-44,3959878,1168890895,305484810,1.34968670450633,77.887949755995,0.251000658263168
426.15,442,10931,9919,11269861,15721615,2023-09-27,2023-10-06,425.88,-1012,4451754,162893327,54801933,9.65147884787202,21.1359517508044,0.28316136732772
401.88,406,4694,38155,1361260,15719860,2023-09-27,2023-11-17,425.88,33461,14358600,1021033106,270136960,1.53960335934494,74.7699084891377,0.913405081215736
422.6,442,8153,8046,12604538,15609240,2023-09-27,2023-12-15,425.88,-107,3004702,1064176186,228355863,1.46679095109914,58.5382790176438,0.192495086243789
425.15,454,5566,5391,13169156,15553035,2023-09-27,2023-12-15,425.88,-175,2383879,1064176186,228355863,1.46150940085028,59.9997884184941,0.153274200180222
417.62,423,27851,28329,9107277,15241002,2023-09-27,2023-10-20,425.88,478,6133725,1168890895,305484810,1.30388576600214,79.1918355219971,0.402448933475634
423.67,434,14916,14734,11201916,15220222,2023-09-27,2023-10-20,425.88,-182,4018306,1168890895,305484810,1.30210801239922,80.4939435343963,0.264010997999898
425.19,438,11784,11554,10334568,14800674,2023-09-27,2023-10-20,425.88,-230,4466106,1168890895,305484810,1.26621518426662,81.760158718663,0.301750177052748
406.87,412,28465,28736,10702840,14741568,2023-09-27,2023-11-17,425.88,271,4038728,1021033106,270136960,1.44378942400326,76.2136979131409,0.273968685013697
420.56,433,11885,11813,10494455,14695372,2023-09-27,2023-11-17,425.88,-72,4200917,1021033106,270136960,1.43926498696703,77.652962900108,0.285866666049692
403.64,408,9647,33255,2913394,14499180,2023-09-27,2023-11-17,425.88,23608,11585786,1021033106,270136960,1.4200499391055,79.0730128392135,0.799064912636439
377.15,380,49683,49373,10035966,14071305,2023-09-27,2023-12-15,425.88,-310,4035339,1064176186,228355863,1.32227211857567,61.3220605370698,0.286777878810814
422.81,432,15895,15048,9505210,13829112,2023-09-27,2023-10-20,425.88,-847,4323902,1168890895,305484810,1.18309690486553,82.9432556235285,0.312666641213116
426.43,443,9841,8139,10549552,13486323,2023-09-27,2023-09-29,425.88,-1702,2936771,408556355,111857149,3.30097007057937,68.2090616360624,0.217759206864614
420.41,432,13688,11635,11552672,13484965,2023-09-27,2023-11-17,425.88,-2053,1932293,1021033106,270136960,1.32071770452466,80.3937305437381,0.143292400091509
413.5,421,17727,17855,9306675,13391250,2023-09-27,2023-11-17,425.88,128,4084575,1021033106,270136960,1.3115392558094,81.7052697995475,0.305018202184262
421.06,434,10040,10239,9196640,13249266,2023-09-27,2023-11-17,425.88,199,4052626,1021033106,270136960,1.29763334040219,83.0029031399497,0.305875510386764
392.41,397,1881,28625,667755,13138875,2023-09-27,2023-12-15,425.88,26744,12471120,1064176186,228355863,1.23465222891203,62.5567127659818,0.949177155578388
422.38,438,7923,8136,8707377,12708432,2023-09-27,2023-11-17,425.88,213,4001055,1021033106,270136960,1.24466404912046,84.2475671890702,0.314834670398362
421.04,425,21677,32001,4487139,12672396,2023-09-27,2023-10-06,425.88,10324,8185257,162893327,54801933,7.77956729927924,28.9155190500836,0.645912343648352
372.48,375,50261,50076,8896197,12619152,2023-09-27,2023-12-15,425.88,-185,3722955,1064176186,228355863,1.18581416930899,63.7425269352908,0.295024182290537
424.63,439,8957,8674,8822645,12464538,2023-09-27,2023-10-20,425.88,-283,3641893,1168890895,305484810,1.06635598354969,84.0096116070782,0.292180343948568
423.36,433,14091,12909,8933694,12444276,2023-09-27,2023-10-20,425.88,-1182,3510582,1168890895,305484810,1.06462254546007,85.0742341525383,0.282104157766993
414.84,419,36239,29908,9095989,12441728,2023-09-27,2023-10-20,425.88,-6331,3345739,1168890895,305484810,1.06440456104331,86.1386387135816,0.268912726592319
422.63,425,49484,49056,5146336,11626272,2023-09-27,2023-09-29,425.88,-428,6479936,408556355,111857149,2.84569603622981,71.0547576722922,0.55735286427154
422.36,437,7878,7868,8295534,11518752,2023-09-27,2023-11-17,425.88,-10,3223218,1021033106,270136960,1.12814676941533,85.3757139584855,0.279823543383867
417.53,420,42524,46574,5485596,11503778,2023-09-27,2023-10-06,425.88,4050,6018182,162893327,54801933,7.0621542403637,35.9776732904473,0.523148308320971
409.68,419,12337,12330,8438508,11491560,2023-09-27,2023-12-15,425.88,-7,3053052,1064176186,228355863,1.0798550231794,64.8223819584702,0.26567776698725
418.21,433,7994,7456,8745436,11027424,2023-09-27,2023-12-15,425.88,-538,2281988,1064176186,228355863,1.03624044073469,65.8586223992049,0.206937540444622
426.01,460,12292,3213,35056784,10920987,2023-09-27,2023-12-15,425.88,-9079,-24135797,1064176186,228355863,1.02623861947612,66.884861018681,-2.21003806707214
422.05,436,7624,7685,7738360,10720575,2023-09-27,2023-11-17,425.88,61,2982215,1021033106,270136960,1.04997330027808,86.4256872587636,0.278176776898627
422.3,431,12292,11928,6908104,10377360,2023-09-27,2023-10-20,425.88,-364,3469256,1168890895,305484810,0.887795434491771,87.0264341480733,0.334310075009444
411.7,422,9704,10034,7559416,10335020,2023-09-27,2023-12-15,425.88,330,2775604,1064176186,228355863,0.971175650795854,67.8560366694768,0.268563002297045
416.95,422,19202,20283,5952620,10242915,2023-09-27,2023-10-20,425.88,1081,4290295,1168890895,305484810,0.87629350556281,87.9027276536361,0.418854886524002
425.71,453,3711,3708,8813625,10119132,2023-09-27,2023-12-15,425.88,-3,1305507,1064176186,228355863,0.950888784500577,68.8069254539774,0.129013733589007
412.38,416,26922,27672,5626698,10017264,2023-09-27,2023-10-20,425.88,750,4390566,1168890895,305484810,0.856988795348603,88.7597164489848,0.438299919019804
425.05,452,3682,3671,8339730,9893345,2023-09-27,2023-12-15,425.88,-11,1553615,1064176186,228355863,0.929671715093237,69.7365971690707,0.157036371419373
426,475,2006,2006,8700022,9829400,2023-09-27,2023-12-15,425.88,0,1129378,1064176186,228355863,0.923662841671595,70.6602600107423,0.114897959183673
421.51,438,5908,5730,7934444,9448770,2023-09-27,2023-12-15,425.88,-178,1514326,1064176186,228355863,0.887895268124333,71.5481552788666,0.160266997715047
398.69,400,66657,71557,5199246,9373967,2023-09-27,2023-10-20,425.88,4900,4174721,1168890895,305484810,0.801953975353705,89.5616704243385,0.445352645256805
424.89,437,8049,7730,6632376,9361030,2023-09-27,2023-10-20,425.88,-319,2728654,1168890895,305484810,0.800847199686674,90.3625176240251,0.291490786804444
390.5,395,20624,20675,6558432,9303750,2023-09-27,2023-12-15,425.88,51,2745318,1064176186,228355863,0.874267825421908,72.4224231042885,0.295076501410721
426.08,433,14251,13272,4546069,9184224,2023-09-27,2023-09-29,425.88,-979,4638155,408556355,111857149,2.24796992816328,73.3027276004555,0.505013270582251
413.88,418,21518,21997,5099766,9062764,2023-09-27,2023-10-20,425.88,479,3962998,1168890895,305484810,0.775330190248423,91.1378478142735,0.437283592511071
417.42,431,6353,6610,6467354,8976380,2023-09-27,2023-12-15,425.88,257,2509026,1064176186,228355863,0.843505062234122,73.2659281665226,0.279514236251139
417.98,432,7300,6391,7621200,8960182,2023-09-27,2023-12-15,425.88,-909,1338982,1064176186,228355863,0.841982945857802,74.1079111123804,0.149436919919707
420.1,437,5434,5234,7411976,8845460,2023-09-27,2023-12-15,425.88,-200,1433484,1064176186,228355863,0.831202588102268,74.9391137004827,0.162058728432439
423.62,443,4584,4542,7678200,8802396,2023-09-27,2023-12-15,425.88,-42,1124196,1064176186,228355863,0.827155889767298,75.76626959025,0.127714772205204
367.77,370,39838,39449,6374080,8797127,2023-09-27,2023-12-15,425.88,-389,2423047,1064176186,228355863,0.826660764987275,76.5929303552372,0.275436173650784
403.25,405,37089,49903,3783078,8733025,2023-09-27,2023-10-20,425.88,12814,4949947,1168890895,305484810,0.747120628397058,91.8849684426706,0.566807835772828
401.15,405,15083,21430,4057327,8250550,2023-09-27,2023-11-17,425.88,6347,4193223,1021033106,270136960,0.808059009205133,87.2337462679687,0.508235572173976
410,413,26920,26808,4549480,8042400,2023-09-27,2023-10-20,425.88,-112,3492920,1168890895,305484810,0.688036841967188,92.5730052846378,0.434313140356113
419.78,425,14674,15356,4460896,8015832,2023-09-27,2023-10-13,425.88,682,3554936,114856729,34649438,6.97898335586416,6.97898335586416,0.443489334606813
419.53,431,7099,6930,5743091,7948710,2023-09-27,2023-11-17,425.88,-169,2205619,1021033106,270136960,0.778496794402669,88.0122430623714,0.277481377481378
423.6,447,3352,3349,6184440,7836660,2023-09-27,2023-12-15,425.88,-3,1652220,1064176186,228355863,0.73640625519504,77.3293366104323,0.21083216574408
424.37,428,39288,21553,6168216,7823739,2023-09-27,2023-09-29,425.88,-17735,1655523,408556355,111857149,1.91497180358387,75.2176994040394,0.211602534286995
414.66,426,6667,6831,5706952,7746354,2023-09-27,2023-12-15,425.88,164,2039402,1064176186,228355863,0.727920254362843,78.0572568647951,0.263272502134553
401.32,408,12376,11529,5928104,7701372,2023-09-27,2023-12-15,425.88,-847,1773268,1064176186,228355863,0.723693322714515,78.7809501875097,0.230253518463983
425.95,451,3169,3060,6775322,7665300,2023-09-27,2023-12-15,425.88,-109,889978,1064176186,228355863,0.720303658439506,79.5012538459492,0.11610478389626
425.85,432,17755,12059,4953645,7416285,2023-09-27,2023-09-29,425.88,-5696,2462640,408556355,111857149,1.81524162070616,77.0329410247456,0.332058436265597
425.81,444,4120,4034,5022280,7337846,2023-09-27,2023-10-13,425.88,-86,2315566,114856729,34649438,6.3886949105089,13.3676782663731,0.315564812889232
421.96,424,41124,35651,3742284,7272804,2023-09-27,2023-09-29,425.88,-5473,3530520,408556355,111857149,1.78012259777479,78.8130636225203,0.485441378593456
398.16,400,38650,39105,4212850,7195320,2023-09-27,2023-10-27,425.88,455,2982470,112653864,35070907,6.38710448493804,6.38710448493804,0.414501370335162
425.41,436,6753,6775,4119330,7174725,2023-09-27,2023-10-06,425.88,22,3055395,162893327,54801933,4.40455427618591,40.3822275666332,0.425855346372161
425.42,455,2454,2371,6024570,7013418,2023-09-27,2023-12-15,425.88,-83,988847.999999999,1064176186,228355863,0.659046696615329,80.1603005425645,0.140993735151676
373.59,376,1191,29045,240582,6999845,2023-09-27,2023-12-15,425.88,27854,6759263,1064176186,228355863,0.657771249919701,80.8180717924842,0.965630381815597
423.82,427,19826,21852,2716162,6948936,2023-09-27,2023-09-29,425.88,2026,4232774,408556355,111857149,1.70085128158146,80.5139149041018,0.609125483383355
422.54,430,9563,9276,4226846,6919896,2023-09-27,2023-10-13,425.88,-287,2693050,114856729,34649438,6.02480678341449,19.3924850497876,0.389174924016199
418.93,420,71046,64170,3765438,6866190,2023-09-27,2023-09-29,425.88,-6876,3100752,408556355,111857149,1.68059801688803,82.1945129209898,0.451597173978582
416.13,429,5159,5285,5159000,6801795,2023-09-27,2023-12-15,425.88,126,1642795,1064176186,228355863,0.639160609820299,81.4572324023045,0.241523744835003
421.5,439,3895,3868,5402365,6769000,2023-09-27,2023-12-15,425.88,-27,1366635,1064176186,228355863,0.636078883276195,82.0933112855807,0.201896144186734
402.79,407,15950,15925,4625500,6704425,2023-09-27,2023-11-17,425.88,-25,2078925,1021033106,270136960,0.656631500056375,88.6688745624278,0.310082520126633
419.63,436,4278,4068,5137878,6659316,2023-09-27,2023-12-15,425.88,-210,1521438,1064176186,228355863,0.625771943368784,82.7190832289495,0.228467608385005
389.21,390,78080,83835,3747840,6622965,2023-09-27,2023-10-20,425.88,5755,2875125,1168890895,305484810,0.56660249714752,93.1396077817853,0.434114478938059
425.1,435,6543,6530,3598650,6464700,2023-09-27,2023-10-06,425.88,-13,2866050,162893327,54801933,3.96867085905858,44.3508984256918,0.443338437978561
416.28,421,14428,13640,4198548,6438080,2023-09-27,2023-10-20,425.88,-788,2239532,1168890895,305484810,0.550785366499069,93.6903931482844,0.347857125105622
396.41,402,11374,11372,4697462,6356948,2023-09-27,2023-12-15,425.88,-2,1659486,1064176186,228355863,0.597358603174005,83.3164418321235,0.261050743218287
348.64,350,47139,46693,4478205,6350248,2023-09-27,2023-12-15,425.88,-446,1872043,1064176186,228355863,0.596729008179478,83.913170840303,0.294798407873204
426.23,451,2598,2561,5029728,6343597,2023-09-27,2023-10-20,425.88,-37,1313869,1168890895,305484810,0.542702233983951,94.2330953822683,0.207117349982983
423.5,446,2818,2805,4801872,6311250,2023-09-27,2023-12-15,425.88,-13,1509378,1064176186,228355863,0.593064389433725,84.5062352297367,0.239156743909685
411.16,418,8339,9149,4227873,6257916,2023-09-27,2023-11-17,425.88,810,2030043,1021033106,270136960,0.612900400900419,89.2817749633282,0.324396012985793
384.14,385,71570,72232,4007920,6211952,2023-09-27,2023-10-27,425.88,662,2204032,112653864,35070907,5.5141934590011,11.9012979439391,0.354805059665625
412.2,419,9110,9077,4673430,6172360,2023-09-27,2023-11-17,425.88,-33,1498930,1021033106,270136960,0.60452104478579,89.886296008114,0.242845524240323
424.34,435,5884,5684,3865788,6059144,2023-09-27,2023-10-13,425.88,-200,2193356,114856729,34649438,5.27539313782826,24.6678781876158,0.361991066724937
414.63,423,6912,7219,3932928,6042303,2023-09-27,2023-11-17,425.88,307,2109375,1021033106,270136960,0.591783259964149,90.4780792680781,0.349101162255517
399.63,406,9479,9481,4246592,6039397,2023-09-27,2023-12-15,425.88,2,1792805,1064176186,228355863,0.567518525546107,85.0737537552828,0.296851655885513
424.91,429,14747,14512,2669207,5935408,2023-09-27,2023-09-29,425.88,-235,3266201,408556355,111857149,1.45277583553926,83.6472887565291,0.550290898283656
406.3,414,6982,7678,4245056,5912060,2023-09-27,2023-12-15,425.88,696,1667004,1064176186,228355863,0.555552743782222,85.629306499065,0.281966691813006
393.55,395,40167,40670,3454362,5897150,2023-09-27,2023-10-27,425.88,503,2442788,112653864,35070907,5.23475164597994,17.1360495899191,0.414231959505863
424.53,433,7026,6958,3253038,5893426,2023-09-27,2023-10-06,425.88,-68,2640388,162893327,54801933,3.61796649902055,47.9688649247124,0.448022593309902
423.77,444,2751,2888,4789491,5842424,2023-09-27,2023-12-15,425.88,137,1052933,1064176186,228355863,0.549009090492841,86.1783155895578,0.180221942125392
424.86,437,4771,4759,3602105,5777426,2023-09-27,2023-10-13,425.88,-12,2175321,114856729,34649438,5.03011538836353,29.6979935759793,0.376520789708081
425.62,431,11725,10536,2837450,5668368,2023-09-27,2023-09-29,425.88,-1189,2830918,408556355,111857149,1.3874139835617,85.0347027400908,0.499423820048381
420.53,422,33858,38425,2370060,5648475,2023-09-27,2023-09-29,425.88,4567,3278415,408556355,111857149,1.3825448878405,86.4172476279313,0.580407101031694
426.14,449,3940,2464,6634960,5632704,2023-09-27,2023-10-20,425.88,-1476,-1002256,1168890895,305484810,0.48188449615736,94.7149798784257,-0.177935144470578
379.29,380,78873,79068,3943650,5613828,2023-09-27,2023-10-27,425.88,195,1670178,112653864,35070907,4.98325383672592,22.119303426645,0.2975114307029
378.47,380,31025,36618,3288650,5602554,2023-09-27,2023-11-17,425.88,5593,2313904,1021033106,270136960,0.548714235324707,91.0267935034028,0.413008781352219
358.23,360,31256,31538,4063280,5582226,2023-09-27,2023-12-15,425.88,282,1518946,1064176186,228355863,0.524558439987493,86.7028740295453,0.272103995789493
424.88,447,2430,2448,4160160,5414976,2023-09-27,2023-11-17,425.88,18,1254816,1021033106,270136960,0.530342842771643,91.5571363461745,0.231730666950324
388.68,393,12272,12424,3853408,5367168,2023-09-27,2023-12-15,425.88,152,1513760,1064176186,228355863,0.504349568296015,87.2072235978414,0.28204073358613
426.6,438,14123,4625,8911613,5272500,2023-09-27,2023-09-29,425.88,-9498,-3639113,408556355,111857149,1.29051963957335,87.7077672675046,-0.690206353722143
410.93,421,5154,5196,4174740,5232372,2023-09-27,2023-12-15,425.88,42,1057632,1064176186,228355863,0.491682868761358,87.6989064666027,0.202132417190521
419.22,424,2160,10946,604800,5232188,2023-09-27,2023-10-13,425.88,8786,4627388,114856729,34649438,4.55540397637478,34.2533975523541,0.884407823266289
418.13,428,5303,5246,3770433,5177802,2023-09-27,2023-11-17,425.88,-57,1407369,1021033106,270136960,0.50711401712375,92.0642503632982,0.271808191970261
425.67,459,2101,1538,5987850,5126154,2023-09-27,2023-12-15,425.88,-563,-861696,1064176186,228355863,0.481701626801861,88.1806080934046,-0.168097954138717
383.08,385,25941,26646,3242625,5116032,2023-09-27,2023-11-17,425.88,705,1873407,1021033106,270136960,0.501064262259093,92.5653146255573,0.366183596975156
410.9,414,11124,16378,2158056,5077180,2023-09-27,2023-10-20,425.88,5254,2919124,1168890895,305484810,0.434358760233135,95.1493386386588,0.574949873748813
381.62,385,14105,14873,3314675,5027074,2023-09-27,2023-12-15,425.88,768,1712399,1064176186,228355863,0.472391138435041,88.6529992318396,0.340635327826883
424.4,443,2692,2689,3717652,5001540,2023-09-27,2023-11-17,425.88,-3,1283888,1021033106,270136960,0.489850913805727,93.055165539363,0.25669853685065
421.79,441,2980,2550,4383580,4898550,2023-09-27,2023-12-15,425.88,-430,514970,1064176186,228355863,0.460313814990782,89.1133130468304,0.105127027385655
405.43,413,6300,6456,3540600,4887192,2023-09-27,2023-12-15,425.88,156,1346592,1064176186,228355863,0.459246510520956,89.5725595573513,0.275534908389112
426.41,436,5590,5056,2655250,4848704,2023-09-27,2023-09-29,425.88,-534,2193454,408556355,111857149,1.18678951891472,88.8945567864194,0.452379439949314
426.42,442,16074,3099,15800742,4828242,2023-09-27,2023-09-29,425.88,-12975,-10972500,408556355,111857149,1.18178115232108,90.0763379387404,-2.27256628810238
422.23,433,4436,4457,3105200,4800189,2023-09-27,2023-10-27,425.88,21,1694989,112653864,35070907,4.26100697265031,26.3803103992953,0.353108804674149
403.8,411,6673,6660,3516671,4795200,2023-09-27,2023-12-15,425.88,-13,1278529,1064176186,228355863,0.450602077276704,90.0231616346281,0.266626835168502
425.92,447,4014,2244,6049098,4730352,2023-09-27,2023-10-20,425.88,-1770,-1318746,1168890895,305484810,0.404687214198892,95.5540258528577,-0.278783904453622
408.28,414,6816,8220,2637792,4701840,2023-09-27,2023-11-17,425.88,1404,2064048,1021033106,270136960,0.460498290640147,93.5156638300032,0.438987290082181
426.85,458,1632,1507,4814400,4694305,2023-09-27,2023-12-15,425.88,-125,-120095,1064176186,228355863,0.441121034444949,90.464282669073,-0.0255831267887366
374.34,375,70655,70862,2826200,4676892,2023-09-27,2023-10-27,425.88,207,1850692,112653864,35070907,4.1515593286707,30.531869727966,0.395709800440121
404.05,406,24617,23835,2978657,4647825,2023-09-27,2023-10-20,425.88,-782,1669168,1168890895,305484810,0.39762693163933,95.9516527844971,0.359128839833686
426.58,441,10483,3199,9183108,4612958,2023-09-27,2023-09-29,425.88,-7284,-4570150,408556355,111857149,1.12908732015685,91.2054252588973,-0.990720054247188
425.48,440,3671,3173,3619606,4607196,2023-09-27,2023-10-13,425.88,-498,987590,114856729,34649438,4.01125475199629,38.2646523043504,0.214358147558732
384.37,385,73277,72476,2931080,4565988,2023-09-27,2023-10-20,425.88,-801,1634908,1168890895,305484810,0.390625679396707,96.3422784638938,0.358062263851767
426.34,440,4378,3337,3721300,4558342,2023-09-27,2023-10-06,425.88,-1041,837042,162893327,54801933,2.79836018083172,50.7672251055441,0.18362860882312
374.57,375,105151,104771,3154530,4505153,2023-09-27,2023-10-20,425.88,-380,1350623,1168890895,305484810,0.38542117311984,96.7276996370136,0.299795145692055
424.8,438,2339,3387,1889912,4470840,2023-09-27,2023-10-13,425.88,1048,2580928,114856729,34649438,3.89253641377859,42.157188718129,0.577280332107613
425.9,441,2909,2920,2949726,4409200,2023-09-27,2023-10-06,425.88,11,1459474,162893327,54801933,2.70680210245813,53.4740272080022,0.331006531797151
424.74,440,3208,2882,3329904,4397932,2023-09-27,2023-10-27,425.88,-326,1068028,112653864,35070907,3.90393355704159,34.4358032850076,0.242847774817801
388.82,390,36166,37229,2495454,4393022,2023-09-27,2023-10-27,425.88,1063,1897568,112653864,35070907,3.89957507360777,38.3353783586154,0.43195048875239
424.2,438,2513,3129,2342116,4318020,2023-09-27,2023-10-27,425.88,616,1975904,112653864,35070907,3.83299768572519,42.1683760443406,0.457594916188438
393.99,395,42121,42489,2569381,4291389,2023-09-27,2023-10-20,425.88,368,1722008,1168890895,305484810,0.367133409829495,97.0948330468431,0.401270544338908
415.37,427,2779,3675,2462194,4274025,2023-09-27,2023-12-15,425.88,896,1811831,1064176186,228355863,0.401627574101719,90.8659102431747,0.423916799737952
426.52,437,8255,4075,4465955,4270600,2023-09-27,2023-09-29,425.88,-4180,-195355,408556355,111857149,1.04529031252004,92.2507155714173,-0.045744157729593
407.64,413,7397,7872,2907021,4219392,2023-09-27,2023-11-17,425.88,475,1312371,1021033106,270136960,0.413247325204752,93.9289111552079,0.311033200991991
424.88,449,1744,1747,3625776,4213764,2023-09-27,2023-12-15,425.88,3,587988,1064176186,228355863,0.395964883957665,91.2618751271324,0.139539850831703
426,460,1306,1235,3737772,4199000,2023-09-27,2023-11-17,425.88,-71,461228,1021033106,270136960,0.411250132373279,94.3401612875812,0.109842343415099
419,422,13917,13987,2157135,4196100,2023-09-27,2023-10-06,425.88,70,2038965,162893327,54801933,2.57598029169114,56.0500074996934,0.485919067705727
363,365,20968,20952,3166168,4190400,2023-09-27,2023-12-15,425.88,-16,1024232,1064176186,228355863,0.393769382845408,91.6556445099778,0.244423444062619
425.69,445,1972,2129,2754884,4111099,2023-09-27,2023-10-27,425.88,157,1356215,112653864,35070907,3.6493191214462,45.8176951657868,0.329891106976504
393.85,399,7431,7911,2734608,4074165,2023-09-27,2023-12-15,425.88,480,1339557,1064176186,228355863,0.382846849384393,92.0384913593622,0.328793016483132
398.55,402,12654,11700,2973690,4036500,2023-09-27,2023-11-17,425.88,-954,1062810,1021033106,270136960,0.395334879572455,94.7354961671537,0.26329988851728
425.36,456,1334,1315,3388360,4029160,2023-09-27,2023-12-15,425.88,-19,640800,1064176186,228355863,0.378617756439816,92.417109115802,0.159040594069235
420.45,424,10989,11279,2109888,4004045,2023-09-27,2023-10-06,425.88,290,1894157,162893327,54801933,2.45807797884808,58.5080854785414,0.473060867198046
421.17,430,4423,4498,2618416,3971734,2023-09-27,2023-10-27,425.88,75,1353318,112653864,35070907,3.52560831823754,49.3433034840243,0.340737320273714
416.45,420,11120,11158,2246240,3961090,2023-09-27,2023-10-13,425.88,38,1714850,114856729,34649438,3.44872262555901,45.605911343688,0.432923765933114
425.34,457,1355,1243,3634110,3935338,2023-09-27,2023-12-15,425.88,-112,301228,1064176186,228355863,0.369801359189596,92.7869104749916,0.0765443781449013
425.93,465,1006,1001,3301692,3910907,2023-09-27,2023-09-29,425.88,-5,609215,408556355,111857149,0.957250316177312,93.2079658875946,0.155773328284206
425,437.5,3096,3098,2662560,3872500,2023-09-27,2023-10-06,425.88,2,1209940,162893327,54801933,2.37732267571648,60.8854081542579,0.312444157520981
392.37,395,14596,14649,2641876,3852687,2023-09-27,2023-11-17,425.88,53,1210811,1021033106,270136960,0.377332231184284,95.1128283983379,0.314277022763593
409.69,416,6023,6012,2553752,3793572,2023-09-27,2023-11-17,425.88,-11,1239820,1021033106,270136960,0.371542507065388,95.4843709054033,0.326821265024099
408.64,418,3958,4033,2746852,3774888,2023-09-27,2023-12-15,425.88,75,1028036,1064176186,228355863,0.354723968611716,93.1416344436033,0.272335497106139
422.79,428,9426,7238,2676984,3770998,2023-09-27,2023-10-06,425.88,-2188,1094014,162893327,54801933,2.3150107309184,63.2004188851763,0.290112590884429
425.94,439,5660,2759,4103500,3603254,2023-09-27,2023-09-29,425.88,-2901,-500246,408556355,111857149,0.881947852701985,94.0899137402966,-0.138831733760651
423.37,429,6083,6289,1879647,3540707,2023-09-27,2023-10-06,425.88,206,1661060,162893327,54801933,2.17363538777743,65.3740542729538,0.469132294764859
407.3,416,3864,4004,2380224,3483480,2023-09-27,2023-12-15,425.88,140,1103256,1064176186,228355863,0.327340533064701,93.468974976668,0.316710875331565
425.71,460,999,992,2884113,3401568,2023-09-27,2023-09-29,425.88,-7,517455,408556355,111857149,0.832582325148265,94.9224960654449,0.152122491744984
424.26,432.5,4008,4033,1799592,3323192,2023-09-27,2023-10-06,425.88,25,1523600,162893327,54801933,2.04010321429557,67.4141574872493,0.458474863926008
404.43,409,7395,7252,2322030,3314164,2023-09-27,2023-11-17,425.88,-143,992134,1021033106,270136960,0.32458927928239,95.8089601846857,0.299361769664989
369.64,370,91373,91329,2467071,3287844,2023-09-27,2023-10-20,425.88,-44,820773,1168890895,305484810,0.281278946911465,97.3761119937546,0.249638668987945
424.94,441,2034,1996,2064510,3205576,2023-09-27,2023-10-13,425.88,-38,1141066,114856729,34649438,2.79093443449883,48.3968457781869,0.355962859716943
425.21,442,1894,1891,2212192,3174989,2023-09-27,2023-10-13,425.88,-3,962797,114856729,34649438,2.76430386590585,51.1611496440927,0.303244200216127
423.24,426,8305,11383,996600,3141708,2023-09-27,2023-09-29,425.88,3078,2145108,408556355,111857149,0.768977880664713,95.6914739461096,0.682784014300502
400.79,407,4647,4995,2179443,3101895,2023-09-27,2023-12-15,425.88,348,922452,1064176186,228355863,0.291483218738368,93.7604581954064,0.297383373711876
424.32,436,2342,2605,1786946,3042640,2023-09-27,2023-10-13,425.88,263,1255694,114856729,34649438,2.64907422185077,53.8102238659435,0.412698840480635
374.7,375,100874,100865,1815732,3025950,2023-09-27,2023-10-13,425.88,-9,1210218,114856729,34649438,2.63454307496429,56.4447669409078,0.399946463094235
424.9,439,2127,2138,2188683,3014580,2023-09-27,2023-10-13,425.88,11,825897,114856729,34649438,2.62464378556349,59.0694107264713,0.273967517863185
413.48,415,15908,19572,1224916,2974944,2023-09-27,2023-10-06,425.88,3664,1750028,162893327,54801933,1.82631422341813,69.2404717106674,0.588255778932309
387.8,390,12871,13512,1904908,2972640,2023-09-27,2023-11-17,425.88,641,1067732,1021033106,270136960,0.291140412835938,96.1001005975217,0.359186447063889
379.49,380,57886,57799,1910238,2947749,2023-09-27,2023-10-20,425.88,-87,1037511,1168890895,305484810,0.252183416998898,97.6282954107535,0.351967212947914
408.11,417,3354,3263,2203578,2900807,2023-09-27,2023-12-15,425.88,-91,697229,1064176186,228355863,0.272587099595179,94.0330452950016,0.240356907577788
414.52,415,24805,60318,719345,2895264,2023-09-27,2023-09-29,425.88,35513,2175919,408556355,111857149,0.708657193693634,96.4001311398032,0.751544246051483
425.41,434,6506,3367,3279024,2892253,2023-09-27,2023-10-06,425.88,-3139,-386771,162893327,54801933,1.77555032687128,71.0160220375387,-0.133726544669502
425.62,438,2314,2324,1700790,2877112,2023-09-27,2023-10-06,425.88,10,1176322,162893327,54801933,1.7662552868111,72.7822773243498,0.40885512972731
425.31,442.5,1666,1667,1955884,2865573,2023-09-27,2023-10-13,425.88,1,909689.000000001,114856729,34649438,2.49491085541884,61.5643215818901,0.317454484670256
405.97,411,4736,5677,1700224,2855531,2023-09-27,2023-11-17,425.88,941,1155307,1021033106,270136960,0.279670755357466,96.3797713528791,0.404585697020974
423.5,441,1564,1611,1978460,2819250,2023-09-27,2023-11-17,425.88,47,840790,1021033106,270136960,0.276117393592133,96.6558887464713,0.298231799237386
414.82,420,5481,5366,1814211,2779588,2023-09-27,2023-10-27,425.88,-115,965377,112653864,35070907,2.4673703158553,51.8106737998796,0.34730938541971
397.92,404,4715,4514,2060455,2744512,2023-09-27,2023-12-15,425.88,-201,684057,1064176186,228355863,0.257900151883309,94.2909454468849,0.249245403190075
421.63,428,3839,4283,1470337,2728271,2023-09-27,2023-10-13,425.88,444,1257934,114856729,34649438,2.3753688823926,63.9396904642827,0.461073698323957
425.37,447,1254,1246,2045274,2695098,2023-09-27,2023-10-27,425.88,-8,649824,112653864,35070907,2.39237066914988,54.2030444690295,0.241113310165345
354.21,355,34038,34013,2008242,2687027,2023-09-27,2023-11-17,425.88,-25,678785,1021033106,270136960,0.263167470693159,96.9190562171644,0.25261562314037
408.32,410,6036,15745,585492,2645160,2023-09-27,2023-10-13,425.88,9709,2059668,114856729,34649438,2.30300829827741,66.2426987625601,0.778655355441637
423.08,435,2784,2217,2216064,2642664,2023-09-27,2023-10-27,425.88,-567,426600,112653864,35070907,2.34582632691587,56.5488707959454,0.161428013549963
418.29,425,3967,3910,1761348,2623610,2023-09-27,2023-10-27,425.88,-57,862262,112653864,35070907,2.32891257063317,58.8777833665785,0.328654792442474
389.54,394,5992,5867,2055256,2616682,2023-09-27,2023-12-15,425.88,-125,561426,1064176186,228355863,0.245888043204154,94.536833490089,0.214556449732906
401.37,403,13602,15882,1360200,2588766,2023-09-27,2023-10-20,425.88,2280,1228566,1168890895,305484810,0.221471996323489,97.8497674070769,0.474575917637979
425.6,446,1271,1266,2024703,2582640,2023-09-27,2023-10-27,425.88,-5,557937,112653864,35070907,2.29254453269353,61.1703278992721,0.2160335935322
319.27,320,34723,34864,1840319,2545072,2023-09-27,2023-12-15,425.88,141,704753,1064176186,228355863,0.239158894314893,94.7759923844039,0.276908865446636
426.52,448,1374,1171,2311068,2515308,2023-09-27,2023-10-27,425.88,-203,204240,112653864,35070907,2.23277561078597,63.403103510058,0.0811988034864915
389.51,390,51229,51326,1588099,2514974,2023-09-27,2023-10-13,425.88,97,926875,114856729,34649438,2.18966186996323,68.4323606325233,0.368542577378534
394.04,397,6999,8381,1420797,2480776,2023-09-27,2023-11-17,425.88,1382,1059979,1021033106,270136960,0.24296724419825,97.1620234613627,0.427277190685495
425.56,437,2212,2146,1459920,2455024,2023-09-27,2023-10-06,425.88,-66,995104,162893327,54801933,1.50713601668901,74.2894133410388,0.405333715678543
426.08,452,996,945,2063712,2449440,2023-09-27,2023-10-20,425.88,-51,385728,1168890895,305484810,0.209552492065566,98.0593198991425,0.157475994513032
426.01,442.5,2046,1478,2172852,2437222,2023-09-27,2023-10-06,425.88,-568,264370,162893327,54801933,1.49620739221564,75.7856207332545,0.108471858534019
424.21,432,3036,3116,1250832,2427364,2023-09-27,2023-10-06,425.88,80,1176532,162893327,54801933,1.49015557893295,77.2757763121874,0.484695332055679
425.28,447,1169,1113,1711416,2417436,2023-09-27,2023-10-06,425.88,-56,706020,162893327,54801933,1.48406079274199,78.7598371049294,0.292053233260363
425.94,443,1428,1414,1756440,2412284,2023-09-27,2023-10-13,425.88,-14,655843.999999999,114856729,34649438,2.10025483139085,70.5326154639142,0.271876777361206
423.22,432,2146,2742,1115920,2407476,2023-09-27,2023-10-13,425.88,596,1291556,114856729,34649438,2.09606874665567,72.6286842105699,0.536477206834045
404.74,412,4066,3309,2191574,2402334,2023-09-27,2023-12-15,425.88,-757,210760,1064176186,228355863,0.225745889788216,95.0017382741921,0.087731347930804
410.64,413,10195,10152,1580225,2395872,2023-09-27,2023-10-13,425.88,-43,815647,114856729,34649438,2.08596572517749,74.7146499357474,0.340438470836505
420.02,428,2667,2964,1424178,2365272,2023-09-27,2023-10-27,425.88,297,941094,112653864,35070907,2.09959242942612,65.5026959394842,0.397879821010015
426.34,470,545,541,2054105,2362006,2023-09-27,2023-12-15,425.88,-4,307901,1064176186,228355863,0.221956291737579,95.2236945659297,0.130355723059129
425.53,444,3625,1252,4215875,2312444,2023-09-27,2023-09-29,425.88,-2373,-1903431,408556355,111857149,0.566003678978387,96.9661348187816,-0.823125230275847
353.44,355,14210,14672,1605730,2288832,2023-09-27,2023-12-15,425.88,462,683102,1064176186,228355863,0.215080174703327,95.438774740633,0.298450039146604
397.15,403,3911,3912,1759950,2288520,2023-09-27,2023-12-15,425.88,1,528570,1064176186,228355863,0.21505085624985,95.6538255968829,0.230965864401447
412.58,415,7033,9331,963521,2258102,2023-09-27,2023-10-13,425.88,2298,1294581,114856729,34649438,1.9660162879965,76.6806662237439,0.573304925995371
425.95,446,1785,1106,2438310,2217530,2023-09-27,2023-10-06,425.88,-679,-220780,162893327,54801933,1.3613387612864,80.1211758662158,-0.0995612235234698
373.69,375,17034,16664,1567128,2182984,2023-09-27,2023-11-17,425.88,-370,615856,1021033106,270136960,0.213801490585556,97.3758249519482,0.282116589035925
412.29,423,1851,2031,1445631,2175201,2023-09-27,2023-12-15,425.88,180,729570,1064176186,228355863,0.204402337565558,95.8582279344484,0.335403486850181
425.9,449,953,928,1807841,2143680,2023-09-27,2023-11-17,425.88,-25,335839.000000001,1021033106,270136960,0.209952056148119,97.5857770080964,0.156664707419018
411.04,415,4754,5411,1188500,2142756,2023-09-27,2023-10-27,425.88,657,954256,112653864,35070907,1.90207057611446,67.4047665155986,0.445340486737641
338.89,340,19338,19300,1489026,2142300,2023-09-27,2023-12-15,425.88,-38,653274.000000001,1064176186,228355863,0.201310650264824,96.0595385847133,0.304940484525977
408.33,411,7135,7995,1077385,2134665,2023-09-27,2023-10-20,425.88,860,1057280,1168890895,305484810,0.182623118131141,98.2419430172737,0.4952908301771
299.49,300,38637,41643,1468206,2123793,2023-09-27,2023-12-15,425.88,3006,655587,1064176186,228355863,0.199571558538898,96.2591101432522,0.308686863550261
421.63,426,10184,4824,2383056,2108088,2023-09-27,2023-10-06,425.88,-5360,-274968,162893327,54801933,1.2941524608924,81.4153283271082,-0.130434782608696
359.73,360,77193,77213,1389474,2084751,2023-09-27,2023-10-20,425.88,20,695277,1168890895,305484810,0.17835291633442,98.4202959336081,0.333506015826351
413.37,418,4250,4475,1266500,2071925,2023-09-27,2023-10-27,425.88,225,805425,112653864,35070907,1.83919567996354,69.2439621955622,0.38873270026666
422.31,427,4410,4395,1124550,2061255,2023-09-27,2023-10-06,425.88,-15,936705,162893327,54801933,1.26540174355945,82.6807300706677,0.454434313076257
426,455,744,706,1688880,2047400,2023-09-27,2023-10-20,425.88,-38,358520,1168890895,305484810,0.175157494061924,98.59545342767,0.175109895477191
419.74,423,5520,6277,960480,2046302,2023-09-27,2023-10-06,425.88,757,1085822,162893327,54801933,1.25622211645293,83.9369521871206,0.53062646667012
417.59,422,3845,4612,907420,2033892,2023-09-27,2023-10-13,425.88,767,1126472,114856729,34649438,1.77080787317215,78.451474096916,0.553850450269729
425.88,439,1567,1541,1261435,2021792,2023-09-27,2023-10-06,425.88,-26,760357,162893327,54801933,1.24117545956932,85.1781276466899,0.376080724426647
376.15,379,6773,6926,1490060,1973910,2023-09-27,2023-12-15,425.88,153,483850,1064176186,228355863,0.185487142633729,96.4445972858859,0.245122624638408
426.04,443,3599,1162,4131652,1970752,2023-09-27,2023-10-06,425.88,-2437,-2160900,162893327,54801933,1.20984207044896,86.3879697171389,-1.09648499659013
419.74,421,22369,15521,1364509,1955646,2023-09-27,2023-09-29,425.88,-6848,591137,408556355,111857149,0.47867227521158,97.4448070939932,0.302271985829746
369.47,370,35780,36406,1359640,1929518,2023-09-27,2023-10-27,425.88,626,569878,112653864,35070907,1.71278456991054,70.9567467654727,0.295347335448542
426.01,445,3513,1016,4717959,1929384,2023-09-27,2023-10-06,425.88,-2497,-2788575,162893327,54801933,1.18444630945502,87.5724160265939,-1.44531881678297
396.78,398,12585,15765,880950,1923330,2023-09-27,2023-10-20,425.88,3180,1042380,1168890895,305484810,0.164543158666661,98.7599965863367,0.541966277237916
399.41,403,5369,5336,1336881,1915624,2023-09-27,2023-11-17,425.88,-33,578743,1021033106,270136960,0.187616247577383,97.7733932556737,0.302117221333623
364.53,365,39450,39500,1301850,1856500,2023-09-27,2023-10-27,425.88,50,554650,112653864,35070907,1.64796832889815,72.6047150943709,0.298761109614867
423.47,436,1479,1474,1248276,1846922,2023-09-27,2023-10-27,425.88,-5,598646,112653864,35070907,1.63946617934028,74.2441812737111,0.324131717527865
416.3,422,3053,3229,1212041,1840530,2023-09-27,2023-10-27,425.88,176,628489,112653864,35070907,1.63379216180281,75.8779734355139,0.341471749985059
423.46,434,2280,1730,1493400,1823420,2023-09-27,2023-10-13,425.88,-550,330020,114856729,34649438,1.58756044671967,80.0390345436357,0.180989569051562
377.95,381,5757,5978,1237755,1823290,2023-09-27,2023-12-15,425.88,221,585535,1064176186,228355863,0.171333471279163,96.6159307571651,0.321142001546655
421.79,429,2386,2528,990190,1822688,2023-09-27,2023-10-13,425.88,142,832498,114856729,34649438,1.58692313099044,81.6259576746261,0.456741910848154
426.49,444,1492,1024,1900808,1793024,2023-09-27,2023-10-06,425.88,-468,-107784,162893327,54801933,1.1007350841327,88.6731511107266,-0.0601129711593375
423.12,434,1463,1648,1089935,1793024,2023-09-27,2023-10-27,425.88,185,703089,112653864,35070907,1.59162228114963,77.4695957166636,0.392124701063678
406.98,410,4866,5810,909942,1754620,2023-09-27,2023-10-27,425.88,944,844678,112653864,35070907,1.55753201683344,79.027127733497,0.481402240941059
409.06,410,12611,18530,643161,1741820,2023-09-27,2023-10-06,425.88,5919,1098659,162893327,54801933,1.06930101562724,89.7424521263539,0.630753464766738
425.23,437.5,1413,1410,1160073,1730070,2023-09-27,2023-10-13,425.88,-3,569997,114856729,34649438,1.50628527824434,83.1322429528705,0.329464703740311
368.87,370,13914,15019,1127034,1697147,2023-09-27,2023-11-17,425.88,1105,570113,1021033106,270136960,0.166218606431749,97.9396118621055,0.33592434833282
423.62,433,1725,1805,971175,1693090,2023-09-27,2023-10-13,425.88,80,721915,114856729,34649438,1.47408864481941,84.6063315976899,0.426389028344624
402.73,405,7239,7443,1035177,1689561,2023-09-27,2023-10-27,425.88,204,654384,112653864,35070907,1.49978077982305,80.5269085133201,0.387310076404463
424.27,431,3170,2485,1198260,1672405,2023-09-27,2023-10-06,425.88,-685,474145,162893327,54801933,1.02668723808434,90.7691393644382,0.283510872067472
416.82,419,7469,7670,858935,1672060,2023-09-27,2023-10-06,425.88,201,813125.000000001,162893327,54801933,1.02647544303641,91.7956148074746,0.486301328899681
397.45,401,4647,4506,1105986,1599630,2023-09-27,2023-11-17,425.88,-141,493644,1021033106,270136960,0.156667789770962,98.0962796518764,0.308598863487182
400.08,404,4379,3978,1121024,1559376,2023-09-27,2023-11-17,425.88,-401,438352,1021033106,270136960,0.15272531231715,98.2490049641936,0.28110731472076
405.87,408,7082,7221,920660,1538073,2023-09-27,2023-10-20,425.88,139,617413,1168890895,305484810,0.131583966183602,98.8915805525203,0.401419828577707
424.21,439,1172,1037,1205988,1533723,2023-09-27,2023-10-27,425.88,-135,327735,112653864,35070907,1.36144730907765,81.8883558223977,0.213685913297251
385.21,389,4002,3979,1160580,1508041,2023-09-27,2023-12-15,425.88,-23,347461,1064176186,228355863,0.141709711215056,96.7576404683801,0.23040553937194
424.87,442,876,870,1097628,1490310,2023-09-27,2023-10-27,425.88,-6,392682,112653864,35070907,1.3229106815191,83.2112665039168,0.263490146345391
425.95,445,2829,782,3739938,1489710,2023-09-27,2023-10-13,425.88,-2047,-2250228,114856729,34649438,1.2970158674813,85.9033474651712,-1.51051412691061
425.94,446,1369,742,2068559,1488452,2023-09-27,2023-10-13,425.88,-627,-580107,114856729,34649438,1.29592058990292,87.1992680550741,-0.389738466541078
393.27,398,3282,3104,1240596,1468192,2023-09-27,2023-12-15,425.88,-178,227596,1064176186,228355863,0.137965124508058,96.8956055928882,0.155017872321876
359.59,360,35226,35547,986328,1457427,2023-09-27,2023-10-27,425.88,321,471099,112653864,35070907,1.29372126996017,84.504987773877,0.323240203454444
425,443,803,803,1079232,1445400,2023-09-27,2023-10-27,425.88,0,366168,112653864,35070907,1.28304520473439,85.7880329786114,0.253333333333333
421.25,423,7708,8225,616640,1439375,2023-09-27,2023-09-29,425.88,517,822735,408556355,111857149,0.352307578228712,97.7971146722219,0.571591836734694
409.18,412,3765,5085,609930,1433970,2023-09-27,2023-10-20,425.88,1320,824040,1168890895,305484810,0.122677831278684,99.0142583837989,0.574656373564301
425.28,444,770,748,1071070,1400256,2023-09-27,2023-10-27,425.88,-22,329186,112653864,35070907,1.24297201203858,87.03100499065,0.235089869281046
421.17,431,1318,1421,831658,1396843,2023-09-27,2023-10-27,425.88,103,565185,112653864,35070907,1.23994237783091,88.2709473684809,0.404615980464519
423.69,437.5,987,986,895209,1361666,2023-09-27,2023-10-27,425.88,-1,466457,112653864,35070907,1.2087166402033,89.4796640086842,0.34256344801148
422.76,431,1719,1652,895599,1361248,2023-09-27,2023-10-13,425.88,-67,465649,114856729,34649438,1.18517043960045,88.3844384946745,0.342075066409648
418.09,419,27452,14933,1290244,1358903,2023-09-27,2023-09-29,425.88,-12519,68659.0000000002,408556355,111857149,0.33261090749647,98.1297255797184,0.0505253134329678
421.92,432.5,673,1281,461005,1355298,2023-09-27,2023-10-27,425.88,608,894293,112653864,35070907,1.20306392686184,90.682727935546,0.65984971570828
422.05,432,1554,1353,1041180,1346235,2023-09-27,2023-10-27,425.88,-201,305055,112653864,35070907,1.19501892984337,91.8777468653894,0.226598625054318
425.77,456,6964,440,17416964,1330120,2023-09-27,2023-11-17,425.88,-6524,-16086844,1021033106,270136960,0.130271975725731,98.3792769399193,-12.0942802153189
395.71,399,4018,4002,839762,1316658,2023-09-27,2023-11-17,425.88,-16,476896,1021033106,270136960,0.128953507213702,98.508230447133,0.362201877784512
425,442.5,766,749,975884,1310750,2023-09-27,2023-10-27,425.88,-17,334866,112653864,35070907,1.16351978836696,93.0412666537563,0.255476635514019
402.36,409,2086,1937,1034656,1286168,2023-09-27,2023-12-15,425.88,-149,251512,1064176186,228355863,0.120860438047803,97.016466030936,0.195551436515292
334.03,335,11286,13207,790020,1281079,2023-09-27,2023-12-15,425.88,1921,491059,1064176186,228355863,0.120382227760169,97.1368482586961,0.383316719733912
395.62,401,1821,2359,702906,1269142,2023-09-27,2023-12-15,425.88,538,566236,1064176186,228355863,0.119260515006488,97.2561087737026,0.446156537251151
408.18,409,217,15460,11501,1267720,2023-09-27,2023-10-06,425.88,15243,1256219,162893327,54801933,0.778251646858438,92.573866454333,0.990927807402266
324.19,325,15011,15368,975715,1244808,2023-09-27,2023-12-15,425.88,357,269093,1064176186,228355863,0.116973863574128,97.3730826372768,0.21617229323719
420.45,426,2756,2148,890188,1192140,2023-09-27,2023-10-13,425.88,-608,301952,114856729,34649438,1.03793657574908,89.4223750704236,0.25328568792256
354.74,355,46240,45412,832320,1180712,2023-09-27,2023-10-20,425.88,-828,348392,1168890895,305484810,0.101011309528594,99.1152696933275,0.295069415742366
395.04,398,2208,3909,470304,1157064,2023-09-27,2023-11-17,425.88,1701,686760,1021033106,270136960,0.113322868102966,98.621553315236,0.593536744726307
363.98,365,9731,11298,681170,1152396,2023-09-27,2023-11-17,425.88,1567,471226,1021033106,270136960,0.112865684102509,98.7344189993385,0.408909784483806
379.8,383,3545,3598,822440,1151360,2023-09-27,2023-12-15,425.88,53,328920,1064176186,228355863,0.108192610880319,97.4812752481571,0.285679544191217
420.2,429,1355,1300,758800,1144000,2023-09-27,2023-10-27,425.88,-55,385200,112653864,35070907,1.01550000983544,94.0567666635918,0.336713286713287
378.8,382,3365,3395,753760,1086400,2023-09-27,2023-12-15,425.88,30,332640,1064176186,228355863,0.102088358515476,97.5833636066726,0.306185567010309
406.36,408,6563,6585,544729,1079940,2023-09-27,2023-10-13,425.88,22,535211,114856729,34649438,0.940249656596088,90.3626247270197,0.495593273700391
359.82,360,59627,59679,775151,1074222,2023-09-27,2023-10-13,425.88,52,299071,114856729,34649438,0.93527128044888,91.2978960074686,0.278407070419336
374.85,375,71149,71511,711490,1072665,2023-09-27,2023-10-06,425.88,362,361175,162893327,54801933,0.658507637946397,93.2323740922794,0.336708105512905
423.87,437,806,807,709280,1059591,2023-09-27,2023-10-27,425.88,1,350311,112653864,35070907,0.940572264791557,94.9973389283833,0.33060964088974
425.27,448,488,461,830088,1047853,2023-09-27,2023-10-06,425.88,-27,217765,162893327,54801933,0.643275583658501,93.8756496759379,0.207820180884151
387.8,392,2433,2471,734766,1037820,2023-09-27,2023-12-15,425.88,38,303054,1064176186,228355863,0.0975233249581475,97.6808869316307,0.292010175174886
424.33,441,814,614,911680,1023538,2023-09-27,2023-10-27,425.88,-200,111858,112653864,35070907,0.908568924009566,95.9059078523929,0.109285634729732
421.11,427,1863,1736,657639,1022504,2023-09-27,2023-10-13,425.88,-127,364865,114856729,34649438,0.890243008748752,92.1881390162173,0.356834789888352
382.42,386,2683,2799,770021,1002042,2023-09-27,2023-12-15,425.88,116,232021,1064176186,228355863,0.0941612876873755,97.7750482193181,0.231548178619259
386.93,391,2116,2446,609408,995522,2023-09-27,2023-12-15,425.88,330,386114,1064176186,228355863,0.0935486071852392,97.8685968265033,0.387850795863879
399.15,400,13273,11694,663650,993990,2023-09-27,2023-10-13,425.88,-1579,330340,114856729,34649438,0.865417297405361,93.0535563136227,0.332337347458224
388.63,391,2005,4110,330825,974070,2023-09-27,2023-11-17,425.88,2105,643245,1021033106,270136960,0.0954004325889116,98.8298194319274,0.660368351350519
393.15,396,3040,3403,626240,969855,2023-09-27,2023-11-17,425.88,363,343615,1021033106,270136960,0.0949876154162625,98.9248070473437,0.354295229699285
404.4,405,15847,16052,602186,963120,2023-09-27,2023-10-06,425.88,205,360934,162893327,54801933,0.591258105987362,94.4669077819253,0.374754963036797
294.55,295,21138,21141,739830,951345,2023-09-27,2023-12-15,425.88,3,211515,1064176186,228355863,0.0893973209056569,97.957994147409,0.22233259227725
329.11,330,10368,10511,653184,935479,2023-09-27,2023-12-15,425.88,143,282295,1064176186,228355863,0.0879064023708571,98.0459005497798,0.301765191949793
419.4,427,1054,1188,524892,902880,2023-09-27,2023-10-27,425.88,134,377988,112653864,35070907,0.801463853916276,96.7073717063092,0.418646996278575
314.33,315,13318,13462,692536,901954,2023-09-27,2023-12-15,425.88,144,209418,1064176186,228355863,0.0847560781631699,98.130656627943,0.232182572503698
414.93,418,1850,2919,320050,896133,2023-09-27,2023-10-13,425.88,1069,576083,114856729,34649438,0.780218109815752,93.8337744234384,0.642854353092677
416.34,417,10269,13306,472374,878196,2023-09-27,2023-09-29,425.88,3037,405822,408556355,111857149,0.214951007187246,98.3446765869056,0.462108686443573
413.37,416,3362,3306,490852,869478,2023-09-27,2023-10-13,425.88,-56,378626,114856729,34649438,0.757010936642641,94.5907853600811,0.435463576996773
412.6,414,5773,6171,415656,863940,2023-09-27,2023-10-06,425.88,398,448284,162893327,54801933,0.530371633946675,94.997279415872,0.518883255781652
375.15,378,3342,3012,711846,858420,2023-09-27,2023-12-15,425.88,-330,146574,1064176186,228355863,0.0806652142091817,98.2113218421522,0.170748584608933
404.64,406,830,6196,69720,842656,2023-09-27,2023-10-13,425.88,5366,772936,114856729,34649438,0.733658364935676,95.3244437250168,0.917261610906467
414.36,416,4292,4976,377696,816064,2023-09-27,2023-10-06,425.88,684,438368,162893327,54801933,0.500980620280412,95.4982600361524,0.537173555015293
417.63,424,1184,1278,494912,814086,2023-09-27,2023-10-27,425.88,94,319174,112653864,35070907,0.722643654726304,97.4300153610355,0.392064229086362
389.78,390,36492,36771,583872,808962,2023-09-27,2023-10-06,425.88,279,225090,162893327,54801933,0.496620711786432,95.9948807479388,0.278245455287146
417.23,418,7920,10386,324720,799722,2023-09-27,2023-09-29,425.88,2466,475002,408556355,111857149,0.195743375476316,98.5404199623819,0.593958900718
399.55,401,4871,5502,448132,797790,2023-09-27,2023-10-20,425.88,631,349658,1168890895,305484810,0.0682518790601068,99.1835215723876,0.43828325749884
405.04,407,4244,4023,551720,788508,2023-09-27,2023-10-20,425.88,-221,236788,1168890895,305484810,0.0674577929704894,99.2509793653581,0.300298792149224
349.3,350,10901,11143,523248,780010,2023-09-27,2023-11-17,425.88,242,256762,1021033106,270136960,0.0763941928441251,99.0012012401878,0.329177831053448
425.63,448,2140,347,3824180,776239,2023-09-27,2023-10-13,425.88,-1793,-3047941,114856729,34649438,0.675832410306583,96.0002761353233,-3.92654968379584
426.15,460,405,227,1163160,768395,2023-09-27,2023-10-20,425.88,-178,-394765,1168890895,305484810,0.0657371020072836,99.3167164673654,-0.513752692300184
364.66,365,27192,22590,625416,768060,2023-09-27,2023-10-20,425.88,-4602,142644,1168890895,305484810,0.0657084423606534,99.3824249097261,0.185719865635497
400.41,402,4521,4830,492789,767970,2023-09-27,2023-10-20,425.88,309,275181,1168890895,305484810,0.065700742754096,99.4481256524802,0.3583225907262
356.64,358,5605,5605,700625,762280,2023-09-27,2023-12-15,425.88,0,61655,1064176186,228355863,0.071630995884736,98.2829528380369,0.0808823529411765
418.33,421,3786,2835,537612,756945,2023-09-27,2023-10-06,425.88,-951,219333,162893327,54801933,0.464687543646278,96.4595682915851,0.289760814854448
352.49,354,2883,4883,320013,737333,2023-09-27,2023-12-15,425.88,2000,417320,1064176186,228355863,0.0692867412088472,98.3522395792458,0.565985789324498
359.1,360,8043,8098,498666,728820,2023-09-27,2023-11-17,425.88,55,230154,1021033106,270136960,0.0713806433618226,99.0725818835496,0.315789906972915
309.69,310,23981,23466,527582,727446,2023-09-27,2023-11-17,425.88,-515,199864,1021033106,270136960,0.0712460737781406,99.1438279573278,0.274747541398262
415.44,416,13418,12964,442794,725984,2023-09-27,2023-09-29,425.88,-454,283190,408556355,111857149,0.177694947371459,98.7181149097534,0.390077467272006
391.32,396,1639,1544,576928,722592,2023-09-27,2023-12-15,425.88,-95,145664,1064176186,228355863,0.0679015382514865,98.4201411174973,0.201585403657942
390.33,393,2462,2704,430850,721968,2023-09-27,2023-11-17,425.88,242,291118,1021033106,270136960,0.0707095583637226,99.2145375156915,0.403228397934534
402.82,404,833,6065,60809,715670,2023-09-27,2023-10-13,425.88,5232,654861,114856729,34649438,0.623098016312131,96.6233741516355,0.915032067852502
410.89,412,7668,6407,460080,711177,2023-09-27,2023-10-06,425.88,-1261,251097,162893327,54801933,0.436590628417823,96.8961589200029,0.353072441881557
402.28,404,11577,4127,1146123,709844,2023-09-27,2023-10-20,425.88,-7450,-436279,1168890895,305484810,0.0607279946346062,99.5088536471148,-0.614612506409859
389.52,392,2460,2848,420660,706304,2023-09-27,2023-11-17,425.88,388,285644,1021033106,270136960,0.0691754259337405,99.2837129416252,0.404420759333092
347.66,349,5158,5203,505484,697202,2023-09-27,2023-12-15,425.88,45,191718,1064176186,228355863,0.0655156551304372,98.4856567726277,0.274981999477913
411.74,413,569,5463,42106,688338,2023-09-27,2023-10-06,425.88,4894,646232,162893327,54801933,0.422569796244631,97.3187287162475,0.938829470405528
309.37,310,10770,10705,495420,674415,2023-09-27,2023-12-15,425.88,-65,178995,1064176186,228355863,0.0633743743632316,98.5490311469909,0.265407797869265
391.33,394,2335,2506,417965,669102,2023-09-27,2023-11-17,425.88,171,251137,1021033106,270136960,0.0655318614125329,99.3492448030378,0.375334403424291
403.71,405,1667,5153,126692,664737,2023-09-27,2023-10-13,425.88,3486,538045,114856729,34649438,0.578753204786112,97.2021273564216,0.809410338223989
369.6,372,2770,2751,473670,660240,2023-09-27,2023-12-15,425.88,-19,186570,1064176186,228355863,0.0620423580874981,98.6110735050784,0.282579062159215
349.78,350,29873,29864,507841,657008,2023-09-27,2023-10-20,425.88,-9,149167,1168890895,305484810,0.0562078122783222,99.5650614593931,0.227039853396001
343.77,345,5163,5297,459507,651531,2023-09-27,2023-12-15,425.88,134,192024,1064176186,228355863,0.0612239785640157,98.6722974836424,0.294727342213955
357.54,359,4437,4437,616743,647802,2023-09-27,2023-12-15,425.88,0,31059.0000000001,1064176186,228355863,0.0608735666633307,98.7331710503058,0.0479452054794522
406.73,409,2887,2783,378197,631741,2023-09-27,2023-10-20,425.88,-104,253544,1168890895,305484810,0.0540461905129306,99.619107649906,0.401341689078277
345.74,347,4977,4997,457884,629622,2023-09-27,2023-12-15,425.88,20,171738,1064176186,228355863,0.0591652029319138,98.7923362532377,0.272763658194917
418.84,426,799,865,377128,619340,2023-09-27,2023-10-27,425.88,66,242212,112653864,35070907,0.549772531548496,97.979787892584,0.39108082797817
284.6,285,15377,15457,445933,618280,2023-09-27,2023-12-15,425.88,80,172347,1064176186,228355863,0.0580994019725226,98.8504356552102,0.27875234521576
339.44,340,10627,10917,414453,611352,2023-09-27,2023-11-17,425.88,290,196899,1021033106,270136960,0.0598758254171633,99.4091206284549,0.322071408942802
344.37,345,8108,9545,381076,601335,2023-09-27,2023-11-17,425.88,1437,220259,1021033106,270136960,0.0588947602645119,99.4680153887195,0.36628335287319
425.77,480,107,107,516489,580261,2023-09-27,2023-12-15,425.88,0,63772,1064176186,228355863,0.0545267792714918,98.9049624344817,0.109902268117278
425.59,451,297,227,603207,576807,2023-09-27,2023-11-17,425.88,-70,-26400,1021033106,270136960,0.0564924875217513,99.5245078762412,-0.0457692087648035
314.66,315,16922,16817,406128,571778,2023-09-27,2023-11-17,425.88,-105,165650,1021033106,270136960,0.0559999471750723,99.5805078234163,0.28971034212579
329.54,330,12095,12400,374945,570400,2023-09-27,2023-11-17,425.88,305,195455,1021033106,270136960,0.0558649858313213,99.6363728092476,0.342663043478261
425.4,458,279,171,734328,557460,2023-09-27,2023-10-20,425.88,-108,-176868,1168890895,305484810,0.0476913630163917,99.6667990129224,-0.317274782047142
304.73,305,20799,20602,415980,556254,2023-09-27,2023-11-17,425.88,-197,140274,1021033106,270136960,0.0544795263475032,99.6908523355951,0.25217616412646
415.18,417,751,3010,69843,547820,2023-09-27,2023-10-06,425.88,2259,477977,162893327,54801933,0.336305980170692,97.6550346964182,0.872507392939287
399.59,400,12283,13157,307075,539437,2023-09-27,2023-10-06,425.88,874,232362,162893327,54801933,0.331159667455254,97.9861943638735,0.430749095816564
274.67,275,16180,16142,388320,532686,2023-09-27,2023-12-15,425.88,-38,144366,1064176186,228355863,0.0500561849633422,98.955018619445,0.271015194692558
371.45,374,2091,2081,424473,530655,2023-09-27,2023-12-15,425.88,-10,106182,1064176186,228355863,0.0498653331075386,99.0048839525526,0.200096107640557
394.9,396,4987,4785,319168,526350,2023-09-27,2023-10-20,425.88,-202,207182,1168890895,305484810,0.0450298656830585,99.7118288786055,0.393620214686045
359.19,361,2934,2883,375552,521823,2023-09-27,2023-12-15,425.88,-51,146271,1064176186,228355863,0.0490353953475896,99.0539193479002,0.280307690538746
384.27,388,1381,1387,371489,517351,2023-09-27,2023-12-15,425.88,6,145862,1064176186,228355863,0.0486151641810936,99.1025345120813,0.281940114158473
380.7,384,1421,1500,333935,495000,2023-09-27,2023-12-15,425.88,79,161065,1064176186,228355863,0.0465148540732333,99.1490493661545,0.325383838383838
426.4,447,2126,240,3401600,494400,2023-09-27,2023-10-13,425.88,-1886,-2907200,114856729,34649438,0.430449312203554,97.6325766686251,-5.88025889967638
365.84,368,1874,2284,305462,493344,2023-09-27,2023-12-15,425.88,410,187882,1064176186,228355863,0.0463592407432429,99.1954086068977,0.380833657650645
374.3,377,1660,1773,345280,478710,2023-09-27,2023-12-15,425.88,113,133430,1064176186,228355863,0.0449840925119142,99.2403926994096,0.278728248835412
410,412,1721,2322,209962,464400,2023-09-27,2023-10-13,425.88,601,254438,114856729,34649438,0.404329815103824,98.036906483729,0.547885443583118
361.16,363,2524,2522,358408,464048,2023-09-27,2023-12-15,425.88,-2,105640,1064176186,228355863,0.0436063131373248,99.283999012547,0.22764886391063
426.54,450,641,194,1146749,455124,2023-09-27,2023-10-27,425.88,-447,-691625,112653864,35070907,0.404002121045755,98.3837900136297,-1.51964080118825
416.02,418,2265,2291,240090,453618,2023-09-27,2023-10-06,425.88,26,213528,162893327,54801933,0.278475495807143,98.2646698596806,0.470722061293864
415.46,419,1011,1202,190068,425508,2023-09-27,2023-10-13,425.88,191,235440,114856729,34649438,0.370468499063734,98.4073749827927,0.553315096308413
368.76,371,1922,1898,344038,425152,2023-09-27,2023-12-15,425.88,-24,81114.0000000001,1064176186,228355863,0.0399512792705925,99.3239502918176,0.190788235736866
299.74,300,13208,16152,237744,419952,2023-09-27,2023-11-17,425.88,2944,182208,1021033106,270136960,0.0411301061182242,99.7319824417133,0.433878157503715
425.74,449,540,178,915840,414028,2023-09-27,2023-10-27,425.88,-362,-501812,112653864,35070907,0.367522236077051,98.7513122497068,-1.21202430753476
239.82,240,22378,22995,268536,413910,2023-09-27,2023-12-15,425.88,617,145374,1064176186,228355863,0.0388948752514182,99.362845167069,0.351221279988403
394.68,395,12791,12779,281402,408928,2023-09-27,2023-10-06,425.88,-12,127526,162893327,54801933,0.251040363366143,98.5157102230468,0.311854409578214
383.63,387,1196,1208,304980,407096,2023-09-27,2023-12-15,425.88,12,102116,1064176186,228355863,0.0382545677450444,99.401099734814,0.250840096684811
363.97,366,1874,1966,273604,399098,2023-09-27,2023-12-15,425.88,92,125494,1064176186,228355863,0.0375030004665036,99.4386027352805,0.314444071380964
304.45,305,7088,7072,333136,388960,2023-09-27,2023-12-15,425.88,-16,55824.0000000001,1064176186,228355863,0.0365503386673229,99.4751530739479,0.143521184697656
289.57,290,9134,9022,301422,387946,2023-09-27,2023-12-15,425.88,-112,86524,1064176186,228355863,0.0364550536935244,99.5116081276414,0.22303104040253
409.76,410,16907,15843,304326,380232,2023-09-27,2023-09-29,425.88,-1064,75906,408556355,111857149,0.0930672097855386,98.8111821195389,0.199630751751562
324.57,325,8766,8826,245448,379518,2023-09-27,2023-11-17,425.88,60,134070,1021033106,270136960,0.0371699994613103,99.7691524411746,0.353263876812167
359.9,360,37110,37089,296880,370890,2023-09-27,2023-10-06,425.88,-21,74010,162893327,54801933,0.227688885008776,98.7433991080555,0.199547035509181
351.7,353,2750,2750,280500,357500,2023-09-27,2023-12-15,425.88,0,77000,1064176186,228355863,0.033594061275113,99.5452021889165,0.215384615384615
413.94,417,792,1115,148896,341190,2023-09-27,2023-10-13,425.88,323,192294,114856729,34649438,0.297057040515232,98.7044320233079,0.563597995251913
429.16,447.5,180,180,330120,330120,2023-09-27,2023-10-27,425.88,0,0,112653864,35070907,0.29303921612489,99.0443514658317,0
426.06,448,162,147,271674,322518,2023-09-27,2023-09-29,425.88,-15,50844,408556355,111857149,0.0789408844221748,98.8901230039611,0.157647015050323
427.42,454,124,121,281728,321618,2023-09-27,2023-10-20,425.88,-3,39890,1168890895,305484810,0.0275148006863378,99.7393436792918,0.124029127722951
407.81,408,16737,16885,301266,320815,2023-09-27,2023-09-29,425.88,148,19549,408556355,111857149,0.0785240508619674,98.9686470548231,0.0609354300765239
334.55,335,6925,6921,290850,311445,2023-09-27,2023-11-17,425.88,-4,20595,1021033106,270136960,0.0305029286680152,99.7996553698426,0.0661272455810817
401.51,402,6234,6236,199488,305564,2023-09-27,2023-10-06,425.88,2,106076,162893327,54801933,0.18758533920791,98.9309844472635,0.347148224267257
369.97,370,101513,101512,304539,304536,2023-09-27,2023-09-29,425.88,-1,-3.00000000005821,408556355,111857149,0.0745395332303667,99.0431865880534,-9.8510520925546e-06
425.1,450,146,122,258420,303780,2023-09-27,2023-10-06,425.88,-24,45360,162893327,54801933,0.186490143945553,99.117474591209,0.149318585818685
364.88,367,1324,1390,202572,294680,2023-09-27,2023-12-15,425.88,66,92108,1064176186,228355863,0.0276909034309099,99.5728930923474,0.312569566987919
319.62,320,7751,7717,201526,293246,2023-09-27,2023-11-17,425.88,-34,91720,1021033106,270136960,0.0287205182943402,99.828375888137,0.312774939811626
425.55,470,275,64,1053800,284480,2023-09-27,2023-10-20,425.88,-211,-769320,1168890895,305484810,0.0243376008160283,99.7636812801078,-2.7043025871766
426.21,500,38,38,263606,280402,2023-09-27,2023-11-17,425.88,0,16796,1021033106,270136960,0.0274625767129631,99.8558384648499,0.0598997154085919
384.95,385,55601,55568,278005,277840,2023-09-27,2023-09-29,425.88,-33,-165,408556355,111857149,0.0680053061468105,99.1111918942003,-0.000593866973797869
199.93,200,38179,38330,190895,268310,2023-09-27,2023-12-15,425.88,151,77415.0000000001,1064176186,228355863,0.0252129302957358,99.5981060226431,0.288528194998323
404.87,405,20364,20417,244368,265421,2023-09-27,2023-09-29,425.88,53,21053,408556355,111857149,0.0649655786164433,99.1761574728167,0.0793192701406446
411.7,412,4666,8485,97986,254550,2023-09-27,2023-09-29,425.88,3819,156564,408556355,111857149,0.0623047461836691,99.2384622190004,0.615061873895109
355.37,357,1380,1530,165600,249390,2023-09-27,2023-12-15,425.88,150,83790,1064176186,228355863,0.0234350292067145,99.6215410518499,0.335979790689282
425.85,450,582,103,1101144,248745,2023-09-27,2023-10-13,425.88,-479,-852399,114856729,34649438,0.216569810202413,98.9210018335103,-3.42679852861364
362.05,364,825,1267,106425,247065,2023-09-27,2023-12-15,425.88,442,140640,1064176186,228355863,0.0232165503466735,99.6447576021965,0.569242911784348
425.09,500,31,31,209994,232221,2023-09-27,2023-12-15,425.88,0,22227,1064176186,228355863,0.0218216685408895,99.6665792707374,0.0957148578293953
350.6,352,1650,1644,174900,230160,2023-09-27,2023-12-15,425.88,-6,55260,1064176186,228355863,0.021627997603021,99.6882072683404,0.240093847758081
405.33,406,1737,3369,74691,225723,2023-09-27,2023-10-06,425.88,1632,151032,162893327,54801933,0.138571053926598,99.2560456451356,0.669103281455589
425.77,470,51,51,199767,225573,2023-09-27,2023-11-17,425.88,0,25806,1021033106,270136960,0.0220926235079394,99.8779310883579,0.114401989599819
411.68,414,766,958,98048,222256,2023-09-27,2023-10-13,425.88,192,124208,114856729,34649438,0.193507164913255,99.1145089984236,0.558851054639695
269.7,270,7339,7335,168797,220050,2023-09-27,2023-12-15,425.88,-4,51253,1064176186,228355863,0.020677966947101,99.7088852352875,0.232915246534878
279.83,280,10275,12892,113025,219164,2023-09-27,2023-11-17,425.88,2617,106139,1021033106,270136960,0.0214649259374749,99.8993960142954,0.484290303151978
344.74,345,7334,8295,154014,215670,2023-09-27,2023-10-27,425.88,961,61656,112653864,35070907,0.191444831399658,99.2357962972313,0.285881207400195
366.77,369,892,914,132908,203822,2023-09-27,2023-12-15,425.88,22,70914,1064176186,228355863,0.0191530314887163,99.7280382667763,0.347921225382932
219.88,220,17964,16862,143712,202344,2023-09-27,2023-12-15,425.88,-1102,58632,1064176186,228355863,0.0190141447123118,99.7470524114886,0.289763966314791
274.85,275,7525,13482,82775,202230,2023-09-27,2023-11-17,425.88,5957,119455,1021033106,270136960,0.0198064096856033,99.9192024239809,0.590688819660782
329.85,330,13095,13062,130950,195930,2023-09-27,2023-10-20,425.88,-33,64980,1168890895,305484810,0.0167620434754092,99.7804433235833,0.331649058337161
360.14,362,1037,1048,137921,194928,2023-09-27,2023-12-15,425.88,11,57007,1064176186,228355863,0.0183172676258328,99.7653696791144,0.292451571862431
416.87,421,62,452,13578,186676,2023-09-27,2023-10-13,425.88,390,173098,114856729,34649438,0.162529441352975,99.2770384397766,0.927264351068161
413.6,414,4432,4482,119664,179280,2023-09-27,2023-09-29,425.88,50,59616,408556355,111857149,0.0438813392096177,99.28234355821,0.332530120481928
339.81,340,9383,9410,121979,178790,2023-09-27,2023-10-20,425.88,27,56811,1168890895,305484810,0.0152956961821488,99.7957390197654,0.317752670731025
294.77,295,7510,7561,120160,173903,2023-09-27,2023-11-17,425.88,51,53743,1021033106,270136960,0.0170320628173637,99.9362344867983,0.309040097065606
412.64,413,3930,4809,86460,173124,2023-09-27,2023-09-29,425.88,879,86664,408556355,111857149,0.0423745703331429,99.3247181285431,0.500589173078256
407.1,408,1346,1874,65954,168660,2023-09-27,2023-10-06,425.88,528,102706,162893327,54801933,0.10354015299841,99.359585798134,0.608952923040436
279.62,280,4478,4398,125384,167124,2023-09-27,2023-12-15,425.88,-80,41740,1064176186,228355863,0.0157045423679496,99.7810742214823,0.249754673176803
425.5,465,49,42,160426,165900,2023-09-27,2023-10-20,425.88,-7,5474,1168890895,305484810,0.0141929414207645,99.8099319611862,0.0329957805907173
264.73,265,6142,6105,135124,164835,2023-09-27,2023-12-15,425.88,-37,29711,1064176186,228355863,0.0154894464063867,99.7965636678887,0.180246913580247
426,464,43,43,140180,163400,2023-09-27,2023-10-20,425.88,0,23220,1168890895,305484810,0.0139790634608374,99.823911024647,0.142105263157895
425.42,447,158,74,246796,159692,2023-09-27,2023-09-29,425.88,-84,-87104,408556355,111857149,0.0390868965922706,99.3638050251354,-0.545449991233124
425.91,451,74,63,147260,158067,2023-09-27,2023-09-29,425.88,-11,10807,408556355,111857149,0.0386891546455078,99.4024941797809,0.0683697419448715
324.87,325,11954,12019,95632,156247,2023-09-27,2023-10-20,425.88,65,60615,1168890895,305484810,0.0133671158418939,99.8372781404889,0.387943448514212
426.01,456,53,51,136846,152949,2023-09-27,2023-10-20,425.88,-2,16103,1168890895,305484810,0.013084968037158,99.8503631085261,0.105283460499905
425.96,465,54,39,179658,152256,2023-09-27,2023-12-15,425.88,-15,-27402,1064176186,228355863,0.0143074052965136,99.8108710731852,-0.179973203026482
399.91,400,17338,16877,156042,151893,2023-09-27,2023-09-29,425.88,-461,-4149,408556355,111857149,0.0371779800120843,99.439672159793,-0.0273152811518635
418.55,423,411,341,107271,151745,2023-09-27,2023-10-13,425.88,-70,44474,114856729,34649438,0.132116769579952,99.4091552093565,0.293083791887706
370.51,373,655,602,115935,149898,2023-09-27,2023-12-15,425.88,-53,33963,1064176186,228355863,0.0140858254462011,99.8249568986314,0.22657407036785
397.91,398,2984,16231,23872,146079,2023-09-27,2023-09-29,425.88,13247,122207,408556355,111857149,0.0357549205176358,99.4754270803106,0.836581575722726
304.91,305,15921,15991,95526,143919,2023-09-27,2023-10-20,425.88,70,48393,1168890895,305484810,0.0123124408459012,99.862675549372,0.336251641548371
349.57,351,985,986,102440,140998,2023-09-27,2023-12-15,425.88,1,38558,1064176186,228355863,0.0132494977669046,99.8382063963984,0.273464871842154
410,411,279,1370,16182,137000,2023-09-27,2023-10-06,425.88,1091,120818,162893327,54801933,0.0841041204837077,99.4436899186177,0.881883211678832
209.9,210,13224,13168,79344,131680,2023-09-27,2023-12-15,425.88,-56,52336,1064176186,228355863,0.0123738908775018,99.8505802872759,0.397448359659781
408.4,412,0,356,0,128160,2023-09-27,2023-10-27,425.88,356,128160,112653864,35070907,0.11376440669625,99.3495607039276,1
354.97,355,42530,42530,85060,127590,2023-09-27,2023-09-29,425.88,0,42530,408556355,111857149,0.0312294738384378,99.5066565541491,0.333333333333333
344.8,345,6339,6300,95085,126000,2023-09-27,2023-10-20,425.88,-39,30915,1168890895,305484810,0.0107794491803275,99.8734549985523,0.245357142857143
426,485,21,21,114933,123900,2023-09-27,2023-10-20,425.88,0,8967,1168890895,305484810,0.0105997916939887,99.8840547902463,0.0723728813559322
299.93,300,17478,17224,87390,120568,2023-09-27,2023-10-20,425.88,-254,33178,1168890895,305484810,0.0103147351489978,99.8943695253953,0.275180810828744
249.78,250,5419,5395,75866,118690,2023-09-27,2023-12-15,425.88,-24,42824,1064176186,228355863,0.0111532283433375,99.8617335156192,0.36080545960064
314.89,315,11523,10244,92184,112684,2023-09-27,2023-10-20,425.88,-1279,20500,1168890895,305484810,0.0096402496145716,99.9040097750098,0.181924674310461
426.02,446,72,53,106416,105894,2023-09-27,2023-09-29,425.88,-19,-521.999999999986,408556355,111857149,0.0259190681295363,99.5325756222786,-0.0049294577596463
410.07,414,0,266,0,104538,2023-09-27,2023-10-27,425.88,266,104538,112653864,35070907,0.0927957517728819,99.4423564557005,1
234.84,235,6365,6422,76380,102752,2023-09-27,2023-12-15,425.88,57,26372,1064176186,228355863,0.00965554401158156,99.8713890596308,0.256656804733728
364.9,365,10573,10143,84584,101430,2023-09-27,2023-10-06,425.88,-430,16846,162893327,54801933,0.0622677440924268,99.5059576627101,0.166084984718525
425.18,455,61,34,145607,101388,2023-09-27,2023-09-29,425.88,-27,-44219,408556355,111857149,0.0248161603066975,99.5573917825853,-0.436136426401547
402.88,403,8221,8447,98652,101364,2023-09-27,2023-09-29,425.88,226,2712,408556355,111857149,0.0248102859640991,99.5822020685494,0.0267550609683911
259.74,260,3852,3856,77040,100256,2023-09-27,2023-12-15,425.88,4,23216,1064176186,228355863,0.00942099638376986,99.8808100560145,0.231567187998723
284.8,285,4817,4971,62621,99420,2023-09-27,2023-11-17,425.88,154,36799,1021033106,270136960,0.0097371965135869,99.9459716833119,0.37013679340173
389.94,390,16538,16442,99228,98652,2023-09-27,2023-09-29,425.88,-96,-576,408556355,111857149,0.0241464852504864,99.6063485537999,-0.00583870575355796
425.67,465,27,25,91098,98325,2023-09-27,2023-11-17,425.88,-2,7227,1021033106,270136960,0.00962995219471366,99.9556016355066,0.0735011441647597
400.97,402,904,929,50624,95687,2023-09-27,2023-10-13,425.88,25,45063,114856729,34649438,0.0833098772993962,99.4924650866559,0.470941716220594
406.83,407,5489,5540,82335,94180,2023-09-27,2023-09-29,425.88,51,11845,408556355,111857149,0.0230518994129953,99.6294004532129,0.12576980250584
379.95,380,19117,18808,76468,94040,2023-09-27,2023-09-29,425.88,-309,17572,408556355,111857149,0.023017632414505,99.6524180856274,0.186856656741812
425.69,455,38,31,95456,90861,2023-09-27,2023-10-27,425.88,-7,-4595,112653864,35070907,0.0806550230713791,99.5230114787718,-0.0505717524570498
354.44,356,577,577,63470,90012,2023-09-27,2023-12-15,425.88,0,26542,1064176186,228355863,0.00845837382795935,99.8892684298425,0.294871794871795
309.9,310,9618,8889,57708,88890,2023-09-27,2023-10-20,425.88,-729,31182,1168890895,305484810,0.00760464474316912,99.911614419753,0.350793115086062
425.93,451,37,35,75850,87745,2023-09-27,2023-10-06,425.88,-2,11895,162893327,54801933,0.053866540524401,99.5598242032346,0.135563279958972
403.41,406,0,336,0,87024,2023-09-27,2023-10-27,425.88,336,87024,112653864,35070907,0.077249014734195,99.600260493506,1
393,394,0,861,0,86100,2023-09-27,2023-10-20,425.88,861,86100,1168890895,305484810,0.00736595693989044,99.9189803766929,1
334.86,335,6119,6118,67309,85652,2023-09-27,2023-10-20,425.88,-1,18343,1168890895,305484810,0.0073276300094715,99.9263080067024,0.214157287629011
394.37,395,1377,1349,60588,84987,2023-09-27,2023-10-13,425.88,-28,24399,114856729,34649438,0.0739939233338258,99.5664590099897,0.287090966853754
411.78,416,0,192,0,81024,2023-09-27,2023-10-27,425.88,192,81024,112653864,35070907,0.0719229657315616,99.6721834592376,1
399.95,402,0,387,0,79335,2023-09-27,2023-10-27,425.88,387,79335,112653864,35070907,0.0704236829373203,99.7426071421749,1
425.48,475,26,16,116298,79232,2023-09-27,2023-10-20,425.88,-10,-37066,1168890895,305484810,0.00677839140837862,99.9330863981108,-0.467816033925687
346.69,348,554,598,52076,78338,2023-09-27,2023-12-15,425.88,44,26262,1064176186,228355863,0.00736137502704839,99.8966298048695,0.33523960274707
425.36,453,44,28,96668,77392,2023-09-27,2023-10-20,425.88,-16,-19276,1168890895,305484810,0.00662097722987226,99.9397073753406,-0.249069671283854
374.96,375,19293,19238,77172,76952,2023-09-27,2023-09-29,425.88,-55,-220,408556355,111857149,0.0188351004844852,99.6712531861119,-0.00285892504418339
426.05,462,23,21,72289,75495,2023-09-27,2023-10-20,425.88,-2,3206,1168890895,305484810,0.00645868663387955,99.9461660619745,0.0424663885025498
384.8,385,3735,3728,56025,74560,2023-09-27,2023-10-06,425.88,-7,18535,162893327,54801933,0.0457722863012062,99.6055964895358,0.248591738197425
403.46,404,1170,1376,44460,74304,2023-09-27,2023-10-06,425.88,206,29844,162893327,54801933,0.0456151282366527,99.6512116177724,0.401647286821706
224.88,225,6149,6155,55341,73860,2023-09-27,2023-12-15,425.88,6,18519,1064176186,228355863,0.00694058004413942,99.9035703849137,0.250731112916328
425.18,466,23,18,77625,73476,2023-09-27,2023-12-15,425.88,-5,-4149,1064176186,228355863,0.00690449579370685,99.9104748807074,-0.0564674179323861
396.92,397,8908,9025,62356,72200,2023-09-27,2023-09-29,425.88,117,9843.99999999999,408556355,111857149,0.0176719806500134,99.6889251667619,0.136343490304709
394.94,395,12033,12032,84231,72192,2023-09-27,2023-09-29,425.88,-1,-12039,408556355,111857149,0.0176700225358139,99.7065951892977,-0.166763630319149
254.8,255,3555,3580,60435,71600,2023-09-27,2023-12-15,425.88,25,11165,1064176186,228355863,0.00672820919523941,99.9172030899026,0.155935754189944
407.36,409,132,421,12936,69044,2023-09-27,2023-10-13,425.88,289,56108,114856729,34649438,0.0601131519251258,99.6265721619149,0.812641214298129
425.61,447.5,1224,31,1949832,67859,2023-09-27,2023-10-13,425.88,-1193,-1881973,114856729,34649438,0.0590814317896864,99.6856535937046,-27.7335799230758
289.94,290,8260,10811,41300,64866,2023-09-27,2023-10-20,425.88,2551,23566,1168890895,305484810,0.00554936309945335,99.951715425074,0.363302808867511
319.88,320,5772,5395,46176,64740,2023-09-27,2023-10-20,425.88,-377,18564,1168890895,305484810,0.00553858365027302,99.9572540087242,0.286746987951807
379.67,380,1915,1915,44045,63195,2023-09-27,2023-10-13,425.88,0,19150,114856729,34649438,0.0550207206405817,99.7406743143451,0.303030303030303
425.1,447.5,30,28,52170,62720,2023-09-27,2023-10-06,425.88,-2,10550,162893327,54801933,0.0385037258156069,99.689715343588,0.168207908163265
289.8,290,3036,3042,45540,60840,2023-09-27,2023-11-17,425.88,6,15300,1021033106,270136960,0.00595867064862831,99.9615603061553,0.251479289940828
408.79,409,4253,2878,72301,60438,2023-09-27,2023-09-29,425.88,-1375,-11863,408556355,111857149,0.0147930632482757,99.721388252546,-0.196283794963434
149.98,150,28975,30135,57950,60270,2023-09-27,2023-12-15,425.88,1160,2320.00000000001,1064176186,228355863,0.00566353586867429,99.9228666257713,0.0384934461589515
425.92,453,25,22,56250,59576,2023-09-27,2023-09-29,425.88,-3,3326,408556355,111857149,0.0145820764432853,99.7359703289893,0.0558278501409964
244.81,245,2649,3119,37086,59261,2023-09-27,2023-12-15,425.88,470,22175,1064176186,228355863,0.00556872074188663,99.9284353465132,0.37419213310609
405.84,406,3303,3580,39636,57280,2023-09-27,2023-09-29,425.88,277,17644,408556355,111857149,0.0140200976680439,99.7499904266573,0.308030726256983
409.13,411,173,298,20241,55726,2023-09-27,2023-10-13,425.88,125,35485,114856729,34649438,0.0485178365126522,99.7891921508578,0.636776370096544
432.26,525,6,6,55644,55644,2023-09-27,2023-12-15,425.88,0,0,1064176186,228355863,0.00522883341424443,99.9336641799274,0
410.74,411,2045,2110,38855,54860,2023-09-27,2023-09-29,425.88,65,16005,408556355,111857149,0.013427768122711,99.76341819478,0.291742617572002
189.96,190,13534,13534,54136,54136,2023-09-27,2023-12-15,425.88,0,0,1064176186,228355863,0.00508712755577487,99.9387513074832,0
425.85,475,13,11,56810,54065,2023-09-27,2023-11-17,425.88,-2,-2745,1021033106,270136960,0.00529512703185552,99.9668554331871,-0.0507722186257283
428.1,449,26,25,47450,52250,2023-09-27,2023-10-06,425.88,-1,4800,162893327,54801933,0.0320762065348447,99.7217915501229,0.091866028708134
401.7,404,0,218,0,50140,2023-09-27,2023-10-27,425.88,218,50140,112653864,35070907,0.0445080161653399,99.7871151583402,1
229.87,230,3795,3821,34155,49673,2023-09-27,2023-12-15,425.88,26,15518,1064176186,228355863,0.00466774211389842,99.9434190495971,0.312403116381133
426.7,480,5,9,24290,47970,2023-09-27,2023-09-29,425.88,4,23680,408556355,111857149,0.0117413422684369,99.7751595370485,0.493641859495518
427.14,455,18,17,42264,47362,2023-09-27,2023-10-06,425.88,-1,5098,162893327,54801933,0.0290754697397764,99.7508670198626,0.107639035513703
431.59,510,6,6,47046,47046,2023-09-27,2023-12-15,425.88,0,0,1064176186,228355863,0.0044208844944027,99.9478399340915,0
179.96,180,11651,11652,34953,46608,2023-09-27,2023-12-15,425.88,1,11655,1064176186,228355863,0.00437972589625305,99.9522196599878,0.250064366632338
264.96,265,11712,11506,35136,46024,2023-09-27,2023-10-20,425.88,-206,10888,1168890895,305484810,0.00393740769107454,99.9611914164153,0.236572223187902
294.94,295,10646,7621,53230,45726,2023-09-27,2023-10-20,425.88,-3025,-7504.00000000001,1168890895,305484810,0.00391191343825122,99.9651033298536,-0.164107947338495
344.98,346,429,440,37752,44880,2023-09-27,2023-12-15,425.88,11,7128,1064176186,228355863,0.00421734676930649,99.9564370067571,0.158823529411765
433.21,463,15,15,44685,44685,2023-09-27,2023-12-15,425.88,0,0,1064176186,228355863,0.0041990227358837,99.960636029493,0
384.54,385,906,911,24462,41906,2023-09-27,2023-10-13,425.88,5,17444,114856729,34649438,0.0364854548487098,99.8256776057065,0.416264973989405
269.87,270,3038,3166,33418,41158,2023-09-27,2023-11-17,425.88,128,7740.00000000001,1021033106,270136960,0.00403101522939257,99.9708864484165,0.188055785023568
204.91,205,4615,4559,27690,41031,2023-09-27,2023-12-15,425.88,-56,13341,1064176186,228355863,0.00385565854036129,99.9644916880333,0.325144403012357
397.64,398,1093,1138,24046,40968,2023-09-27,2023-10-06,425.88,45,16922,162893327,54801933,0.0251502015180769,99.7760172213807,0.413054090997852
425.9,453,47,15,102930,40650,2023-09-27,2023-11-17,425.88,-32,-62280,1021033106,270136960,0.00398126170063677,99.9748677101171,-1.53210332103321
364.97,365,13171,13467,39513,40401,2023-09-27,2023-09-29,425.88,296,888,408556355,111857149,0.00988872147148464,99.7850482585199,0.0219796539689612
431.57,471,10,10,39430,39430,2023-09-27,2023-12-15,425.88,0,0,1064176186,228355863,0.00370521352749008,99.9681969015608,0
425.84,469,11,9,41701,38844,2023-09-27,2023-09-29,425.88,-2,-2857.00000000001,408556355,111857149,0.00950762349541717,99.7945558820154,-0.0735506127072394
430.62,453,17,17,38046,38046,2023-09-27,2023-10-27,425.88,0,0,112653864,35070907,0.0337724767256985,99.820887635066,0
279.95,280,7300,7224,29200,36120,2023-09-27,2023-10-20,425.88,-76,6920.00000000001,1168890895,305484810,0.00309010876502721,99.9681934386186,0.191583610188262
184.95,185,7198,7198,28792,35990,2023-09-27,2023-12-15,425.88,0,7198,1064176186,228355863,0.00338195878403165,99.9715788603448,0.2
249.98,250,16550,16545,33100,33090,2023-09-27,2023-10-20,425.88,-5,-10,1168890895,305484810,0.00283088867759553,99.9710243272962,-0.000302206104563312
284.94,285,5285,5313,15855,31878,2023-09-27,2023-10-20,425.88,28,16023,1168890895,305484810,0.00272720064262285,99.9737515279388,0.502635046113307
403.87,404,2282,2450,29666,31850,2023-09-27,2023-09-29,425.88,168,2184,408556355,111857149,0.00779574215655023,99.8023516241719,0.0685714285714285
425.55,452,13,12,27950,31740,2023-09-27,2023-09-29,425.88,-1,3790,408556355,111857149,0.00776881808630782,99.8101204422582,0.119407687460617
395.92,396,4229,3931,29603,31448,2023-09-27,2023-09-29,425.88,-298,1845,408556355,111857149,0.00769734691802799,99.8178177891762,0.0586682777919103
428.98,453,14,13,29778,31226,2023-09-27,2023-10-06,425.88,-1,1448,162893327,54801933,0.0191696004833887,99.7951868218641,0.0463716133990906
402.5,403,399,623,15162,31150,2023-09-27,2023-10-06,425.88,224,15988,162893327,54801933,0.0191229441829744,99.8143097660471,0.513258426966292
427.7,456,12,11,29952,31130,2023-09-27,2023-09-29,425.88,-1,1178,408556355,111857149,0.00761951187859996,99.8254373010548,0.0378413106328301
405.17,408,0,109,0,30847,2023-09-27,2023-10-27,425.88,109,30847,112653864,35070907,0.0273821055973722,99.8482697406633,1
400.57,401,369,678,16236,29154,2023-09-27,2023-10-06,425.88,309,12918,162893327,54801933,0.0178976023984089,99.8322073684455,0.44309528709611
406.29,407,210,405,9660,28755,2023-09-27,2023-10-06,425.88,195,19095,162893327,54801933,0.0176526568212337,99.8498600252667,0.664058424621805
427.52,456,15,10,36540,28480,2023-09-27,2023-10-06,425.88,-5,-8060,162893327,54801933,0.0174838346815766,99.8673438599483,-0.283005617977528
359.97,360,10577,9409,21154,28227,2023-09-27,2023-09-29,425.88,-1168,7073,408556355,111857149,0.00690896118847545,99.8323462622433,0.250575689942254
386.94,387,4575,4695,22875,28170,2023-09-27,2023-09-29,425.88,120,5295,408556355,111857149,0.00689500962480439,99.8392412718681,0.187965921192758
425.63,449,801,12,1338471,28044,2023-09-27,2023-10-13,425.88,-789,-1310427,114856729,34649438,0.0244165058888278,99.8500941115953,-46.7275353016688
269.96,270,6633,6987,19899,27948,2023-09-27,2023-10-20,425.88,354,8049,1168890895,305484810,0.0023909844896174,99.9761425124284,0.287999141262345
425.61,480,8,5,39176,27195,2023-09-27,2023-10-20,425.88,-3,-11981,1168890895,305484810,0.00232656444808735,99.9784690768765,-0.440558926273212
429.09,453,12,11,27600,26301,2023-09-27,2023-10-13,425.88,-1,-1299,114856729,34649438,0.0228989631073335,99.8729930747027,-0.0493897570434584
349.72,350,840,934,17640,26152,2023-09-27,2023-10-27,425.88,94,8512,112653864,35070907,0.0232144722528115,99.8714842129161,0.325481798715204
392.64,394,0,192,0,26112,2023-09-27,2023-10-27,425.88,192,26112,112653864,35070907,0.0231789652594606,99.8946631781756,1
401.86,402,1606,1848,16060,25872,2023-09-27,2023-09-29,425.88,242,9812,408556355,111857149,0.00633254132101311,99.8455738131891,0.379251700680272
387.94,388,4188,4276,29316,25656,2023-09-27,2023-09-29,425.88,88,-3660,408556355,111857149,0.00627967223762803,99.8518534854268,-0.14265668849392
164.97,165,8473,8475,16946,25425,2023-09-27,2023-12-15,425.88,2,8479,1064176186,228355863,0.00238917205012517,99.973968032395,0.333490658800393
430.84,452,12,12,25392,25392,2023-09-27,2023-10-06,425.88,0,0,162893327,54801933,0.0155881155279,99.8829319754762,0
426.54,462,77,7,251713,24822,2023-09-27,2023-12-15,425.88,-70,-226891,1064176186,228355863,0.00233250850061777,99.9763005408956,-9.14072194021433
234.98,235,12233,12209,12233,24418,2023-09-27,2023-10-20,425.88,-24,12185,1168890895,305484810,0.00208898881020029,99.9805580656867,0.499017118519125
393.91,394,2591,2603,18137,23427,2023-09-27,2023-09-29,425.88,12,5290,408556355,111857149,0.00573409266880698,99.8575875780956,0.225807828573868
426.53,473,5,5,14260,23235,2023-09-27,2023-12-15,425.88,0,8975,1064176186,228355863,0.00218337905937692,99.978483919955,0.386270712287497
249.92,250,2693,2847,16158,22776,2023-09-27,2023-11-17,425.88,154,6618,1021033106,270136960,0.00223068183256342,99.9770983919497,0.290569020021075
209.96,210,5644,5643,16932,22572,2023-09-27,2023-11-17,425.88,-1,5640,1021033106,270136960,0.00221070206904731,99.9793090940187,0.249867091972355
425.59,482,4,4,20512,22564,2023-09-27,2023-10-20,425.88,0,2052,1168890895,305484810,0.00193037691511833,99.9824884426018,0.0909413224605566
430.63,468,6,6,22422,22422,2023-09-27,2023-12-15,425.88,0,0,1064176186,228355863,0.00210698193541422,99.9805909018904,0
379.82,380,1380,1240,19320,22320,2023-09-27,2023-10-06,425.88,-140,3000,162893327,54801933,0.0137022187532581,99.8966341942295,0.134408602150538
361.97,362,7383,7383,22149,22149,2023-09-27,2023-09-29,425.88,0,0,408556355,111857149,0.00542128392544524,99.863008862021,0
194.93,195,3001,3001,15005,21007,2023-09-27,2023-12-15,425.88,0,6002,1064176186,228355863,0.00197401523134629,99.9825649171217,0.285714285714286
259.97,260,6128,6793,18384,20379,2023-09-27,2023-10-20,425.88,665,1995,1168890895,305484810,0.00174344757814201,99.98423189018,0.0978948918003827
154.97,155,6772,6771,13544,20313,2023-09-27,2023-12-15,425.88,-1,6769,1064176186,228355863,0.00190880046624159,99.984473717588,0.333234874218481
391.93,392,2848,2856,17088,19992,2023-09-27,2023-09-29,425.88,8,2904,408556355,111857149,0.00489332738441922,99.8679021894054,0.145258103241297
324.82,325,962,1102,11544,19836,2023-09-27,2023-10-27,425.88,140,8292,112653864,35070907,0.0176079180027061,99.9122710961783,0.418027828191168
392.71,393,336,683,7392,19807,2023-09-27,2023-10-06,425.88,347,12415,162893327,54801933,0.0121594913461372,99.9087936855756,0.626798606553239
349.99,350,19707,19724,19707,19724,2023-09-27,2023-09-29,425.88,17,17,408556355,111857149,0.00482773055873773,99.8727299199642,0.000861894139119854
431.3,464,6,6,19620,19620,2023-09-27,2023-11-17,425.88,0,0,1021033106,270136960,0.00192158313816712,99.9812306771569,0
214.91,215,2161,2166,17288,19494,2023-09-27,2023-12-15,425.88,5,2206,1064176186,228355863,0.00183183952586588,99.9863055571138,0.113163024520365
425.6,449,11,8,19756,18720,2023-09-27,2023-09-29,425.88,-3,-1036,408556355,111857149,0.00458198722670707,99.8773119071909,-0.0553418803418803
400.9,401,1121,1811,11210,18110,2023-09-27,2023-09-29,425.88,690,6900,408556355,111857149,0.0044326810189992,99.8817445882099,0.381004969630039
174.96,175,4481,4481,13443,17924,2023-09-27,2023-12-15,425.88,0,4481,1064176186,228355863,0.00168430756446189,99.9879898646783,0.25
425.55,470,13,4,50830,17780,2023-09-27,2023-09-29,425.88,-9,-33050,408556355,111857149,0.00435190880827199,99.8860964970181,-1.85883014623172
169.97,170,5923,5900,17769,17700,2023-09-27,2023-12-15,425.88,-23,-69,1064176186,228355863,0.00166325841837622,99.9896531230967,-0.00389830508474576
159.97,160,5792,5797,11584,17391,2023-09-27,2023-12-15,425.88,5,5807,1064176186,228355863,0.00163422187310626,99.9912873449698,0.333908343396009
432.1,461,6,6,17340,17340,2023-09-27,2023-10-27,425.88,0,0,112653864,35070907,0.0153922816176106,99.9276633777959,0
254.91,255,1414,1922,9898,17298,2023-09-27,2023-11-17,425.88,508,7400,1021033106,270136960,0.00169416641814551,99.9829248435751,0.427795120823217
264.88,265,1377,1438,12393,17256,2023-09-27,2023-11-17,425.88,61,4863,1021033106,270136960,0.0016900529374216,99.9846148965125,0.281815020862309
431.9,475,4,4,17240,17240,2023-09-27,2023-09-29,425.88,0,0,408556355,111857149,0.00421973609980929,99.890316233118,0
334.77,335,697,703,12546,16169,2023-09-27,2023-10-27,425.88,6,3623,112653864,35070907,0.0143528143872633,99.9420161921832,0.224070752674872
431.27,590,1,1,15873,15873,2023-09-27,2023-12-15,425.88,0,0,1064176186,228355863,0.00149157632061502,99.9927789212904,0
390.94,391,2584,2640,15504,15840,2023-09-27,2023-09-29,425.88,56,336,408556355,111857149,0.00387706611490598,99.8941932992329,0.0212121212121212
369.88,370,1107,1307,11070,15684,2023-09-27,2023-10-06,425.88,200,4614,162893327,54801933,0.00962838704866038,99.9184220726243,0.294185156847743
425.66,457,5,5,12840,15670,2023-09-27,2023-10-20,425.88,0,2830,1168890895,305484810,0.00134058705282327,99.9855724772328,0.180599872367581
426.17,452,376,6,826448,15498,2023-09-27,2023-10-27,425.88,-370,-810950,112653864,35070907,0.0137571845738021,99.955773376757,-52.3261065943993
324.92,325,1882,1931,11292,15448,2023-09-27,2023-10-13,425.88,49,4156,114856729,34649438,0.0134497997065544,99.8864428744092,0.269031589849819
427.85,505,2,2,14732,15430,2023-09-27,2023-11-17,425.88,0,698.000000000002,1021033106,270136960,0.00151121446594896,99.9861261109784,0.0452365521710954
427.25,458,5,5,13315,15375,2023-09-27,2023-11-17,425.88,0,2060,1021033106,270136960,0.00150582776500099,99.9876319387434,0.133983739837398
425.4,451,603,6,1230120,15360,2023-09-27,2023-10-27,425.88,-597,-1214760,112653864,35070907,0.0136346854467415,99.9694080622037,-79.0859375
381.95,382,2844,3060,14220,15300,2023-09-27,2023-09-29,425.88,216,1080,408556355,111857149,0.00374489340644328,99.8979381926393,0.0705882352941175
425.84,451,6,6,12804,15096,2023-09-27,2023-10-13,425.88,0,2292,114856729,34649438,0.0131433309405842,99.8995862053498,0.151828298887122
354.91,355,1647,1667,13176,15003,2023-09-27,2023-10-06,425.88,20,1827,162893327,54801933,0.00921032204100049,99.9276323946653,0.121775644871026
434.49,464,5,5,14755,14755,2023-09-27,2023-12-15,425.88,0,0,1064176186,228355863,0.00138651852899103,99.9941654398194,0
431.12,460,5,5,14440,14440,2023-09-27,2023-10-06,425.88,0,0,162893327,54801933,0.00886469707872073,99.936497091744,0
425.92,474,203,3,860517,14424,2023-09-27,2023-10-20,425.88,-200,-846093,1168890895,305484810,0.00123399027759558,99.9868064675104,-58.658693843594
366.97,367,4792,4792,14376,14376,2023-09-27,2023-09-29,425.88,0,0,408556355,111857149,0.0035187312164071,99.9014569238557,0
388.94,389,2332,2374,13992,14244,2023-09-27,2023-09-29,425.88,42,252.000000000002,408556355,111857149,0.00348642233211621,99.9049433461878,0.0176916596461669
425.42,461,28,4,81480,14232,2023-09-27,2023-12-15,425.88,-24,-67248,1064176186,228355863,0.00133737253165708,99.995502812351,-4.72512647554806
219.96,220,3535,3534,14140,14136,2023-09-27,2023-11-17,425.88,-1,-3.99999999999818,1021033106,270136960,0.00138448008364579,99.9890164188271,-0.000282965478211529
375.97,376,4671,4672,18684,14016,2023-09-27,2023-09-29,425.88,1,-4668,408556355,111857149,0.00343061607743196,99.9083739622653,-0.33304794520548
430.04,458,5,5,13980,13980,2023-09-27,2023-09-29,425.88,0,0,408556355,111857149,0.00342180456353445,99.9117957668288,0
391.11,392,0,156,0,13884,2023-09-27,2023-10-20,425.88,156,13884,1168890895,305484810,0.00118779263825132,99.9879942601486,1
427.4,495,2,2,12700,13520,2023-09-27,2023-11-17,425.88,0,819.999999999998,1021033106,270136960,0.00132414903302851,99.9903405678601,0.0606508875739644
274.96,275,3427,3357,13708,13428,2023-09-27,2023-10-20,425.88,-70,-280.000000000002,1168890895,305484810,0.00114878129836061,99.989143041447,-0.0208519511468574
254.97,255,4448,4448,13344,13344,2023-09-27,2023-10-20,425.88,0,0,1168890895,305484810,0.00114159499890706,99.9902846364459,0
424.93,490,2,2,11926,13014,2023-09-27,2023-12-15,425.88,0,1088,1064176186,228355863,0.00122291779981628,99.9967257301509,0.0836022744736436
229.95,230,2585,2598,10340,12990,2023-09-27,2023-11-17,425.88,13,2650,1021033106,270136960,0.00127224082389352,99.991612808684,0.204003079291763
427.61,460,8,4,23296,12956,2023-09-27,2023-10-13,425.88,-4,-10340,114856729,34649438,0.0112801401474702,99.9108663454973,-0.798085828959555
259.88,260,1053,1076,8424,12912,2023-09-27,2023-11-17,425.88,23,4488,1021033106,270136960,0.00126460150254912,99.9928774101866,0.347583643122677
376.95,377,2579,2579,12895,12895,2023-09-27,2023-09-29,425.88,0,0,408556355,111857149,0.00315623532523439,99.914952002154,0
354.86,355,890,890,10680,12460,2023-09-27,2023-10-13,425.88,0,1780,114856729,34649438,0.0108482977954213,99.9217146432927,0.142857142857143
398.57,399,200,288,6400,12384,2023-09-27,2023-10-06,425.88,88,5984,162893327,54801933,0.00760252137277545,99.9440996131167,0.483204134366925
430.99,472,3,3,12303,12303,2023-09-27,2023-10-20,425.88,0,0,1168890895,305484810,0.0010525362163934,99.9913371726623,0
431.35,462,4,4,12260,12260,2023-09-27,2023-11-17,425.88,0,0,1021033106,270136960,0.00120074461131136,99.9940781547978,0
432.42,555,1,1,12258,12258,2023-09-27,2023-12-15,425.88,0,0,1064176186,228355863,0.00115187693177716,99.9978776070826,0
392.93,393,1755,1749,12285,12243,2023-09-27,2023-09-29,425.88,-6,-42,408556355,111857149,0.00299664901797942,99.917948651172,-0.00343053173241852
380.96,381,3116,3016,15580,12064,2023-09-27,2023-09-29,425.88,-100,-3516,408556355,111857149,0.00295283621276678,99.9209014873848,-0.291445623342175
385.95,386,2237,2234,11185,11170,2023-09-27,2023-09-29,425.88,-3,-15,408556355,111857149,0.00273401695097853,99.9236355043358,-0.00134288272157565
428.33,540,0,1,0,11167,2023-09-27,2023-10-20,425.88,1,11167,1168890895,305484810,0.000955350071402515,99.9922925227337,1
360.97,361,3602,3606,7204,10818,2023-09-27,2023-09-29,425.88,4,3614,408556355,111857149,0.00264785992620284,99.926283364262,0.334072841560362
431.09,467,3,3,10773,10773,2023-09-27,2023-09-29,425.88,0,0,408556355,111857149,0.00263684553383094,99.9289202097958,0
432.41,540,1,1,10759,10759,2023-09-27,2023-12-15,425.88,0,0,1064176186,228355863,0.00101101679792711,99.9988886238806,0
378.96,379,2667,2678,10668,10712,2023-09-27,2023-09-29,425.88,11,44,408556355,111857149,0.00262191491306016,99.9315421247088,0.0041075429424944
373.96,374,2558,2582,10232,10328,2023-09-27,2023-09-29,425.88,24,96,408556355,111857149,0.00252792543148668,99.9340700501403,0.00929512006196747
369.75,370,403,412,6851,10300,2023-09-27,2023-10-13,425.88,9,3449,114856729,34649438,0.00896769400424071,99.9306823372969,0.334854368932039
368.97,369,3146,3406,9438,10218,2023-09-27,2023-09-29,425.88,260,780,408556355,111857149,0.00250100136124428,99.9365710515016,0.0763358778625954
324.98,325,5043,5043,10086,10086,2023-09-27,2023-09-29,425.88,0,0,408556355,111857149,0.00246869247695339,99.9390397439785,0
234.95,235,1977,1977,9885,9885,2023-09-27,2023-11-17,425.88,0,0,1021033106,270136960,0.000968137070376247,99.9950462918682,0
224.95,225,1972,1973,7888,9865,2023-09-27,2023-11-17,425.88,1,1977,1021033106,270136960,0.00096617827003153,99.9960124701383,0.200405473897618
367.97,368,3295,3280,9885,9840,2023-09-27,2023-09-29,425.88,-15,-45,408556355,111857149,0.00240848046532038,99.9414482244438,-0.00457317073170732
382.96,383,2679,2455,13395,9820,2023-09-27,2023-09-29,425.88,-224,-3575,408556355,111857149,0.00240358517982177,99.9438518096237,-0.364052953156823
432.76,457,10,4,24240,9696,2023-09-27,2023-11-17,425.88,-6,-14544,1021033106,270136960,0.000949626407118674,99.9969620965454,-1.5
377.95,378,1907,1912,9535,9560,2023-09-27,2023-09-29,425.88,5,25,408556355,111857149,0.00233994646833972,99.946191756092,0.00261506276150628
329.99,330,9234,9234,9234,9234,2023-09-27,2023-09-29,425.88,0,0,408556355,111857149,0.00226015331471224,99.9484519094067,0
383.95,384,1790,1843,8950,9215,2023-09-27,2023-09-29,425.88,53,265,408556355,111857149,0.00225550279348855,99.9507074122002,0.0287574606619642
340.98,341,4577,4577,9154,9154,2023-09-27,2023-09-29,425.88,0,0,408556355,111857149,0.00224057217271776,99.9529479843729,0
149.99,150,9027,9027,9027,9027,2023-09-27,2023-10-20,425.88,0,0,1168890895,305484810,0.00077227053770489,99.9930647932714,0
329.9,330,1039,894,7273,8940,2023-09-27,2023-10-13,425.88,-145,1667,114856729,34649438,0.00778361013571961,99.9384659474327,0.186465324384787
364.83,365,515,515,8240,8755,2023-09-27,2023-10-13,425.88,0,515.000000000002,114856729,34649438,0.00762253990360461,99.9460884873363,0.0588235294117649
214.97,215,2909,2899,8727,8697,2023-09-27,2023-11-17,425.88,-10,-30,1021033106,270136960,0.000851784329900073,99.9978138808753,-0.00344946533287341
299.99,300,8400,8400,8400,8400,2023-09-27,2023-09-29,425.88,0,0,408556355,111857149,0.00205601990941984,99.9550040042823,0
430,472,2,2,8400,8400,2023-09-27,2023-12-15,425.88,0,0,1064176186,228355863,0.000789342978212444,99.9996779668588,0
372.96,373,1994,2088,7976,8352,2023-09-27,2023-09-29,425.88,94,375.999999999999,408556355,111857149,0.00204427122422316,99.9570482755066,0.0450191570881225
429.4,470,4,2,16240,8120,2023-09-27,2023-10-13,425.88,-2,-8120,114856729,34649438,0.00706967721499365,99.9531581645513,-1
324.95,325,1578,1591,4734,7955,2023-09-27,2023-10-06,425.88,13,3221,162893327,54801933,0.00488356407626201,99.948983177193,0.4049025769956
425.63,452,3,3,6720,7911,2023-09-27,2023-10-13,425.88,0,1191,114856729,34649438,0.00688771138519886,99.9600458759365,0.150549867273417
239.98,240,3853,3939,7706,7878,2023-09-27,2023-10-20,425.88,86,172,1168890895,305484810,0.00067397222732238,99.9937387654987,0.0218329525260218
169.98,170,3883,3883,7766,7766,2023-09-27,2023-10-20,425.88,0,0,1168890895,305484810,0.000664390494717644,99.9944031559934,0
345.98,346,3817,3831,7634,7662,2023-09-27,2023-09-29,425.88,14,28,408556355,111857149,0.00187538387452081,99.9589236593811,0.00365439832941791
430.79,456,3,3,7563,7563,2023-09-27,2023-10-13,425.88,0,0,114856729,34649438,0.00658472521884199,99.9666306011553,0
391.71,392,120,260,2640,7540,2023-09-27,2023-10-06,425.88,140,4900,162893327,54801933,0.00462879612005224,99.9536119733131,0.649867374005305
398.91,399,756,836,6048,7524,2023-09-27,2023-09-29,425.88,80,1476,408556355,111857149,0.00184160640458034,99.9607652657857,0.196172248803828
425.4,500,0,1,0,7460,2023-09-27,2023-10-27,425.88,1,7460,112653864,35070907,0.00662205425994087,99.9760301164637,1
344.92,345,371,928,3339,7424,2023-09-27,2023-10-06,425.88,557,4085,162893327,54801933,0.00455758387205143,99.9581695571851,0.550242456896552
344.89,345,652,653,5216,7183,2023-09-27,2023-10-13,425.88,1,1967,114856729,34649438,0.00625387825557874,99.9728844794109,0.273841013504107
365.97,366,2109,2363,6327,7089,2023-09-27,2023-09-29,425.88,254,762,408556355,111857149,0.00173513394498539,99.9625003997307,0.107490478205671
425.87,461,3,2,8364,7026,2023-09-27,2023-09-29,425.88,-1,-1338,408556355,111857149,0.00171971379566474,99.9642201135263,-0.190435525192143
433.49,468,2,2,6902,6902,2023-09-27,2023-11-17,425.88,0,0,1021033106,270136960,0.000675981998961746,99.9984898628743,0
425.58,459,2,2,5554,6684,2023-09-27,2023-11-17,425.88,0,1130,1021033106,270136960,0.000654631075204333,99.9991444939494,0.169060442848594
432.75,465,2,2,6450,6450,2023-09-27,2023-10-06,425.88,0,0,162893327,54801933,0.00395964654832055,99.9621292037335,0
431.25,495,1,1,6375,6375,2023-09-27,2023-10-20,425.88,0,0,1168890895,305484810,0.000545388797814188,99.9949485447913,0
427.41,459,3,2,8787,6318,2023-09-27,2023-10-20,425.88,-1,-2469,1168890895,305484810,0.000540512380327849,99.9954890571716,-0.390788224121557
388.8,389,80,315,1520,6300,2023-09-27,2023-10-06,425.88,235,4780,162893327,54801933,0.00386756174487123,99.9659967654783,0.758730158730159
342.98,343,3112,3137,6224,6274,2023-09-27,2023-09-29,425.88,25,50,408556355,111857149,0.00153565106091668,99.9657557645872,0.00796939751354798
356.97,357,2290,2069,4580,6207,2023-09-27,2023-09-29,425.88,-221,1627,408556355,111857149,0.0015192518544963,99.9672750164417,0.262123409054294
349.85,350,394,404,4334,6060,2023-09-27,2023-10-13,425.88,10,1726,114856729,34649438,0.0052761384141455,99.978160617825,0.284818481848185
431.08,490,1,1,5892,5892,2023-09-27,2023-10-20,425.88,0,0,1168890895,305484810,0.000504067575956266,99.9959931247476,0
430.68,460,2,2,5864,5864,2023-09-27,2023-10-27,425.88,0,0,112653864,35070907,0.00520532522524039,99.9812354416889,0
371.96,372,1154,1460,4616,5840,2023-09-27,2023-09-29,425.88,306,1224,408556355,111857149,0.00142942336559665,99.9687044398073,0.20958904109589
339.88,340,460,478,4140,5736,2023-09-27,2023-10-13,425.88,18,1596,114856729,34649438,0.00499404784546842,99.9831546656705,0.278242677824268
396.33,398,0,34,0,5678,2023-09-27,2023-10-27,425.88,34,5678,112653864,35070907,0.00504021770615875,99.9862756593951,1
319.99,320,5436,5605,5436,5605,2023-09-27,2023-09-29,425.88,169,169,408556355,111857149,0.00137190376098788,99.9700763435683,0.0301516503122212
199.99,200,5588,5597,5588,5597,2023-09-27,2023-10-20,425.88,9,9,1168890895,305484810,0.000478829976684864,99.9964719547242,0.00160800428801144
229.98,230,2765,2776,5530,5552,2023-09-27,2023-10-20,425.88,11,22,1168890895,305484810,0.000474980173406176,99.9969469348977,0.00396253602305476
390.76,391,46,231,920,5544,2023-09-27,2023-10-06,425.88,185,4624,162893327,54801933,0.00340345433548668,99.9694002198138,0.834054834054834
334.89,335,467,482,2802,5302,2023-09-27,2023-10-13,425.88,15,2500,114856729,34649438,0.00461618578742565,99.9877708514579,0.47152018106375
357.98,358,2616,2611,5232,5222,2023-09-27,2023-09-29,425.88,-5,-10,408556355,111857149,0.00127815904368933,99.971354502612,-0.00191497510532363
294.99,295,5149,5149,5149,5149,2023-09-27,2023-09-29,425.88,0,0,408556355,111857149,0.00126029125161938,99.9726147938636,0
383.8,384,170,256,2550,5120,2023-09-27,2023-10-06,425.88,86,2570,162893327,54801933,0.00314316129106995,99.9725433811049,0.501953125
289.99,290,5106,5106,5106,5106,2023-09-27,2023-09-29,425.88,0,0,408556355,111857149,0.00124976638779735,99.9738645602514,0
239.95,240,997,998,4985,4990,2023-09-27,2023-11-17,425.88,1,5.00000000000091,1021033106,270136960,0.000488720686006826,99.9996332146355,0.00100200400801621
339.99,340,5903,4987,5903,4987,2023-09-27,2023-09-29,425.88,-916,-916,408556355,111857149,0.00122063943908056,99.9750851996905,-0.183677561660317
370.97,371,1660,1659,6640,4977,2023-09-27,2023-09-29,425.88,-1,-1663,408556355,111857149,0.00121819179633126,99.9763033914869,-0.334137030339562
159.99,160,4707,4707,4707,4707,2023-09-27,2023-10-20,425.88,0,0,1168890895,305484810,0.000402689422950805,99.9973496243206,0
339.74,340,153,176,3060,4576,2023-09-27,2023-10-27,425.88,23,1516,112653864,35070907,0.00406200003934175,99.9903376594344,0.331293706293706
396.61,397,23,116,552,4524,2023-09-27,2023-10-06,425.88,93,3972,162893327,54801933,0.00277727767203134,99.9753206587769,0.877984084880637
368.89,369,200,400,2000,4400,2023-09-27,2023-10-06,425.88,200,2400,162893327,54801933,0.00270115423451324,99.9780218130114,0.545454545454545
385.78,386,43,196,645,4312,2023-09-27,2023-10-06,425.88,153,3667,162893327,54801933,0.00264713114982298,99.9806689441612,0.850417439703154
355.97,356,1811,1419,3622,4257,2023-09-27,2023-09-29,425.88,-392,635,408556355,111857149,0.00104196151838098,99.9773453530052,0.149166079398638
425.86,468,1,1,3688,4214,2023-09-27,2023-10-20,425.88,0,526,1168890895,305484810,0.000360512689253175,99.9977101370098,0.124822021831989
334.98,335,2092,2092,4184,4184,2023-09-27,2023-09-29,425.88,0,0,408556355,111857149,0.00102409372631103,99.9783694467315,0
304.99,305,4159,4178,8318,4178,2023-09-27,2023-09-29,425.88,19,-4140,408556355,111857149,0.00102262514066144,99.9793920718722,-0.990904739109622
314.99,315,4067,4067,4067,4067,2023-09-27,2023-09-29,425.88,0,0,408556355,111857149,0.000995456306144106,99.9803875281783,0
284.99,285,3927,3927,3927,3927,2023-09-27,2023-09-29,425.88,0,0,408556355,111857149,0.000961189307653775,99.981348717486,0
244.98,245,1932,1931,1932,3862,2023-09-27,2023-10-20,425.88,-1,1930,1168890895,305484810,0.000330398672495434,99.9980405356823,0.499741066804764
244.93,245,545,535,3270,3745,2023-09-27,2023-11-17,425.88,-10,475.000000000001,1021033106,270136960,0.000366785364548209,100,0.126835781041389
393.37,394,0,59,0,3717,2023-09-27,2023-10-13,425.88,59,3717,114856729,34649438,0.00323620569065657,99.9910070571486,1
339.94,340,599,612,2396,3672,2023-09-27,2023-10-06,425.88,13,1276,162893327,54801933,0.00225423598843923,99.9829231801497,0.347494553376906
432.66,469,1,1,3634,3634,2023-09-27,2023-10-06,425.88,0,0,162893327,54801933,0.00223090783823207,99.9851540879879,0
189.99,190,3622,3622,3622,3622,2023-09-27,2023-10-20,425.88,0,0,1168890895,305484810,0.00030986638834243,99.9983504020707,0
353.97,354,1094,1186,2188,3558,2023-09-27,2023-09-29,425.88,92,1370,408556355,111857149,0.000870871290204261,99.9822195887762,0.38504777965149
344.99,345,3481,3491,6962,3491,2023-09-27,2023-09-29,425.88,10,-3471,408556355,111857149,0.000854472083783888,99.98307406086,-0.994270982526496
441.73,476,1,1,3427,3427,2023-09-27,2023-12-15,425.88,0,0,1064176186,228355863,0.000322033141230244,100,0
432.75,467,1,1,3425,3425,2023-09-27,2023-10-06,425.88,0,0,162893327,54801933,0.00210260301209269,99.987256691,0
327.98,328,1652,1652,3304,3304,2023-09-27,2023-09-29,425.88,0,0,408556355,111857149,0.000808701164371804,99.9838827620244,0
354.64,355,87,91,2175,3276,2023-09-27,2023-10-27,425.88,4,1101,112653864,35070907,0.00290802275543784,99.9932456821898,0.336080586080586
214.99,215,3194,3226,3194,3226,2023-09-27,2023-10-20,425.88,32,32,1168890895,305484810,0.000275988119489972,99.9986263901902,0.00991940483570986
431.79,464,1,1,3221,3221,2023-09-27,2023-09-29,425.88,0,0,408556355,111857149,0.000788385729552536,99.9846711477539,0
352.98,353,1600,1578,4800,3156,2023-09-27,2023-09-29,425.88,-22,-1644,408556355,111857149,0.000772476051682026,99.9854436238056,-0.520912547528517
336.98,337,1575,1575,3150,3150,2023-09-27,2023-09-29,425.88,0,0,408556355,111857149,0.00077100746603244,99.9862146312716,0
382.8,383,0,156,0,3120,2023-09-27,2023-10-06,425.88,156,3120,162893327,54801933,0.00191536391174575,99.9891720549117,1
395.2,396,0,39,0,3120,2023-09-27,2023-10-13,425.88,39,3120,114856729,34649438,0.00271642769837194,99.9937234848469,1
431.8,463,1,1,3120,3120,2023-09-27,2023-09-29,425.88,0,0,408556355,111857149,0.000763664537784512,99.9869782958094,0
425.9,457,2,1,5232,3110,2023-09-27,2023-10-13,425.88,-1,-2122,114856729,34649438,0.0027077211993387,99.9964312060463,-0.682315112540193
329.95,330,565,607,1695,3035,2023-09-27,2023-10-06,425.88,42,1340,162893327,54801933,0.00186318252312447,99.9910352374349,0.441515650741351
438.33,468,1,1,2967,2967,2023-09-27,2023-09-29,425.88,0,0,408556355,111857149,0.000726215603720079,99.9877045114131,0
397.16,398,0,35,0,2940,2023-09-27,2023-10-13,425.88,35,2940,114856729,34649438,0.00255971071577356,99.9989909167621,1
219.99,220,2922,2936,2922,2936,2023-09-27,2023-10-20,425.88,14,14,1168890895,305484810,0.000251178276138424,99.9988775684663,0.00476839237057221
224.99,225,2895,2890,5790,2890,2023-09-27,2023-10-20,425.88,-5,-2900,1168890895,305484810,0.000247242921675765,99.999124811388,-1.00346020761246
395.63,396,7,78,161,2886,2023-09-27,2023-10-06,425.88,71,2725,162893327,54801933,0.00177171161836482,99.9928069490532,0.944213444213444
358.98,359,1438,1435,2876,2870,2023-09-27,2023-09-29,425.88,-3,-6,408556355,111857149,0.000702473469051779,99.9884069848822,-0.00209059233449477
334.95,335,545,573,2725,2865,2023-09-27,2023-10-06,425.88,28,140,162893327,54801933,0.00175881974588192,99.9945657687991,0.0488656195462478
338.98,339,1396,1406,2792,2812,2023-09-27,2023-09-29,425.88,10,20,408556355,111857149,0.000688277141105785,99.9890952620233,0.00711237553342817
431.81,459,1,1,2719,2719,2023-09-27,2023-10-27,425.88,0,0,112653864,35070907,0.00241358787302671,99.9956592700629,0
325.99,326,2745,2695,2745,2695,2023-09-27,2023-09-29,425.88,-50,-50,408556355,111857149,0.000659639720938865,99.9897549017442,-0.0185528756957328
154.99,155,2672,2672,2672,2672,2023-09-27,2023-10-20,425.88,0,0,1168890895,305484810,0.000228592763570119,99.9993534041516,0
348.96,349,641,641,2564,2564,2023-09-27,2023-09-29,425.88,0,0,408556355,111857149,0.000627575600922913,99.9903824773451,0
349.92,350,300,312,1800,2496,2023-09-27,2023-10-06,425.88,12,696,162893327,54801933,0.0015322911293966,99.9960980599285,0.278846153846154
264.99,265,2482,2482,2482,2482,2023-09-27,2023-09-29,425.88,0,0,408556355,111857149,0.000607504930378577,99.9909899822755,0
309.99,310,2467,2467,2467,2467,2023-09-27,2023-09-29,425.88,0,0,408556355,111857149,0.000603833466254613,99.9915938157418,0
259.99,260,2350,2350,2350,2350,2023-09-27,2023-09-29,425.88,0,0,408556355,111857149,0.000575196046087693,99.9921690117879,0
351.98,352,1134,1116,2268,2232,2023-09-27,2023-09-29,425.88,-18,-36,408556355,111857149,0.000546313861645843,99.9927153256495,-0.0161290322580645
370.89,371,1,201,10,2211,2023-09-27,2023-10-06,425.88,200,2201,162893327,54801933,0.0013573300028429,99.9974553899314,0.995477159656264
346.98,347,1030,1081,3090,2162,2023-09-27,2023-09-29,425.88,51,-928,408556355,111857149,0.000529180362400678,99.9932445060119,-0.429232192414431
362.97,363,691,696,2073,2088,2023-09-27,2023-09-29,425.88,5,15,408556355,111857149,0.000511067806055789,99.993755573818,0.00718390804597701
441.3,462,1,1,2070,2070,2023-09-27,2023-09-29,425.88,0,0,408556355,111857149,0.000506662049107032,99.9942622358671,0
341.98,342,1013,1024,2026,2048,2023-09-27,2023-09-29,425.88,11,21.9999999999998,408556355,111857149,0.000501277235058551,99.9947635131021,0.0107421874999999
328.99,329,1590,2039,1590,2039,2023-09-27,2023-09-29,425.88,449,449,408556355,111857149,0.000499074356584173,99.9952625874587,0.220205983325159
432.23,452.5,1,1,2027,2027,2023-09-27,2023-10-27,425.88,0,0,112653864,35070907,0.00179931688805632,99.9974585869509,0
363.97,364,650,671,1950,2013,2023-09-27,2023-09-29,425.88,21,63,408556355,111857149,0.000492710485435969,99.9957552979441,0.0312965722801788
394.49,396,0,13,0,1963,2023-09-27,2023-10-27,425.88,13,1963,112653864,35070907,0.0017425056986949,99.9992010926496,1
335.99,336,1950,1927,1950,1927,2023-09-27,2023-09-29,425.88,-23,-23,408556355,111857149,0.000471660757791909,99.9962269587019,-0.0119356512714063
209.99,210,1853,1905,1853,1905,2023-09-27,2023-10-20,425.88,52,52,1168890895,305484810,0.000162975005464475,99.999516379157,0.0272965879265092
279.99,280,1837,1837,1837,1837,2023-09-27,2023-09-29,425.88,0,0,408556355,111857149,0.000449631973048125,99.996676590675,0
337.99,338,1760,1760,3520,1760,2023-09-27,2023-09-29,425.88,0,-1760,408556355,111857149,0.000430785123878443,99.9971073757989,-1
330.98,331,879,879,1758,1758,2023-09-27,2023-09-29,425.88,0,0,408556355,111857149,0.000430295595328581,99.9975376713942,0
194.99,195,1731,1736,1731,1736,2023-09-27,2023-10-20,425.88,5,5.00000000000023,1168890895,305484810,0.000148516855373401,99.9996648960124,0.00288018433179737
393.68,394,0,45,0,1440,2023-09-27,2023-10-06,425.88,45,1440,162893327,54801933,0.000884014113113424,99.9983394040445,1
347.98,348,755,712,1510,1424,2023-09-27,2023-09-29,425.88,-43,-86,408556355,111857149,0.000348544327501649,99.9978862157217,-0.0603932584269663
326.99,327,1358,1367,2716,1367,2023-09-27,2023-09-29,425.88,9,-1349,408556355,111857149,0.000334592763830586,99.9982208084855,-0.986832479882955
254.99,255,1257,1257,1257,1257,2023-09-27,2023-09-29,425.88,0,0,408556355,111857149,0.000307668693588183,99.9985284771791,0
386.77,387,41,53,738,1219,2023-09-27,2023-10-06,425.88,12,481,162893327,54801933,0.0007483425026981,99.9990877465472,0.394585726004922
391.39,392,0,19,0,1159,2023-09-27,2023-10-13,425.88,19,1159,114856729,34649438,0.00100908323795291,100,1
274.99,275,1140,1140,1140,1140,2023-09-27,2023-09-29,425.88,0,0,408556355,111857149,0.000279031273421264,99.9988075084526,0
164.99,165,1098,1098,1098,1098,2023-09-27,2023-10-20,425.88,0,0,1168890895,305484810,9.39351999999966e-05,99.9997588312124,0
331.99,332,1000,1029,1000,1029,2023-09-27,2023-09-29,425.88,29,29,408556355,111857149,0.00025186243890393,99.9990593708915,0.0281827016520894
350.99,351,1003,1007,2006,1007,2023-09-27,2023-09-29,425.88,4,-999,408556355,111857149,0.00024647762485545,99.9993058485163,-0.992055610724925
204.99,205,943,953,943,953,2023-09-27,2023-10-20,425.88,10,9.99999999999989,1168890895,305484810,8.15302783242229e-05,99.9998403614907,0.0104931794333682
269.99,270,948,948,948,948,2023-09-27,2023-09-29,425.88,0,0,408556355,111857149,0.000232036532634525,99.9995378850489,0
329.8,330,43,45,602,900,2023-09-27,2023-10-27,425.88,2,298,112653864,35070907,0.000798907350395012,100,0.331111111111111
332.99,333,774,802,774,802,2023-09-27,2023-09-29,425.88,28,28,408556355,111857149,0.000196300948494609,99.9997341859974,0.0349127182044888
343.99,344,797,798,1594,798,2023-09-27,2023-09-29,425.88,1,-796,408556355,111857149,0.000195321891394885,99.9999295078888,-0.997493734335839
174.99,175,713,713,713,713,2023-09-27,2023-10-20,425.88,0,0,1168890895,305484810,6.09979941712182e-05,99.9999013594849,0
184.99,185,612,612,612,612,2023-09-27,2023-10-20,425.88,0,0,1168890895,305484810,5.2357324590162e-05,99.9999537168095,0
179.99,180,541,541,541,541,2023-09-27,2023-10-20,425.88,0,0,1168890895,305484810,4.62831905282315e-05,100,0
380.84,381,8,27,104,432,2023-09-27,2023-10-06,425.88,19,328,162893327,54801933,0.000265204233934027,99.9993529507811,0.759259259259259
377.85,378,1,26,13,390,2023-09-27,2023-10-06,425.88,25,377,162893327,54801933,0.000239420488968219,99.9995923712701,0.966666666666667
381.85,382,20,21,280,315,2023-09-27,2023-10-06,425.88,1,35,162893327,54801933,0.000193378087243562,99.9997857493573,0.111111111111111
333.99,334,268,288,268,288,2023-09-27,2023-09-29,425.88,20,20,408556355,111857149,7.04921111801088e-05,100,0.0694444444444445
387.75,388,2,5,38,125,2023-09-27,2023-10-06,425.88,3,87,162893327,54801933,7.67373362077625e-05,99.9998624866935,0.696
367.9,368,0,10,0,100,2023-09-27,2023-10-06,425.88,10,100,162893327,54801933,6.138986896621e-05,99.9999238765625,1
372.87,373,3,4,30,52,2023-09-27,2023-10-06,425.88,1,22,162893327,54801933,3.19227318624292e-05,99.9999557992943,0.423076923076923
378.84,379,0,2,0,32,2023-09-27,2023-10-06,425.88,2,32,162893327,54801933,1.96447580691872e-05,99.9999754440524,1
373.87,374,1,2,11,26,2023-09-27,2023-10-06,425.88,1,15,162893327,54801933,1.59613659312146e-05,99.9999914054183,0.576923076923077
371.86,372,0,1,0,14,2023-09-27,2023-10-06,425.88,1,14,162893327,54801933,8.5945816552694e-06,100,1
429.46,454,1,0,2400,0,2023-09-27,2023-09-29,425.88,-1,-2400,408556355,111857149,0,100,-Inf
427.89,457,10,0,25250,0,2023-09-27,2023-09-29,425.88,-10,-25250,408556355,111857149,0,100,-Inf
442.86,459,0,0,0,0,2023-09-27,2023-09-29,425.88,0,0,408556355,111857149,0,100,
445.5,466,0,0,0,0,2023-09-27,2023-09-29,425.88,0,0,408556355,111857149,0,100,
441.6,471,0,0,0,0,2023-09-27,2023-09-29,425.88,0,0,408556355,111857149,0,100,
443.9,472,0,0,0,0,2023-09-27,2023-09-29,425.88,0,0,408556355,111857149,0,100,
445.11,473,0,0,0,0,2023-09-27,2023-09-29,425.88,0,0,408556355,111857149,0,100,
431.77,474,0,0,0,0,2023-09-27,2023-09-29,425.88,0,0,408556355,111857149,0,100,
443.9,476,0,0,0,0,2023-09-27,2023-09-29,425.88,0,0,408556355,111857149,0,100,
444.94,477,0,0,0,0,2023-09-27,2023-09-29,425.88,0,0,408556355,111857149,0,100,
457.53,478,0,0,0,0,2023-09-27,2023-09-29,425.88,0,0,408556355,111857149,0,100,
438.37,479,0,0,0,0,2023-09-27,2023-09-29,425.88,0,0,408556355,111857149,0,100,
431.03,481,0,0,0,0,2023-09-27,2023-09-29,425.88,0,0,408556355,111857149,0,100,
449.97,482,0,0,0,0,2023-09-27,2023-09-29,425.88,0,0,408556355,111857149,0,100,
483,483,0,0,0,0,2023-09-27,2023-09-29,425.88,0,0,408556355,111857149,0,100,
449.8,484,0,0,0,0,2023-09-27,2023-09-29,425.88,0,0,408556355,111857149,0,100,
447.13,485,0,0,0,0,2023-09-27,2023-09-29,425.88,0,0,408556355,111857149,0,100,
437.37,486,0,0,0,0,2023-09-27,2023-09-29,425.88,0,0,408556355,111857149,0,100,
487,487,0,0,0,0,2023-09-27,2023-09-29,425.88,0,0,408556355,111857149,0,100,
488,488,0,0,0,0,2023-09-27,2023-09-29,425.88,0,0,408556355,111857149,0,100,
489,489,0,0,0,0,2023-09-27,2023-09-29,425.88,0,0,408556355,111857149,0,100,
450.8,490,0,0,0,0,2023-09-27,2023-09-29,425.88,0,0,408556355,111857149,0,100,
491,491,0,0,0,0,2023-09-27,2023-09-29,425.88,0,0,408556355,111857149,0,100,
492,492,0,0,0,0,2023-09-27,2023-09-29,425.88,0,0,408556355,111857149,0,100,
493,493,0,0,0,0,2023-09-27,2023-09-29,425.88,0,0,408556355,111857149,0,100,
434.27,494,0,0,0,0,2023-09-27,2023-09-29,425.88,0,0,408556355,111857149,0,100,
451.55,495,0,0,0,0,2023-09-27,2023-09-29,425.88,0,0,408556355,111857149,0,100,
496,496,0,0,0,0,2023-09-27,2023-09-29,425.88,0,0,408556355,111857149,0,100,
497,497,0,0,0,0,2023-09-27,2023-09-29,425.88,0,0,408556355,111857149,0,100,
430.63,498,0,0,0,0,2023-09-27,2023-09-29,425.88,0,0,408556355,111857149,0,100,
499,499,0,0,0,0,2023-09-27,2023-09-29,425.88,0,0,408556355,111857149,0,100,
446.64,500,0,0,0,0,2023-09-27,2023-09-29,425.88,0,0,408556355,111857149,0,100,
447.08,502,0,0,0,0,2023-09-27,2023-09-29,425.88,0,0,408556355,111857149,0,100,
447.21,504,0,0,0,0,2023-09-27,2023-09-29,425.88,0,0,408556355,111857149,0,100,
447.09,505,0,0,0,0,2023-09-27,2023-09-29,425.88,0,0,408556355,111857149,0,100,
447.1,510,0,0,0,0,2023-09-27,2023-09-29,425.88,0,0,408556355,111857149,0,100,
515,515,0,0,0,0,2023-09-27,2023-09-29,425.88,0,0,408556355,111857149,0,100,
435.05,520,0,0,0,0,2023-09-27,2023-09-29,425.88,0,0,408556355,111857149,0,100,
441.79,525,0,0,0,0,2023-09-27,2023-09-29,425.88,0,0,408556355,111857149,0,100,
440.47,530,0,0,0,0,2023-09-27,2023-09-29,425.88,0,0,408556355,111857149,0,100,
440.6,540,0,0,0,0,2023-09-27,2023-09-29,425.88,0,0,408556355,111857149,0,100,
449.99,550,0,0,0,0,2023-09-27,2023-09-29,425.88,0,0,408556355,111857149,0,100,
376,376,0,0,0,0,2023-09-27,2023-10-06,425.88,0,0,162893327,54801933,0,100,
377,377,0,0,0,0,2023-09-27,2023-10-06,425.88,0,0,162893327,54801933,0,100,
434.28,452.5,0,0,0,0,2023-09-27,2023-10-06,425.88,0,0,162893327,54801933,0,100,
434.2,454,0,0,0,0,2023-09-27,2023-10-06,425.88,0,0,162893327,54801933,0,100,
432.05,457,0,0,0,0,2023-09-27,2023-10-06,425.88,0,0,162893327,54801933,0,100,
432.52,458,0,0,0,0,2023-09-27,2023-10-06,425.88,0,0,162893327,54801933,0,100,
432.87,459,0,0,0,0,2023-09-27,2023-10-06,425.88,0,0,162893327,54801933,0,100,
444.42,461,0,0,0,0,2023-09-27,2023-10-06,425.88,0,0,162893327,54801933,0,100,
432.77,462,0,0,0,0,2023-09-27,2023-10-06,425.88,0,0,162893327,54801933,0,100,
431.3,463,0,0,0,0,2023-09-27,2023-10-06,425.88,0,0,162893327,54801933,0,100,
434.21,464,0,0,0,0,2023-09-27,2023-10-06,425.88,0,0,162893327,54801933,0,100,
434.3,466,0,0,0,0,2023-09-27,2023-10-06,425.88,0,0,162893327,54801933,0,100,
447.29,468,0,0,0,0,2023-09-27,2023-10-06,425.88,0,0,162893327,54801933,0,100,
429.43,470,1,0,3715,0,2023-09-27,2023-10-06,425.88,-1,-3715,162893327,54801933,0,100,-Inf
441.7,471,0,0,0,0,2023-09-27,2023-10-06,425.88,0,0,162893327,54801933,0,100,
445.8,472,0,0,0,0,2023-09-27,2023-10-06,425.88,0,0,162893327,54801933,0,100,
473,473,0,0,0,0,2023-09-27,2023-10-06,425.88,0,0,162893327,54801933,0,100,
449.8,474,0,0,0,0,2023-09-27,2023-10-06,425.88,0,0,162893327,54801933,0,100,
442.6,475,0,0,0,0,2023-09-27,2023-10-06,425.88,0,0,162893327,54801933,0,100,
447.17,476,0,0,0,0,2023-09-27,2023-10-06,425.88,0,0,162893327,54801933,0,100,
477,477,0,0,0,0,2023-09-27,2023-10-06,425.88,0,0,162893327,54801933,0,100,
442,478,0,0,0,0,2023-09-27,2023-10-06,425.88,0,0,162893327,54801933,0,100,
479,479,0,0,0,0,2023-09-27,2023-10-06,425.88,0,0,162893327,54801933,0,100,
444.83,480,0,0,0,0,2023-09-27,2023-10-06,425.88,0,0,162893327,54801933,0,100,
481,481,0,0,0,0,2023-09-27,2023-10-06,425.88,0,0,162893327,54801933,0,100,
482,482,0,0,0,0,2023-09-27,2023-10-06,425.88,0,0,162893327,54801933,0,100,
483,483,0,0,0,0,2023-09-27,2023-10-06,425.88,0,0,162893327,54801933,0,100,
484,484,0,0,0,0,2023-09-27,2023-10-06,425.88,0,0,162893327,54801933,0,100,
485,485,0,0,0,0,2023-09-27,2023-10-06,425.88,0,0,162893327,54801933,0,100,
445.85,486,0,0,0,0,2023-09-27,2023-10-06,425.88,0,0,162893327,54801933,0,100,
487,487,0,0,0,0,2023-09-27,2023-10-06,425.88,0,0,162893327,54801933,0,100,
488,488,0,0,0,0,2023-09-27,2023-10-06,425.88,0,0,162893327,54801933,0,100,
489,489,0,0,0,0,2023-09-27,2023-10-06,425.88,0,0,162893327,54801933,0,100,
444.75,490,0,0,0,0,2023-09-27,2023-10-06,425.88,0,0,162893327,54801933,0,100,
491,491,0,0,0,0,2023-09-27,2023-10-06,425.88,0,0,162893327,54801933,0,100,
492,492,0,0,0,0,2023-09-27,2023-10-06,425.88,0,0,162893327,54801933,0,100,
493,493,0,0,0,0,2023-09-27,2023-10-06,425.88,0,0,162893327,54801933,0,100,
445.1,494,0,0,0,0,2023-09-27,2023-10-06,425.88,0,0,162893327,54801933,0,100,
446.24,495,0,0,0,0,2023-09-27,2023-10-06,425.88,0,0,162893327,54801933,0,100,
496,496,0,0,0,0,2023-09-27,2023-10-06,425.88,0,0,162893327,54801933,0,100,
500,500,0,0,0,0,2023-09-27,2023-10-06,425.88,0,0,162893327,54801933,0,100,
505,505,0,0,0,0,2023-09-27,2023-10-06,425.88,0,0,162893327,54801933,0,100,
510,510,0,0,0,0,2023-09-27,2023-10-06,425.88,0,0,162893327,54801933,0,100,
446.23,515,0,0,0,0,2023-09-27,2023-10-06,425.88,0,0,162893327,54801933,0,100,
520,520,0,0,0,0,2023-09-27,2023-10-06,425.88,0,0,162893327,54801933,0,100,
525,525,0,0,0,0,2023-09-27,2023-10-06,425.88,0,0,162893327,54801933,0,100,
530,530,0,0,0,0,2023-09-27,2023-10-06,425.88,0,0,162893327,54801933,0,100,
446.11,540,0,0,0,0,2023-09-27,2023-10-06,425.88,0,0,162893327,54801933,0,100,
432.72,452.5,0,0,0,0,2023-09-27,2023-10-13,425.88,0,0,114856729,34649438,0,100,
431.27,454,0,0,0,0,2023-09-27,2023-10-13,425.88,0,0,114856729,34649438,0,100,
432.9,455,0,0,0,0,2023-09-27,2023-10-13,425.88,0,0,114856729,34649438,0,100,
439.21,457.5,0,0,0,0,2023-09-27,2023-10-13,425.88,0,0,114856729,34649438,0,100,
429.08,458,1,0,2774,0,2023-09-27,2023-10-13,425.88,-1,-2774,114856729,34649438,0,100,-Inf
446,459,0,0,0,0,2023-09-27,2023-10-13,425.88,0,0,114856729,34649438,0,100,
431.34,461,0,0,0,0,2023-09-27,2023-10-13,425.88,0,0,114856729,34649438,0,100,
430.62,462,0,0,0,0,2023-09-27,2023-10-13,425.88,0,0,114856729,34649438,0,100,
443.42,462.5,0,0,0,0,2023-09-27,2023-10-13,425.88,0,0,114856729,34649438,0,100,
445.85,463,0,0,0,0,2023-09-27,2023-10-13,425.88,0,0,114856729,34649438,0,100,
433.04,464,0,0,0,0,2023-09-27,2023-10-13,425.88,0,0,114856729,34649438,0,100,
434.6,465,0,0,0,0,2023-09-27,2023-10-13,425.88,0,0,114856729,34649438,0,100,
443.82,466,0,0,0,0,2023-09-27,2023-10-13,425.88,0,0,114856729,34649438,0,100,
447,467,0,0,0,0,2023-09-27,2023-10-13,425.88,0,0,114856729,34649438,0,100,
468,468,0,0,0,0,2023-09-27,2023-10-13,425.88,0,0,114856729,34649438,0,100,
449.61,469,0,0,0,0,2023-09-27,2023-10-13,425.88,0,0,114856729,34649438,0,100,
430.47,471,0,0,0,0,2023-09-27,2023-10-13,425.88,0,0,114856729,34649438,0,100,
443.8,472,0,0,0,0,2023-09-27,2023-10-13,425.88,0,0,114856729,34649438,0,100,
447.37,474,0,0,0,0,2023-09-27,2023-10-13,425.88,0,0,114856729,34649438,0,100,
446.41,475,0,0,0,0,2023-09-27,2023-10-13,425.88,0,0,114856729,34649438,0,100,
476,476,0,0,0,0,2023-09-27,2023-10-13,425.88,0,0,114856729,34649438,0,100,
446.5,478,0,0,0,0,2023-09-27,2023-10-13,425.88,0,0,114856729,34649438,0,100,
426.63,480,0,0,0,0,2023-09-27,2023-10-13,425.88,0,0,114856729,34649438,0,100,
482,482,0,0,0,0,2023-09-27,2023-10-13,425.88,0,0,114856729,34649438,0,100,
446.38,484,0,0,0,0,2023-09-27,2023-10-13,425.88,0,0,114856729,34649438,0,100,
485,485,0,0,0,0,2023-09-27,2023-10-13,425.88,0,0,114856729,34649438,0,100,
486,486,0,0,0,0,2023-09-27,2023-10-13,425.88,0,0,114856729,34649438,0,100,
443.51,488,0,0,0,0,2023-09-27,2023-10-13,425.88,0,0,114856729,34649438,0,100,
443.93,490,0,0,0,0,2023-09-27,2023-10-13,425.88,0,0,114856729,34649438,0,100,
495,495,0,0,0,0,2023-09-27,2023-10-13,425.88,0,0,114856729,34649438,0,100,
428.09,500,0,0,0,0,2023-09-27,2023-10-13,425.88,0,0,114856729,34649438,0,100,
505,505,0,0,0,0,2023-09-27,2023-10-13,425.88,0,0,114856729,34649438,0,100,
510,510,0,0,0,0,2023-09-27,2023-10-13,425.88,0,0,114856729,34649438,0,100,
515,515,0,0,0,0,2023-09-27,2023-10-13,425.88,0,0,114856729,34649438,0,100,
444.71,520,0,0,0,0,2023-09-27,2023-10-13,425.88,0,0,114856729,34649438,0,100,
525,525,0,0,0,0,2023-09-27,2023-10-13,425.88,0,0,114856729,34649438,0,100,
530,530,0,0,0,0,2023-09-27,2023-10-13,425.88,0,0,114856729,34649438,0,100,
444.75,540,0,0,0,0,2023-09-27,2023-10-13,425.88,0,0,114856729,34649438,0,100,
429.1,461,1,0,3080,0,2023-09-27,2023-10-20,425.88,-1,-3080,1168890895,305484810,0,100,-Inf
426.01,463,179,0,561881,0,2023-09-27,2023-10-20,425.88,-179,-561881,1168890895,305484810,0,100,-Inf
432.42,466,0,0,0,0,2023-09-27,2023-10-20,425.88,0,0,1168890895,305484810,0,100,
467,467,0,0,0,0,2023-09-27,2023-10-20,425.88,0,0,1168890895,305484810,0,100,
438.6,476,0,0,0,0,2023-09-27,2023-10-20,425.88,0,0,1168890895,305484810,0,100,
449.25,478,0,0,0,0,2023-09-27,2023-10-20,425.88,0,0,1168890895,305484810,0,100,
430.49,484,0,0,0,0,2023-09-27,2023-10-20,425.88,0,0,1168890895,305484810,0,100,
430.48,486,0,0,0,0,2023-09-27,2023-10-20,425.88,0,0,1168890895,305484810,0,100,
443.46,488,0,0,0,0,2023-09-27,2023-10-20,425.88,0,0,1168890895,305484810,0,100,
431.06,492,0,0,0,0,2023-09-27,2023-10-20,425.88,0,0,1168890895,305484810,0,100,
494,494,0,0,0,0,2023-09-27,2023-10-20,425.88,0,0,1168890895,305484810,0,100,
439.3,496,0,0,0,0,2023-09-27,2023-10-20,425.88,0,0,1168890895,305484810,0,100,
438.16,498,0,0,0,0,2023-09-27,2023-10-20,425.88,0,0,1168890895,305484810,0,100,
441,500,0,0,0,0,2023-09-27,2023-10-20,425.88,0,0,1168890895,305484810,0,100,
432.11,502,0,0,0,0,2023-09-27,2023-10-20,425.88,0,0,1168890895,305484810,0,100,
451.26,504,0,0,0,0,2023-09-27,2023-10-20,425.88,0,0,1168890895,305484810,0,100,
449.21,505,0,0,0,0,2023-09-27,2023-10-20,425.88,0,0,1168890895,305484810,0,100,
506,506,0,0,0,0,2023-09-27,2023-10-20,425.88,0,0,1168890895,305484810,0,100,
442.77,510,0,0,0,0,2023-09-27,2023-10-20,425.88,0,0,1168890895,305484810,0,100,
444.62,515,0,0,0,0,2023-09-27,2023-10-20,425.88,0,0,1168890895,305484810,0,100,
455.07,520,0,0,0,0,2023-09-27,2023-10-20,425.88,0,0,1168890895,305484810,0,100,
444.6,525,0,0,0,0,2023-09-27,2023-10-20,425.88,0,0,1168890895,305484810,0,100,
430.05,530,1,0,9995,0,2023-09-27,2023-10-20,425.88,-1,-9995,1168890895,305484810,0,100,-Inf
431.05,535,0,0,0,0,2023-09-27,2023-10-20,425.88,0,0,1168890895,305484810,0,100,
456.29,545,0,0,0,0,2023-09-27,2023-10-20,425.88,0,0,1168890895,305484810,0,100,
428.35,550,1,0,11960,0,2023-09-27,2023-10-20,425.88,-1,-11960,1168890895,305484810,0,100,-Inf
450.59,555,0,0,0,0,2023-09-27,2023-10-20,425.88,0,0,1168890895,305484810,0,100,
430.49,560,0,0,0,0,2023-09-27,2023-10-20,425.88,0,0,1168890895,305484810,0,100,
430.47,565,0,0,0,0,2023-09-27,2023-10-20,425.88,0,0,1168890895,305484810,0,100,
435.56,570,0,0,0,0,2023-09-27,2023-10-20,425.88,0,0,1168890895,305484810,0,100,
445.25,575,0,0,0,0,2023-09-27,2023-10-20,425.88,0,0,1168890895,305484810,0,100,
452.56,580,0,0,0,0,2023-09-27,2023-10-20,425.88,0,0,1168890895,305484810,0,100,
446.3,585,0,0,0,0,2023-09-27,2023-10-20,425.88,0,0,1168890895,305484810,0,100,
446.27,590,0,0,0,0,2023-09-27,2023-10-20,425.88,0,0,1168890895,305484810,0,100,
456.13,595,0,0,0,0,2023-09-27,2023-10-20,425.88,0,0,1168890895,305484810,0,100,
444.32,600,0,0,0,0,2023-09-27,2023-10-20,425.88,0,0,1168890895,305484810,0,100,
432.64,454,0,0,0,0,2023-09-27,2023-10-27,425.88,0,0,112653864,35070907,0,100,
433.93,456,0,0,0,0,2023-09-27,2023-10-27,425.88,0,0,112653864,35070907,0,100,
435.43,457,0,0,0,0,2023-09-27,2023-10-27,425.88,0,0,112653864,35070907,0,100,
447.27,457.5,0,0,0,0,2023-09-27,2023-10-27,425.88,0,0,112653864,35070907,0,100,
439.33,458,0,0,0,0,2023-09-27,2023-10-27,425.88,0,0,112653864,35070907,0,100,
443.48,462,0,0,0,0,2023-09-27,2023-10-27,425.88,0,0,112653864,35070907,0,100,
463,463,0,0,0,0,2023-09-27,2023-10-27,425.88,0,0,112653864,35070907,0,100,
443,464,0,0,0,0,2023-09-27,2023-10-27,425.88,0,0,112653864,35070907,0,100,
425.13,465,15,0,49110,0,2023-09-27,2023-10-27,425.88,-15,-49110,112653864,35070907,0,100,-Inf
466,466,0,0,0,0,2023-09-27,2023-10-27,425.88,0,0,112653864,35070907,0,100,
467,467,0,0,0,0,2023-09-27,2023-10-27,425.88,0,0,112653864,35070907,0,100,
468,468,0,0,0,0,2023-09-27,2023-10-27,425.88,0,0,112653864,35070907,0,100,
469,469,0,0,0,0,2023-09-27,2023-10-27,425.88,0,0,112653864,35070907,0,100,
442.93,470,0,0,0,0,2023-09-27,2023-10-27,425.88,0,0,112653864,35070907,0,100,
472,472,0,0,0,0,2023-09-27,2023-10-27,425.88,0,0,112653864,35070907,0,100,
474,474,0,0,0,0,2023-09-27,2023-10-27,425.88,0,0,112653864,35070907,0,100,
445.74,475,0,0,0,0,2023-09-27,2023-10-27,425.88,0,0,112653864,35070907,0,100,
476,476,0,0,0,0,2023-09-27,2023-10-27,425.88,0,0,112653864,35070907,0,100,
478,478,0,0,0,0,2023-09-27,2023-10-27,425.88,0,0,112653864,35070907,0,100,
429.7,480,0,0,0,0,2023-09-27,2023-10-27,425.88,0,0,112653864,35070907,0,100,
444.4,482,0,0,0,0,2023-09-27,2023-10-27,425.88,0,0,112653864,35070907,0,100,
484,484,0,0,0,0,2023-09-27,2023-10-27,425.88,0,0,112653864,35070907,0,100,
485,485,0,0,0,0,2023-09-27,2023-10-27,425.88,0,0,112653864,35070907,0,100,
444.46,490,0,0,0,0,2023-09-27,2023-10-27,425.88,0,0,112653864,35070907,0,100,
495,495,0,0,0,0,2023-09-27,2023-10-27,425.88,0,0,112653864,35070907,0,100,
505,505,0,0,0,0,2023-09-27,2023-10-27,425.88,0,0,112653864,35070907,0,100,
510,510,0,0,0,0,2023-09-27,2023-10-27,425.88,0,0,112653864,35070907,0,100,
515,515,0,0,0,0,2023-09-27,2023-10-27,425.88,0,0,112653864,35070907,0,100,
520,520,0,0,0,0,2023-09-27,2023-10-27,425.88,0,0,112653864,35070907,0,100,
525,525,0,0,0,0,2023-09-27,2023-10-27,425.88,0,0,112653864,35070907,0,100,
530,530,0,0,0,0,2023-09-27,2023-10-27,425.88,0,0,112653864,35070907,0,100,
444.75,540,0,0,0,0,2023-09-27,2023-10-27,425.88,0,0,112653864,35070907,0,100,
431.55,466,0,0,0,0,2023-09-27,2023-11-17,425.88,0,0,1021033106,270136960,0,100,
433.7,472,0,0,0,0,2023-09-27,2023-11-17,425.88,0,0,1021033106,270136960,0,100,
474,474,0,0,0,0,2023-09-27,2023-11-17,425.88,0,0,1021033106,270136960,0,100,
433.23,476,0,0,0,0,2023-09-27,2023-11-17,425.88,0,0,1021033106,270136960,0,100,
448.11,478,0,0,0,0,2023-09-27,2023-11-17,425.88,0,0,1021033106,270136960,0,100,
443.84,480,0,0,0,0,2023-09-27,2023-11-17,425.88,0,0,1021033106,270136960,0,100,
449.76,482,0,0,0,0,2023-09-27,2023-11-17,425.88,0,0,1021033106,270136960,0,100,
484,484,0,0,0,0,2023-09-27,2023-11-17,425.88,0,0,1021033106,270136960,0,100,
431.54,485,0,0,0,0,2023-09-27,2023-11-17,425.88,0,0,1021033106,270136960,0,100,
441.95,486,0,0,0,0,2023-09-27,2023-11-17,425.88,0,0,1021033106,270136960,0,100,
443.39,488,0,0,0,0,2023-09-27,2023-11-17,425.88,0,0,1021033106,270136960,0,100,
443.6,490,0,0,0,0,2023-09-27,2023-11-17,425.88,0,0,1021033106,270136960,0,100,
492,492,0,0,0,0,2023-09-27,2023-11-17,425.88,0,0,1021033106,270136960,0,100,
494,494,0,0,0,0,2023-09-27,2023-11-17,425.88,0,0,1021033106,270136960,0,100,
430.64,496,0,0,0,0,2023-09-27,2023-11-17,425.88,0,0,1021033106,270136960,0,100,
449.9,510,0,0,0,0,2023-09-27,2023-11-17,425.88,0,0,1021033106,270136960,0,100,
444.16,515,0,0,0,0,2023-09-27,2023-11-17,425.88,0,0,1021033106,270136960,0,100,
520,520,0,0,0,0,2023-09-27,2023-11-17,425.88,0,0,1021033106,270136960,0,100,
525,525,0,0,0,0,2023-09-27,2023-11-17,425.88,0,0,1021033106,270136960,0,100,
448.8,530,0,0,0,0,2023-09-27,2023-11-17,425.88,0,0,1021033106,270136960,0,100,
535,535,0,0,0,0,2023-09-27,2023-11-17,425.88,0,0,1021033106,270136960,0,100,
439.89,540,0,0,0,0,2023-09-27,2023-11-17,425.88,0,0,1021033106,270136960,0,100,
444.59,545,0,0,0,0,2023-09-27,2023-11-17,425.88,0,0,1021033106,270136960,0,100,
434.33,550,0,0,0,0,2023-09-27,2023-11-17,425.88,0,0,1021033106,270136960,0,100,
443.66,560,0,0,0,0,2023-09-27,2023-11-17,425.88,0,0,1021033106,270136960,0,100,
432.99,467,0,0,0,0,2023-09-27,2023-12-15,425.88,0,0,1064176186,228355863,0,100,
427.65,469,1,0,3769,0,2023-09-27,2023-12-15,425.88,-1,-3769,1064176186,228355863,0,100,-Inf
474,474,0,0,0,0,2023-09-27,2023-12-15,425.88,0,0,1064176186,228355863,0,100,
431.9,477,0,0,0,0,2023-09-27,2023-12-15,425.88,0,0,1064176186,228355863,0,100,
436,478,0,0,0,0,2023-09-27,2023-12-15,425.88,0,0,1064176186,228355863,0,100,
444.12,479,0,0,0,0,2023-09-27,2023-12-15,425.88,0,0,1064176186,228355863,0,100,
449,481,0,0,0,0,2023-09-27,2023-12-15,425.88,0,0,1064176186,228355863,0,100,
482,482,0,0,0,0,2023-09-27,2023-12-15,425.88,0,0,1064176186,228355863,0,100,
483,483,0,0,0,0,2023-09-27,2023-12-15,425.88,0,0,1064176186,228355863,0,100,
457.21,484,0,0,0,0,2023-09-27,2023-12-15,425.88,0,0,1064176186,228355863,0,100,
431,485,0,0,0,0,2023-09-27,2023-12-15,425.88,0,0,1064176186,228355863,0,100,
486,486,0,0,0,0,2023-09-27,2023-12-15,425.88,0,0,1064176186,228355863,0,100,
434.75,487,0,0,0,0,2023-09-27,2023-12-15,425.88,0,0,1064176186,228355863,0,100,
444.6,488,0,0,0,0,2023-09-27,2023-12-15,425.88,0,0,1064176186,228355863,0,100,
445.13,489,0,0,0,0,2023-09-27,2023-12-15,425.88,0,0,1064176186,228355863,0,100,
443.85,491,0,0,0,0,2023-09-27,2023-12-15,425.88,0,0,1064176186,228355863,0,100,
444.92,492,0,0,0,0,2023-09-27,2023-12-15,425.88,0,0,1064176186,228355863,0,100,
493,493,0,0,0,0,2023-09-27,2023-12-15,425.88,0,0,1064176186,228355863,0,100,
432.31,494,0,0,0,0,2023-09-27,2023-12-15,425.88,0,0,1064176186,228355863,0,100,
434.7,495,0,0,0,0,2023-09-27,2023-12-15,425.88,0,0,1064176186,228355863,0,100,
496,496,0,0,0,0,2023-09-27,2023-12-15,425.88,0,0,1064176186,228355863,0,100,
497,497,0,0,0,0,2023-09-27,2023-12-15,425.88,0,0,1064176186,228355863,0,100,
450.44,498,0,0,0,0,2023-09-27,2023-12-15,425.88,0,0,1064176186,228355863,0,100,
499,499,0,0,0,0,2023-09-27,2023-12-15,425.88,0,0,1064176186,228355863,0,100,
432.27,501,0,0,0,0,2023-09-27,2023-12-15,425.88,0,0,1064176186,228355863,0,100,
432.21,505,0,0,0,0,2023-09-27,2023-12-15,425.88,0,0,1064176186,228355863,0,100,
430.13,515,0,0,0,0,2023-09-27,2023-12-15,425.88,0,0,1064176186,228355863,0,100,
450,520,0,0,0,0,2023-09-27,2023-12-15,425.88,0,0,1064176186,228355863,0,100,
432.24,530,0,0,0,0,2023-09-27,2023-12-15,425.88,0,0,1064176186,228355863,0,100,
440.9,535,0,0,0,0,2023-09-27,2023-12-15,425.88,0,0,1064176186,228355863,0,100,
431.24,545,0,0,0,0,2023-09-27,2023-12-15,425.88,0,0,1064176186,228355863,0,100,
440.93,550,0,0,0,0,2023-09-27,2023-12-15,425.88,0,0,1064176186,228355863,0,100,
432.4,560,0,0,0,0,2023-09-27,2023-12-15,425.88,0,0,1064176186,228355863,0,100,
565,565,0,0,0,0,2023-09-27,2023-12-15,425.88,0,0,1064176186,228355863,0,100,
451.5,570,0,0,0,0,2023-09-27,2023-12-15,425.88,0,0,1064176186,228355863,0,100,
575,575,0,0,0,0,2023-09-27,2023-12-15,425.88,0,0,1064176186,228355863,0,100,
580,580,0,0,0,0,2023-09-27,2023-12-15,425.88,0,0,1064176186,228355863,0,100,
585,585,0,0,0,0,2023-09-27,2023-12-15,425.88,0,0,1064176186,228355863,0,100,
431.25,595,0,0,0,0,2023-09-27,2023-12-15,425.88,0,0,1064176186,228355863,0,100,
452.7,600,0,0,0,0,2023-09-27,2023-12-15,425.88,0,0,1064176186,228355863,0,100,
605,605,0,0,0,0,2023-09-27,2023-12-15,425.88,0,0,1064176186,228355863,0,100,
610,610,0,0,0,0,2023-09-27,2023-12-15,425.88,0,0,1064176186,228355863,0,100,
615,615,0,0,0,0,2023-09-27,2023-12-15,425.88,0,0,1064176186,228355863,0,100,
620,620,0,0,0,0,2023-09-27,2023-12-15,425.88,0,0,1064176186,228355863,0,100,
625,625,0,0,0,0,2023-09-27,2023-12-15,425.88,0,0,1064176186,228355863,0,100,
630,630,0,0,0,0,2023-09-27,2023-12-15,425.88,0,0,1064176186,228355863,0,100,
635,635,0,0,0,0,2023-09-27,2023-12-15,425.88,0,0,1064176186,228355863,0,100,
640,640,0,0,0,0,2023-09-27,2023-12-15,425.88,0,0,1064176186,228355863,0,100,
645,645,0,0,0,0,2023-09-27,2023-12-15,425.88,0,0,1064176186,228355863,0,100,
650,650,0,0,0,0,2023-09-27,2023-12-15,425.88,0,0,1064176186,228355863,0,100,
655,655,0,0,0,0,2023-09-27,2023-12-15,425.88,0,0,1064176186,228355863,0,100,
660,660,0,0,0,0,2023-09-27,2023-12-15,425.88,0,0,1064176186,228355863,0,100,
665,665,0,0,0,0,2023-09-27,2023-12-15,425.88,0,0,1064176186,228355863,0,100,
445.5,670,0,0,0,0,2023-09-27,2023-12-15,425.88,0,0,1064176186,228355863,0,100,
675,675,0,0,0,0,2023-09-27,2023-12-15,425.88,0,0,1064176186,228355863,0,100,
680,680,0,0,0,0,2023-09-27,2023-12-15,425.88,0,0,1064176186,228355863,0,100,
445.94,685,0,0,0,0,2023-09-27,2023-12-15,425.88,0,0,1064176186,228355863,0,100,
690,690,0,0,0,0,2023-09-27,2023-12-15,425.88,0,0,1064176186,228355863,0,100,
695,695,0,0,0,0,2023-09-27,2023-12-15,425.88,0,0,1064176186,228355863,0,100,
433.84,700,0,0,0,0,2023-09-27,2023-12-15,425.88,0,0,1064176186,228355863,0,100,
440.65,705,0,0,0,0,2023-09-27,2023-12-15,425.88,0,0,1064176186,228355863,0,100,
710,710,0,0,0,0,2023-09-27,2023-12-15,425.88,0,0,1064176186,228355863,0,100,
442.92,715,0,0,0,0,2023-09-27,2023-12-15,425.88,0,0,1064176186,228355863,0,100,
442.77,720,0,0,0,0,2023-09-27,2023-12-15,425.88,0,0,1064176186,228355863,0,100,
