Watch,strike,open_interest.yt,open_interest.td,OI_Dollar.yt,OI_Dollar.td,Date.td,expiry,stkClose,diff_oi,diff_oi_d,totalOI,totalOIdiff,OI_pct,cum_sep_OI,pct
400.5,405,126761,126767,47662136,57045150,2024-02-01,2024-09-20,482.88,6,9383014,275196706,45340715,20.7288636659772,20.7288636659772,0.164483992065934
466.15,490,18609,18697,38930028,44592345,2024-02-01,2024-12-20,482.88,88,5662317,461752055,55002926,9.65720553209016,9.65720553209016,0.126979574633269
393.45,400,64858,65066,36515054,42618230,2024-02-01,2024-12-20,482.88,208,6103176,461752055,55002926,9.22967846889171,18.8868840009819,0.143205759600997
452.87,460,56854,57096,32179364,40709448,2024-02-01,2024-06-21,482.88,242,8530084,413696011,79729983,9.84042555827303,9.84042555827303,0.209535732344
471.91,500,11747,11983,28897620,33660247,2024-02-01,2024-12-20,482.88,236,4762627,461752055,55002926,7.28967995605347,26.1765639570353,0.141491148297278
460.85,470,33712,33664,24609760,30802560,2024-02-01,2024-06-21,482.88,-48,6192800,413696011,79729983,7.44569905944778,17.2861246177208,0.201048224563153
474.01,490,19588,18196,24720056,29095404,2024-02-01,2024-06-21,482.88,-1392,4375348,413696011,79729983,7.03303953298211,24.3191641507029,0.150379352010372
460.05,480,13555,13518,24480330,26968410,2024-02-01,2024-12-20,482.88,-37,2488080,461752055,55002926,5.84045262126662,32.017016578302,0.0922590542045303
467.95,480,20891,19384,19073483,23357720,2024-02-01,2024-06-21,482.88,-1507,4284237,413696011,79729983,5.64610713638232,29.9652712870852,0.18341845865093
435.33,440,48851,49877,17390956,23292559,2024-02-01,2024-06-21,482.88,1026,5901603,413696011,79729983,5.63035619891438,35.5956274859996,0.25336859724172
448.85,460,17857,20885,16660581,23286775,2024-02-01,2024-09-20,482.88,3028,6626194,275196706,45340715,8.46186545561341,29.1907291215906,0.284547516777227
436.84,450,16663,16757,19162450,22052212,2024-02-01,2024-12-20,482.88,94,2889762,461752055,55002926,4.77576910838004,36.792785686682,0.131041820203796
457.79,460,99624,98854,14644728,21846734,2024-02-01,2024-03-15,482.88,-770,7202006,452229307,160916150,4.83089743672893,4.83089743672893,0.329660534155815
477.71,486,26137,26199,13983295,21718971,2024-02-01,2024-03-15,482.88,62,7735676,452229307,160916150,4.80264561889617,9.6335430556251,0.356171385835913
428.6,440,18870,18882,19002090,21525480,2024-02-01,2024-12-20,482.88,12,2523390,461752055,55002926,4.66169663283902,41.454482319521,0.117228047876284
473.97,480,34306,34474,13139198,20787822,2024-02-01,2024-03-15,482.88,168,7648624,452229307,160916150,4.59674366040147,14.2302867160266,0.367937728156418
464.19,470,33868,33545,14224560,19489645,2024-02-01,2024-04-19,482.88,-323,5265085,232702399,73324968,8.37535198766902,8.37535198766902,0.270147814390667
466.41,470,47471,53888,10633504,19345792,2024-02-01,2024-03-15,482.88,6417,8712288,452229307,160916150,4.27787224325114,18.5081589592777,0.450345377434018
424.32,435,17922,17925,16757070,19143900,2024-02-01,2024-12-20,482.88,3,2386830,461752055,55002926,4.1459263240312,45.6004086435522,0.124678357074577
444.29,450,32943,32964,14890236,18822444,2024-02-01,2024-06-21,482.88,21,3932208,413696011,79729983,4.54982487128695,40.1454523572866,0.20891059630726
461.75,467,32665,35349,12216710,18558225,2024-02-01,2024-04-19,482.88,2684,6341515,232702399,73324968,7.97508967666466,16.3504416643337,0.341709134359563
456.91,465,22691,22667,15134897,18337603,2024-02-01,2024-06-21,482.88,-24,3202706,413696011,79729983,4.43262746374415,44.5780798210307,0.174652379593996
464.56,475,17051,17175,13777208,17930700,2024-02-01,2024-06-21,482.88,124,4153492,413696011,79729983,4.33426949335511,48.9123493143858,0.231641374848723
471.17,485,14072,12603,15183688,17429949,2024-02-01,2024-06-21,482.88,-1469,2246261,413696011,79729983,4.21322626676234,53.1255755811482,0.128873641569462
452.4,470,9843,9862,15177906,17357120,2024-02-01,2024-12-20,482.88,19,2179214,461752055,55002926,3.75896973539187,49.3593783789441,0.125551589203739
411.51,420,20436,20439,15224820,17352711,2024-02-01,2024-12-20,482.88,3,2127891,461752055,55002926,3.75801489394563,53.1173932728897,0.122625853677849
460,465,15811,34608,5518039,17304000,2024-02-01,2024-04-19,482.88,18797,11785961,232702399,73324968,7.43610726591607,23.7865489302498,0.681111939435969
426.3,430,46379,46134,13589047,17069580,2024-02-01,2024-06-21,482.88,-245,3480533,413696011,79729983,4.12611665235515,57.2516922335033,0.203902673645163
470.38,475,36215,36383,10683425,16808946,2024-02-01,2024-03-15,482.88,168,6125521,452229307,160916150,3.71690771469616,22.2250666739739,0.364420291432907
479.71,490,19325,16142,12947750,16610118,2024-02-01,2024-03-15,482.88,-3183,3662368,452229307,160916150,3.67294152388934,25.8980081978632,0.220490185560392
455.93,475,8567,8553,14315457,16310571,2024-02-01,2024-12-20,482.88,-14,1995114,461752055,55002926,3.5323223412617,56.6497156141514,0.12232030380788
448.53,450,104449,105590,10236002,15521730,2024-02-01,2024-03-15,482.88,1141,5285728,452229307,160916150,3.43226981527758,29.3302780131408,0.340537298355273
440.82,455,10777,10777,13277264,15281786,2024-02-01,2024-12-20,482.88,0,2004522,461752055,55002926,3.30952203342116,59.9592376475726,0.1311706629055
375.04,380,30624,30619,13137696,15187024,2024-02-01,2024-12-20,482.88,-5,2049328,461752055,55002926,3.28899976416997,63.2482374117425,0.134939406166738
463.49,480,9092,9095,12683340,15015845,2024-02-01,2024-09-20,482.88,3,2332505,275196706,45340715,5.4564043364676,34.6471334580582,0.155336246478304
436.43,445,17266,17262,12569648,14793534,2024-02-01,2024-09-20,482.88,-4,2223886,275196706,45340715,5.37562175617029,40.0227552142285,0.150328244758825
456.49,470,10668,10689,12182856,14440839,2024-02-01,2024-09-20,482.88,21,2257983,275196706,45340715,5.2474607018007,45.2702159160292,0.156360928890627
467.18,485,8054,7943,12330674,14154426,2024-02-01,2024-09-20,482.88,-111,1823752,275196706,45340715,5.14338496478951,50.4136008808187,0.128846764962422
384.6,390,26358,26144,13099926,14117760,2024-02-01,2024-12-20,482.88,-214,1017834,461752055,55002926,3.05743306329194,66.3056704750345,0.0720959982320141
423.6,430,21896,21918,12152280,14027520,2024-02-01,2024-09-20,482.88,22,1875240,275196706,45340715,5.09727031398406,55.5108711948028,0.133682931836847
397.89,400,63050,63095,10592400,13313045,2024-02-01,2024-06-21,482.88,45,2720645,413696011,79729983,3.21807429755468,60.469766531058,0.204359333270488
419.95,430,13271,13241,11466144,13307205,2024-02-01,2024-12-20,482.88,-30,1841061,461752055,55002926,2.88189405026037,69.1875645252949,0.138350690471816
409.53,410,282978,282481,10470186,13276607,2024-02-01,2024-03-15,482.88,-497,2806421,452229307,160916150,2.93581304760507,32.2660910607459,0.211380889710752
416.95,420,42195,42224,10422165,12878320,2024-02-01,2024-06-21,482.88,29,2456155,413696011,79729983,3.11299109915759,63.5827576302156,0.190720140515222
438.94,440,113106,117813,8256738,12488178,2024-02-01,2024-03-15,482.88,4707,4231440,452229307,160916150,2.76147029984503,35.0275613605909,0.338835657211164
448.66,455,18557,19569,9092930,12406746,2024-02-01,2024-06-21,482.88,1012,3313816,413696011,79729983,2.99900063575909,66.5817582659747,0.267097915924127
430.81,435,28595,29596,9178995,12400724,2024-02-01,2024-06-21,482.88,1001,3221729,413696011,79729983,2.99754497753666,69.5793032435113,0.25980168577254
414.49,415,243138,242259,9725520,12355209,2024-02-01,2024-03-15,482.88,-879,2629689,452229307,160916150,2.73206729611622,37.7596286567071,0.212840511237001
453.14,455,66261,66098,7620015,12294228,2024-02-01,2024-03-15,482.88,-163,4674213,452229307,160916150,2.71858276535802,40.4782114220651,0.380195730874684
476.76,480,38894,37912,5795206,12283488,2024-02-01,2024-02-16,482.88,-982,6488282,187049931,90530418,6.56695671275067,6.56695671275067,0.528211693616667
395.86,400,28380,28380,10018140,11749320,2024-02-01,2024-09-20,482.88,0,1731180,275196706,45340715,4.26942610279645,59.7802972975992,0.147342995169082
429.24,430,153837,152916,8461035,11621616,2024-02-01,2024-03-15,482.88,-921,3160581,452229307,160916150,2.56985025519366,43.0480616772588,0.271957101318784
461.25,464,25642,41881,4179646,11517275,2024-02-01,2024-03-15,482.88,16239,7337629,452229307,160916150,2.54677766825935,45.5948393455181,0.63709766416101
414.31,420,19842,19851,9544002,11295219,2024-02-01,2024-09-20,482.88,9,1751217,275196706,45340715,4.10441649690385,63.8847137945031,0.155040552998574
421.58,425,33062,32895,8893678,11250090,2024-02-01,2024-06-21,482.88,-167,2356412,413696011,79729983,2.71940983254973,72.2987130760611,0.209457168787094
456.86,459,34271,52553,4558043,11246342,2024-02-01,2024-03-15,482.88,18282,6688299,452229307,160916150,2.48686713265136,48.0817064781695,0.594708839549784
416.09,425,12431,12517,10006955,11152647,2024-02-01,2024-12-20,482.88,86,1145692,461752055,55002926,2.41528908842647,71.6028536137213,0.10272825814356
440.65,450,9979,11924,7783620,11148940,2024-02-01,2024-09-20,482.88,1945,3365320,275196706,45340715,4.05126215427884,67.9359759487819,0.301851117684731
477.1,495,5923,5753,8315892,10297870,2024-02-01,2024-06-21,482.88,-170,1981978,413696011,79729983,2.48923599120708,74.7879490672682,0.192464849527135
462.19,465,35693,36399,6389047,10228119,2024-02-01,2024-03-15,482.88,706,3839072,452229307,160916150,2.26171078293252,50.343417261102,0.375344870352017
479.69,485,20033,19040,5108415,10110240,2024-02-01,2024-02-16,482.88,-993,5001825,187049931,90530418,5.40510223444028,11.972058947191,0.494728611783697
475.39,478,38124,38664,4651128,10091304,2024-02-01,2024-02-16,482.88,540,5440176,187049931,90530418,5.39497873431453,17.3670376815055,0.539095442967529
467.83,475,13863,13815,6986952,9905355,2024-02-01,2024-04-19,482.88,-48,2918403,232702399,73324968,4.25666217562287,28.0432111058726,0.294628814414022
432.76,445,7575,8026,8135550,9823824,2024-02-01,2024-12-20,482.88,451,1688274,461752055,55002926,2.12751061822562,73.730364231947,0.171855073950836
473.05,475,48374,49407,4450408,9634365,2024-02-01,2024-02-16,482.88,1033,5183957,187049931,90530418,5.15069155518694,22.5177292366924,0.538069400526137
439.99,445,19241,19224,7600195,9631224,2024-02-01,2024-06-21,482.88,-17,2031029,413696011,79729983,2.32809206371584,77.116041130984,0.210879634821078
445.11,455,9610,9612,8399140,9506268,2024-02-01,2024-09-20,482.88,2,1107128,275196706,45340715,3.45435384680804,71.3903297955899,0.116462948446225
379.66,385,17617,17613,8086203,9405342,2024-02-01,2024-12-20,482.88,-4,1319139,461752055,55002926,2.03688146011608,75.767245692063,0.140254229989723
432.18,440,11794,11800,7807628,9227600,2024-02-01,2024-09-20,482.88,6,1419972,275196706,45340715,3.35309246034362,74.7434222559335,0.153883133209068
468.77,470,86994,74260,5045652,9133980,2024-02-01,2024-02-16,482.88,-12734,4088328,187049931,90530418,4.88317742282407,27.4009066595165,0.447595462219098
408.05,415,13064,13064,9079480,9079480,2024-02-01,2024-12-20,482.88,0,0,461752055,55002926,1.96631068593728,77.7335563780003,0
471.47,480,10893,10579,6655623,9023887,2024-02-01,2024-04-19,482.88,-314,2368264,232702399,73324968,3.87786590889422,31.9210770147668,0.26244388920207
455.78,460,21237,21263,6307389,8972986,2024-02-01,2024-04-19,482.88,26,2665597,232702399,73324968,3.8559920475938,35.7770690623606,0.297069113893636
451.26,453,51578,51337,5467268,8932638,2024-02-01,2024-03-15,482.88,-241,3465370,452229307,160916150,1.97524527086875,52.3186625319708,0.387944748236747
424.33,425,132392,132476,6354816,8875892,2024-02-01,2024-03-15,482.88,84,2521076,452229307,160916150,1.96269721192572,54.2813597438965,0.284036353754642
480,486,11035,14783,3156010,8869800,2024-02-01,2024-02-16,482.88,3748,5713790,187049931,90530418,4.74194240681115,32.1428490663276,0.644184761775914
470.96,476,13255,17029,4082540,8582616,2024-02-01,2024-03-15,482.88,3774,4500076,452229307,160916150,1.8978460411899,56.1792057850864,0.524324518305375
481.1,488,9431,12297,3300850,8484930,2024-02-01,2024-02-16,482.88,2866,5184080,187049931,90530418,4.53618451214505,36.6790335784727,0.610974987418871
455.04,459,807,21214,232416,8400744,2024-02-01,2024-04-19,482.88,20407,8168328,232702399,73324968,3.61008053036875,39.3871495927294,0.972333878999289
398.52,405,12787,12805,7659413,8297640,2024-02-01,2024-12-20,482.88,18,638227.000000001,461752055,55002926,1.79699037831028,79.5305467563106,0.0769166895647438
460.34,475,5616,5623,6924528,8243318,2024-02-01,2024-09-20,482.88,7,1318790,275196706,45340715,2.9954275688169,77.7388498247505,0.159982909794333
458.49,463,4434,17839,1401144,8045389,2024-02-01,2024-04-19,482.88,13405,6644245,232702399,73324968,3.45737260749082,42.8445222002202,0.825845089653216
476.97,485,10272,9721,5290080,7805963,2024-02-01,2024-03-15,482.88,-551,2515883,452229307,160916150,1.72610728211827,57.9053130672047,0.32230270627724
399.61,400,196321,196481,6085951,7662759,2024-02-01,2024-03-15,482.88,160,1576808,452229307,160916150,1.69444104603331,59.599754113238,0.205775491569029
448.63,465,4618,4676,6640684,7654612,2024-02-01,2024-12-20,482.88,58,1013928,461752055,55002926,1.65773209173915,81.1882788480497,0.132459751062497
317.7,320,33215,33215,6742645,7639450,2024-02-01,2024-12-20,482.88,0,896805,461752055,55002926,1.65444851133364,82.8427273593834,0.117391304347826
481.6,491,4933,8048,2367840,7565120,2024-02-01,2024-02-16,482.88,3115,5197280,187049931,90530418,4.04443880815973,40.7234723866324,0.687005625819551
424.5,425,151187,151212,5291545,7560600,2024-02-01,2024-03-08,482.88,25,2269055,44041877,11919273,17.1668432750948,17.1668432750948,0.300115731555697
442.41,445,29114,29153,5531660,7550627,2024-02-01,2024-04-19,482.88,39,2018967,232702399,73324968,3.2447568363917,46.0892790366119,0.267390641863252
405.28,410,15954,15980,6525186,7542560,2024-02-01,2024-09-20,482.88,26,1017374,275196706,45340715,2.74078861975913,80.4796384445096,0.134884442417428
477.65,490,6292,6099,5820100,7532265,2024-02-01,2024-04-19,482.88,-193,1712165,232702399,73324968,3.23686607115726,49.3261451077692,0.227310775709564
481.99,490,10124,9317,4181212,7462917,2024-02-01,2024-02-16,482.88,-807,3281705,187049931,90530418,3.98979938677443,44.7132717734069,0.439734891866009
478.7,483,17083,16436,3467849,7067480,2024-02-01,2024-02-16,482.88,-647,3599631,187049931,90530418,3.77839219839114,48.491663971798,0.509323125074284
468.04,472,17635,17734,4496925,7022664,2024-02-01,2024-03-15,482.88,99,2525739,452229307,160916150,1.55289891462076,61.1526530278587,0.359655395730167
446.9,455,8596,8595,6275080,6961950,2024-02-01,2024-08-16,482.88,-1,686870,25910468,4922867,26.8692560859958,26.8692560859958,0.0986605764189631
447.57,449,48991,48469,4556163,6931067,2024-02-01,2024-03-15,482.88,-522,2374904,452229307,160916150,1.53264436707548,62.6852973949342,0.342646233256727
428.26,430,39054,39204,4998912,6821496,2024-02-01,2024-04-19,482.88,150,1822584,232702399,73324968,2.93142487112907,52.2575699788983,0.267182447955698
478.88,480,67919,60543,1901732,6780816,2024-02-01,2024-02-02,482.88,-7376,4879084,59097355,35805173,11.473975442725,11.473975442725,0.719542308772278
446.98,450,22074,22402,4834206,6765404,2024-02-01,2024-04-19,482.88,328,1931198,232702399,73324968,2.90732026359556,55.1648902424938,0.285451984833426
472.34,478,12013,11845,4036368,6704270,2024-02-01,2024-03-15,482.88,-168,2667902,452229307,160916150,1.48249348200691,64.1677908769411,0.397940715394816
412.25,415,24166,24149,5316520,6640975,2024-02-01,2024-06-21,482.88,-17,1324455,413696011,79729983,1.60527895445431,78.7213200854383,0.199436829682389
470.37,490,3270,3322,5415120,6521086,2024-02-01,2024-09-20,482.88,52,1105966,275196706,45340715,2.36960903158485,82.8492474760944,0.169598438051576
479.6,483,19075,18861,2346225,6412740,2024-02-01,2024-02-09,482.88,-214,4066515,48138698,26427571,13.3213823107555,13.3213823107555,0.634130652420026
482.43,490,5733,8462,1932021,6405734,2024-02-01,2024-02-09,482.88,2729,4473713,48138698,26427571,13.3068285311747,26.6282108419301,0.698391940720611
482.75,500,3426,3706,4179720,6392850,2024-02-01,2024-03-15,482.88,280,2213130,452229307,160916150,1.41363018739517,65.5814210643363,0.346188319763486
480.7,487,11832,10125,3620592,6378750,2024-02-01,2024-02-16,482.88,-1707,2758158,187049931,90530418,3.41018570062985,51.9018496724279,0.432397883597884
481.53,495,4734,4689,4227462,6316083,2024-02-01,2024-03-15,482.88,-45,2088621,452229307,160916150,1.39665494965367,66.97807601399,0.330682956509596
444.78,460,4015,4056,5319875,6173232,2024-02-01,2024-12-20,482.88,41,853357,461752055,55002926,1.33691489472635,84.1796422541097,0.138235044462933
393.07,395,31728,31742,4981296,6126206,2024-02-01,2024-06-21,482.88,14,1144910,413696011,79729983,1.48084724945535,80.2021673348937,0.186887283907854
402.63,405,25296,25240,4730352,5981880,2024-02-01,2024-06-21,482.88,-56,1251528,413696011,79729983,1.44596028024065,81.6481276151343,0.209219843928665
476.17,488,4985,5044,4222295,5967052,2024-02-01,2024-04-19,482.88,59,1744757,232702399,73324968,2.56424172060212,57.7291319630959,0.292398490913101
462.76,485,2649,2670,5165550,5938080,2024-02-01,2024-12-20,482.88,21,772530,461752055,55002926,1.28598886257258,85.4656311166823,0.130097607307413
471.86,477,10303,11312,3379384,5814368,2024-02-01,2024-03-15,482.88,1009,2434984,452229307,160916150,1.28571233885114,68.2637883528411,0.418787390134233
346.67,350,17437,17422,5039293,5801526,2024-02-01,2024-12-20,482.88,-15,762233,461752055,55002926,1.25641584854452,86.7220469652268,0.13138491493445
476.28,482,10045,10087,3244535,5769764,2024-02-01,2024-03-08,482.88,42,2525229,44041877,11919273,13.1006314739946,30.2674747490894,0.43766590799901
372.09,375,19633,19633,4810085,5713203,2024-02-01,2024-09-20,482.88,0,903118,275196706,45340715,2.07604338112971,84.9252908572242,0.15807560137457
463.74,467,19215,17521,3593205,5711846,2024-02-01,2024-03-15,482.88,-1694,2118641,452229307,160916150,1.2630419814875,69.5268303343286,0.37092053952435
439.25,440,75795,75821,3789750,5686575,2024-02-01,2024-03-08,482.88,26,1896825,44041877,11919273,12.9117453372843,43.1792200863737,0.333561941942206
479.17,484,11360,11650,2578720,5626950,2024-02-01,2024-02-16,482.88,290,3048230,187049931,90530418,3.0082609332799,54.9101106057077,0.541719759372307
482.98,489,10211,9260,2164732,5574520,2024-02-01,2024-02-02,482.88,-951,3409788,59097355,35805173,9.43277410638767,20.9067495491126,0.611673830213184
443.78,445,45324,45598,3807216,5562956,2024-02-01,2024-03-15,482.88,274,1755740,452229307,160916150,1.23011841866321,70.7569487529918,0.315612778529976
446.6,448,34394,39709,3061066,5559260,2024-02-01,2024-03-15,482.88,5315,2498194,452229307,160916150,1.22930113416997,71.9862498871618,0.449375276565586
388.18,390,30406,30419,4439276,5536258,2024-02-01,2024-06-21,482.88,13,1096982,413696011,79729983,1.3382430221209,82.9863706372552,0.198145028645703
459.45,460,106684,1e+05,3307204,5500000,2024-02-01,2024-02-16,482.88,-6684,2192796,187049931,90530418,2.94039135464851,57.8505019603563,0.398690181818182
482.83,488,11212,10626,1995736,5493642,2024-02-01,2024-02-02,482.88,-586,3497906,59097355,35805173,9.29591857368236,30.202668122795,0.636718956204281
465.61,472,8266,8517,3678370,5442363,2024-02-01,2024-04-19,482.88,251,1763993,232702399,73324968,2.33876531715515,60.0678972802511,0.324122628350957
370.35,375,11596,11594,4638400,5391210,2024-02-01,2024-12-20,482.88,-2,752810.000000001,461752055,55002926,1.16755517200676,87.8896021372336,0.139636556542965
365.73,370,12543,12545,4691082,5356715,2024-02-01,2024-12-20,482.88,2,665632.999999999,461752055,55002926,1.16008471256289,89.0496868497965,0.124261417678558
482.98,490,9313,7439,2365502,5222178,2024-02-01,2024-02-02,482.88,-1874,2856676,59097355,35805173,8.83656806637116,39.0392361891662,0.547027696106873
473,495,2363,2362,4371550,5196400,2024-02-01,2024-09-20,482.88,-1,824850,275196706,45340715,1.88824934554268,86.8135402027668,0.15873489338773
478.57,488,5297,5448,3225873,5137464,2024-02-01,2024-03-15,482.88,151,1911591,452229307,160916150,1.13603075264647,73.1222806398083,0.37208844675116
459.44,462,19654,19964,2967754,5110784,2024-02-01,2024-03-15,482.88,310,2143030,452229307,160916150,1.13013109077427,74.2524117305825,0.419315314440994
449.67,450,157362,153683,3147240,5071539,2024-02-01,2024-02-16,482.88,-3679,1924299,187049931,90530418,2.71132898733868,60.5618309476949,0.379430977460688
474.64,485,4838,4821,3551092,4994556,2024-02-01,2024-04-19,482.88,-17,1443464,232702399,73324968,2.14632767924322,62.2142249594943,0.289007471334789
452.76,465,4075,4074,4221700,4986576,2024-02-01,2024-09-20,482.88,-1,764876,275196706,45340715,1.81200424688223,88.6255444496491,0.153387013453721
450.32,452,24301,29499,2478702,4955832,2024-02-01,2024-03-15,482.88,5198,2477130,452229307,160916150,1.09586705755008,75.3482787881326,0.499841398982048
482.5,487,12873,10968,1995315,4935600,2024-02-01,2024-02-02,482.88,-1905,2940285,59097355,35805173,8.35164281041004,47.3908789995762,0.595730002431315
469.54,474,9994,11042,2638416,4924732,2024-02-01,2024-03-15,482.88,1048,2286316,452229307,160916150,1.08899001541269,76.4372688035453,0.464251861827202
476,481,9440,9801,2586560,4900500,2024-02-01,2024-03-01,482.88,361,2313940,50809473,20654916,9.64485500567975,9.64485500567975,0.47218447097235
449.38,451,29650,29782,2935350,4824684,2024-02-01,2024-03-15,482.88,132,1889334,452229307,160916150,1.06686672564545,77.5041355291907,0.391597460061633
469.65,480,2265,4600,1689690,4761000,2024-02-01,2024-05-17,482.88,2335,3071310,66606452,19312622,7.14795617697817,7.14795617697817,0.645097668557026
407.41,410,18213,18260,3660813,4729340,2024-02-01,2024-06-21,482.88,47,1068527,413696011,79729983,1.14319207201638,84.1295627092716,0.225935754249007
481.16,489,6937,6026,2698493,4724384,2024-02-01,2024-02-16,482.88,-911,2025891,187049931,90530418,2.52573415811632,63.0875651058113,0.428815904888341
418.64,420,34734,34717,3542868,4721512,2024-02-01,2024-04-19,482.88,-17,1178644,232702399,73324968,2.02899154468966,64.243216504184,0.249632744764813
462.6,470,5738,6315,3236232,4673100,2024-02-01,2024-05-17,482.88,577,1436868,66606452,19312622,7.01598697975986,14.163943156738,0.307476407523914
464.73,468,14167,14253,2904235,4660731,2024-02-01,2024-03-15,482.88,86,1756496,452229307,160916150,1.03061233048304,78.5347478596738,0.376871353442196
459.27,470,4339,4337,4256559,4653601,2024-02-01,2024-08-16,482.88,-2,397042,25910468,4922867,17.9603124111845,44.8295684971804,0.085319304340875
456.66,461,10692,10681,3143448,4635554,2024-02-01,2024-04-19,482.88,-11,1492106,232702399,73324968,1.99205251854752,66.2352690227315,0.321882993920468
389.21,395,7879,7932,4167991,4592628,2024-02-01,2024-12-20,482.88,53,424637,461752055,55002926,0.994609108994653,90.0442959587911,0.0924605694169002
478.06,482,9911,11644,1754247,4587736,2024-02-01,2024-02-16,482.88,1733,2833489,187049931,90530418,2.45267986760177,65.540244973413,0.617622504869504
386.47,390,12876,12880,4017312,4546640,2024-02-01,2024-09-20,482.88,4,529327.999999999,275196706,45340715,1.65214186829693,90.277686317946,0.116421797195291
478.5,492,3362,3360,3311570,4536000,2024-02-01,2024-04-19,482.88,-2,1224430,232702399,73324968,1.94927083669644,68.1845398594279,0.2699360670194
402.5,410,6022,6022,3944410,4516500,2024-02-01,2024-12-20,482.88,0,572090,461752055,55002926,0.978122338838319,91.0224182976294,0.126666666666667
427.99,435,6443,6439,3968888,4513739,2024-02-01,2024-09-20,482.88,-4,544851.000000001,275196706,45340715,1.64018641996391,91.9178727379099,0.120709460604612
478.08,491,3431,3469,3115348,4481948,2024-02-01,2024-04-19,482.88,38,1366600,232702399,73324968,1.92604288535934,70.1105827447873,0.304912060559382
481.77,485,9405,13869,893475,4479687,2024-02-01,2024-02-02,482.88,4464,3586212,59097355,35805173,7.58018188800497,54.9710608875812,0.800549681261213
394.65,395,126095,126129,3530660,4414515,2024-02-01,2024-03-15,482.88,34,883854.999999999,452229307,160916150,0.976167384923596,79.5109152445974,0.200215652229067
480.22,482,23542,24570,1082932,4373460,2024-02-01,2024-02-02,482.88,1028,3290528,59097355,35805173,7.40043272664234,62.3714936142235,0.752385525419233
468.76,473,9659,9564,2414750,4055136,2024-02-01,2024-03-15,482.88,-95,1640386,452229307,160916150,0.896699072181096,80.4076143167785,0.404520588212085
423.45,425,25603,25664,2893139,3977920,2024-02-01,2024-04-19,482.88,61,1084781,232702399,73324968,1.70944520430148,71.8200279490887,0.272700557075055
349.02,350,38841,40557,3107280,3974586,2024-02-01,2024-06-21,482.88,1716,867306,413696011,79729983,0.960750380549355,85.0903130898209,0.218212915760283
368.76,370,32785,31920,3475210,3958080,2024-02-01,2024-06-21,482.88,-865,482870.000000001,413696011,79729983,0.956760494362127,86.0470735841831,0.121996018271485
464.2,465,48704,49340,1996864,3947200,2024-02-01,2024-02-16,482.88,636,1950336,187049931,90530418,2.11023868273974,67.6504836561528,0.494106201864613
482.11,494,3277,3292,2677309,3914188,2024-02-01,2024-03-15,482.88,15,1236879,452229307,160916150,0.865531698059542,81.273146014838,0.3159988738405
477.82,487,4702,4257,2708352,3907926,2024-02-01,2024-03-15,482.88,-445,1199574,452229307,160916150,0.864147002308278,82.1372930171463,0.306959241295767
479.95,491,3110,3434,2242310,3794570,2024-02-01,2024-03-15,482.88,324,1552260,452229307,160916150,0.839080957661154,82.9763739748074,0.409074018927046
442.54,450,4416,5079,2954304,3788934,2024-02-01,2024-08-16,482.88,663,834630,25910468,4922867,14.6231785547062,59.4527470518865,0.220280955012676
356.23,360,10043,10044,3334276,3786588,2024-02-01,2024-12-20,482.88,1,452312,461752055,55002926,0.820047893452255,91.8424661910817,0.119451073103279
482.15,486,11160,9766,1328040,3759910,2024-02-01,2024-02-02,482.88,-1394,2431870,59097355,35805173,6.36223059390729,68.7337242081308,0.64678941783181
451.47,455,10329,10363,2623566,3658139,2024-02-01,2024-04-19,482.88,34,1034573,232702399,73324968,1.57202461844839,73.3920525675371,0.282814021009043
409.74,410,140665,140676,2531970,3657576,2024-02-01,2024-03-01,482.88,11,1125606,50809473,20654916,7.1986103851146,16.8434653907944,0.307746441905787
327.37,330,13899,13899,3196770,3655437,2024-02-01,2024-12-20,482.88,0,458667,461752055,55002926,0.791644987914564,92.6341111789963,0.125475285171103
472.96,485,3018,3004,2664894,3616816,2024-02-01,2024-05-17,482.88,-14,951922,66606452,19312622,5.43012860075477,19.5940717574928,0.263193372292093
432.97,435,17552,17653,2527488,3583559,2024-02-01,2024-04-19,482.88,101,1056071,232702399,73324968,1.53997509926831,74.9320276668055,0.294698929193017
468.77,495,1324,1324,2996212,3472852,2024-02-01,2024-12-20,482.88,0,476640.000000001,461752055,55002926,0.75210320395867,93.3862143829549,0.137247426610751
383.35,385,20827,20829,2811645,3436785,2024-02-01,2024-06-21,482.88,2,625140,413696011,79729983,0.830751302554861,86.8778248867379,0.181896743613581
458.53,465,5325,5309,2476125,3434923,2024-02-01,2024-05-17,482.88,-16,958797.999999999,66606452,19312622,5.15704244387616,24.751114201369,0.279132312427382
459.39,464,7442,7419,2515396,3420159,2024-02-01,2024-04-19,482.88,-23,904763.000000001,232702399,73324968,1.46975665687056,76.401784323676,0.26453828608553
474.5,488,2482,2486,2521712,3356100,2024-02-01,2024-05-17,482.88,4,834388,66606452,19312622,5.03870105556741,29.7898152569364,0.24861833675993
445.76,447,27542,27034,2368612,3352216,2024-02-01,2024-03-15,482.88,-508,983604,452229307,160916150,0.741264652270756,83.7176386270782,0.293419039823209
467.24,471,5619,8703,1286751,3272328,2024-02-01,2024-03-15,482.88,3084,1985577,452229307,160916150,0.72359927792119,84.4412379049994,0.606778110262785
444.82,446,27173,27148,2364051,3203464,2024-02-01,2024-03-15,482.88,-25,839413,452229307,160916150,0.708371604938908,85.1496095099383,0.262032911872898
474.61,477,12243,13212,1346730,3157668,2024-02-01,2024-02-16,482.88,969,1810938,187049931,90530418,1.68814176146368,69.3386254176165,0.573504877650215
471.4,473,19771,19376,1502596,3100160,2024-02-01,2024-02-16,482.88,-395,1597564,187049931,90530418,1.65739702945948,70.9960224470759,0.515316628819158
329.31,330,44896,44891,3052928,3097479,2024-02-01,2024-06-21,482.88,-5,44550.9999999991,413696011,79729983,0.748733107798808,87.6265579945367,0.0143829869387328
409.74,415,5742,5742,2503512,3020292,2024-02-01,2024-09-20,482.88,0,516780,275196706,45340715,1.09750296211758,93.0153757000275,0.171102661596958
476.52,484,4008,4035,1903800,3018180,2024-02-01,2024-03-15,482.88,27,1114380,452229307,160916150,0.667400354926577,85.8170098648649,0.369222511579826
471.91,483,2756,2709,2301260,3004281,2024-02-01,2024-05-17,482.88,-47,703021,66606452,19312622,4.51049546971816,34.3003107266545,0.234006406191698
470.5,472,21834,19952,1528380,2992800,2024-02-01,2024-02-16,482.88,-1882,1464420,187049931,90530418,1.60000059021674,72.5960230372927,0.489314354450682
484.75,498,2249,2246,2291731,2975950,2024-02-01,2024-03-15,482.88,-3,684219,452229307,160916150,0.658062171985682,86.4750720368506,0.229916161225827
358.93,360,27658,27663,2516878,2959941,2024-02-01,2024-06-21,482.88,5,443063,413696011,79729983,0.715486956919196,88.3420449514559,0.149686429560589
479.41,489,3017,2994,1967084,2871246,2024-02-01,2024-03-15,482.88,-23,904162,452229307,160916150,0.634909316038644,87.1099813528892,0.314902310704133
419.41,420,47998,47824,2111912,2821616,2024-02-01,2024-03-15,482.88,-174,709704,452229307,160916150,0.623934795097214,87.7339161479864,0.251523949396374
480.15,484,7588,7288,1145788,2805880,2024-02-01,2024-02-09,482.88,-300,1660092,48138698,26427571,5.82874094351285,32.456951785443,0.591647540165652
462.37,464,17285,17195,1572935,2802785,2024-02-01,2024-03-01,482.88,-90,1229850,50809473,20654916,5.5162646540341,22.3597300448285,0.438795697850531
480.65,485,4853,6392,863834,2780520,2024-02-01,2024-02-09,482.88,1539,1916686,48138698,26427571,5.77605983443923,38.2330116198822,0.689326456921727
476.14,480,6238,7018,1185220,2708948,2024-02-01,2024-02-23,482.88,780,1523728,38550562,1795056,7.02700002142641,7.02700002142641,0.562479604628808
434.12,435,30627,30781,1868247,2708728,2024-02-01,2024-03-15,482.88,154,840481,452229307,160916150,0.598972237772286,88.3328883857587,0.310286230289641
427.42,430,13196,10484,2612808,2704872,2024-02-01,2024-05-17,482.88,-2712,92064,66606452,19312622,4.06097595470181,38.3612866813563,0.0340363610551627
473.82,476,14346,12369,1434600,2696442,2024-02-01,2024-02-16,482.88,-1977,1261842,187049931,90530418,1.4415626809293,74.037585718222,0.467965563509247
475.07,482,4099,3888,1762570,2694384,2024-02-01,2024-03-15,482.88,-211,931814,452229307,160916150,0.595800395572329,88.928688781331,0.345835634415881
381.7,385,8130,8130,2260140,2682900,2024-02-01,2024-09-20,482.88,0,422760,275196706,45340715,0.974902657446779,93.9902783574742,0.157575757575758
472.22,474,13433,14944,1114939,2660032,2024-02-01,2024-02-16,482.88,1511,1545093,187049931,90530418,1.42209729016152,75.4596830083835,0.580855042345355
480.45,492,2310,2300,1737120,2656500,2024-02-01,2024-03-15,482.88,-10,919380,452229307,160916150,0.587423229516613,89.5161120108477,0.346086956521739
361.21,365,6977,6967,2469858,2640493,2024-02-01,2024-12-20,482.88,-10,170635,461752055,55002926,0.571842176208615,93.9580565591636,0.0646224019529686
413.8,415,21828,21825,2051832,2619000,2024-02-01,2024-04-19,482.88,-3,567168,232702399,73324968,1.12547185214021,77.5272561758162,0.216558991981672
475.92,483,2808,3661,1243944,2591988,2024-02-01,2024-03-15,482.88,853,1348044,452229307,160916150,0.573157900180052,90.0892699110277,0.520081111486627
337.1,340,8916,8916,2282496,2585640,2024-02-01,2024-12-20,482.88,0,303144,461752055,55002926,0.559962857122531,94.5180194162861,0.117241379310345
437.73,440,11393,11365,1902631,2579855,2024-02-01,2024-04-19,482.88,-28,677224,232702399,73324968,1.10864993703825,78.6359061128545,0.262504675650376
482.55,491,2913,3052,1205982,2578940,2024-02-01,2024-02-09,482.88,139,1372958,48138698,26427571,5.35731149188954,43.5903231117717,0.532372990453442
409.66,410,75399,75415,1884975,2564110,2024-02-01,2024-03-08,482.88,16,679135,44041877,11919273,5.82198165623141,49.0012017426051,0.264861881900543
476.11,479,7560,8872,1028160,2564008,2024-02-01,2024-02-16,482.88,1312,1535848,187049931,90530418,1.37076126480902,76.8304442731925,0.599002811223678
479.62,494,1768,1769,1821040,2543822,2024-02-01,2024-04-19,482.88,1,722782,232702399,73324968,1.09316535236923,79.7290714652237,0.284132301709789
448.96,452,8169,8331,1919715,2532624,2024-02-01,2024-04-19,482.88,162,612909,232702399,73324968,1.08835319742449,80.8174246626482,0.242005524704812
409.82,410,140645,140650,1969030,2531700,2024-02-01,2024-02-23,482.88,5,562670,38550562,1795056,6.56721943508891,13.5942194565153,0.22224987162776
373.57,375,17564,17679,1984732,2528097,2024-02-01,2024-06-21,482.88,115,543365,413696011,79729983,0.61110016359331,88.9531451150492,0.214930439773474
465.47,469,6218,7150,1305780,2523950,2024-02-01,2024-03-15,482.88,932,1218170,452229307,160916150,0.558112877898911,90.6473827889266,0.48264426791339
440.9,442,22874,22879,1715550,2516690,2024-02-01,2024-03-15,482.88,5,801140,452229307,160916150,0.556507497644331,91.2038902865709,0.318330823422829
481.52,487,7164,4540,1690704,2487920,2024-02-01,2024-02-09,482.88,-2624,797216,48138698,26427571,5.16823284252516,48.7585559542969,0.320434740666903
481.55,490,1956,2934,911496,2479230,2024-02-01,2024-02-23,482.88,978,1567734,38550562,1795056,6.43111246990381,20.0253319264191,0.632347140039448
439.76,440,100533,102882,1608528,2469168,2024-02-01,2024-02-16,482.88,2349,860640,187049931,90530418,1.32005822552268,78.1505024987152,0.348554654847301
460.31,463,10476,9165,1655208,2465385,2024-02-01,2024-03-15,482.88,-1311,810177,452229307,160916150,0.545162589385212,91.7490528759561,0.328620884770533
461.66,475,1810,1821,2155710,2429214,2024-02-01,2024-08-16,482.88,11,273504,25910468,4922867,9.37541537265942,68.8281624245459,0.112589504259402
482.64,487.5,4026,4870,728706,2366820,2024-02-01,2024-02-02,482.88,844,1638114,59097355,35805173,4.00495081378854,72.7386750219193,0.69211600375187
473.1,479,4101,3987,1402542,2352330,2024-02-01,2024-03-15,482.88,-114,949788.000000001,452229307,160916150,0.520163103891894,92.269215979848,0.40376477790106
414.84,415,146760,146703,1467600,2347248,2024-02-01,2024-02-16,482.88,-57,879648,187049931,90530418,1.25487776843927,79.4053802671544,0.374757162430216
418.92,425,3857,3857,1986355,2345056,2024-02-01,2024-09-20,482.88,0,358701,275196706,45340715,0.852138106623994,94.8424164640982,0.152960526315789
298.19,300,12839,12850,2054240,2325850,2024-02-01,2024-12-20,482.88,11,271610,461752055,55002926,0.503701060951423,95.0217204772375,0.116778812047208
482.21,489,3344,3356,986480,2278724,2024-02-01,2024-02-09,482.88,12,1292244,48138698,26427571,4.73366354860699,53.4922195029039,0.567091056222693
424.68,425,70782,71006,1769550,2272192,2024-02-01,2024-03-01,482.88,224,502642,50809473,20654916,4.47198497807682,26.8317150229053,0.221214580457989
471.77,475,7061,7022,1263919,2268106,2024-02-01,2024-03-01,482.88,-39,1004187,50809473,20654916,4.46394317059734,31.2956581935026,0.442742534960888
348.06,350,11506,11481,2036562,2227314,2024-02-01,2024-09-20,482.88,-25,190752,275196706,45340715,0.809353437537149,95.6517699016354,0.0856421681002319
443.47,449,3907,3993,1722987,2208129,2024-02-01,2024-06-21,482.88,86,485142,413696011,79729983,0.533756415649848,89.4869015306991,0.219707272537066
473.91,478,5097,5368,1121340,2195512,2024-02-01,2024-03-01,482.88,271,1074172,50809473,20654916,4.32106823859401,35.6167264320966,0.489258086496453
455.84,458,9804,10104,1264716,2182464,2024-02-01,2024-03-15,482.88,300,917748,452229307,160916150,0.482601186216355,92.7518171660644,0.420510029031407
437.33,442,5061,4670,1928241,2180890,2024-02-01,2024-06-21,482.88,-391,252649,413696011,79729983,0.527172112375045,90.0140736430741,0.115846741467933
476.06,490,1192,1562,1265904,2177428,2024-02-01,2024-05-17,482.88,370,911524,66606452,19312622,3.26909471172552,41.6303813930819,0.418624174944017
482.69,499,1333,1329,1285012,2167599,2024-02-01,2024-03-01,482.88,-4,882587,50809473,20654916,4.26613163257962,39.8828580646763,0.407172636636204
483.27,491,5776,2801,1755904,2165173,2024-02-01,2024-02-02,482.88,-2975,409269,59097355,35805173,3.66373926548828,76.4024142874076,0.189023694642414
477.47,481,6150,6064,1014750,2140592,2024-02-01,2024-02-16,482.88,-86,1125842,187049931,90530418,1.14439603829632,80.5497763054508,0.525948896380067
474.39,481,2662,3183,1019546,2103963,2024-02-01,2024-03-15,482.88,521,1084417,452229307,160916150,0.46524251467851,93.2170596807429,0.5154163832729
481.26,491,2184,2156,1292928,2099944,2024-02-01,2024-03-01,482.88,-28,807016,50809473,20654916,4.13297732885362,44.0158353935299,0.384303581428838
479.57,481,14096,14684,493360,2099812,2024-02-01,2024-02-02,482.88,588,1606452,59097355,35805173,3.55314040704529,79.9555546944529,0.765045632656638
470.08,478,2643,2640,1456293,2090880,2024-02-01,2024-04-19,482.88,-3,634587,232702399,73324968,0.898521033296266,81.7159456959445,0.303502353076217
378.46,380,13440,13452,1653120,2071608,2024-02-01,2024-06-21,482.88,12,418488,413696011,79729983,0.500756097452436,90.5148297405266,0.202011191306463
480.79,483,9847,9367,590820,2070107,2024-02-01,2024-02-02,482.88,-480,1479287,59097355,35805173,3.50287589013078,83.4584305845837,0.714594462991527
445.67,450,4582,4777,1443330,2068441,2024-02-01,2024-05-17,482.88,195,625111,66606452,19312622,3.10546641937931,44.7358478124612,0.302213599517704
481.25,489,1449,2648,649152,2052200,2024-02-01,2024-02-23,482.88,1199,1403048,38550562,1795056,5.32339839818678,25.3487303246059,0.683679953220934
466.84,469,9186,9481,1038018,2047896,2024-02-01,2024-03-01,482.88,295,1009878,50809473,20654916,4.03053973813112,48.046375131661,0.493129533921645
351.81,355,6343,6345,1979016,2024055,2024-02-01,2024-12-20,482.88,2,45039,461752055,55002926,0.438342391351133,95.4600628685886,0.022251865685468
484.52,493,2410,2366,1405030,2006368,2024-02-01,2024-02-16,482.88,-44,601338,187049931,90530418,1.07263765844426,81.622413963895,0.299714708368555
429.8,430,100214,100074,1402996,2001480,2024-02-01,2024-02-16,482.88,-140,598484,187049931,90530418,1.07002445245489,82.6924384163499,0.299020724663749
467.64,470,8299,8466,1037375,1997976,2024-02-01,2024-03-01,482.88,167,960601,50809473,20654916,3.93229034278706,51.978665474448,0.480787056501179
481.35,484,8881,7532,666075,1995980,2024-02-01,2024-02-02,482.88,-1349,1329905,59097355,35805173,3.37744388052562,86.8358744651093,0.666291746410285
477.9,485,2240,2811,952000,1995810,2024-02-01,2024-03-08,482.88,571,1043810,44041877,11919273,4.53161884994139,53.5328205925465,0.523000686438088
477.71,480,8729,8699,741965,1992071,2024-02-01,2024-02-09,482.88,-30,1250106,48138698,26427571,4.13819044295714,57.630409945861,0.62754088584192
476.48,491,1259,1362,1367274,1977624,2024-02-01,2024-05-17,482.88,103,610350,66606452,19312622,2.9691177665491,47.7049655790103,0.308627929272703
466.41,475,1604,2300,1016936,1975700,2024-02-01,2024-05-17,482.88,696,958764,66606452,19312622,2.96622915749964,50.6711947365099,0.485278129270638
482,492,1870,1972,964920,1972000,2024-02-01,2024-02-16,482.88,102,1007080,187049931,90530418,1.05426395479397,83.7467023711439,0.510689655172414
342.05,345,6672,6667,1801440,1966765,2024-02-01,2024-12-20,482.88,-5,165325,461752055,55002926,0.425935299843982,95.8859981684326,0.0840593563542162
332.25,335,7054,7061,1714122,1941775,2024-02-01,2024-12-20,482.88,7,227653,461752055,55002926,0.420523304438786,96.3065214728714,0.117239638990099
454.46,460,3895,3492,1585265,1934568,2024-02-01,2024-05-17,482.88,-403,349303,66606452,19312622,2.90447538025295,53.5756701167629,0.18055865702317
481.1,486,3272,3933,638040,1927170,2024-02-01,2024-02-09,482.88,661,1289130,48138698,26427571,4.00336959674314,61.6337795426042,0.668923862451159
479.19,485,2900,3304,838100,1919624,2024-02-01,2024-02-23,482.88,404,1081524,38550562,1795056,4.97949679695979,30.3282271215657,0.563404083299646
452.45,456,5428,5371,1384140,1906705,2024-02-01,2024-04-19,482.88,-57,522565,232702399,73324968,0.819374878898434,82.5353205748429,0.274067042358414
475.49,480,2499,4223,634746,1904573,2024-02-01,2024-03-01,482.88,1724,1269827,50809473,20654916,3.74846044949138,55.7271259239394,0.666725297481378
453.67,457,5688,5693,1547136,1895769,2024-02-01,2024-04-19,482.88,5,348633,232702399,73324968,0.814675314112254,83.3499958889552,0.183900570164403
469.54,477,2343,2525,1220703,1883650,2024-02-01,2024-04-19,482.88,182,662947,232702399,73324968,0.809467374678849,84.159463263634,0.351948079526451
476.12,487,1736,1721,1341928,1872448,2024-02-01,2024-04-19,482.88,-15,530520,232702399,73324968,0.804653500800393,84.9641167644344,0.283329630515774
454.97,457,9361,9107,1142042,1848721,2024-02-01,2024-03-15,482.88,-254,706679,452229307,160916150,0.408801679011927,93.6258613597548,0.382252919721256
322.59,325,7629,7630,1647864,1838830,2024-02-01,2024-12-20,482.88,1,190966,461752055,55002926,0.398228871986287,96.7047503448577,0.103851905831425
454.59,455,48531,44222,1116213,1813102,2024-02-01,2024-02-16,482.88,-4309,696889,187049931,90530418,0.969314444708349,84.7160168158522,0.384362821286392
424.75,425,71882,71889,1221994,1797225,2024-02-01,2024-02-23,482.88,7,575231,38550562,1795056,4.66199429206765,34.9902214136334,0.320066213189779
450.1,455,3631,3631,1310791,1779190,2024-02-01,2024-05-17,482.88,0,468399,66606452,19312622,2.67119767916778,56.2468677959306,0.263265306122449
473.57,483,1370,1882,906940,1774726,2024-02-01,2024-04-19,482.88,512,867786,232702399,73324968,0.762659090592358,85.7267758550267,0.488969001412049
363.9,365,16122,16133,1596078,1774630,2024-02-01,2024-06-21,482.88,11,178552,413696011,79729983,0.428969570122348,90.9437993106489,0.100613649042336
471.2,475,4299,4670,924285,1774600,2024-02-01,2024-03-08,482.88,371,850315,44041877,11919273,4.02934688728185,57.5621674798284,0.479158683647019
480.9,493,1391,1460,1147575,1766600,2024-02-01,2024-03-15,482.88,69,619025,452229307,160916150,0.390642528614361,94.0165038883692,0.350404732254047
480.59,489,2007,2077,973395,1746757,2024-02-01,2024-03-01,482.88,70,773362,50809473,20654916,3.43785695238366,59.1649828763231,0.442741606302422
478.71,500,1193,802,2024521,1707458,2024-02-01,2024-06-21,482.88,-391,-317063,413696011,79729983,0.412732526927846,91.3565318375768,-0.18569300094058
299.52,300,34371,34311,1409211,1646928,2024-02-01,2024-06-21,482.88,-60,237717,413696011,79729983,0.398101010454268,91.754632848031,0.144339643263094
478.4,481,3958,6325,391842,1644500,2024-02-01,2024-02-09,482.88,2367,1252658,48138698,26427571,3.41617049966744,65.0499500422716,0.761725752508361
472.12,473,18104,18572,597432,1634336,2024-02-01,2024-02-09,482.88,468,1036904,48138698,26427571,3.395056509422,68.4450065516936,0.634449709239716
481.81,488,3548,2611,936672,1616209,2024-02-01,2024-02-09,482.88,-937,679537,48138698,26427571,3.35740073402068,71.8024072857143,0.420451191646625
463.52,469,2507,2936,990265,1608928,2024-02-01,2024-04-19,482.88,429,618663,232702399,73324968,0.69141014743041,86.4181860024572,0.384518760317429
481.86,515,483,483,1600662,1600662,2024-02-01,2024-12-20,482.88,0,0,461752055,55002926,0.346649675441076,97.0514000202988,0
480.48,490,1597,1670,840022,1589840,2024-02-01,2024-03-01,482.88,73,749818,50809473,20654916,3.12902281037239,62.2940056866955,0.471631107532834
466.07,467,16291,16727,749386,1555611,2024-02-01,2024-02-16,482.88,436,806225,187049931,90530418,0.831655479199295,85.5476722950515,0.518269027411094
452.21,454,8216,8528,903760,1526512,2024-02-01,2024-03-15,482.88,312,622752,452229307,160916150,0.337552647820766,94.3540565361899,0.407957487396103
470.94,479,1643,1893,967727,1525758,2024-02-01,2024-04-19,482.88,250,558031,232702399,73324968,0.655669218090012,87.0738552205472,0.365740176358243
450.1,460,1110,1536,890220,1520640,2024-02-01,2024-08-16,482.88,426,630420,25910468,4922867,5.86882490891326,74.6969873334592,0.414575441919192
466.96,468,13967,14373,698350,1494792,2024-02-01,2024-02-16,482.88,406,796442,187049931,90530418,0.799140631599592,86.3468129266511,0.532811254007247
482.12,495,1063,1153,892920,1485064,2024-02-01,2024-03-08,482.88,90,592144,44041877,11919273,3.37193621425354,60.9341036940819,0.398732983898337
469.47,476,2251,2262,1125500,1477086,2024-02-01,2024-04-19,482.88,11,351586,232702399,73324968,0.63475323260419,87.7086084531514,0.238026763505984
474.01,477,4839,4940,682299,1477060,2024-02-01,2024-02-23,482.88,101,794761,38550562,1795056,3.83148759283976,38.8217090064731,0.538069543552733
479.57,492,574,1185,638288,1472955,2024-02-01,2024-05-17,482.88,611,834667,66606452,19312622,2.21142990772125,58.4582977036519,0.566661574861418
377,380,4868,4868,1270548,1460400,2024-02-01,2024-09-20,482.88,0,189852,275196706,45340715,0.530674956552714,96.1824448581881,0.13
478.63,495,981,881,1217421,1442197,2024-02-01,2024-05-17,482.88,-100,224776,66606452,19312622,2.16525119818723,60.6235489018391,0.155856654812068
483.01,493,1425,1439,735300,1437561,2024-02-01,2024-02-09,482.88,14,702261,48138698,26427571,2.98628974136359,74.7886970270779,0.488508661545493
441.82,443,11663,12146,909714,1433228,2024-02-01,2024-03-15,482.88,483,523514,452229307,160916150,0.316925059436716,94.6709815956267,0.365269168617973
441.2,445,3753,3767,1043334,1431460,2024-02-01,2024-05-17,482.88,14,388126,66606452,19312622,2.14913113822667,62.7726800400658,0.271139955010968
445.25,451,2365,2451,1094995,1409325,2024-02-01,2024-06-21,482.88,86,314330,413696011,79729983,0.340666809088473,92.0952996571195,0.223035850495805
437.89,445,89,1937,53489,1377207,2024-02-01,2024-08-16,482.88,1848,1323718,25910468,4922867,5.3152532790994,80.0122406125586,0.961161248817353
391.44,395,3853,3853,1371668,1371668,2024-02-01,2024-09-20,482.88,0,0,275196706,45340715,0.498431838061318,96.6808766962494,0
419.2,422,4853,4852,1208397,1358560,2024-02-01,2024-06-21,482.88,-1,150163,413696011,79729983,0.328395721466118,92.4236953785856,0.110531003415381
268.78,270,11115,11095,1255995,1353590,2024-02-01,2024-12-20,482.88,-20,97595,461752055,55002926,0.293142171289308,97.3445421915881,0.0721008577191025
394.81,395,70858,70862,1062870,1346378,2024-02-01,2024-03-01,482.88,4,283508,50809473,20654916,2.64985625810368,64.9438619447992,0.210570879797501
463.22,464,16662,17032,649818,1328496,2024-02-01,2024-02-16,482.88,370,678678,187049931,90530418,0.710236027833659,87.0570489544848,0.510861906998591
469.67,471,10405,9892,655515,1315636,2024-02-01,2024-02-16,482.88,-513,660121,187049931,90530418,0.703360858229881,87.7604098127147,0.501750484176474
479.71,495,859,860,951772,1314940,2024-02-01,2024-04-19,482.88,1,363168,232702399,73324968,0.565073675927166,88.2736821290785,0.27618598567235
479.68,486,868,2065,293384,1305080,2024-02-01,2024-02-23,482.88,1197,1011696,38550562,1795056,3.3853721769348,42.2070811834079,0.77519845526711
469.83,481,1151,1146,1121074,1280082,2024-02-01,2024-06-21,482.88,-5,159008,413696011,79729983,0.30942575368463,92.7331211322702,0.124217042345725
465.01,471,1865,2134,788895,1278266,2024-02-01,2024-04-19,482.88,269,489371,232702399,73324968,0.549313632129766,88.8229957612083,0.38283972193581
473.87,475,11443,11300,480606,1276900,2024-02-01,2024-02-09,482.88,-143,796294,48138698,26427571,2.6525436977959,77.4412407248738,0.623615005090453
450.4,453,4764,4873,1100484,1266980,2024-02-01,2024-04-19,482.88,109,166496,232702399,73324968,0.544463660643224,89.3674594218515,0.131411703420733
483.34,500,755,758,789730,1262828,2024-02-01,2024-03-01,482.88,3,473098,50809473,20654916,2.48541841793951,67.4292803627387,0.374633758516599
458.76,460,7433,10168,512877,1260832,2024-02-01,2024-03-01,482.88,2735,747955,50809473,20654916,2.48149001663528,69.9107703793739,0.593223363620213
474.36,484,970,1305,659600,1258020,2024-02-01,2024-04-19,482.88,335,598420,232702399,73324968,0.540613249113947,89.9080726709655,0.475684011382967
466.6,473,1901,1961,876361,1255040,2024-02-01,2024-04-19,482.88,60,378679,232702399,73324968,0.539332643493719,90.4474053144592,0.301726638194799
418.23,421,4358,4473,1072068,1239021,2024-02-01,2024-06-21,482.88,115,166953,413696011,79729983,0.299500349787032,93.0326214820573,0.134745900190554
444.07,445,13095,13317,746415,1238481,2024-02-01,2024-03-08,482.88,222,492066,44041877,11919273,2.81205317384634,63.7461568679282,0.397314129163064
458.72,461,4787,5410,689328,1233480,2024-02-01,2024-03-15,482.88,623,544152,452229307,160916150,0.272755432013609,94.9437370276403,0.441151863021695
478.36,485,1738,1801,622204,1195864,2024-02-01,2024-03-01,482.88,63,573660,50809473,20654916,2.35362409682935,72.2643944762033,0.479703377641605
475.29,486,1057,1111,816004,1189881,2024-02-01,2024-04-19,482.88,54,373877,232702399,73324968,0.511331642953969,90.9587369574132,0.314213774318608
474.55,479,2620,2627,563300,1169015,2024-02-01,2024-03-01,482.88,7,605715,50809473,20654916,2.30078158850418,74.5651760647075,0.518141341214612
461.3,462,16900,16592,574600,1161440,2024-02-01,2024-02-16,482.88,-308,586840,187049931,90530418,0.620925115444175,88.3813349281588,0.505269320843091
481.8,491,1109,1256,578898,1155520,2024-02-01,2024-02-23,482.88,147,576622,38550562,1795056,2.9974141492412,45.2044953326491,0.499015162004985
399.89,400,104755,104772,838040,1152492,2024-02-01,2024-02-16,482.88,17,314452,187049931,90530418,0.616141366018467,88.9974762941773,0.272845277884792
478.65,484,1572,2144,397716,1147040,2024-02-01,2024-02-23,482.88,572,749324,38550562,1795056,2.97541706395876,48.1799123966079,0.65326754080067
467.19,474,1851,1683,888480,1146123,2024-02-01,2024-04-19,482.88,-168,257643,232702399,73324968,0.492527367541235,91.4512643249544,0.224795244489466
477.37,482,2918,2475,653632,1145925,2024-02-01,2024-02-23,482.88,-443,492293,38550562,1795056,2.97252475852362,51.1524371551315,0.429603159020006
288.4,290,7158,7158,1030752,1145280,2024-02-01,2024-12-20,482.88,0,114528,461752055,55002926,0.248029215592771,97.5925714071809,0.1
464.28,472,1165,1474,700165,1137928,2024-02-01,2024-05-17,482.88,309,437763,66606452,19312622,1.70843509274447,64.4811151328103,0.384701844053402
389.66,390,33433,33451,835825,1137334,2024-02-01,2024-03-15,482.88,18,301509,452229307,160916150,0.251494978851514,95.1952320064918,0.26510154448913
447.84,451,3590,3594,793390,1135704,2024-02-01,2024-04-19,482.88,4,342314,232702399,73324968,0.488049974938161,91.9393142998925,0.301411283221685
249.06,250,11986,11945,1102712,1122830,2024-02-01,2024-12-20,482.88,-41,20118,461752055,55002926,0.243167298952248,97.8357387061331,0.0179172270067597
467.86,469,9698,9811,494598,1118454,2024-02-01,2024-02-16,482.88,113,623856,187049931,90530418,0.597944085849462,89.5954203800268,0.557784227156414
479.8,487,1198,1549,424092,1115280,2024-02-01,2024-02-23,482.88,351,691188,38550562,1795056,2.89303175398584,54.0454689091173,0.619743920809124
474.77,478,1414,3433,214928,1108859,2024-02-01,2024-02-23,482.88,2019,893931,38550562,1795056,2.87637570627375,56.9218446153911,0.806171929884683
478.06,483,2082,2204,545484,1088776,2024-02-01,2024-02-23,482.88,122,543292,38550562,1795056,2.82428048649459,59.7461251018857,0.498993365026415
403.97,405,10459,10467,815802,1078101,2024-02-01,2024-04-19,482.88,8,262299,232702399,73324968,0.463296040192521,92.4026103400851,0.243297242095128
476.3,478,6437,6325,386220,1075250,2024-02-01,2024-02-09,482.88,-112,689030,48138698,26427571,2.23364994209025,79.674890666964,0.640809114159498
438.39,443,2301,2323,1000935,1070903,2024-02-01,2024-06-21,482.88,22,69968.0000000001,413696011,79729983,0.258862297804462,93.2914837798617,0.0653355159150737
475.9,495,548,550,998456,1050500,2024-02-01,2024-08-16,482.88,2,52044,25910468,4922867,4.05434591146713,84.0665865240258,0.0495421227986673
319.38,320,16651,16653,915805,1032486,2024-02-01,2024-06-21,482.88,2,116681,413696011,79729983,0.24957601053591,93.5410597903976,0.113009764781314
476.88,489,829,850,690557,1030200,2024-02-01,2024-04-19,482.88,21,339643,232702399,73324968,0.442711379180926,92.845321719266,0.329686468646865
477.96,484,1387,1683,461871,1016532,2024-02-01,2024-03-01,482.88,296,554661,50809473,20654916,2.00067416562262,76.5658502303301,0.5456404717215
457.59,462,2113,2299,661369,1013859,2024-02-01,2024-04-19,482.88,186,352490,232702399,73324968,0.435689105207721,93.2810108244737,0.347671619031838
482.75,492,4086,1092,1454616,1010100,2024-02-01,2024-02-02,482.88,-2994,-444516,59097355,35805173,1.70921355109717,88.5450880162065,-0.44007128007128
474.8,480,1535,1938,472780,1007760,2024-02-01,2024-03-08,482.88,403,534980,44041877,11919273,2.28818585547569,66.0343427234039,0.53086052234659
394.14,395,11667,11668,770022,1003448,2024-02-01,2024-04-19,482.88,1,233426,232702399,73324968,0.431215150472084,93.7122259749458,0.232623912748842
470.09,487,586,588,822158,994308,2024-02-01,2024-08-16,482.88,2,172150,25910468,4922867,3.83747603478254,87.9040625588083,0.173135487193103
394.86,395,70302,70307,913926,984298,2024-02-01,2024-02-23,482.88,5,70372.0000000001,38550562,1795056,2.55326498223294,62.2993900841186,0.0714946083401573
436.68,440,2780,2964,706120,984048,2024-02-01,2024-05-17,482.88,184,277928,66606452,19312622,1.47740642302941,65.9585215558397,0.282433377233631
472,481,1085,1078,653170,970200,2024-02-01,2024-04-19,482.88,-7,317030,232702399,73324968,0.416927373404517,94.1291533483503,0.326767676767677
273.75,275,7753,7753,969125,969125,2024-02-01,2024-12-20,482.88,0,0,461752055,55002926,0.209879953863984,98.0456186599971,0
462.67,468,1694,1802,631862,960466,2024-02-01,2024-04-19,482.88,108,328604,232702399,73324968,0.412744348200725,94.541897696551,0.342129757846712
476.73,482.5,1518,1662,520674,958974,2024-02-01,2024-03-08,482.88,144,438300,44041877,11919273,2.17741400985249,68.2117567332564,0.457050973227637
475.28,479,2267,2576,417128,958272,2024-02-01,2024-02-23,482.88,309,541144,38550562,1795056,2.48575364478474,64.7851437289034,0.564708141321045
463.05,466,3315,3234,639795,954030,2024-02-01,2024-03-15,482.88,-81,314235,452229307,160916150,0.210961559817706,95.4061935663095,0.329376434703311
367.3,370,3528,3529,793800,952830,2024-02-01,2024-09-20,482.88,1,159030,275196706,45340715,0.346235975658808,97.0271126719082,0.166902805327288
479.47,493,688,688,789136,930864,2024-02-01,2024-05-17,482.88,0,141728,66606452,19312622,1.39755830261008,67.3560798584498,0.152254249815225
480.52,482.5,3959,4679,209827,926442,2024-02-01,2024-02-02,482.88,720,716615,59097355,35805173,1.56765391615242,90.1127419323589,0.773513074752656
362.5,365,3694,3698,779434,924500,2024-02-01,2024-09-20,482.88,4,145066,275196706,45340715,0.335941521044224,97.3630541929525,0.156912925905895
483.11,492,952,1034,442680,919226,2024-02-01,2024-02-09,482.88,82,476546,48138698,26427571,1.90953648143953,81.5844271484036,0.518420932393122
476.74,481,1847,2154,380482,917604,2024-02-01,2024-02-23,482.88,307,537122,38550562,1795056,2.38026101928164,67.165404748185,0.585352722961103
404.57,405,21568,21276,690176,914868,2024-02-01,2024-03-15,482.88,-292,224692,452229307,160916150,0.202301793766763,95.6084953600763,0.245600458208179
481.83,497,651,600,874293,910200,2024-02-01,2024-05-17,482.88,-51,35907,66606452,19312622,1.36653428109337,68.7226141395431,0.0394495715227423
477.6,494,583,554,694936,908560,2024-02-01,2024-05-17,482.88,-29,213624,66606452,19312622,1.36407205716347,70.0866861967066,0.235123712247953
465.13,466,8294,10424,364936,906888,2024-02-01,2024-02-16,482.88,2130,541952,187049931,90530418,0.484837388151723,90.0802577681785,0.597595292913789
472.79,482,985,983,655025,905343,2024-02-01,2024-04-19,482.88,-2,250318,232702399,73324968,0.389056152360509,94.9309538489115,0.276489684020311
479.5,493,671,669,672342,903150,2024-02-01,2024-04-19,482.88,-2,230808,232702399,73324968,0.388113746949381,95.3190675958609,0.255558877262913
422.64,425,3524,3809,623748,898924,2024-02-01,2024-05-17,482.88,285,275176,66606452,19312622,1.34960499021927,71.4362911869259,0.306117091100026
442.45,448,1622,1614,686106,895770,2024-02-01,2024-06-21,482.88,-8,209664,413696011,79729983,0.216528556278489,93.7575883466761,0.23406008238722
454.48,462,1182,1181,689106,888112,2024-02-01,2024-06-21,482.88,-1,199006,413696011,79729983,0.214677438598749,93.9722657852749,0.224077593816996
476.52,477,18795,18369,263130,881712,2024-02-01,2024-02-02,482.88,-426,618582,59097355,35805173,1.49196524954459,91.6047071819035,0.701569219881322
436.99,438,8655,8666,571230,875266,2024-02-01,2024-03-15,482.88,11,304036,452229307,160916150,0.193544731942815,95.8020400920191,0.347364115594574
461.12,466,943,1790,327221,873520,2024-02-01,2024-04-19,482.88,847,546299,232702399,73324968,0.375380745430132,95.6944483412911,0.62539953292426
444.7,445,28965,28973,550335,869190,2024-02-01,2024-02-16,482.88,8,318855,187049931,90530418,0.464683411190352,90.5449411793688,0.366841542125427
398.58,400,1823,6062,202353,860804,2024-02-01,2024-05-17,482.88,4239,658451,66606452,19312622,1.29237329740969,72.7286644843355,0.764925581200831
477.75,482.5,1562,1792,351450,851200,2024-02-01,2024-02-23,482.88,230,499750,38550562,1795056,2.20800931514306,69.3734140633281,0.587112312030075
482.93,494,768,767,561408,849069,2024-02-01,2024-03-08,482.88,-1,287661,44041877,11919273,1.92786742490562,70.139624158162,0.338795786914844
480.06,487.5,1132,1141,511664,848904,2024-02-01,2024-03-01,482.88,9,337240,50809473,20654916,1.67075930899736,78.2366095393275,0.39726517957272
409.94,410,141223,141228,564892,847368,2024-02-01,2024-02-09,482.88,5,282476,48138698,26427571,1.76026364485388,83.3446907932574,0.333356935829533
430.03,434,2084,2116,666880,840052,2024-02-01,2024-06-21,482.88,32,173172,413696011,79729983,0.203060212731904,94.1753259980068,0.206144381538286
374.17,375,10092,10100,777084,838300,2024-02-01,2024-05-17,482.88,8,61216,66606452,19312622,1.25858678075211,73.9872512650877,0.0730239770965048
357.7,360,3628,3643,729228,837890,2024-02-01,2024-09-20,482.88,15,108662,275196706,45340715,0.304469487363704,97.6675236803162,0.129685280884126
470.01,483,657,644,662913,836556,2024-02-01,2024-06-21,482.88,-13,173643,413696011,79729983,0.202215147779126,94.3775411457859,0.207568889590177
374.42,375,14185,14417,765990,836186,2024-02-01,2024-04-19,482.88,232,70195.9999999999,232702399,73324968,0.359337077569192,96.0537854188603,0.0839478297890659
454.13,456,4789,4418,579469,826166,2024-02-01,2024-03-15,482.88,-371,246697,452229307,160916150,0.182687408182504,95.9847275002016,0.298604638777195
483.57,494,785,789,457655,822927,2024-02-01,2024-02-09,482.88,4,365272,48138698,26427571,1.70949160278494,85.0541823960424,0.443869261793573
431.16,432,9698,9730,552786,817320,2024-02-01,2024-03-15,482.88,32,264534,452229307,160916150,0.180731320891594,96.1654588210932,0.323660255469094
263.94,265,7688,7688,814928,814928,2024-02-01,2024-12-20,482.88,0,0,461752055,55002926,0.17648605808587,98.222104718083,0
379.72,380,29048,28723,639056,804244,2024-02-01,2024-03-15,482.88,-325,165188,452229307,160916150,0.177839867419296,96.3432986885125,0.205395377522244
472.43,475,2851,3087,376332,793359,2024-02-01,2024-02-23,482.88,236,417027,38550562,1795056,2.05796999794711,71.4313840612752,0.525647279478773
441.99,447,1606,1580,664884,791580,2024-02-01,2024-06-21,482.88,-26,126696,413696011,79729983,0.191343396830578,94.5688845426165,0.160054574395513
479.24,487,823,1014,322616,786864,2024-02-01,2024-03-01,482.88,191,464248,50809473,20654916,1.54865609411064,79.7852656334381,0.589997763272942
339.15,340,9150,9150,649650,777750,2024-02-01,2024-06-21,482.88,0,128100,413696011,79729983,0.188000362420705,94.7568849050372,0.164705882352941
479.87,488,926,951,426886,773163,2024-02-01,2024-03-01,482.88,25,346277,50809473,20654916,1.52169065008803,81.3069562835261,0.44787063012586
481.74,492,716,753,453228,772578,2024-02-01,2024-03-01,482.88,37,319350,50809473,20654916,1.52053928998634,82.8274955735125,0.41335632130348
481.23,496,523,523,666302,772471,2024-02-01,2024-05-17,482.88,0,106169,66606452,19312622,1.15975401301964,75.1470052781073,0.137440758293839
477.34,478,8832,11692,150144,771672,2024-02-01,2024-02-02,482.88,2860,621528,59097355,35805173,1.30576402277225,92.9104712046757,0.805430286442945
481.46,500,578,414,764694,767556,2024-02-01,2024-04-19,482.88,-164,2862,232702399,73324968,0.329844472295277,96.3836298911555,0.00372871816518925
484.5,494,810,807,521640,766650,2024-02-01,2024-02-23,482.88,-3,245010,38550562,1795056,1.98868696129514,73.4200710225703,0.319585208374095
475.33,481,1251,1348,394065,764316,2024-02-01,2024-03-08,482.88,97,370251,44041877,11919273,1.73543012256267,71.8750542807247,0.484421364985163
479.02,482,1994,2547,219340,759006,2024-02-01,2024-02-09,482.88,553,539666,48138698,26427571,1.57670654075438,86.6308889367968,0.711016777205977
389.24,390,9957,9953,587463,756428,2024-02-01,2024-04-19,482.88,-4,168965,232702399,73324968,0.325062398690613,96.7086922898461,0.223372217844924
483.4,497,562,556,538958,756160,2024-02-01,2024-03-15,482.88,-6,217202,452229307,160916150,0.167207208443923,96.5105058969564,0.287243440541684
408.87,410,6615,6674,555660,754162,2024-02-01,2024-04-19,482.88,59,198502,232702399,73324968,0.324088622739124,97.0327809125853,0.263208700517926
477.33,483,610,1320,183000,748440,2024-02-01,2024-03-01,482.88,710,565440,50809473,20654916,1.47303240086745,84.3005279743799,0.755491422158089
307.99,310,3678,3672,662040,738072,2024-02-01,2024-12-20,482.88,-6,76031.9999999999,461752055,55002926,0.159841627559189,98.3819463456421,0.103014340064384
399.09,400,8107,8106,583704,737646,2024-02-01,2024-04-19,482.88,-1,153942,232702399,73324968,0.316991145415738,97.349772058001,0.2086936009956
476.06,500,296,308,602656,737352,2024-02-01,2024-09-20,482.88,12,134696,275196706,45340715,0.267936346592753,97.9354600269089,0.182675302976055
404.88,405,61421,61419,614210,737028,2024-02-01,2024-02-16,482.88,-2,122818,187049931,90530418,0.394027410787978,90.9389685901568,0.166639530655552
476.75,483,1032,1178,355008,736250,2024-02-01,2024-03-08,482.88,146,381242,44041877,11919273,1.67170440987336,73.546758690598,0.517815959252971
420.15,423,2436,2578,682080,734730,2024-02-01,2024-06-21,482.88,142,52650.0000000001,413696011,79729983,0.177601422412555,94.9344863274498,0.0716589767669758
278.54,280,5020,5005,632520,730730,2024-02-01,2024-12-20,482.88,-15,98210,461752055,55002926,0.158251596736261,98.5401979423784,0.134399846728614
433.81,434,38251,38239,573765,726541,2024-02-01,2024-02-16,482.88,-12,152776,187049931,90530418,0.388420886399579,91.3273894765564,0.210278566522743
474.09,479,1290,1476,361200,724716,2024-02-01,2024-03-08,482.88,186,363516,44041877,11919273,1.64551569861566,75.1922743892137,0.501597867302502
461.96,463,6810,6842,388170,711568,2024-02-01,2024-02-23,482.88,32,323398,38550562,1795056,1.84580447880371,75.265875501374,0.454486429968745
369.78,370,32014,32014,576252,704308,2024-02-01,2024-03-15,482.88,0,128056,452229307,160916150,0.155741343848819,96.6662472408052,0.181818181818182
353.08,355,3656,3656,687328,701952,2024-02-01,2024-09-20,482.88,0,14624,275196706,45340715,0.255072820530054,98.1905328474389,0.0208333333333333
476.8,482,1191,1334,350154,693680,2024-02-01,2024-03-01,482.88,143,343526,50809473,20654916,1.36525722280174,85.6657851971816,0.495222581017184
477.04,479,3745,3539,265895,693644,2024-02-01,2024-02-09,482.88,-206,427749,48138698,26427571,1.44092804504185,88.0718169818386,0.616669357768538
471.12,479,875,874,628250,688712,2024-02-01,2024-05-17,482.88,-1,60462,66606452,19312622,1.03400193122432,76.1810072093316,0.0877899615514177
460,469,762,765,529590,688500,2024-02-01,2024-06-21,482.88,3,158910,413696011,79729983,0.166426550339641,95.1009128777894,0.230806100217865
453.68,455,4433,5192,367939,685344,2024-02-01,2024-03-08,482.88,759,317405,44041877,11919273,1.55611896377623,76.7483933529899,0.46313238315357
461.76,468,1070,1093,569240,682032,2024-02-01,2024-05-17,482.88,23,112792,66606452,19312622,1.02397287277815,77.2049800821098,0.165376404626176
469.19,477,875,871,588000,680251,2024-02-01,2024-05-17,482.88,-4,92250.9999999999,66606452,19312622,1.02129895764452,78.2262790397543,0.135613178076916
477.24,484,353,999,132022,675324,2024-02-01,2024-03-08,482.88,646,543302,44041877,11919273,1.53336788983812,78.2817612428281,0.804505689121074
469.33,479,687,697,628605,673999,2024-02-01,2024-06-21,482.88,10,45394,413696011,79729983,0.16292131953866,95.2638341973281,0.0673502482941369
438.95,444,1293,1321,512028,667105,2024-02-01,2024-06-21,482.88,28,155077,413696011,79729983,0.161254878524802,95.4250890758528,0.232462655803809
461.87,469,980,925,518420,659525,2024-02-01,2024-05-17,482.88,-55,141105,66606452,19312622,0.990181852052411,79.2164608918067,0.213949433304272
479.83,510,218,218,657706,657706,2024-02-01,2024-12-20,482.88,0,0,461752055,55002926,0.142437048818332,98.6826349911967,0
482.32,492,147,678,95844,656304,2024-02-01,2024-03-08,482.88,531,560460,44041877,11919273,1.49018171954842,79.7719429623765,0.853964016675199
468.26,470,3398,3746,292228,651804,2024-02-01,2024-02-23,482.88,348,359576,38550562,1795056,1.69077690748062,76.9566524088546,0.551662769789691
478.13,479,13645,7416,286545,645192,2024-02-01,2024-02-02,482.88,-6229,358647,59097355,35805173,1.09174429210918,94.0022154967849,0.555876390283823
467.15,476,662,728,440892,644280,2024-02-01,2024-05-17,482.88,66,203388,66606452,19312622,0.967293678996744,80.1837545708034,0.315682622462283
440.77,446,1225,1229,502250,642767,2024-02-01,2024-06-21,482.88,4,140517,413696011,79729983,0.155371814788903,95.5804608906418,0.218612654352199
419.83,420,38440,37623,461280,639591,2024-02-01,2024-02-16,482.88,-817,178311,187049931,90530418,0.341935972165635,91.669325448722,0.27878910115996
333.55,335,4393,4393,636985,636985,2024-02-01,2024-09-20,482.88,0,0,275196706,45340715,0.231465343193461,98.4219981906324,0
374.74,375,24501,24428,490020,635128,2024-02-01,2024-03-15,482.88,-73,145108,452229307,160916150,0.140443794811379,96.8066910356166,0.228470481540729
445.4,449,1647,1754,602802,631440,2024-02-01,2024-05-17,482.88,107,28638,66606452,19312622,0.948016267252908,81.1317708380564,0.0453534777651083
483.16,495,499,533,346805,631072,2024-02-01,2024-02-16,482.88,34,284267,187049931,90530418,0.33738157326559,92.0067070219876,0.450450978652198
424.85,428,1880,2002,580920,630630,2024-02-01,2024-06-21,482.88,122,49710,413696011,79729983,0.152438018069263,95.732898908711,0.0788259359687931
384.71,385,21715,21744,499445,630576,2024-02-01,2024-03-15,482.88,29,131131,452229307,160916150,0.139437225814292,96.9461282614309,0.207954314785212
408.24,410,3587,3581,477071,630256,2024-02-01,2024-05-17,482.88,-6,153185,66606452,19312622,0.946238661684006,82.0780094997403,0.243052029651443
480.54,500,311,323,454993,628558,2024-02-01,2024-05-17,482.88,12,173565,66606452,19312622,0.943689359102929,83.0216988588433,0.276132035548032
457.51,458,14707,12824,382382,628376,2024-02-01,2024-02-16,482.88,-1883,245994,187049931,90530418,0.335940246885202,92.3426472688728,0.391475804295517
293.54,295,4246,4246,619916,619916,2024-02-01,2024-12-20,482.88,0,0,461752055,55002926,0.134253002945488,98.8168879941422,0
283.55,285,4200,4197,579600,608565,2024-02-01,2024-12-20,482.88,-3,28965,461752055,55002926,0.131794757253436,98.9486827513957,0.0475955731926746
432.15,433,7074,7088,417366,602480,2024-02-01,2024-03-15,482.88,14,185114,452229307,160916150,0.133224448454421,97.0793527098853,0.307253352808392
442.77,444,4830,4885,381570,600855,2024-02-01,2024-03-15,482.88,55,219285,452229307,160916150,0.132865117474574,97.2122178273599,0.364954939211623
434.77,435,26631,26068,399465,599564,2024-02-01,2024-02-16,482.88,-563,200099,187049931,90530418,0.320536873119723,92.6631841419925,0.333740851685558
465.79,467,4956,4936,346920,597256,2024-02-01,2024-02-23,482.88,-20,250336,38550562,1795056,1.54927961880296,78.5059320276576,0.419143549834577
344.22,345,7636,7636,595608,595608,2024-02-01,2024-06-21,482.88,0,0,413696011,79729983,0.143972381691638,95.8768712904027,0
480.74,488,795,820,321180,595320,2024-02-01,2024-02-23,482.88,25,274140,38550562,1795056,1.54425764272905,80.0501896703866,0.460491836323322
475.66,476,17849,17490,214188,594660,2024-02-01,2024-02-02,482.88,-359,380472,59097355,35805173,1.00623792723042,95.0084534240153,0.639814347694481
435.82,436,32625,32672,489375,588096,2024-02-01,2024-02-16,482.88,47,98721,187049931,90530418,0.314405889836976,92.9775900318295,0.167865450538688
438.01,439,5901,5901,407169,584199,2024-02-01,2024-03-15,482.88,0,177030,452229307,160916150,0.129182030212827,97.3413998575727,0.303030303030303
482.48,494,495,506,357390,582912,2024-02-01,2024-03-01,482.88,11,225522,50809473,20654916,1.14725063178671,86.8130358289684,0.386888586956522
443.31,446,1351,2153,267498,579157,2024-02-01,2024-04-19,482.88,802,311659,232702399,73324968,0.248883123890785,97.5986551818918,0.538125240651499
465.39,473,333,758,206460,576838,2024-02-01,2024-05-17,482.88,425,370378,66606452,19312622,0.866039223947854,83.8877380827911,0.642083219205392
471.21,481,442,587,343876,574673,2024-02-01,2024-05-17,482.88,145,230797,66606452,19312622,0.862788788089178,84.7505268708803,0.401614483367063
410.88,411,47825,47814,478250,573768,2024-02-01,2024-02-16,482.88,-11,95517.9999999999,187049931,90530418,0.306745903049812,93.2843359348793,0.166474951548361
470.72,473,2490,2482,253980,565896,2024-02-01,2024-02-23,482.88,-8,311916,38550562,1795056,1.46793190719243,81.5181215775791,0.551189617880317
472.7,484,449,497,381650,561610,2024-02-01,2024-05-17,482.88,48,179960,66606452,19312622,0.843176573945119,85.5937034448254,0.320435889674329
313.11,315,2960,2968,565360,560952,2024-02-01,2024-12-20,482.88,8,-4408,461752055,55002926,0.121483379213115,99.0701661306088,-0.00785806985267902
486.4,515,195,195,501540,557700,2024-02-01,2024-06-21,482.88,0,56160.0000000001,413696011,79729983,0.134809131625879,96.0116804220285,0.100699300699301
473.37,488,392,381,451976,557403,2024-02-01,2024-06-21,482.88,-11,105427,413696011,79729983,0.134737339780634,96.1464177618092,0.18913963505758
469.1,471,2841,2931,275577,556890,2024-02-01,2024-02-23,482.88,90,281313,38550562,1795056,1.44457038006346,82.9626919576425,0.505150029628832
421.03,424,1867,1868,532095,554796,2024-02-01,2024-06-21,482.88,1,22701,413696011,79729983,0.134107166916821,96.280524928726,0.0409177427378712
474.82,487,361,450,347282,548100,2024-02-01,2024-05-17,482.88,89,200818,66606452,19312622,0.822893253644557,86.41659669847,0.366389345010035
462.33,463,7588,8094,265580,542298,2024-02-01,2024-02-16,482.88,506,276718,187049931,90530418,0.289921518335123,93.5742574532145,0.510269261549923
473.13,477,1169,1400,277053,541800,2024-02-01,2024-03-08,482.88,231,264747,44041877,11919273,1.23019280036589,81.0021357627424,0.488643410852713
464.25,466,3064,3084,291080,539700,2024-02-01,2024-03-01,482.88,20,248620,50809473,20654916,1.06220349894202,87.8752393279104,0.460663331480452
439.9,441,4839,4854,348408,533940,2024-02-01,2024-03-15,482.88,15,185532,452229307,160916150,0.118068420541352,97.4594682781141,0.347477244634229
475.52,477,3930,3571,224010,528508,2024-02-01,2024-02-09,482.88,-359,304498,48138698,26427571,1.09788594614669,89.1697029279853,0.576146434869482
441.73,442,19093,19568,343674,528336,2024-02-01,2024-02-16,482.88,475,184662,187049931,90530418,0.282457201227195,93.8567146544417,0.349516216952848
334.24,335,6827,6827,471063,518852,2024-02-01,2024-06-21,482.88,0,47789.0000000001,413696011,79729983,0.125418661578538,96.4059435903045,0.092105263157895
473.2,476,1869,1849,242970,517720,2024-02-01,2024-02-23,482.88,-20,274750,38550562,1795056,1.34296356042747,84.30565551807,0.530692266089778
466.01,474,176,644,111936,514556,2024-02-01,2024-05-17,482.88,468,402620,66606452,19312622,0.772531766141815,87.1891284646118,0.782460995499032
432.82,433,28694,28586,430410,514548,2024-02-01,2024-02-16,482.88,-108,84138,187049931,90530418,0.275085907409396,94.1318005618511,0.163518272347769
481.89,510,177,182,466749,511602,2024-02-01,2024-09-20,482.88,5,44852.9999999999,275196706,45340715,0.185904114709861,98.6079023053423,0.0876716666471201
473.16,477,1183,1330,225953,510720,2024-02-01,2024-03-01,482.88,147,284767,50809473,20654916,1.00516689082762,88.880406218738,0.557579495614035
384.92,385,63558,63554,381348,508432,2024-02-01,2024-02-16,482.88,-4,127084,187049931,90530418,0.271816192223027,94.4036167540741,0.249952796047456
460.35,461,7853,7801,251296,507065,2024-02-01,2024-02-16,482.88,-52,255769,187049931,90530418,0.271085371317245,94.6747021253913,0.504410677132123
470.52,484,375,376,385875,506848,2024-02-01,2024-06-21,482.88,1,120973,413696011,79729983,0.122517014069058,96.5284606043736,0.238677078729718
438.77,439,21985,21988,373745,505724,2024-02-01,2024-02-16,482.88,3,131979,187049931,90530418,0.27036845044332,94.9450705758347,0.260970410737873
424.93,425,72153,72216,432918,505512,2024-02-01,2024-02-09,482.88,63,72594.0000000001,48138698,26427571,1.05011564708294,90.2198185750682,0.143604899586954
289.75,290,20046,20048,461058,501200,2024-02-01,2024-05-17,482.88,2,40142,66606452,19312622,0.752479654673694,87.9416081192855,0.0800917797286513
474.35,477.5,1356,1588,197976,500220,2024-02-01,2024-02-23,482.88,232,302244,38550562,1795056,1.29756863207338,85.6032241501434,0.604222142257407
458.33,460,2663,2981,266300,497827,2024-02-01,2024-03-08,482.88,318,231527,44041877,11919273,1.13034919015827,82.1324849529006,0.465075216892615
303.1,305,2616,2616,436872,497040,2024-02-01,2024-12-20,482.88,0,60168,461752055,55002926,0.107642184721842,99.1778083153306,0.121052631578947
452.62,453,10238,12970,235474,492860,2024-02-01,2024-02-16,482.88,2732,257386,187049931,90530418,0.263491142373103,95.2085617182077,0.522229436351094
313.8,315,4100,4100,467400,492000,2024-02-01,2024-09-20,482.88,0,24600,275196706,45340715,0.178781209684973,98.7866835150272,0.05
473.21,477.5,783,1146,205146,491634,2024-02-01,2024-03-08,482.88,363,286488,44041877,11919273,1.11628757330211,83.2487725262027,0.582726174349211
406.58,407,11587,11583,417132,486486,2024-02-01,2024-03-15,482.88,-4,69353.9999999999,452229307,160916150,0.107575071422782,97.5670433495368,0.142561142561142
456.72,462,917,916,409899,483648,2024-02-01,2024-05-17,482.88,-1,73749.0000000001,66606452,19312622,0.726127853199567,88.6677359724851,0.152484865025804
469.42,470,7231,8335,173544,483430,2024-02-01,2024-02-09,482.88,1104,309886,48138698,26427571,1.00424402836986,91.2240626034381,0.641015245226817
470.09,482,419,404,408106,481164,2024-02-01,2024-06-21,482.88,-15,73058.0000000001,413696011,79729983,0.116308590657404,96.644769195031,0.151835964452869
410.59,411,11719,11711,421884,480151,2024-02-01,2024-03-15,482.88,-8,58266.9999999999,452229307,160916150,0.106174233418269,97.6732175829551,0.121351408202836
402.61,403,12315,12304,455655,479856,2024-02-01,2024-03-15,482.88,-11,24201.0000000001,452229307,160916150,0.106109001025004,97.7793265839801,0.0504338801640493
465.38,468,1626,1783,235770,467146,2024-02-01,2024-03-08,482.88,157,231376,44041877,11919273,1.06068594669569,84.3094584728984,0.495296973537181
471.24,472,9916,6085,277648,462460,2024-02-01,2024-02-09,482.88,-3831,184812,48138698,26427571,0.960682401505749,92.1847450049438,0.399628075941703
454.87,458,1434,1462,387180,457606,2024-02-01,2024-04-19,482.88,28,70426,232702399,73324968,0.196648595788649,97.7953037776804,0.153900954095882
433.11,434,5089,5119,310429,455591,2024-02-01,2024-03-15,482.88,30,145162,452229307,160916150,0.100743360270545,97.8800699442507,0.318623502220193
409.39,412,1733,1734,362197,452574,2024-02-01,2024-06-21,482.88,1,90377,413696011,79729983,0.109397719089924,96.7541669141209,0.199695519406771
478.72,486,322,621,121072,452088,2024-02-01,2024-03-01,482.88,299,331016,50809473,20654916,0.889771086584582,89.7701773053226,0.732193732193732
324.36,325,7051,7051,408958,451264,2024-02-01,2024-06-21,482.88,0,42306.0000000001,413696011,79729983,0.109081061456017,96.8632479755769,0.0937500000000001
353.96,355,4304,4304,370144,447616,2024-02-01,2024-06-21,482.88,0,77472,413696011,79729983,0.108199254548771,96.9714472301257,0.173076923076923
458.46,459,8986,8287,260594,447498,2024-02-01,2024-02-16,482.88,-699,186904,187049931,90530418,0.239239863713182,95.4478015819209,0.417664436489102
483.78,510,469,170,925337,445740,2024-02-01,2024-03-15,482.88,-299,-479597,452229307,160916150,0.0985650405890213,97.9786349848397,-1.07595683582357
463.82,465,3777,3755,234174,443090,2024-02-01,2024-02-23,482.88,-22,208916,38550562,1795056,1.14937364596656,86.75259779611,0.471497889819224
426.27,427,6060,6051,309060,441723,2024-02-01,2024-03-15,482.88,-9,132663,452229307,160916150,0.0976767744068387,98.0763117592465,0.30033075026657
425.78,429,1353,1370,388311,441140,2024-02-01,2024-06-21,482.88,17,52829.0000000001,413696011,79729983,0.106633853909701,97.0780810840354,0.119755633132339
484.67,499,307,307,439931,439931,2024-02-01,2024-05-17,482.88,0,0,66606452,19312622,0.660493070551183,89.3282290430363,0
349.83,350,25838,25844,335894,439348,2024-02-01,2024-03-15,482.88,6,103454,452229307,160916150,0.0971515983593695,98.1734633576059,0.235471653450113
434.48,439,947,961,331450,434372,2024-02-01,2024-06-21,482.88,14,102922,413696011,79729983,0.10499787004231,97.1830789540777,0.236944370263277
424.82,425,23120,24082,277440,433476,2024-02-01,2024-02-16,482.88,962,156036,187049931,90530418,0.231743469608658,95.6795450515296,0.359964565512278
453.41,458,949,944,380549,433296,2024-02-01,2024-05-17,482.88,-5,52747,66606452,19312622,0.65053157312748,89.9787606161637,0.121734334034932
119.86,120,30628,30671,367536,429394,2024-02-01,2024-12-20,482.88,43,61858.0000000001,461752055,55002926,0.0929923311332096,99.2708006464638,0.144058836406657
482.85,494,393,385,226761,429275,2024-02-01,2024-02-16,482.88,-8,202514,187049931,90530418,0.229497545230316,95.9090425967599,0.471758196959991
468.85,472,1415,1361,256115,428715,2024-02-01,2024-03-08,482.88,-54,172600,44041877,11919273,0.973425814708124,85.2828842876066,0.402598462848279
408.54,409,9308,9308,325780,428168,2024-02-01,2024-03-15,482.88,0,102388,452229307,160916150,0.0946794012180197,98.2681427588239,0.239130434782609
339.86,340,30558,30561,366696,427854,2024-02-01,2024-03-15,482.88,3,61158,452229307,160916150,0.0946099674163753,98.3627527262403,0.142941283708929
444.67,447,1307,1827,295382,425691,2024-02-01,2024-04-19,482.88,520,130309,232702399,73324968,0.182933653382748,97.9782374310632,0.306111710137165
455.56,456,9680,9658,251680,424952,2024-02-01,2024-02-16,482.88,-22,173272,187049931,90530418,0.227186397625562,96.1362289943855,0.407744874715262
451.97,458,701,702,382746,423306,2024-02-01,2024-06-21,482.88,1,40560.0000000001,413696011,79729983,0.102322959067643,97.2854019131454,0.0958172102450711
460.15,462,2197,2273,252655,420505,2024-02-01,2024-03-08,482.88,76,167850,44041877,11919273,0.954784465702949,86.2376687533095,0.39916291126146
453.6,454,10519,10498,241937,419920,2024-02-01,2024-02-16,482.88,-21,177983,187049931,90530418,0.224496206844364,96.3607252012298,0.42384978091065
471.47,474,1321,1643,150594,415679,2024-02-01,2024-02-23,482.88,322,265085,38550562,1795056,1.07826962418862,87.8308674202986,0.637715641155796
476.94,477.5,6088,7393,91320,414008,2024-02-01,2024-02-02,482.88,1305,322688,59097355,35805173,0.700552503576514,95.7090059275919,0.779424552182567
435.05,436,4362,4344,270444,412680,2024-02-01,2024-03-15,482.88,-18,142236,452229307,160916150,0.0912545900082499,98.4540073162485,0.344664146554231
470.37,472.5,1832,1929,183200,410877,2024-02-01,2024-02-23,482.88,97,227677,38550562,1795056,1.06581325584825,88.8966806761468,0.554124470340272
469.71,473,1130,1244,213570,409276,2024-02-01,2024-03-08,482.88,114,195706,44041877,11919273,0.929288277154945,87.1669570304644,0.478176096326196
467.26,470,1008,1487,163296,407438,2024-02-01,2024-03-08,482.88,479,244142,44041877,11919273,0.925114976366697,88.0920720068311,0.599212640941689
478.15,494,78,256,108810,405760,2024-02-01,2024-06-21,482.88,178,296950,413696011,79729983,0.0980816805603668,97.3834835937057,0.73183655362776
369.52,370,8404,8410,361372,403680,2024-02-01,2024-04-19,482.88,6,42308,232702399,73324968,0.173474790863673,98.1517122219269,0.104805786761792
449.75,454,948,948,329904,402900,2024-02-01,2024-05-17,482.88,0,72996,66606452,19312622,0.604896354485298,90.583656970649,0.181176470588235
483,505,181,182,303175,400400,2024-02-01,2024-04-19,482.88,1,97225,232702399,73324968,0.172065265214563,98.3237774871414,0.24281968031968
432.25,436,1060,1065,346620,399375,2024-02-01,2024-06-21,482.88,5,52755,413696011,79729983,0.0965382767493013,97.480021870455,0.132093896713615
428.46,432,1119,1125,422982,398250,2024-02-01,2024-06-21,482.88,6,-24732,413696011,79729983,0.0962663379415568,97.5762882083966,-0.0621016949152542
479.24,498,6,212,10128,397712,2024-02-01,2024-07-19,482.88,206,387584,4933850,1821237,8.06088551536833,8.06088551536833,0.974534336404232
472.17,486,94,285,103212,394155,2024-02-01,2024-06-21,482.88,191,290943,413696011,79729983,0.0952764806813668,97.6715646890779,0.738143623701336
470.86,474,1066,1242,167362,389988,2024-02-01,2024-03-01,482.88,176,222626,50809473,20654916,0.767549783482305,90.5377270888049,0.57085346215781
449.23,450,4906,5062,240394,389774,2024-02-01,2024-03-01,482.88,156,149380,50809473,20654916,0.767128602180149,91.304855690985,0.383247728170684
474.76,475,14848,16219,148480,389256,2024-02-01,2024-02-02,482.88,1371,240776,59097355,35805173,0.658669072414493,96.3676750000064,0.618554370388639
479.18,486,430,566,190920,386012,2024-02-01,2024-03-08,482.88,136,195092,44041877,11919273,0.876465823652339,88.9685378304835,0.505403977078433
465.92,477,348,348,292320,385584,2024-02-01,2024-06-21,482.88,0,93264,413696011,79729983,0.0932046695514306,97.7647693586294,0.24187725631769
389.91,390,42809,42808,256854,385272,2024-02-01,2024-02-16,482.88,-1,128418,187049931,90530418,0.205972810543298,96.5666980117731,0.333317759920264
258.99,260,3811,3811,384911,384911,2024-02-01,2024-12-20,482.88,0,0,461752055,55002926,0.0833588060588057,99.3541594525226,0
451.65,456,879,879,334899,382365,2024-02-01,2024-05-17,482.88,0,47466,66606452,19312622,0.574066007899655,91.1577229785487,0.124137931034483
483.36,495,329,325,212863,378300,2024-02-01,2024-02-09,482.88,-4,165437,48138698,26427571,0.785854241425474,92.9705992463693,0.437316944224161
415.46,416,6994,6985,272766,377190,2024-02-01,2024-03-15,482.88,-9,104424,452229307,160916150,0.0834068014083837,98.5374141176569,0.276847212280283
478.51,505,142,142,376158,376158,2024-02-01,2024-12-20,482.88,0,0,461752055,55002926,0.0814631999851089,99.4356226525077,0
413.49,414,7017,7324,273663,373524,2024-02-01,2024-03-15,482.88,307,99861,452229307,160916150,0.0825961507178481,98.6200102683748,0.267348282841263
462.93,464,3384,3418,196272,365726,2024-02-01,2024-02-23,482.88,34,169454,38550562,1795056,0.94869174669879,89.8453724228456,0.463335940020671
479.54,488,209,431,101783,364626,2024-02-01,2024-03-08,482.88,222,262843,44041877,11919273,0.827907493588432,89.7964453240719,0.720856439200715
436.72,441,832,845,309504,361660,2024-02-01,2024-06-21,482.88,13,52156.0000000001,413696011,79729983,0.087421679296782,97.8521910379262,0.144212796549245
448.72,449,12450,12913,249000,361564,2024-02-01,2024-02-16,482.88,463,112564,187049931,90530418,0.193298119954933,96.7599961317281,0.311325242557334
468.49,471,394,1438,52008,360938,2024-02-01,2024-03-01,482.88,1044,308930,50809473,20654916,0.710375405783091,92.0152310967681,0.855908771035469
425.3,426,5146,5147,257300,360290,2024-02-01,2024-03-15,482.88,1,102990,452229307,160916150,0.0796697592179712,98.6996800275927,0.285853062810514
467.92,471,1043,1163,177310,358204,2024-02-01,2024-03-08,482.88,120,180894,44041877,11919273,0.81332591705844,90.6097712411304,0.50500273587118
460.9,467,586,587,289484,358070,2024-02-01,2024-05-17,482.88,1,68586,66606452,19312622,0.537590562547905,91.6953135410966,0.191543552936577
483.31,493,862,369,362040,357561,2024-02-01,2024-02-02,482.88,-493,-4479.00000000006,59097355,35805173,0.605037230515647,96.972712230522,-0.0125265339340702
445.38,448,1227,1351,289572,353962,2024-02-01,2024-04-19,482.88,124,64390.0000000001,232702399,73324968,0.152109304210482,98.4758867913519,0.181912182663676
483.72,500,444,217,447552,353276,2024-02-01,2024-02-16,482.88,-227,-94276.0000000001,187049931,90530418,0.188867217491783,96.9488633492199,-0.266862170087977
394.95,395,70622,70636,282488,353180,2024-02-01,2024-02-09,482.88,14,70692,48138698,26427571,0.733671691743719,93.704270938113,0.200158559374823
379,380,3308,3510,287796,351000,2024-02-01,2024-05-17,482.88,202,63204,66606452,19312622,0.526975975240357,92.2222895163369,0.180068376068376
462.8,465,1065,1593,139515,350460,2024-02-01,2024-03-08,482.88,528,210945,44041877,11919273,0.795742651931025,91.4055138930614,0.60190891970553
444.57,448,970,1017,311370,348831,2024-02-01,2024-05-17,482.88,47,37461,66606452,19312622,0.523719533957461,92.7460090502944,0.107390111543985
416.02,419,1157,1167,275366,347766,2024-02-01,2024-06-21,482.88,10,72400,413696011,79729983,0.0840631745902911,97.9362542125165,0.208185964125303
461.53,471,367,367,272314,347549,2024-02-01,2024-06-21,482.88,0,75235,413696011,79729983,0.0840107206158195,98.0202649331323,0.216473072861668
476.5,489,106,276,106848,345000,2024-02-01,2024-05-17,482.88,170,238152,66606452,19312622,0.517967838911462,93.2639768892059,0.690295652173913
474.71,476,2641,2673,113563,344817,2024-02-01,2024-02-09,482.88,32,231254,48138698,26427571,0.716298974268062,94.4205699123811,0.670657189175708
421.4,422,5747,5745,258615,344700,2024-02-01,2024-03-15,482.88,-2,86085,452229307,160916150,0.0762223930790049,98.7759024206717,0.249738903394256
483.72,492.5,259,392,177415,344176,2024-02-01,2024-03-08,482.88,133,166761,44041877,11919273,0.78147441354509,92.1869883066065,0.484522453628376
467.54,468,7456,7454,156576,342884,2024-02-01,2024-02-09,482.88,-2,186308,48138698,26427571,0.712283493832758,95.1328534062139,0.543355770464647
469.99,485,230,227,310040,340727,2024-02-01,2024-08-16,482.88,-3,30687,25910468,4922867,1.31501677237169,89.21907933118,0.0900633058137453
334.87,335,26210,26201,288310,340613,2024-02-01,2024-03-15,482.88,-9,52303,452229307,160916150,0.0753186480238442,98.8512210686956,0.15355550140482
457.84,464,548,551,284960,339416,2024-02-01,2024-05-17,482.88,3,54456,66606452,19312622,0.50958426670137,93.7735611559072,0.160440285667146
450.84,454,1178,1052,289788,332432,2024-02-01,2024-04-19,482.88,-126,42644,232702399,73324968,0.142857143471048,98.618743934823,0.12827886605381
364.79,365,15666,15668,266322,329028,2024-02-01,2024-03-15,482.88,2,62706,452229307,160916150,0.0727568945459786,98.9239779632416,0.190579525146796
298.98,300,3223,3223,322300,328746,2024-02-01,2024-09-20,482.88,0,6446,275196706,45340715,0.119458551949383,98.9061420669766,0.0196078431372549
472.39,476,1159,908,216733,327788,2024-02-01,2024-03-01,482.88,-251,111055,50809473,20654916,0.645131666687431,92.6603627634556,0.338801298400186
428.25,429,4359,4359,226668,326925,2024-02-01,2024-03-15,482.88,0,100257,452229307,160916150,0.072291864976367,98.9962698282179,0.306666666666667
436.09,437,3440,3585,227040,326235,2024-02-01,2024-03-15,482.88,145,99195,452229307,160916150,0.0721392875141549,99.0684091157321,0.304059956779622
405.98,410,683,800,224024,321600,2024-02-01,2024-08-16,482.88,117,97576,25910468,4922867,1.24119718717547,90.4602765183554,0.303407960199005
477.21,482.5,550,606,151250,320574,2024-02-01,2024-03-01,482.88,56,169324,50809473,20654916,0.630933526903536,93.2912962903591,0.528190059081523
456.5,457,6385,6362,172395,318100,2024-02-01,2024-02-16,482.88,-23,145705,187049931,90530418,0.170061543620671,97.1189248928405,0.458047783715813
476.49,496,161,163,299943,318013,2024-02-01,2024-08-16,482.88,2,18070,25910468,4922867,1.22735336158343,91.6876298799389,0.0568215764764334
466.61,467,10635,8142,212700,317538,2024-02-01,2024-02-09,482.88,-2493,104838,48138698,26427571,0.659631467390331,95.7924848736042,0.330158910114695
338.36,340,1927,1927,316028,316028,2024-02-01,2024-09-20,482.88,0,0,275196706,45340715,0.114837130354315,99.0209791973309,0
485.5,520,91,91,313950,313950,2024-02-01,2024-12-20,482.88,0,0,461752055,55002926,0.0679910347123415,99.5036136872201,0
199.46,200,5747,5772,275856,311688,2024-02-01,2024-12-20,482.88,25,35832,461752055,55002926,0.0675011614187619,99.5711148486389,0.114961114961115
472.04,476,582,787,130950,311652,2024-02-01,2024-03-08,482.88,205,180702,44041877,11919273,0.707626516462956,92.8946148230694,0.579819799006584
481.66,496,214,217,192600,311178,2024-02-01,2024-03-15,482.88,3,118578,452229307,160916150,0.0688097819365785,99.1372188976687,0.381061643175289
394.9,395,30528,30510,213696,305100,2024-02-01,2024-02-16,482.88,-18,91404,187049931,90530418,0.163111527691502,97.282036420532,0.299587020648968
448,452,758,756,258478,302400,2024-02-01,2024-05-17,482.88,-2,43922,66606452,19312622,0.454010070976307,94.2275712268835,0.145244708994709
480.29,490,281,309,163542,300039,2024-02-01,2024-03-08,482.88,28,136497,44041877,11919273,0.681258430470618,93.57587325354,0.454930858988332
482.39,496,220,220,252780,299420,2024-02-01,2024-04-19,482.88,0,46640,232702399,73324968,0.128670783492868,98.7474147183158,0.155767817781043
473.04,474,2710,3114,102980,298944,2024-02-01,2024-02-09,482.88,404,195964,48138698,26427571,0.621005578505675,96.4134904521099,0.655520766431171
471.31,482,267,279,218673,298251,2024-02-01,2024-05-17,482.88,12,79578,66606452,19312622,0.447780944704876,94.6753521715884,0.266815534566523
417.91,420,1408,1425,226688,297825,2024-02-01,2024-05-17,482.88,17,71137,66606452,19312622,0.447141367025525,95.1224935386139,0.238855032317636
423.43,427,830,830,253980,296310,2024-02-01,2024-06-21,482.88,0,42330,413696011,79729983,0.0716250561091342,98.0918899892414,0.142857142857143
482.6,510,107,108,243639,295920,2024-02-01,2024-06-21,482.88,1,52281,413696011,79729983,0.0715307839891161,98.1634207732305,0.176672749391728
457.77,466,178,359,114454,295457,2024-02-01,2024-06-21,482.88,181,181003,413696011,79729983,0.0714188660620177,98.2348396392925,0.612620448999347
485.93,510,122,122,293654,293654,2024-02-01,2024-08-16,482.88,0,0,25910468,4922867,1.13334116543167,92.8209710453705,0
446.24,449,1053,1063,221130,293388,2024-02-01,2024-04-19,482.88,10,72257.9999999999,232702399,73324968,0.12607863144548,98.8734933497613,0.246288191746083
482.52,498,187,189,166430,292572,2024-02-01,2024-03-01,482.88,2,126142,50809473,20654916,0.575821756702731,93.8671180470618,0.431148571975445
451.61,452,7379,7415,162338,289185,2024-02-01,2024-02-16,482.88,36,126847,187049931,90530418,0.154603104344369,97.4366395248764,0.438636167159431
439.16,445,490,489,245490,285576,2024-02-01,2024-07-19,482.88,-1,40086,4933850,1821237,5.78809651691884,13.8489820322872,0.140368938566266
433.95,438,704,702,266816,284310,2024-02-01,2024-06-21,482.88,-2,17494,413696011,79729983,0.0687243754931928,98.3035640147857,0.0615314269635257
450.64,451,7589,7803,159369,280908,2024-02-01,2024-02-16,482.88,214,121539,187049931,90530418,0.150178082663928,97.5868176075403,0.432664787047717
467.4,469,3646,1745,309910,279200,2024-02-01,2024-02-23,482.88,-1901,-30710,38550562,1795056,0.724243656940721,90.5696160797863,-0.109992836676218
445.71,446,9779,9622,185801,279038,2024-02-01,2024-02-16,482.88,-157,93237,187049931,90530418,0.149178349603347,97.7359959571437,0.334137285961052
447.7,448,9301,9298,186020,278940,2024-02-01,2024-02-16,482.88,-3,92920,187049931,90530418,0.149125957175574,97.8851219143192,0.333118233311823
482.54,498,180,180,253260,278280,2024-02-01,2024-05-17,482.88,0,25020,66606452,19312622,0.417797362934149,95.5402909015481,0.0899094437257439
463.27,472,318,318,237546,277614,2024-02-01,2024-06-21,482.88,0,40068.0000000001,413696011,79729983,0.0671057957094974,98.3706698104952,0.144329896907217
429.9,433,895,895,277450,277450,2024-02-01,2024-06-21,482.88,0,0,413696011,79729983,0.0670661530744129,98.4377359635696,0
478.26,497,30,147,49320,275478,2024-02-01,2024-07-19,482.88,117,226158,4933850,1821237,5.58342876252825,19.4324107948154,0.82096573955089
483,493,274,275,170428,275000,2024-02-01,2024-02-23,482.88,1,104572,38550562,1795056,0.713348874135739,91.2829649539221,0.380261818181818
466.56,468,1886,1897,141450,273168,2024-02-01,2024-02-23,482.88,11,131718,38550562,1795056,0.708596673636042,91.9915616275581,0.482186786153576
448.94,450,1359,2566,92412,271996,2024-02-01,2024-03-08,482.88,1207,179584,44041877,11919273,0.617584940805316,94.1934581943454,0.660245003602994
430.26,431,3629,3671,203224,271654,2024-02-01,2024-03-15,482.88,42,68430,452229307,160916150,0.0600699679996635,99.1972888656683,0.251901315644165
470.45,474,667,762,140737,270510,2024-02-01,2024-03-08,482.88,95,129773,44041877,11919273,0.614210879341042,94.8076690736864,0.479734575431592
459.14,460,2688,3142,126336,270212,2024-02-01,2024-02-23,482.88,454,143876,38550562,1795056,0.700928821738059,92.6924904492962,0.532455997513064
470,472,1317,1349,126432,269800,2024-02-01,2024-02-23,482.88,32,143368,38550562,1795056,0.699860095424809,93.392350544721,0.531386212008895
457.67,463,504,506,232344,269698,2024-02-01,2024-05-17,482.88,2,37354,66606452,19312622,0.40491272527172,95.9452036268198,0.13850306639278
464.52,467,843,1081,118020,268088,2024-02-01,2024-03-08,482.88,238,150068,44041877,11919273,0.608711567856202,95.4163806415426,0.559771418340247
423.05,426,906,906,267270,267270,2024-02-01,2024-06-21,482.88,0,0,413696011,79729983,0.0646054090185559,98.5023413725882,0
466.64,478,239,235,212949,266960,2024-02-01,2024-06-21,482.88,-4,54011,413696011,79729983,0.0645304747693108,98.5668718473575,0.202318699430626
458.58,467,387,315,254646,265230,2024-02-01,2024-06-21,482.88,-72,10584,413696011,79729983,0.0641122933138459,98.6309841406714,0.0399049881235154
483.5,510,98,100,199136,265000,2024-02-01,2024-04-19,482.88,2,65864,232702399,73324968,0.113879358845802,98.9873727086071,0.248543396226415
463.34,465,1279,1541,117668,255806,2024-02-01,2024-03-01,482.88,262,138138,50809473,20654916,0.50346123448279,94.3705792815446,0.540010789426362
432.04,435,844,852,186524,252192,2024-02-01,2024-05-17,482.88,8,65668,66606452,19312622,0.378629986176114,96.3238336129959,0.260388910036797
420.41,421,4292,4271,188848,251989,2024-02-01,2024-03-15,482.88,-21,63141,452229307,160916150,0.0557215103266184,99.2530103759949,0.25057046140903
464.07,466,1280,1302,167680,251286,2024-02-01,2024-03-08,482.88,22,83606,44041877,11919273,0.570561513534039,95.9869421550766,0.332712526762334
469.37,472,376,945,53016,248535,2024-02-01,2024-03-01,482.88,569,195519,50809473,20654916,0.489150910894116,94.8597301924387,0.786685979841873
459.42,470,201,230,170448,243340,2024-02-01,2024-07-19,482.88,29,72892,4933850,1821237,4.93205103519564,24.3644618300111,0.299547957590203
461.35,463,1209,1473,137826,243045,2024-02-01,2024-03-08,482.88,264,105219,44041877,11919273,0.551849776974764,96.5387919320514,0.432919829661174
442.72,443,8629,8592,155322,240576,2024-02-01,2024-02-16,482.88,-37,85254,187049931,90530418,0.128615925551985,98.0137378398712,0.354374501197127
474.34,489,124,161,148552,236026,2024-02-01,2024-06-21,482.88,37,87474,413696011,79729983,0.057053003588183,98.6880371442595,0.370611712268987
400.65,401,6718,6717,235130,235095,2024-02-01,2024-03-15,482.88,-1,-35,452229307,160916150,0.0519857948967469,99.3049961708917,-0.000148875986303409
404.78,405,10700,10686,181900,235092,2024-02-01,2024-03-01,482.88,-14,53192,50809473,20654916,0.462693246198401,95.3224234386371,0.226260357647219
149.87,150,18068,18083,252952,235079,2024-02-01,2024-09-20,482.88,15,-17873.0000000001,275196706,45340715,0.0854221707144998,99.1064013680455,-0.0760297602082707
478.33,495,129,141,206271,235047,2024-02-01,2024-07-19,482.88,12,28776,4933850,1821237,4.76396728720979,29.1284291172208,0.122426578514085
229.23,230,3031,3031,221263,233387,2024-02-01,2024-12-20,482.88,0,12124,461752055,55002926,0.0505437923822559,99.6216586410211,0.051948051948052
454.64,463,276,279,219144,233244,2024-02-01,2024-07-19,482.88,3,14100,4933850,1821237,4.72742381710024,33.8558529343211,0.0604517157997633
453.44,454,4156,4154,153772,232624,2024-02-01,2024-02-23,482.88,-2,78852,38550562,1795056,0.603425703625281,93.9957762483463,0.338967604374441
407.53,408,4973,4909,184001,230723,2024-02-01,2024-03-15,482.88,-64,46722,452229307,160916150,0.0510190287158899,99.3560151996076,0.202502568014459
384.34,385,3392,3391,183168,223806,2024-02-01,2024-04-19,482.88,-1,40638,232702399,73324968,0.0961769199465795,99.0835496285537,0.181576901423554
473.84,477.5,360,610,70920,223260,2024-02-01,2024-03-01,482.88,250,152340,50809473,20654916,0.439406250090411,95.7618296887275,0.682343456060199
224.54,225,4752,4849,185328,223054,2024-02-01,2024-09-20,482.88,97,37726,275196706,45340715,0.0810525689940489,99.1874539370395,0.169133931693671
468.48,469,4315,4287,94930,222924,2024-02-01,2024-02-09,482.88,-28,127994,48138698,26427571,0.463086891132785,96.8765773432427,0.574159803341049
449.86,450,15790,15860,157900,222040,2024-02-01,2024-02-09,482.88,70,64140,48138698,26427571,0.461250530706086,97.3378278739487,0.288866870834084
379.39,380,3572,3610,185744,220210,2024-02-01,2024-04-19,482.88,38,34466,232702399,73324968,0.0946315985337134,99.1781812270874,0.156514236410699
446.71,447,7415,7441,140885,215789,2024-02-01,2024-02-16,482.88,26,74904,187049931,90530418,0.115364383641499,98.1291022235127,0.347116859524814
308.88,310,1920,1920,215040,215040,2024-02-01,2024-09-20,482.88,0,0,275196706,45340715,0.0781404701842616,99.2655944072238,0
461.91,464,904,1026,113904,214434,2024-02-01,2024-03-08,482.88,122,100530,44041877,11919273,0.486886605673051,97.0256785377244,0.468815579618904
460.94,462,1163,2011,59313,213166,2024-02-01,2024-02-23,482.88,848,153853,38550562,1795056,0.552951731287342,94.5487279796336,0.721752061773454
388.8,390,1740,1760,167040,211200,2024-02-01,2024-05-17,482.88,20,44160,66606452,19312622,0.317086398777103,96.640920011773,0.209090909090909
459.38,468,310,245,210800,211190,2024-02-01,2024-06-21,482.88,-65,389.999999999971,413696011,79729983,0.0510495616067229,98.7390867058663,0.00184667834651248
463.04,475,176,176,167376,210496,2024-02-01,2024-07-19,482.88,0,43120,4933850,1821237,4.26636399566262,38.1222169299837,0.204849498327759
455.54,465,222,222,169386,210012,2024-02-01,2024-07-19,482.88,0,40626,4933850,1821237,4.25655421222777,42.3787711422115,0.193446088794926
474.68,491,146,127,183084,207264,2024-02-01,2024-06-21,482.88,-19,24180,413696011,79729983,0.0501005555985407,98.7891872614648,0.116662806855025
483.24,550,31,31,183737,206956,2024-02-01,2024-03-15,482.88,0,23219,452229307,160916150,0.0457635090863317,99.4017787086939,0.112192929898143
453.65,459,207,386,85284,206510,2024-02-01,2024-05-17,482.88,179,121226,66606452,19312622,0.310045038880017,96.9509650506531,0.587022420221781
472.74,487,148,144,171532,205344,2024-02-01,2024-06-21,482.88,-4,33812,413696011,79729983,0.0496364466999901,98.8388237081648,0.164660277388188
420.44,425,450,449,190350,204744,2024-02-01,2024-08-16,482.88,-1,14393.9999999999,25910468,4922867,0.790198000283129,93.6111690456537,0.0703024264447307
436.79,437,9718,9696,155488,203616,2024-02-01,2024-02-16,482.88,-22,48128,187049931,90530418,0.108856495648747,98.2379587191615,0.236366493792236
439.6,442,888,841,177600,201840,2024-02-01,2024-04-19,482.88,-47,24240,232702399,73324968,0.0867373954318365,99.2649186225192,0.120095124851367
427.25,428,2678,2678,139256,200850,2024-02-01,2024-03-15,482.88,0,61594,452229307,160916150,0.044413309109133,99.4461920178031,0.306666666666667
457.46,466,234,234,183456,199836,2024-02-01,2024-07-19,482.88,0,16380,4933850,1821237,4.05030554232496,46.4290766845364,0.0819672131147541
481.99,493,41,180,28208,198180,2024-02-01,2024-03-08,482.88,139,169972,44041877,11919273,0.449980821662074,97.4756593593865,0.857664749217883
410.32,413,736,736,170752,197248,2024-02-01,2024-06-21,482.88,0,26496,413696011,79729983,0.0476794541777682,98.8865031623425,0.134328358208955
219.36,220,3081,3081,197184,197184,2024-02-01,2024-12-20,482.88,0,0,461752055,55002926,0.0427034374541116,99.6643620784752,0
466.03,468,335,1000,35510,197000,2024-02-01,2024-03-01,482.88,665,161490,50809473,20654916,0.387722974414633,96.1495526631422,0.819746192893401
343.24,345,1106,1106,194656,194656,2024-02-01,2024-09-20,482.88,0,0,275196706,45340715,0.0707334047813785,99.3363278120052,0
464.41,473,220,225,171600,193275,2024-02-01,2024-06-21,482.88,5,21675,413696011,79729983,0.046719087170507,98.9332222495131,0.112145906092355
476.01,492,113,120,150064,191880,2024-02-01,2024-06-21,482.88,7,41816,413696011,79729983,0.0463818830489038,98.979604132562,0.217927871586408
481.91,492,262,190,144100,191710,2024-02-01,2024-02-23,482.88,-72,47610,38550562,1795056,0.497294955129318,95.0460229347629,0.248343852694174
466.64,476,206,204,171392,190944,2024-02-01,2024-06-21,482.88,-2,19552,413696011,79729983,0.0461556299608603,99.0257597625228,0.10239651416122
294.52,295,3975,3975,190800,190800,2024-02-01,2024-06-21,482.88,0,0,413696011,79729983,0.046120821793469,99.0718805843163,0
189.55,190,4238,4238,190710,190710,2024-02-01,2024-12-20,482.88,0,0,461752055,55002926,0.0413013863035217,99.7056634647787,0
324.75,325,7612,7612,190300,190300,2024-02-01,2024-04-19,482.88,0,0,232702399,73324968,0.0817782716541741,99.3466968941734,0
464.73,466,1319,1494,89692,189738,2024-02-01,2024-02-23,482.88,175,100046,38550562,1795056,0.492179595202788,95.5382025299657,0.527284992990334
464.65,465,5370,5377,91290,188195,2024-02-01,2024-02-09,482.88,7,96905,48138698,26427571,0.390943269799279,97.728771143748,0.514918037142326
433.13,437,486,485,182250,187695,2024-02-01,2024-06-21,482.88,-1,5445,413696011,79729983,0.0453702706840942,99.1172508550004,0.0290098297770319
481.71,493,129,164,84108,185156,2024-02-01,2024-03-01,482.88,35,101048,50809473,20654916,0.364412360663532,96.5139650238057,0.545745209445009
463.73,474,168,179,141960,183833,2024-02-01,2024-06-21,482.88,11,41873,413696011,79729983,0.0444367349725303,99.1616875899729,0.22777738490913
420.76,425,35,431,13300,182744,2024-02-01,2024-07-19,482.88,396,169444,4933850,1821237,3.70388236367137,50.1329590482078,0.927220592741759
473.38,478,183,394,46665,182028,2024-02-01,2024-03-08,482.88,211,135363,44041877,11919273,0.413306635409749,97.8889659947963,0.743638341354077
447.84,454,288,295,139104,181720,2024-02-01,2024-06-21,482.88,7,42616,413696011,79729983,0.04392597346074,99.2056135634337,0.234514637904468
466.7,478,0,160,0,180800,2024-02-01,2024-07-19,482.88,160,180800,4933850,1821237,3.66448108475126,53.7974401329591,1
469.81,478,216,216,151416,176904,2024-02-01,2024-05-17,482.88,0,25488,66606452,19312622,0.26559589152114,97.2165609421742,0.144078144078144
459.38,466,265,267,130645,176754,2024-02-01,2024-05-17,482.88,2,46109,66606452,19312622,0.265370688112917,97.4819316302871,0.260865383527388
441.85,444,820,820,153340,176300,2024-02-01,2024-04-19,482.88,0,22960,232702399,73324968,0.0757620036396789,99.4224588978131,0.130232558139535
439.62,440,4581,4624,109944,175712,2024-02-01,2024-02-23,482.88,43,65768,38550562,1795056,0.45579620862596,95.9939987385917,0.374294299763249
415.32,418,647,647,197335,173396,2024-02-01,2024-06-21,482.88,0,-23939,413696011,79729983,0.0419138680068153,99.2475274314405,-0.138059701492537
470.3,471,2220,2453,57720,171710,2024-02-01,2024-02-09,482.88,233,113990,48138698,26427571,0.356698471570627,98.0854696153186,0.663851843224041
473.7,486,207,139,191475,170970,2024-02-01,2024-05-17,482.88,-68,-20505,66606452,19312622,0.256686844691863,97.738618474979,-0.119933321635375
329.88,330,14244,14243,156684,170916,2024-02-01,2024-03-15,482.88,-1,14232,452229307,160916150,0.0377941007702095,99.4839861185733,0.0832689742329565
482.78,491,135,207,80190,170154,2024-02-01,2024-03-08,482.88,72,89964,44041877,11919273,0.386345931623214,98.2753119264195,0.528721040939384
487.23,525,45,45,171990,169965,2024-02-01,2024-06-21,482.88,0,-2025,413696011,79729983,0.0410845150740407,99.2886119465145,-0.0119142176330421
484.54,501,1998,103,2253744,169538,2024-02-01,2024-03-01,482.88,-1895,-2084206,50809473,20654916,0.333673998153848,96.8476390219596,-12.2934445375078
309.44,310,3009,3020,144432,169120,2024-02-01,2024-06-21,482.88,11,24688,413696011,79729983,0.0408802588140015,99.3294922053285,0.145979186376538
467.14,479,128,142,133760,168412,2024-02-01,2024-07-19,482.88,14,34652,4933850,1821237,3.4133992723735,57.2108394053326,0.205757309455383
430.83,431,9873,9820,148095,166940,2024-02-01,2024-02-16,482.88,-53,18845,187049931,90530418,0.0892488968627313,98.3272076160242,0.112884868815143
444.56,445,3769,3774,105532,166056,2024-02-01,2024-02-23,482.88,5,60524,38550562,1795056,0.430748584158125,96.4247473227498,0.364479452714747
437.76,438,6849,6869,109584,164856,2024-02-01,2024-02-16,482.88,20,55272,187049931,90530418,0.0881347558476245,98.4153423718718,0.335274421313146
447.76,451,506,506,163944,163944,2024-02-01,2024-05-17,482.88,0,0,66606452,19312622,0.246138317050727,97.9847567920297,0
469.76,486,52,100,72592,162400,2024-02-01,2024-08-16,482.88,48,89808,25910468,4922867,0.626773703971692,94.2379427496254,0.553004926108374
314.5,315,3232,3232,161600,161600,2024-02-01,2024-06-21,482.88,0,0,413696011,79729983,0.0390624989613448,99.3685547042899,0
484,497,123,124,144894,161200,2024-02-01,2024-04-19,482.88,1,16306,232702399,73324968,0.0692730288526162,99.4917319266657,0.101153846153846
418.43,419,2828,2821,121604,160797,2024-02-01,2024-03-15,482.88,-7,39193,452229307,160916150,0.0355565191178554,99.5195426376911,0.243742109616473
464.96,465,39882,39850,159528,159400,2024-02-01,2024-02-02,482.88,-32,-128,59097355,35805173,0.269724423368863,97.2424366538909,-0.000803011292346299
129.83,130,9271,9323,139065,158491,2024-02-01,2024-12-20,482.88,52,19426,461752055,55002926,0.0343238320834327,99.7399872968622,0.122568473919655
427.58,431,452,459,134696,156978,2024-02-01,2024-06-21,482.88,7,22282,413696011,79729983,0.0379452534774381,99.4064999577673,0.141943457044936
438.74,441,588,693,99960,156618,2024-02-01,2024-04-19,482.88,105,56658,232702399,73324968,0.0673039902781578,99.5590359169439,0.361759184768034
429.98,430,78171,78166,156342,156332,2024-02-01,2024-02-02,482.88,-5,-10,59097355,35805173,0.264532989674411,97.5069696435653,-6.3966430417317e-05
359.81,360,8119,8148,121785,154812,2024-02-01,2024-03-15,482.88,29,33027,452229307,160916150,0.034233075478233,99.5537757131694,0.213336175490272
379.92,380,19509,19301,97545,154408,2024-02-01,2024-02-16,482.88,-208,56863,187049931,90530418,0.0825490815070122,98.4978914533788,0.368264597689239
422.4,423,2493,2567,114678,154020,2024-02-01,2024-03-15,482.88,74,39342,452229307,160916150,0.0340579430868243,99.5878336562562,0.255434359174133
443.76,444,6389,6387,115002,153288,2024-02-01,2024-02-16,482.88,-2,38286,187049931,90530418,0.0819503109038837,98.5798417642827,0.249765147956787
289.64,290,4255,4255,153180,153180,2024-02-01,2024-06-21,482.88,0,0,413696011,79729983,0.0370271880624926,99.4435271458298,0
461.45,462.5,1216,1446,65664,151830,2024-02-01,2024-02-23,482.88,230,86166,38550562,1795056,0.393846398400106,96.8185937211499,0.56751630112626
471.29,490,79,81,119053,151551,2024-02-01,2024-08-16,482.88,2,32498,25910468,4922867,0.58490259612447,94.8228453457499,0.214436064427157
487.72,515,55,55,150040,150040,2024-02-01,2024-08-16,482.88,0,0,25910468,4922867,0.57907097625562,95.4019163220055,0
399.85,400,9991,9991,109901,149865,2024-02-01,2024-02-23,482.88,0,39964,38550562,1795056,0.388749196444918,97.2073429175948,0.266666666666667
414.99,415,149312,149382,149312,149382,2024-02-01,2024-02-02,482.88,70,70,59097355,35805173,0.252772734075831,97.7597423776411,0.00046859728749113
485.92,525,38,38,143146,148504,2024-02-01,2024-12-20,482.88,0,5358,461752055,55002926,0.0321609830193392,99.7721482798815,0.0360798362333675
259.72,260,5222,5230,135772,146440,2024-02-01,2024-06-21,482.88,8,10668,413696011,79729983,0.0353979724498721,99.4789251182797,0.072848948374761
414.5,417,585,585,146250,146250,2024-02-01,2024-06-21,482.88,0,0,413696011,79729983,0.0353520450067864,99.5142771632865,0
484.63,530,22,32,90376,145184,2024-02-01,2024-12-20,482.88,10,54808,461752055,55002926,0.0314419824292931,99.8035902623108,0.377507163323782
359.3,360,2072,2073,124320,145110,2024-02-01,2024-05-17,482.88,1,20790,66606452,19312622,0.217861777114325,98.202618569144,0.143270622286541
299.92,300,18548,18137,111288,145096,2024-02-01,2024-03-15,482.88,-411,33808,452229307,160916150,0.0320846079088811,99.6199182641651,0.233004355736892
409.86,410,10265,10237,92385,143318,2024-02-01,2024-02-16,482.88,-28,50933,187049931,90530418,0.0766201833028209,98.6564619475855,0.355384529507808
470.12,473,484,493,75988,141984,2024-02-01,2024-03-01,482.88,9,65996,50809473,20654916,0.279443953295875,97.1270829752554,0.46481293666892
304.5,305,2828,2836,124432,141800,2024-02-01,2024-06-21,482.88,8,17368,413696011,79729983,0.0342763759450414,99.5485535392315,0.122482369534556
411.88,412,11745,11745,117450,140940,2024-02-01,2024-02-16,482.88,0,23490,187049931,90530418,0.0753488650043929,98.7318108125899,0.166666666666667
328.47,330,910,913,126490,139689,2024-02-01,2024-09-20,482.88,3,13199,275196706,45340715,0.050759691869277,99.3870875038744,0.0944884708173157
473.81,474,9943,7200,89487,136800,2024-02-01,2024-02-02,482.88,-2743,47313,59097355,35805173,0.231482441134633,97.9912248187757,0.345855263157895
485.53,499,100,101,108000,136047,2024-02-01,2024-03-15,482.88,1,28047,452229307,160916150,0.0300836318863342,99.6500018960514,0.206156695847758
466.69,480,69,102,73830,135762,2024-02-01,2024-07-19,482.88,33,61932,4933850,1821237,2.75164425347345,59.962483658806,0.456180669112123
483.4,520,37,37,106523,135420,2024-02-01,2024-04-19,482.88,0,28897,232702399,73324968,0.0581945010373529,99.6172304179812,0.213387978142076
319.89,320,12183,12183,109647,134013,2024-02-01,2024-03-15,482.88,0,24366,452229307,160916150,0.0296338600629437,99.6796357561143,0.181818181818182
465.11,467,610,707,61610,133623,2024-02-01,2024-03-01,482.88,97,72013,50809473,20654916,0.262988360457901,97.3900713357133,0.538926681783825
274.66,275,3889,3889,120559,132226,2024-02-01,2024-06-21,482.88,0,11667,413696011,79729983,0.0319621162602895,99.5805156554918,0.0882352941176472
434.45,440,238,238,132090,132090,2024-02-01,2024-08-16,482.88,0,0,25910468,4922867,0.509793956635596,95.911710278641,0
454.82,455,7339,7336,95407,132048,2024-02-01,2024-02-09,482.88,-3,36641,48138698,26427571,0.274307377403518,98.3597769927221,0.277482430631286
423.37,424,2097,2080,96462,131040,2024-02-01,2024-03-15,482.88,-17,34578,452229307,160916150,0.0289764502148907,99.7086122063292,0.263873626373626
239.1,240,1440,1455,110880,130950,2024-02-01,2024-12-20,482.88,15,20070,461752055,55002926,0.0283593756826919,99.8319496379935,0.153264604810997
344.85,345,8645,8705,112385,130575,2024-02-01,2024-03-15,482.88,60,18190,452229307,160916150,0.0288736262729651,99.7374858326022,0.13930691173655
452.1,459,164,188,99712,129720,2024-02-01,2024-06-21,482.88,24,30008,413696011,79729983,0.0313563574583271,99.6118720129501,0.231329016342892
466.37,469,461,493,70072,129659,2024-02-01,2024-03-08,482.88,32,59587,44041877,11919273,0.294399350872353,98.5697112772919,0.459567018101327
472.8,490,56,75,76552,129000,2024-02-01,2024-07-19,482.88,19,52448,4933850,1821237,2.61459103945195,62.577074698258,0.406573643410853
480.1,489,140,142,73640,126380,2024-02-01,2024-03-08,482.88,2,52740,44041877,11919273,0.286954164101589,98.8566654413934,0.417312865959804
486.5,497,120,120,92400,126000,2024-02-01,2024-02-16,482.88,0,33600,187049931,90530418,0.0673616928519476,98.7991725054419,0.266666666666667
219.6,220,3101,3133,111636,125320,2024-02-01,2024-09-20,482.88,32,13684,275196706,45340715,0.0455383357677254,99.4326258396421,0.109192467283754
483.7,497,94,94,77362,125020,2024-02-01,2024-02-23,482.88,0,47658,38550562,1795056,0.324301368161637,97.5316442857565,0.381203007518797
214.63,215,3337,3362,113458,124394,2024-02-01,2024-09-20,482.88,25,10936,275196706,45340715,0.0452018491820175,99.4778276888242,0.0879142080807755
485.94,508,56,56,123536,123536,2024-02-01,2024-07-19,482.88,0,0,4933850,1821237,2.50384588100571,65.0809205792637,0
454.32,455,1801,1807,70239,122876,2024-02-01,2024-02-23,482.88,6,52637,38550562,1795056,0.318739840939284,97.8503841266958,0.428374947101143
440.74,441,4740,4709,80580,122434,2024-02-01,2024-02-16,482.88,-31,41854,187049931,90530418,0.0654552500209155,98.8646277554628,0.341849486253818
279.65,280,3472,3472,107632,121520,2024-02-01,2024-06-21,482.88,0,13888,413696011,79729983,0.0293742257041004,99.6412462386542,0.114285714285714
483.7,525,0,29,0,119770,2024-02-01,2024-03-01,482.88,29,119770,50809473,20654916,0.235723759622541,97.6257950953359,1
364.94,365,19680,19894,78720,119364,2024-02-01,2024-02-16,482.88,214,40644,187049931,90530418,0.0638139770284117,98.9284417324912,0.340504674776314
484.06,505,57,57,115710,119358,2024-02-01,2024-07-19,482.88,0,3648,4933850,1821237,2.41916556036361,67.5000861396273,0.0305635148042025
413.32,415,696,700,100920,117600,2024-02-01,2024-05-17,482.88,4,16680,66606452,19312622,0.176559472046342,98.3791780411904,0.141836734693878
482.74,501,62,64,71548,116864,2024-02-01,2024-03-08,482.88,2,45316,44041877,11919273,0.265347455559172,99.1220128969526,0.387766976998905
219.87,220,8961,8961,116493,116493,2024-02-01,2024-06-21,482.88,0,0,413696011,79729983,0.0281590822494056,99.6694053209036,0
429.92,435,203,228,85869,115824,2024-02-01,2024-07-19,482.88,25,29955,4933850,1821237,2.34753792677118,69.8476240663985,0.258625155408206
469.93,470,15913,16387,79565,114709,2024-02-01,2024-02-02,482.88,474,35144,59097355,35805173,0.194101749562227,98.185326568338,0.306375262621067
406.75,410,301,352,80668,114400,2024-02-01,2024-07-19,482.88,51,33732,4933850,1821237,2.31867608459925,72.1663001509977,0.29486013986014
470.84,489,75,62,112050,112592,2024-02-01,2024-08-16,482.88,-13,542,25910468,4922867,0.434542517719093,96.3462527963602,0.00481384112547961
452.2,457,231,232,89628,111360,2024-02-01,2024-05-17,482.88,1,21732,66606452,19312622,0.167191010264291,98.5463690514547,0.195150862068965
403.52,405,604,746,73084,110408,2024-02-01,2024-05-17,482.88,142,37324,66606452,19312622,0.165761719300106,98.7121307707548,0.338055213390334
443.87,450,184,180,101752,110340,2024-02-01,2024-07-19,482.88,-4,8588,4933850,1821237,2.23638740537309,74.4026875563708,0.0778321551567881
459.77,460,4657,4796,65198,110308,2024-02-01,2024-02-09,482.88,139,45110,48138698,26427571,0.229146205823847,98.588923198546,0.408945860681002
323.71,325,847,847,109263,109263,2024-02-01,2024-09-20,482.88,0,0,275196706,45340715,0.0397036002313196,99.5175312890555,0
428.84,429,6840,6825,95760,109200,2024-02-01,2024-02-16,482.88,-15,13440,187049931,90530418,0.0583801338050213,98.9868218662962,0.123076923076923
478.02,493,76,71,101232,106358,2024-02-01,2024-06-21,482.88,-5,5126,413696011,79729983,0.0257092157458584,99.6951145366495,0.0481957163542
483.07,495,88,88,64768,104984,2024-02-01,2024-02-23,482.88,0,40216,38550562,1795056,0.27232806619006,98.1227121928858,0.383067896060352
469.89,472.5,311,401,43851,104661,2024-02-01,2024-03-01,482.88,90,60810,50809473,20654916,0.205987178808172,97.831782274144,0.581018717573881
440.54,443,73,422,13286,103812,2024-02-01,2024-04-19,482.88,349,90526,232702399,73324968,0.0446114867943411,99.6618419047756,0.872018649096444
318.62,320,765,748,96390,103224,2024-02-01,2024-09-20,482.88,-17,6834,275196706,45340715,0.0375091698953693,99.5550404589508,0.066205533596838
349.6,350,2564,2572,82048,102880,2024-02-01,2024-04-19,482.88,8,20832,232702399,73324968,0.0442109752379476,99.7060528800135,0.20248833592535
149.75,150,4115,4115,102875,102875,2024-02-01,2024-12-20,482.88,0,0,461752055,55002926,0.0222792728015038,99.854228910795,0
426.84,427,6445,6410,90230,102560,2024-02-01,2024-02-16,482.88,-35,12330,187049931,90530418,0.0548302795150456,99.0416521458113,0.120222308892356
411.55,414,416,416,101920,101920,2024-02-01,2024-06-21,482.88,0,0,413696011,79729983,0.0246364473647294,99.7197509840142,0
407.89,408,9221,9244,82989,101684,2024-02-01,2024-02-16,482.88,23,18695,187049931,90530418,0.0543619553647416,99.096014101176,0.183853900318634
396.58,400,231,297,64911,101574,2024-02-01,2024-08-16,482.88,66,36663,25910468,4922867,0.392019163837566,96.7382719601977,0.360948667966212
475.93,491,63,67,88767,100969,2024-02-01,2024-07-19,482.88,4,12202,4933850,1821237,2.04645459428236,76.4491421506532,0.120848973447296
411.53,412,2109,2103,78033,98841,2024-02-01,2024-03-15,482.88,-6,20808,452229307,160916150,0.0218563897717491,99.7593422223739,0.210519925941664
304.69,305,3178,3178,98518,98518,2024-02-01,2024-05-17,482.88,0,0,66606452,19312622,0.147910595808346,98.8600413665631,0
471.87,485,66,75,79794,98475,2024-02-01,2024-07-19,482.88,9,18681,4933850,1821237,1.99590583418629,78.4450479848394,0.18970297029703
482.39,495,69,78,50508,98358,2024-02-01,2024-03-01,482.88,9,47850,50809473,20654916,0.19358201176383,98.0253642859079,0.48648813517965
465.16,471,168,168,98112,98112,2024-02-01,2024-05-17,482.88,0,0,66606452,19312622,0.147301045250091,99.0073424118132,0
234.82,235,5446,5446,98028,98028,2024-02-01,2024-06-21,482.88,0,0,413696011,79729983,0.0236956599516257,99.7434466439658,0
483.19,540,12,16,58932,90896,2024-02-01,2024-09-20,482.88,4,31964,275196706,45340715,0.0330294651128564,99.5880699240637,0.351654638267911
416.47,417,1675,1672,70350,88616,2024-02-01,2024-03-15,482.88,-3,18266,452229307,160916150,0.0195953686831712,99.7789375910571,0.206125304685384
472.4,487,50,60,63600,87600,2024-02-01,2024-07-19,482.88,10,24000,4933850,1821237,1.77548972911621,80.2205377139556,0.273972602739726
449.48,450,1695,1681,54240,87412,2024-02-01,2024-02-23,482.88,-14,33172,38550562,1795056,0.226746370130739,98.3494585630165,0.379490230174347
425.33,430,154,185,63294,86395,2024-02-01,2024-07-19,482.88,31,23101,4933850,1821237,1.75106661126706,81.9716043252227,0.267388159036981
448.69,453,196,195,69776,84045,2024-02-01,2024-05-17,482.88,-1,14269,66606452,19312622,0.126181469626996,99.1335238814402,0.169778095068118
457.75,459,743,672,53496,84000,2024-02-01,2024-03-01,482.88,-71,30504,50809473,20654916,0.165323501780859,98.1906877876887,0.363142857142857
465.09,480,52,56,63284,83496,2024-02-01,2024-08-16,482.88,4,20212,25910468,4922867,0.322248135386825,97.0605200955846,0.242071476477915
244.16,245,992,992,83328,83328,2024-02-01,2024-12-20,482.88,0,0,461752055,55002926,0.018046048544386,99.8722749593394,0
224.3,225,1182,1182,82740,82740,2024-02-01,2024-12-20,482.88,0,0,461752055,55002926,0.0179187074760285,99.8901936668154,0
413.76,416,368,368,82432,82432,2024-02-01,2024-06-21,482.88,0,0,413696011,79729983,0.0199257420444405,99.7633723860103,0
455.27,461,141,143,61194,81939,2024-02-01,2024-05-17,482.88,2,20745,66606452,19312622,0.123019613775554,99.2565434952158,0.2531761432285
477.75,494,49,50,75362,81250,2024-02-01,2024-07-19,482.88,1,5888,4933850,1821237,1.64678699190288,83.6183913171256,0.0724676923076923
478.71,487,56,98,27440,81242,2024-02-01,2024-03-08,482.88,42,53802,44041877,11919273,0.184465344199567,99.3064782411522,0.662243667068758
289.16,290,962,962,80808,80808,2024-02-01,2024-09-20,482.88,0,0,275196706,45340715,0.0293637235614295,99.6174336476251,0
477.21,493,29,51,43645,80529,2024-02-01,2024-07-19,482.88,22,36884,4933850,1821237,1.63217365748857,85.2505649746142,0.458021333929392
403.91,404,8927,8927,80343,80343,2024-02-01,2024-02-16,482.88,0,0,187049931,90530418,0.0429527022920955,99.1389668034681,0
214.86,215,5736,5736,74568,80304,2024-02-01,2024-06-21,482.88,0,5736.00000000002,413696011,79729983,0.0194113546818802,99.7827837406922,0.0714285714285716
431.79,432,3831,3803,53634,79863,2024-02-01,2024-02-16,482.88,-28,26229,187049931,90530418,0.0426960863193262,99.1816628897874,0.328424927688667
479.5,487.5,50,99,23450,79200,2024-02-01,2024-03-08,482.88,49,55750,44041877,11919273,0.179828847894017,99.4863070890462,0.703914141414141
354.82,355,4387,4394,65805,79092,2024-02-01,2024-03-15,482.88,7,13287,452229307,160916150,0.0174893574511304,99.7964269485082,0.167994234562282
359.96,360,19632,19641,78528,78564,2024-02-01,2024-02-16,482.88,9,36,187049931,90530418,0.0420016193430192,99.2236645091305,0.000458225141286085
447.4,455,102,103,62424,78280,2024-02-01,2024-07-19,482.88,1,15856,4933850,1821237,1.5865905935527,86.8371555681669,0.202554931016863
303.97,305,757,757,77971,77971,2024-02-01,2024-09-20,482.88,0,0,275196706,45340715,0.0283328245942014,99.6457664722193,0
453.79,461,81,108,45765,77868,2024-02-01,2024-06-21,482.88,27,32103,413696011,79729983,0.0188225165168441,99.801606257209,0.412274618585298
284.17,285,937,937,77771,77771,2024-02-01,2024-09-20,482.88,0,0,275196706,45340715,0.0282601493057115,99.6740266215251,0
435.11,440,126,159,56952,77751,2024-02-01,2024-07-19,482.88,33,20799,4933850,1821237,1.57586874347619,88.4130243116431,0.267507813404329
174.78,175,3530,3530,77660,77660,2024-02-01,2024-09-20,482.88,0,0,275196706,45340715,0.0282198145205997,99.7022464360457,0
483.72,504,126,38,167706,77064,2024-02-01,2024-02-16,482.88,-88,-90642,187049931,90530418,0.041199694428115,99.2648642035586,-1.17619121768919
427.82,428,4279,4273,72743,76914,2024-02-01,2024-02-16,482.88,-6,4171,187049931,90530418,0.0411195019366246,99.3059837054952,0.0542293990690902
472.4,472.5,8020,7678,64160,76780,2024-02-01,2024-02-02,482.88,-342,12620,59097355,35805173,0.12992121220992,98.3152477805479,0.164365720239646
399.99,400,76384,76554,76384,76554,2024-02-01,2024-02-02,482.88,170,170,59097355,35805173,0.129538792387578,98.4447865729355,0.00222065470125663
456,457,419,763,26816,76300,2024-02-01,2024-03-01,482.88,344,49484,50809473,20654916,0.150168847450947,98.3408566351397,0.648545216251638
329.72,330,2705,2705,67625,75740,2024-02-01,2024-04-19,482.88,0,8115.00000000001,232702399,73324968,0.032548009958419,99.7386008899719,0.107142857142857
439.47,440,1126,1383,40536,73299,2024-02-01,2024-03-01,482.88,257,32763,50809473,20654916,0.144262468536133,98.4851191036758,0.446977448532722
364.54,365,1268,1589,51988,73094,2024-02-01,2024-04-19,482.88,321,21106,232702399,73324968,0.0314109353036794,99.7700118252756,0.28875147070895
421.86,422,5143,5143,66859,72002,2024-02-01,2024-02-16,482.88,0,5143.00000000002,187049931,90530418,0.0384934651486185,99.3444771706438,0.0714285714285716
249.78,250,3198,3268,70356,71896,2024-02-01,2024-06-21,482.88,70,1540,413696011,79729983,0.0173789444636439,99.8189852016726,0.0214198286413709
403.58,404,1799,1704,70161,71568,2024-02-01,2024-03-15,482.88,-95,1407,452229307,160916150,0.015825599732748,99.812252548241,0.0196596244131455
461.75,462,2807,2837,42105,70925,2024-02-01,2024-02-09,482.88,30,28820,48138698,26427571,0.14733468694978,98.7362578854958,0.40634473034896
460.58,462,309,496,24411,70432,2024-02-01,2024-03-01,482.88,187,46021,50809473,20654916,0.138619819969398,98.6237389236452,0.653410381644707
482.47,505,31,31,69843,69843,2024-02-01,2024-09-20,482.88,0,0,275196706,45340715,0.0253793008699748,99.7276257369156,0
234.16,235,820,825,64780,69300,2024-02-01,2024-12-20,482.88,5,4519.99999999999,461752055,55002926,0.0150080544849985,99.9052017213004,0.0652236652236651
474.27,492,22,39,32428,69147,2024-02-01,2024-07-19,482.88,17,36719,4933850,1821237,1.40148160158902,89.8145059132321,0.531028099556018
334.69,335,2230,2230,60210,69130,2024-02-01,2024-04-19,482.88,0,8920,232702399,73324968,0.0297074719887181,99.7997192972643,0.129032258064516
329.58,330,1642,1642,65680,68964,2024-02-01,2024-05-17,482.88,0,3284,66606452,19312622,0.103539518964319,99.3600830141801,0.0476190476190476
482.75,496,42,52,29610,68900,2024-02-01,2024-02-16,482.88,10,39290,187049931,90530418,0.0368350844245968,99.3813122550684,0.570246734397678
410.81,415,83,162,30129,67878,2024-02-01,2024-08-16,482.88,79,37749,25910468,4922867,0.261971339151419,97.322491434736,0.556130115795987
179.91,180,5975,7469,41825,67221,2024-02-01,2024-06-21,482.88,1494,25396,413696011,79729983,0.01624888764035,99.835234089313,0.377798604602728
466.1,467.5,604,478,42280,66920,2024-02-01,2024-02-23,482.88,-126,24640,38550562,1795056,0.17359020602605,98.5230487690426,0.368200836820084
425.85,426,4455,4449,57915,66735,2024-02-01,2024-02-16,482.88,-6,8820,187049931,90530418,0.0356776394640851,99.4169898945325,0.132164531355361
304.93,305,9530,9530,66710,66710,2024-02-01,2024-03-15,482.88,0,0,452229307,160916150,0.014751365948072,99.8270039141891,0
429.72,430,2369,2375,45011,66500,2024-02-01,2024-02-23,482.88,6,21489,38550562,1795056,0.172500727745551,98.6955494967881,0.323142857142857
488.4,520,21,21,66360,66360,2024-02-01,2024-09-20,482.88,0,0,275196706,45340715,0.0241136607209245,99.7517393976366,0
456.12,465,74,74,65712,65712,2024-02-01,2024-08-16,482.88,0,0,25910468,4922867,0.253611783469137,97.5761032182051,0
279.2,280,819,819,65520,65520,2024-02-01,2024-09-20,482.88,0,0,275196706,45340715,0.0238084245092672,99.7755478221458,0
229.94,230,10557,10813,63342,64878,2024-02-01,2024-04-19,482.88,256,1536.00000000001,232702399,73324968,0.02788024544603,99.8275995427104,0.0236752057708315
294.06,295,676,676,63544,63544,2024-02-01,2024-09-20,482.88,0,0,275196706,45340715,0.0230903926589877,99.7986382148048,0
478.05,499,0,30,0,62850,2024-02-01,2024-08-16,482.88,30,62850,25910468,4922867,0.242566054769833,97.8186692729749,1
417.44,418,1085,1121,45570,62776,2024-02-01,2024-03-15,482.88,36,17206,452229307,160916150,0.0138814532867062,99.8408853674758,0.274085637823372
199.88,200,5225,5230,57475,62760,2024-02-01,2024-06-21,482.88,5,5285,413696011,79729983,0.0151705596213738,99.8504046489344,0.0842096876991715
412.5,413,1230,1253,46740,62650,2024-02-01,2024-03-15,482.88,23,15910,452229307,160916150,0.0138535913153457,99.8547389587911,0.253950518754988
472.1,488,32,39,41824,62010,2024-02-01,2024-07-19,482.88,7,20186,4933850,1821237,1.25682783222027,91.0713337454523,0.32552814062248
253.95,255,604,589,57984,61845,2024-02-01,2024-12-20,482.88,-15,3861.00000000001,461752055,55002926,0.0133935516540365,99.9185952729544,0.0624302692214408
412.9,413,6093,6093,60930,60930,2024-02-01,2024-02-16,482.88,0,0,187049931,90530418,0.0325741900434061,99.4495640845759,0
454.02,455,653,621,37874,60858,2024-02-01,2024-03-01,482.88,-32,22984,50809473,20654916,0.119776877040232,98.7435158006854,0.377666042262316
274.27,275,816,816,59568,59568,2024-02-01,2024-09-20,482.88,0,0,275196706,45340715,0.02164560792381,99.8202838227286,0
229.54,230,1217,1294,49897,59524,2024-02-01,2024-09-20,482.88,77,9627,275196706,45340715,0.0216296193603422,99.841913442089,0.161733082454136
239.8,240,1997,2968,39940,59360,2024-02-01,2024-06-21,482.88,971,19420,413696011,79729983,0.0143487001135237,99.8647533490479,0.327156334231806
444.34,445,723,868,28920,57288,2024-02-01,2024-03-01,482.88,145,28368,50809473,20654916,0.112750628214546,98.8562664289,0.495182237117721
264.72,265,1980,1980,55440,55440,2024-02-01,2024-06-21,482.88,0,0,413696011,79729983,0.0134011444456495,99.8781544934936,0
284.95,285,11071,11055,55355,55275,2024-02-01,2024-03-15,482.88,-16,-80.0000000000073,452229307,160916150,0.0122227814837308,99.8669617402748,-0.00144730890999561
423.84,424,3434,3436,48076,54976,2024-02-01,2024-02-16,482.88,2,6899.99999999999,187049931,90530418,0.0293910827478466,99.4789551673238,0.125509313154831
472.87,473,4397,4206,35176,54678,2024-02-01,2024-02-02,482.88,-191,19502,59097355,35805173,0.0925219072833293,98.5373084802188,0.356669958667106
462.73,463,2080,2023,33280,54621,2024-02-01,2024-02-09,482.88,-57,21341,48138698,26427571,0.113465885595826,98.8497237710916,0.390710532579045
454.98,456,345,530,21390,54060,2024-02-01,2024-03-01,482.88,185,32670,50809473,20654916,0.106397482217538,98.9626639111175,0.604328523862375
483.55,495,469,47,260295,53815,2024-02-01,2024-02-02,482.88,-422,-206480,59097355,35805173,0.0910616050413762,98.6283700852602,-3.83684846232463
486.97,501,37,38,44992,53314,2024-02-01,2024-03-15,482.88,1,8322,452229307,160916150,0.0117891519135888,99.8787508921884,0.156094084105488
468.62,483,18,37,22050,53206,2024-02-01,2024-07-19,482.88,19,31156,4933850,1821237,1.07838706081458,92.1497208062669,0.585573055670413
491.1,550,9,9,53010,53010,2024-02-01,2024-12-20,482.88,0,0,461752055,55002926,0.0114801871320313,99.9300754600865,0
486.18,499,38,41,38304,52562,2024-02-01,2024-02-23,482.88,3,14258,38550562,1795056,0.136345612808446,98.8318951095966,0.271260606521822
269.7,270,1752,1752,52560,52560,2024-02-01,2024-06-21,482.88,0,0,413696011,79729983,0.0127049810978235,99.8908594745914,0
374.94,375,8748,8746,52488,52476,2024-02-01,2024-02-16,482.88,-2,-12,187049931,90530418,0.0280545412230064,99.5070097085468,-0.000228675966155957
451.18,452,456,639,23256,52398,2024-02-01,2024-03-01,482.88,183,29142,50809473,20654916,0.103126438646589,99.0657903497641,0.556166265888011
434.91,435,5723,5818,45784,52362,2024-02-01,2024-02-09,482.88,95,6578,48138698,26427571,0.108773195319907,98.9584969664115,0.125625453573202
480.73,500,27,27,52029,52029,2024-02-01,2024-08-16,482.88,0,0,25910468,4922867,0.20080301135433,98.0194722843293,0
154.82,155,2876,2876,51768,51768,2024-02-01,2024-09-20,482.88,0,0,275196706,45340715,0.0188112716727067,99.8607247137617,0
269.96,270,12875,12876,51500,51504,2024-02-01,2024-03-15,482.88,1,4,452229307,160916150,0.0113889124837281,99.8901398046721,7.7663870767319e-05
483.59,505,24,24,51384,51384,2024-02-01,2024-08-16,482.88,0,0,25910468,4922867,0.198313669980797,98.2177859543101,0
456.82,458,415,433,27805,51094,2024-02-01,2024-03-01,482.88,18,23289,50809473,20654916,0.100559988095133,99.1663503378592,0.455806944063882
294.95,295,10187,10187,50935,50935,2024-02-01,2024-03-15,482.88,0,0,452229307,160916150,0.0112630913590923,99.9014028960313,0
309.69,310,1637,1637,50747,50747,2024-02-01,2024-05-17,482.88,0,0,66606452,19312622,0.076189315713739,99.4362723298938,0
429.61,430,1294,1295,36232,50505,2024-02-01,2024-03-01,482.88,1,14273,50809473,20654916,0.0994007554457414,99.265751093305,0.282605682605682
413.89,414,4431,4581,62034,50391,2024-02-01,2024-02-16,482.88,150,-11643,187049931,90530418,0.0269398655912896,99.5339495741381,-0.231053164255522
401.62,402,1264,1313,48032,49894,2024-02-01,2024-03-15,482.88,49,1862,452229307,160916150,0.0110328984052332,99.9124357944365,0.0373191165270373
471.91,472,4937,5507,29622,49563,2024-02-01,2024-02-02,482.88,570,19941,59097355,35805173,0.0838666975873963,98.7122367828476,0.40233642031354
415.88,416,4227,4097,46497,49164,2024-02-01,2024-02-16,482.88,-130,2667,187049931,90530418,0.0262838910108981,99.560233465149,0.0542470100073224
486.45,496,51,51,39015,48705,2024-02-01,2024-02-23,482.88,0,9690,38550562,1795056,0.126340570599204,98.9582356801958,0.198952879581152
239.97,240,16113,16113,48339,48339,2024-02-01,2024-03-15,482.88,0,0,452229307,160916150,0.0106890462983639,99.9231248407349,0
269.31,270,694,694,47886,47886,2024-02-01,2024-09-20,482.88,0,0,275196706,45340715,0.0174006443231192,99.8781253580848,0
470.92,471,6169,5983,37014,47864,2024-02-01,2024-02-02,482.88,-186,10850,59097355,35805173,0.0809917804273981,98.793228563275,0.226683937823834
463.71,464,1672,1641,25080,47589,2024-02-01,2024-02-09,482.88,-31,22509,48138698,26427571,0.0988580954142133,99.0573550618257,0.472987455084158
483.36,720,2,2,45826,47328,2024-02-01,2024-12-20,482.88,0,1502,461752055,55002926,0.0102496566041271,99.9403251166906,0.031735970250169
429.45,430,858,858,33462,47190,2024-02-01,2024-03-08,482.88,0,13728,44041877,11919273,0.107148021870185,99.5934551109164,0.290909090909091
449.96,450,11819,11783,35457,47132,2024-02-01,2024-02-02,482.88,-36,11675,59097355,35805173,0.0797531463125549,98.8729817095875,0.247708563184249
453.14,454,581,548,32536,47128,2024-02-01,2024-03-01,482.88,-33,14592,50809473,20654916,0.0927543570467657,99.3585054503517,0.309624851468342
284.61,285,1207,1206,43452,47034,2024-02-01,2024-06-21,482.88,-1,3582,413696011,79729983,0.0113692176741825,99.9022286922655,0.0761576731725985
429.36,435,81,83,44631,46812,2024-02-01,2024-08-16,482.88,2,2180.99999999999,25910468,4922867,0.180668292058638,98.3984542463687,0.04659061779031
484.74,505,23,23,46598,46598,2024-02-01,2024-06-21,482.88,0,0,413696011,79729983,0.01126382627847,99.913492518544,0
434.56,435,989,1056,30659,46464,2024-02-01,2024-03-01,482.88,67,15805,50809473,20654916,0.0914475141279265,99.4499529644797,0.340155819559229
469.13,483,33,33,45771,45771,2024-02-01,2024-08-16,482.88,0,0,25910468,4922867,0.176650610865076,98.5751048572338,0
457.31,458,668,661,28724,45609,2024-02-01,2024-02-23,482.88,-7,16885,38550562,1795056,0.118309559274389,99.0765452394702,0.370212019557544
420.83,421,2724,2677,32688,45509,2024-02-01,2024-02-16,482.88,-47,12821,187049931,90530418,0.0243298673015816,99.5845633324505,0.281724494056121
369.94,370,7578,7583,37890,45498,2024-02-01,2024-02-16,482.88,5,7607.99999999999,187049931,90530418,0.0243239865188723,99.6088873189694,0.167216141368851
408.9,409,4493,4495,44930,44950,2024-02-01,2024-02-16,482.88,2,20,187049931,90530418,0.0240310166166274,99.632918335586,0.000444938820912125
369.15,370,510,516,36210,43860,2024-02-01,2024-05-17,482.88,6,7650,66606452,19312622,0.0658494765642223,99.502121806458,0.174418604651163
465.64,466,1013,1208,17221,43488,2024-02-01,2024-02-09,482.88,195,26267,48138698,26427571,0.0903389618057389,99.1476940236315,0.60400570272259
249.4,250,719,718,39545,43080,2024-02-01,2024-09-20,482.88,-1,3534.99999999999,275196706,45340715,0.0156542571407087,99.8937796152255,0.0820566388115133
259.32,260,637,632,40768,42976,2024-02-01,2024-09-20,482.88,-5,2208.00000000001,275196706,45340715,0.0156164659906939,99.9093960812162,0.0513775130305288
417.86,418,3123,3046,34353,42644,2024-02-01,2024-02-16,482.88,-77,8291.00000000001,187049931,90530418,0.0227981907141147,99.6557165263001,0.19442360003752
455.95,456,8421,8331,25263,41655,2024-02-01,2024-02-02,482.88,-90,16392,59097355,35805173,0.0704853880516311,98.9434670976392,0.393518185091826
484,510,19,16,43130,41600,2024-02-01,2024-05-17,482.88,-3,-1530,66606452,19312622,0.0624564118803386,99.5645782183384,-0.0367788461538462
477.29,497,15,21,28575,41391,2024-02-01,2024-08-16,482.88,6,12816,25910468,4922867,0.159746246188992,98.7348511034228,0.309632528810611
459.67,461,404,311,30704,41363,2024-02-01,2024-03-01,482.88,-93,10659,50809473,20654916,0.0814080476685913,99.5313610121483,0.257694074414332
194.5,195,816,817,37536,40850,2024-02-01,2024-12-20,482.88,1,3314,461752055,55002926,0.00884673918776604,99.9491718558784,0.0811260709914321
461.51,463,341,269,27962,40081,2024-02-01,2024-03-01,482.88,-72,12119,50809473,20654916,0.0788848961295072,99.6102459082778,0.30236271550111
482.18,496,27,29,22167,40078,2024-02-01,2024-03-01,482.88,2,17911,50809473,20654916,0.0788789917187293,99.6891248999965,0.446903538100704
451.84,460,28,49,19012,39984,2024-02-01,2024-07-19,482.88,21,20972,4933850,1821237,0.810401613344548,92.9601224196115,0.524509803921569
460.12,461,448,453,21952,39864,2024-02-01,2024-02-23,482.88,5,17912,38550562,1795056,0.103407052794717,99.1799522922649,0.449327714228376
249.97,250,13089,13100,39267,39300,2024-02-01,2024-03-15,482.88,11,33.0000000000073,452229307,160916150,0.00869028154338525,99.9318151222782,0.000839694656488735
359.53,360,831,834,32409,39198,2024-02-01,2024-04-19,482.88,3,6788.99999999999,232702399,73324968,0.0168446909737273,99.8444442336841,0.173197612123067
400.91,401,4353,4353,39177,39177,2024-02-01,2024-02-16,482.88,0,0,187049931,90530418,0.0209446749274663,99.6766612012276,0
415.24,420,81,81,31509,38556,2024-02-01,2024-08-16,482.88,0,7047,25910468,4922867,0.148804722477417,98.8836558259002,0.182773109243697
344.67,345,1012,1162,31372,38346,2024-02-01,2024-04-19,482.88,150,6974,232702399,73324968,0.0164785580917024,99.8609227917758,0.181870338496845
384.96,385,9494,9495,47470,37980,2024-02-01,2024-02-09,482.88,1,-9490.00000000001,48138698,26427571,0.0788970237624624,99.2265910473939,-0.249868351764087
482,500,21,21,37800,37800,2024-02-01,2024-07-19,482.88,0,0,4933850,1821237,0.766135979002199,93.7262583986137,0
324.6,325,933,938,33588,37520,2024-02-01,2024-05-17,482.88,5,3932.00000000001,66606452,19312622,0.05633087917669,99.6209090975151,0.104797441364606
405.9,406,3725,3725,37250,37250,2024-02-01,2024-02-16,482.88,0,0,187049931,90530418,0.0199144687201194,99.6965756699477,0
451.85,452,2490,2449,27390,36735,2024-02-01,2024-02-09,482.88,-41,9345,48138698,26427571,0.0763107469171684,99.3029017943111,0.254389546753777
454.95,455,7311,7276,29244,36380,2024-02-01,2024-02-02,482.88,-35,7136,59097355,35805173,0.0615594386584645,99.0050265362976,0.196151731720726
455.59,463,50,49,30400,36309,2024-02-01,2024-06-21,482.88,-1,5909,413696011,79729983,0.00877673437368484,99.9222692529177,0.162742019884877
471.8,488,20,22,29520,35640,2024-02-01,2024-08-16,482.88,2,6120,25910468,4922867,0.137550583802655,99.0212064097028,0.171717171717172
465.54,467.5,157,181,16642,35476,2024-02-01,2024-03-01,482.88,24,18834,50809473,20654916,0.0698216255854494,99.758946525582,0.530894125606044
393.78,395,286,289,32890,35258,2024-02-01,2024-05-17,482.88,3,2368,66606452,19312622,0.0529348117806966,99.6738439092958,0.0671620625106359
471.37,486,9,24,11115,35112,2024-02-01,2024-07-19,482.88,15,23997,4933850,1821237,0.711655198273154,94.4379135968868,0.683441558441558
449.61,456,50,54,25500,34506,2024-02-01,2024-06-21,482.88,4,9006,413696011,79729983,0.00834090711113963,99.9306101600288,0.260998087289167
450.43,457,35,52,18410,34164,2024-02-01,2024-06-21,482.88,17,15754,413696011,79729983,0.0082582377135853,99.9388683977424,0.461128673457441
434.4,435,564,566,25380,33960,2024-02-01,2024-03-08,482.88,2,8580,44041877,11919273,0.0771084302333436,99.6705635411497,0.252650176678445
470.01,482,27,28,30807,33572,2024-02-01,2024-07-19,482.88,1,2765,4933850,1821237,0.680442250980472,95.1183558478673,0.0823603002502085
264.38,265,539,539,33418,33418,2024-02-01,2024-09-20,482.88,0,0,275196706,45340715,0.0121433139537651,99.92153939517,0
169.72,170,1173,1173,32844,32844,2024-02-01,2024-09-20,482.88,0,0,275196706,45340715,0.0119347358757993,99.9334741310457,0
214.41,215,548,548,32332,32332,2024-02-01,2024-12-20,482.88,0,0,461752055,55002926,0.00700202622812366,99.9561738821065,0
452.47,453,612,610,21420,32330,2024-02-01,2024-02-23,482.88,-2,10910,38550562,1795056,0.0838638876393034,99.2638161799042,0.337457469842252
482.99,500,450,19,471600,32319,2024-02-01,2024-02-23,482.88,-431,-439281,38550562,1795056,0.083835353684338,99.3476515335885,-13.5920356446672
456.27,457,451,442,18942,32266,2024-02-01,2024-02-23,482.88,-9,13324,38550562,1795056,0.0836978719013227,99.4313494054899,0.412942416165623
349.96,350,7632,8046,30528,32184,2024-02-01,2024-02-16,482.88,414,1656,187049931,90530418,0.0172061009741832,99.7137817709219,0.0514541387024609
184.57,185,739,739,31777,31777,2024-02-01,2024-12-20,482.88,0,0,461752055,55002926,0.006881831852378,99.9630557139589,0
483.83,494,508,31,259080,31527,2024-02-01,2024-02-02,482.88,-477,-227553,59097355,35805173,0.0533475652167512,99.0583741015144,-7.21771814635075
467.45,467.5,6458,6305,32290,31525,2024-02-01,2024-02-02,482.88,-153,-765.000000000004,59097355,35805173,0.0533441809705358,99.1117182824849,-0.0242664551942904
229.83,230,1830,1830,31110,31110,2024-02-01,2024-06-21,482.88,0,0,413696011,79729983,0.00752001449682821,99.9463884122392,0
483.72,502,229,17,269304,31076,2024-02-01,2024-02-16,482.88,-212,-238228,187049931,90530418,0.016613745770374,99.7303955166923,-7.66598017762904
339.67,340,917,941,25676,31053,2024-02-01,2024-04-19,482.88,24,5377,232702399,73324968,0.01334451218958,99.8742673039654,0.173155572730493
422.86,423,2208,2208,26496,30912,2024-02-01,2024-02-16,482.88,0,4416,187049931,90530418,0.0165260686463445,99.7469215853386,0.142857142857143
419.69,420,987,989,23688,30659,2024-02-01,2024-03-01,482.88,2,6971,50809473,20654916,0.0603411100130875,99.8192876355951,0.227372060406406
455.26,456,414,412,16560,30488,2024-02-01,2024-02-23,482.88,-2,13928,38550562,1795056,0.0790857471805469,99.5104351526704,0.456835476252952
429.93,430,4188,4355,25128,30485,2024-02-01,2024-02-09,482.88,167,5357,48138698,26427571,0.0633274294207126,99.3662292237318,0.175725766770543
354.58,355,717,717,25095,30114,2024-02-01,2024-04-19,482.88,0,5019,232702399,73324968,0.0129409924991792,99.8872082964645,0.166666666666667
254.36,255,467,467,29888,29888,2024-02-01,2024-09-20,482.88,0,0,275196706,45340715,0.0108605951119197,99.9443347261577,0
324.89,325,2695,2692,26950,29612,2024-02-01,2024-03-15,482.88,-3,2662,452229307,160916150,0.00654800552322453,99.9383631278015,0.0898959881129272
483.85,505,8,14,11008,29610,2024-02-01,2024-02-02,482.88,6,18602,59097355,35805173,0.0501037652192725,99.1618220477042,0.62823370482945
401.3,405,49,78,15092,28860,2024-02-01,2024-08-16,482.88,29,13768,25910468,4922867,0.111383553550634,99.1325899632535,0.477061677061677
444.88,445,2427,2405,21843,28860,2024-02-01,2024-02-09,482.88,-22,7017,48138698,26427571,0.0599517668716341,99.4261809906035,0.243139293139293
384.78,385,25,1310,500,28820,2024-02-01,2024-03-08,482.88,1285,28320,44041877,11919273,0.0654377196503228,99.7360012608,0.98265093684941
418.87,419,2213,2214,28769,28782,2024-02-01,2024-02-16,482.88,1,13,187049931,90530418,0.0153873352671806,99.7623089206058,0.000451671183378501
405.55,406,615,639,21525,28755,2024-02-01,2024-03-15,482.88,24,7230,452229307,160916150,0.00635849989262195,99.9447216276941,0.251434533124674
249.58,250,623,683,24920,28686,2024-02-01,2024-08-16,482.88,60,3766,25910468,4922867,0.110712010296379,99.2433019735499,0.13128355295266
483.15,500,100,17,100700,28645,2024-02-01,2024-02-02,482.88,-83,-72055,59097355,35805173,0.048470866420333,99.2102929141245,-2.51544772211555
239.86,240,1829,2042,20119,28588,2024-02-01,2024-05-17,482.88,213,8469,66606452,19312622,0.042920766895075,99.7167646761908,0.296243178956206
439.89,440,3176,2592,25408,28512,2024-02-01,2024-02-09,482.88,-584,3104,48138698,26427571,0.0592288557534315,99.4854098463569,0.108866442199776
416.87,417,2182,2183,21820,28379,2024-02-01,2024-02-16,482.88,1,6559,187049931,90530418,0.0151718847733764,99.7774808053792,0.23112160400296
179.63,180,763,763,28231,28231,2024-02-01,2024-12-20,482.88,0,0,461752055,55002926,0.0061138872462625,99.9691696012051,0
406.9,407,2806,2806,28060,28060,2024-02-01,2024-02-16,482.88,0,0,187049931,90530418,0.0150013420748068,99.792482147454,0
458.8,459,1305,1400,16965,28000,2024-02-01,2024-02-09,482.88,95,11035,48138698,26427571,0.0581652623841218,99.543575108741,0.394107142857143
458.43,459,514,488,23130,27816,2024-02-01,2024-02-23,482.88,-26,4686,38550562,1795056,0.0721545901198535,99.5825897427903,0.16846419327006
402.9,403,2618,2768,26180,27680,2024-02-01,2024-02-16,482.88,150,1500,187049931,90530418,0.014798187763031,99.807280335217,0.0541907514450867
480.71,498,15,16,18855,27664,2024-02-01,2024-04-19,482.88,1,8809,232702399,73324968,0.0118881455966425,99.8990964420612,0.318428282244072
199.98,200,9293,13822,9293,27644,2024-02-01,2024-03-15,482.88,4529,18351,452229307,160916150,0.00611282806578478,99.9508344557599,0.66383301982347
474.8,489,12,19,16116,26980,2024-02-01,2024-07-19,482.88,7,10864,4933850,1821237,0.546834622049718,95.665190469917,0.402668643439585
467.95,468,4342,5393,21710,26965,2024-02-01,2024-02-02,482.88,1051,5255,59097355,35805173,0.0456280995993814,99.2559210137239,0.194882254774708
466.34,479,21,21,26586,26586,2024-02-01,2024-08-16,482.88,0,0,25910468,4922867,0.102607177917435,99.3459091514673,0
354.96,355,6618,6618,26472,26472,2024-02-01,2024-02-16,482.88,0,0,187049931,90530418,0.0141523708982282,99.8214327061152,0
339.97,340,8813,8820,26439,26460,2024-02-01,2024-02-16,482.88,7,20.9999999999964,187049931,90530418,0.014145955498909,99.8355786616142,0.000793650793650656
486,497,25,24,20875,26400,2024-02-01,2024-03-01,482.88,-1,5525,50809473,20654916,0.0519588148454128,99.8712464504405,0.209280303030303
299.81,300,1354,1353,21664,25707,2024-02-01,2024-04-19,482.88,-1,4043,232702399,73324968,0.011047157274902,99.9101435993361,0.157272338273622
434.98,435,12587,12698,37761,25396,2024-02-01,2024-02-02,482.88,111,-12365,59097355,35805173,0.0429731584433855,99.2988941721673,-0.486887698850213
159.84,160,1560,1560,24960,24960,2024-02-01,2024-09-20,482.88,0,0,275196706,45340715,0.00906987600353036,99.9534046021612,0
478.18,496,14,14,22876,24948,2024-02-01,2024-07-19,482.88,0,2072,4933850,1821237,0.505649746141451,96.1708402160585,0.0830527497194164
169.67,170,754,754,24882,24882,2024-02-01,2024-12-20,482.88,0,0,461752055,55002926,0.00538860622937563,99.9745582074345,0
401.9,402,2177,2477,17416,24770,2024-02-01,2024-02-16,482.88,300,7354,187049931,90530418,0.013242453428117,99.8488211150423,0.296891400888171
483.2,545,4,4,21652,24720,2024-02-01,2024-02-16,482.88,0,3068,187049931,90530418,0.0132157225976202,99.8620368376399,0.12411003236246
485.4,510,9,10,20421,24600,2024-02-01,2024-07-19,482.88,1,4179,4933850,1821237,0.498596430779209,96.6694366468377,0.169878048780488
384.01,385,163,246,14181,24354,2024-02-01,2024-05-17,482.88,83,10173,66606452,19312622,0.0365640253589847,99.7533287015498,0.417713722591771
482.97,496,108,18,62100,23454,2024-02-01,2024-02-02,482.88,-90,-38646,59097355,35805173,0.039687055368214,99.3385812275355,-1.64773599386032
462.45,462.5,4674,4673,23370,23365,2024-02-01,2024-02-02,482.88,-1,-5,59097355,35805173,0.0395364564116279,99.3781176839471,-0.000213995292103574
204.47,205,439,439,23267,23267,2024-02-01,2024-12-20,482.88,0,0,461752055,55002926,0.00503885142427791,99.9795970588588,0
139.79,140,1099,1101,23079,23121,2024-02-01,2024-12-20,482.88,2,41.9999999999964,461752055,55002926,0.0050072327236313,99.9846042915824,0.00181653042688449
259.97,260,7627,7627,22881,22881,2024-02-01,2024-03-15,482.88,0,0,452229307,160916150,0.00505960132300758,99.9558940570829,0
489.77,535,5,5,22615,22615,2024-02-01,2024-12-20,482.88,0,0,461752055,55002926,0.0048976501035821,99.989501941686,0
466.95,467,3727,4502,18635,22510,2024-02-01,2024-02-02,482.88,775,3875,59097355,35805173,0.0380896911545364,99.4162073751017,0.172145713016437
455.82,456,1280,1249,15360,22482,2024-02-01,2024-02-09,482.88,-31,7122,48138698,26427571,0.046702551032851,99.5902776597739,0.316786762743528
289.84,290,1342,1387,18788,22192,2024-02-01,2024-04-19,482.88,45,3404,232702399,73324968,0.00953664426983411,99.9196802436059,0.15338860850757
194.98,195,12635,11084,25270,22168,2024-02-01,2024-03-15,482.88,-1551,-3102,452229307,160916150,0.0049019379453884,99.9607959950283,-0.139931432695778
392.12,395,50,74,13250,21312,2024-02-01,2024-08-16,482.88,24,8062,25910468,4922867,0.0822524703143147,99.4281616217816,0.378284534534535
457.95,458,4102,4251,12306,21255,2024-02-01,2024-02-02,482.88,149,8949,59097355,35805173,0.0359660766543613,99.452173451756,0.421030345800988
334.97,335,7031,7041,14062,21123,2024-02-01,2024-02-16,482.88,10,7061,187049931,90530418,0.0112927066516801,99.8733295442916,0.334280168536666
456.8,457.5,301,300,13244,21000,2024-02-01,2024-02-23,482.88,-1,7756,38550562,1795056,0.054473914024911,99.6370636568152,0.369333333333333
483.13,504,3049,10,4222865,20870,2024-02-01,2024-02-23,482.88,-3039,-4201995,38550562,1795056,0.0541366945571377,99.6912003513723,-201.341399137518
224.84,225,1286,1286,20576,20576,2024-02-01,2024-06-21,482.88,0,0,413696011,79729983,0.00497370036280094,99.9513621126021,0
314.63,315,535,555,17120,20535,2024-02-01,2024-05-17,482.88,20,3415,66606452,19312622,0.0308303465856431,99.7841590481355,0.166301436571707
349.98,350,3076,10246,3076,20492,2024-02-01,2024-02-09,482.88,7170,17416,48138698,26427571,0.0425686627419794,99.6328463225158,0.849892641030646
274.88,275,1687,1692,18557,20304,2024-02-01,2024-04-19,482.88,5,1747,232702399,73324968,0.00872530755473647,99.9284055511607,0.0860421591804571
299.4,300,181,335,10317,20100,2024-02-01,2024-07-19,482.88,154,9783,4933850,1821237,0.40738976661228,97.07682641345,0.486716417910448
452.17,453,178,238,9790,19754,2024-02-01,2024-03-01,482.88,60,9964,50809473,20654916,0.0388785768354653,99.9101250272759,0.504404171307077
457.85,458,1302,1308,15624,19620,2024-02-01,2024-02-09,482.88,6,3996,48138698,26427571,0.0407572302848739,99.6736035528007,0.203669724770642
485.94,499,14,15,17612,19590,2024-02-01,2024-03-08,482.88,1,1978,44041877,11919273,0.0444803930586337,99.7804816538587,0.10096988259316
478.6,498,10,10,19400,19400,2024-02-01,2024-08-16,482.88,0,0,25910468,4922867,0.0748732134054854,99.5030348351871,0
209.88,210,1612,1612,19344,19344,2024-02-01,2024-06-21,482.88,0,0,413696011,79729983,0.00467589715289761,99.9560380097549,0
486.66,535,3,4,14820,19336,2024-02-01,2024-09-20,482.88,1,4516,275196706,45340715,0.00702624689119644,99.9604308490524,0.233553992552751
460.76,461,802,802,11228,19248,2024-02-01,2024-02-09,482.88,0,8020,48138698,26427571,0.0399844632274849,99.7135880160282,0.416666666666667
244.8,245,958,958,19160,19160,2024-02-01,2024-06-21,482.88,0,0,413696011,79729983,0.00463142005011985,99.9606694298051,0
452.84,453,1222,1191,13442,19056,2024-02-01,2024-02-09,482.88,-31,5614,48138698,26427571,0.0395856157139938,99.7531736317422,0.2946053736356
314.92,315,2378,2378,19024,19024,2024-02-01,2024-03-15,482.88,0,0,452229307,160916150,0.00420671542191758,99.9650027104502,0
459.97,460,7034,6322,28136,18966,2024-02-01,2024-02-02,482.88,-712,-9170,59097355,35805173,0.0320928068608147,99.4842662586168,-0.483496783718233
483.36,496,80,15,56240,18960,2024-02-01,2024-02-09,482.88,-65,-37280,48138698,26427571,0.0393861919572482,99.7925598236994,-1.9662447257384
259.98,260,9357,9357,18714,18714,2024-02-01,2024-02-16,482.88,0,0,187049931,90530418,0.010004815238344,99.8833343595299,0
453.84,454,1103,1165,13236,18640,2024-02-01,2024-02-09,482.88,62,5404,48138698,26427571,0.0387214461014297,99.8312812698009,0.289914163090129
294.84,295,1172,1162,18752,18592,2024-02-01,2024-04-19,482.88,-10,-160,232702399,73324968,0.00798960392324963,99.9363951550839,-0.00860585197934596
461.97,462,5956,6012,17868,18036,2024-02-01,2024-02-02,482.88,56,168,59097355,35805173,0.030519132370645,99.5147853909875,0.00931470392548237
453.96,454,4504,4502,13512,18008,2024-02-01,2024-02-02,482.88,-2,4496,59097355,35805173,0.0304717529236292,99.5452571439111,0.249666814749
484.04,520,56,5,160944,17980,2024-02-01,2024-05-17,482.88,-51,-142964,66606452,19312622,0.0269943818655886,99.8111534300011,-7.95127919911012
471.36,484,10,14,12220,17696,2024-02-01,2024-07-19,482.88,4,5476,4933850,1821237,0.358665139799548,97.4354915532495,0.309448462929476
184.92,185,2190,2190,17520,17520,2024-02-01,2024-06-21,482.88,0,0,413696011,79729983,0.00423499369927451,99.9649044235044,0
487.4,575,0,2,0,17520,2024-02-01,2024-06-21,482.88,2,17520,413696011,79729983,0.00423499369927451,99.9691394172036,1
364.28,365,240,242,15360,17424,2024-02-01,2024-05-17,482.88,2,2064,66606452,19312622,0.026159627899111,99.8373130579002,0.118457300275482
486.53,515,6,6,17082,17082,2024-02-01,2024-09-20,482.88,0,0,275196706,45340715,0.00620719638991609,99.9666380454423,0
483.03,502,7,9,9100,17073,2024-02-01,2024-03-15,482.88,2,7973,452229307,160916150,0.00377529711934393,99.9687780075695,0.4669946699467
279.95,280,3214,3414,16070,17070,2024-02-01,2024-03-15,482.88,200,999.999999999998,452229307,160916150,0.00377463373907344,99.9725526413086,0.0585823081429407
456.81,457,828,897,9936,17043,2024-02-01,2024-02-09,482.88,69,7107,48138698,26427571,0.0354039488147353,99.8666852186156,0.417004048582996
249.85,250,1117,1119,15638,16785,2024-02-01,2024-05-17,482.88,2,1147,66606452,19312622,0.0252002613800837,99.8625133192802,0.0683348227584151
239.52,240,349,349,16752,16752,2024-02-01,2024-09-20,482.88,0,0,275196706,45340715,0.00608728216390788,99.9727253276062,0
483.25,500,6,10,6420,16750,2024-02-01,2024-03-08,482.88,4,10330,44041877,11919273,0.0380319848765755,99.8185136387352,0.616716417910448
244.93,245,2381,2386,16667,16702,2024-02-01,2024-04-19,482.88,5,35,232702399,73324968,0.00717740774129277,99.9435725628252,0.00209555741827326
468.94,469,2990,2719,14950,16314,2024-02-01,2024-02-02,482.88,-271,1364,59097355,35805173,0.0276052963791696,99.5728624402903,0.0836091700380041
249.92,250,2007,2012,16056,16096,2024-02-01,2024-04-19,482.88,5,40,232702399,73324968,0.00691698928295105,99.9504895521081,0.00248508946322068
387.08,390,4,55,984,16060,2024-02-01,2024-08-16,482.88,51,15076,25910468,4922867,0.061982670478974,99.5650175056661,0.938729763387298
483.59,506,3388,7,5170088,15687,2024-02-01,2024-02-23,482.88,-3381,-5154401,38550562,1795056,0.0406920137766085,99.7318923651489,-328.57786702365
483.64,501,9,9,15624,15624,2024-02-01,2024-06-21,482.88,0,0,413696011,79729983,0.00377668616195577,99.9729161033656,0
483.88,498,20,11,16520,15532,2024-02-01,2024-02-02,482.88,-9,-988,59097355,35805173,0.0262820561089409,99.5991444963992,-0.06361061035282
319.98,320,7761,7732,15522,15464,2024-02-01,2024-02-16,482.88,-29,-57.9999999999982,187049931,90530418,0.00826731125605173,99.891601670786,-0.00375064666321768
339.49,340,303,303,13938,15453,2024-02-01,2024-05-17,482.88,0,1515,66606452,19312622,0.023200455115069,99.8857137743953,0.0980392156862745
434.67,435,471,468,10362,15444,2024-02-01,2024-02-23,482.88,-3,5082,38550562,1795056,0.0400616727714631,99.7719540379204,0.329059829059829
483,505,5,7,8705,15400,2024-02-01,2024-05-17,482.88,2,6695,66606452,19312622,0.0231208832441638,99.9088346576395,0.43474025974026
324.98,325,7422,7657,14844,15314,2024-02-01,2024-02-16,482.88,235,470.000000000002,187049931,90530418,0.00818711876456132,99.8997887895505,0.0306908710983415
482.79,498,37,10,32079,15210,2024-02-01,2024-02-16,482.88,-27,-16869,187049931,90530418,0.00813151863712797,99.9079203081877,-1.10907297830375
159.68,160,475,475,15200,15200,2024-02-01,2024-12-20,482.88,0,0,461752055,55002926,0.00329180993033155,99.9927937516163,0
463.96,464,3633,3794,14532,15176,2024-02-01,2024-02-02,482.88,161,644,59097355,35805173,0.0256796602825964,99.6248241566818,0.0424354243542435
487.06,502,764,10,898464,14940,2024-02-01,2024-02-23,482.88,-754,-883524,38550562,1795056,0.0387542988348652,99.8107083367552,-59.1381526104418
483.54,520,4,4,11700,14584,2024-02-01,2024-03-15,482.88,0,2884,452229307,160916150,0.00322491262159619,99.9757775539302,0.197750959956116
483.55,520,0,4,0,14580,2024-02-01,2024-03-08,482.88,4,14580,44041877,11919273,0.0331048560895804,99.8516184948248,1
249.99,250,14120,14120,14120,14120,2024-02-01,2024-02-16,482.88,0,0,187049931,90530418,0.00754878653229763,99.91546909472,0
479.4,497,8,8,12264,14080,2024-02-01,2024-06-21,482.88,0,1816,413696011,79729983,0.00340346525603797,99.9763195686216,0.128977272727273
344.52,345,293,293,14064,14064,2024-02-01,2024-05-17,482.88,0,0,66606452,19312622,0.0211150715549298,99.9299497291944,0
451.53,452,303,298,10908,14006,2024-02-01,2024-02-23,482.88,-5,3098,38550562,1795056,0.0363315066587097,99.847039843414,0.221190918177924
199.72,200,500,500,14000,14000,2024-02-01,2024-09-20,482.88,0,0,275196706,45340715,0.00508727019428786,99.9778125978005,0
465.96,466,3435,3474,13740,13896,2024-02-01,2024-02-02,482.88,39,156,59097355,35805173,0.0235137427047285,99.6483378993865,0.0112262521588946
452.96,453,3470,3470,10410,13880,2024-02-01,2024-02-02,482.88,0,3470,59097355,35805173,0.0234866687350051,99.6718245681215,0.25
189.91,190,1517,1522,13653,13698,2024-02-01,2024-06-21,482.88,5,44.9999999999982,413696011,79729983,0.00331112692309716,99.9796306955447,0.00328515111695125
484.62,496,2,12,1740,13656,2024-02-01,2024-03-08,482.88,10,11916,44041877,11919273,0.0310068528641502,99.882625347689,0.872583479789104
439.97,440,4502,4495,9004,13485,2024-02-01,2024-02-02,482.88,-7,4481,59097355,35805173,0.02281828010746,99.694642848229,0.332295142751205
460.97,461,3258,4484,13032,13452,2024-02-01,2024-02-02,482.88,1226,419.999999999998,59097355,35805173,0.0227624400449056,99.7174052882739,0.031222123104371
264.99,265,13312,13312,13312,13312,2024-02-01,2024-02-16,482.88,0,0,187049931,90530418,0.00711681631146926,99.9225859110314,0
450.97,451,4374,4368,13122,13104,2024-02-01,2024-02-02,482.88,-6,-18,59097355,35805173,0.0221735812034227,99.7395788694773,-0.00137362637362637
452.41,461,4,15,2828,12885,2024-02-01,2024-07-19,482.88,11,10057,4933850,1821237,0.261155081731305,97.6966466349808,0.780519984478075
487.28,550,3,2,17739,12544,2024-02-01,2024-06-21,482.88,-1,-5195,413696011,79729983,0.00303217813719746,99.9826628736819,-0.414142219387755
486.6,498,152,11,122360,12540,2024-02-01,2024-02-09,482.88,-141,-109820,48138698,26427571,0.0260497282248888,99.8927349468405,-8.75757575757576
482.42,498,8,8,12464,12464,2024-02-01,2024-06-21,482.88,0,0,413696011,79729983,0.00301284026642452,99.9856757139483,0
416.11,420,10,32,3470,12448,2024-02-01,2024-07-19,482.88,22,8978,4933850,1821237,0.252297901233317,97.9489445362141,0.721240359897172
294.98,295,5979,5979,11958,11958,2024-02-01,2024-02-16,482.88,0,0,187049931,90530418,0.00639294542161579,99.9289788564531,0
184.79,185,561,561,11781,11781,2024-02-01,2024-09-20,482.88,0,0,275196706,45340715,0.00428093786849324,99.982093535669,0
482.5,497,3,8,2649,11600,2024-02-01,2024-03-08,482.88,5,8951,44041877,11919273,0.0263385686309419,99.9089639163199,0.771637931034483
484.83,600,1,1,11248,11517,2024-02-01,2024-12-20,482.88,0,269,461752055,55002926,0.0024941957215545,99.9952879473379,0.0233567769384388
309.93,310,1644,1644,13152,11508,2024-02-01,2024-03-15,482.88,0,-1644,452229307,160916150,0.00254472671758976,99.9783222806478,-0.142857142857143
461.5,473,10,10,9080,11500,2024-02-01,2024-07-19,482.88,0,2420,4933850,1821237,0.233083697315484,98.1820282335296,0.210434782608696
419.76,420,466,478,7456,11472,2024-02-01,2024-02-23,482.88,12,4016,38550562,1795056,0.0297583210330371,99.876798164447,0.350069735006974
448.96,449,1734,2837,5202,11348,2024-02-01,2024-02-02,482.88,1103,6146,59097355,35805173,0.0192022130262852,99.7587810825036,0.541593232287628
289.99,290,7767,11235,7767,11235,2024-02-01,2024-02-16,482.88,3468,3468,187049931,90530418,0.006006417612632,99.9349852740657,0.3086782376502
244.99,245,11208,11208,11208,11208,2024-02-01,2024-02-16,482.88,0,0,187049931,90530418,0.00599198296416372,99.9409772570299,0
476.09,492,7,7,11137,11137,2024-02-01,2024-08-16,482.88,0,0,25910468,4922867,0.0429826277163346,99.6080001333824,0
344.97,345,3653,3694,10959,11082,2024-02-01,2024-02-16,482.88,41,123.000000000002,187049931,90530418,0.00592462127131178,99.9469018783012,0.0110990795885221
414.79,415,528,527,7392,11067,2024-02-01,2024-02-23,482.88,-1,3675,38550562,1795056,0.0287077526911281,99.9055059171381,0.332068311195446
209.45,210,200,200,11000,11000,2024-02-01,2024-12-20,482.88,0,0,461752055,55002926,0.00238223087063467,99.9976701782085,0
279.86,280,733,781,9529,10934,2024-02-01,2024-04-19,482.88,48,1405,232702399,73324968,0.00469870531932075,99.9551882574275,0.128498262301079
447.97,448,3583,3632,14332,10896,2024-02-01,2024-02-02,482.88,49,-3436,59097355,35805173,0.0184373733816006,99.7772184558852,-0.315345080763583
259.9,260,1070,1080,9630,10800,2024-02-01,2024-04-19,482.88,10,1170,232702399,73324968,0.00464112103975344,99.9598293784672,0.108333333333333
491.21,545,2,2,10758,10758,2024-02-01,2024-12-20,482.88,0,0,461752055,55002926,0.00232982179148071,100,0
394.99,395,9847,10290,9847,10290,2024-02-01,2024-02-02,482.88,443,443,59097355,35805173,0.0174119467783287,99.7946304026635,0.0430515063168124
349.91,350,1120,1122,7840,10098,2024-02-01,2024-03-01,482.88,2,2258,50809473,20654916,0.0198742466783704,99.9299992739543,0.223608635373341
414.73,415,369,372,7749,10044,2024-02-01,2024-03-01,482.88,3,2295,50809473,20654916,0.0197679672843684,99.9497672412387,0.228494623655914
209.99,210,9815,10015,9815,10015,2024-02-01,2024-02-16,482.88,200,200,187049931,90530418,0.00535418534850997,99.9522560636497,0.0199700449326011
446.97,447,3328,3320,6656,9960,2024-02-01,2024-02-02,482.88,-8,3304,59097355,35805173,0.0168535461527847,99.8114839488163,0.331726907630522
482.25,502,5,5,9875,9875,2024-02-01,2024-07-19,482.88,0,0,4933850,1821237,0.200147957477426,98.382176191007,0
485.69,498,6,8,6210,9848,2024-02-01,2024-03-08,482.88,2,3638,44041877,11919273,0.0223605365411651,99.9313244528611,0.369415109666938
483.72,500,279,6,272025,9768,2024-02-01,2024-02-09,482.88,-273,-262257,48138698,26427571,0.0202913672488608,99.9130263140894,-26.8485872235872
444.97,445,3234,3213,6468,9639,2024-02-01,2024-02-02,482.88,-21,3171,59097355,35805173,0.01631037463521,99.8277943234515,0.328976034858388
446.98,453,14,16,7280,9632,2024-02-01,2024-06-21,482.88,2,2352,413696011,79729983,0.00232827964106234,99.9880039935894,0.244186046511628
309.8,310,463,466,9723,9320,2024-02-01,2024-04-19,482.88,3,-402.999999999998,232702399,73324968,0.00400511556393538,99.9638344940312,-0.0432403433476393
239.93,240,1324,1329,9268,9303,2024-02-01,2024-04-19,482.88,5,35.0000000000018,232702399,73324968,0.00399781009563206,99.9678323041268,0.0037622272385254
204.88,205,765,765,9180,9180,2024-02-01,2024-06-21,482.88,0,0,413696011,79729983,0.00221902067119521,99.9902230142606,0
463.81,474,9,9,8514,9171,2024-02-01,2024-07-19,482.88,0,656.999999999998,4933850,1821237,0.1858791815722,98.5680553725792,0.0716388616290479
481.24,499,2,5,2552,8880,2024-02-01,2024-04-19,482.88,3,6328,232702399,73324968,0.00381603285490839,99.9716483369817,0.712612612612613
482.8,505,33,4,49995,8880,2024-02-01,2024-03-15,482.88,-29,-41115,452229307,160916150,0.00196360560064277,99.9802858862484,-4.63006756756757
269.99,270,8858,8858,8858,8858,2024-02-01,2024-02-16,482.88,0,0,187049931,90530418,0.00473563393081391,99.9569916975805,0
284.99,285,2813,8779,2813,8779,2024-02-01,2024-02-16,482.88,5966,5966,187049931,90530418,0.00469339921862896,99.9616850967991,0.679576261533204
349.46,350,162,162,8748,8748,2024-02-01,2024-05-17,482.88,0,0,66606452,19312622,0.0131338627675289,99.9430835919619,0
289.94,290,1459,1445,8754,8670,2024-02-01,2024-03-15,482.88,-14,-84,452229307,160916150,0.00191716898170865,99.9822030552301,-0.00968858131487889
483.8,570,0,1,0,8620,2024-02-01,2024-04-19,482.88,1,8620,232702399,73324968,0.00370430216321062,99.9753526391449,1
234.94,235,1431,1431,8586,8586,2024-02-01,2024-04-19,482.88,0,0,232702399,73324968,0.00368969122660398,99.9790423303715,0
279.99,280,8504,8504,8504,8504,2024-02-01,2024-02-16,482.88,0,0,187049931,90530418,0.00454637965089653,99.96623147645,0
462.97,463,3245,2803,12980,8409,2024-02-01,2024-02-02,482.88,-442,-4571,59097355,35805173,0.0142290632127275,99.8420233866643,-0.543584254964919
189.74,190,292,323,7592,8398,2024-02-01,2024-09-20,482.88,31,806,275196706,45340715,0.00305163536368782,99.9851451710327,0.0959752321981424
484.35,512,1,3,2568,8295,2024-02-01,2024-07-19,482.88,2,5727,4933850,1821237,0.168124284281038,98.7361796568603,0.690415913200723
194.89,195,741,742,7410,8162,2024-02-01,2024-06-21,482.88,1,751.999999999999,413696011,79729983,0.00197294626560951,99.9921959605262,0.092134280813526
484.67,505,252,4,363888,8132,2024-02-01,2024-03-01,482.88,-248,-355756,50809473,20654916,0.0160048894819279,99.9657721307206,-43.7476635514019
224.99,225,8073,8074,16146,8074,2024-02-01,2024-03-15,482.88,1,-8072,452229307,160916150,0.00178537743463849,99.9839884326648,-0.999752291305425
473.92,494,0,4,0,8032,2024-02-01,2024-08-16,482.88,4,8032,25910468,4922867,0.0309990541274669,99.6389991875099,1
483.65,497,185,6,137640,8010,2024-02-01,2024-02-09,482.88,-179,-129630,48138698,26427571,0.0166394197034577,99.9296657337928,-16.1835205992509
219.98,220,3779,3979,7558,7958,2024-02-01,2024-03-15,482.88,200,400,452229307,160916150,0.00175972673084631,99.9857481593956,0.0502638853983413
382.35,385,28,30,6384,7950,2024-02-01,2024-08-16,482.88,2,1566,25910468,4922867,0.0306825797202891,99.6696817672301,0.196981132075472
465.67,477,1,7,1010,7931,2024-02-01,2024-07-19,482.88,6,6921,4933850,1821237,0.160746678557313,98.8969263354176,0.872651620224436
274.95,275,1565,1565,6260,7825,2024-02-01,2024-03-15,482.88,0,1565,452229307,160916150,0.00173031687218803,99.9874784762678,0.2
419.92,420,976,976,4880,7808,2024-02-01,2024-02-09,482.88,0,2928,48138698,26427571,0.0162197988819723,99.9458855326748,0.375
487.27,565,1,1,7402,7773,2024-02-01,2024-03-15,482.88,0,371,452229307,160916150,0.00171881828083291,99.9891972945486,0.047729319439084
464.18,477,1,6,1233,7692,2024-02-01,2024-08-16,482.88,5,6459,25910468,4922867,0.029686843170876,99.699368610401,0.839703588143526
254.91,255,840,850,6720,7650,2024-02-01,2024-04-19,482.88,10,930,232702399,73324968,0.00328746073649202,99.982329791108,0.12156862745098
264.96,265,1900,1900,7600,7600,2024-02-01,2024-03-15,482.88,0,0,452229307,160916150,0.00168056335190147,99.9908778579005,0
456.54,464,8,10,4928,7460,2024-02-01,2024-06-21,482.88,2,2532,413696011,79729983,0.00180325644957693,99.9939992169758,0.33941018766756
397.25,400,7,27,1575,7425,2024-02-01,2024-07-19,482.88,20,5850,4933850,1821237,0.150490995875432,99.047417331293,0.787878787878788
259.83,260,133,433,2261,7361,2024-02-01,2024-05-17,482.88,300,5100,66606452,19312622,0.0110514819194993,99.9541350738814,0.69284064665127
363.17,365,40,40,7320,7320,2024-02-01,2024-08-16,482.88,0,0,25910468,4922867,0.0282511300066058,99.7276197404076,0
488.5,525,2,2,7300,7300,2024-02-01,2024-09-20,482.88,0,0,275196706,45340715,0.00265264802987867,99.9877978190626,0
269.81,270,339,383,5424,7277,2024-02-01,2024-05-17,482.88,44,1853,66606452,19312622,0.0109253680108948,99.9650604418923,0.254637900233613
424.42,430,5,13,2340,7254,2024-02-01,2024-08-16,482.88,8,4914,25910468,4922867,0.0279964067032676,99.7556161471109,0.67741935483871
481.53,496,5,5,7235,7235,2024-02-01,2024-06-21,482.88,0,0,413696011,79729983,0.00174886868802803,99.9957480856638,0
319.76,320,301,301,7224,7224,2024-02-01,2024-04-19,482.88,0,0,232702399,73324968,0.00310439429547952,99.9854341854035,0
234.98,235,3473,3470,10419,6940,2024-02-01,2024-03-15,482.88,-3,-3479,452229307,160916150,0.00153461969239424,99.9924124775929,-0.501296829971181
219.99,220,6924,6924,6924,6924,2024-02-01,2024-02-16,482.88,0,0,187049931,90530418,0.0037016854071975,99.9699331618572,0
234.53,235,144,144,6768,6768,2024-02-01,2024-09-20,482.88,0,0,275196706,45340715,0.00245933176249573,99.9902571508251,0
389.88,390,560,563,5040,6756,2024-02-01,2024-02-23,482.88,3,1716,38550562,1795056,0.0175250363405856,99.9230309534787,0.253996447602131
338.95,340,62,64,6200,6720,2024-02-01,2024-07-19,482.88,2,520,4933850,1821237,0.136201951822613,99.1836192831156,0.0773809523809524
384.88,385,557,557,6684,6684,2024-02-01,2024-03-01,482.88,0,0,50809473,20654916,0.0131550272131341,99.9789271579337,0
483.02,505,2855,3,4219690,6594,2024-02-01,2024-03-08,482.88,-2852,-4213096,44041877,11919273,0.0149721139269337,99.946296566788,-638.928723081589
179.78,180,298,298,6556,6556,2024-02-01,2024-09-20,482.88,0,0,275196706,45340715,0.00238229595669652,99.9926394467818,0
483.15,505,165,3,234630,6555,2024-02-01,2024-02-16,482.88,-162,-228075,187049931,90530418,0.00350441187813109,99.9734375737353,-34.7940503432494
465.17,478,1,5,1242,6415,2024-02-01,2024-08-16,482.88,4,5173,25910468,4922867,0.0247583331956798,99.7803744803066,0.80639127045986
404.99,405,1059,6335,1059,6335,2024-02-01,2024-02-02,482.88,5276,5276,59097355,35805173,0.0107195998873384,99.8527429865516,0.832833464877664
486.88,550,0,1,0,6312,2024-02-01,2024-02-23,482.88,1,6312,38550562,1795056,0.0163733021583447,99.9394042556371,1
254.74,255,242,242,6292,6292,2024-02-01,2024-06-21,482.88,0,0,413696011,79729983,0.00152092353629197,99.9972690092001,0
239.99,240,6211,6211,6211,6211,2024-02-01,2024-02-16,482.88,0,0,187049931,90530418,0.00332050376431307,99.9767580774996,0
284.85,285,326,414,4238,6210,2024-02-01,2024-04-19,482.88,88,1972,232702399,73324968,0.00266864459785823,99.9881028300013,0.317552334943639
485.14,515,0,2,0,5972,2024-02-01,2024-07-19,482.88,2,5972,4933850,1821237,0.12104137742331,99.3046606605389,1
264.89,265,522,532,5220,5852,2024-02-01,2024-04-19,482.88,10,632,232702399,73324968,0.00251480003005899,99.9906176300314,0.107997265892003
377.59,380,18,24,3780,5784,2024-02-01,2024-08-16,482.88,6,2004,25910468,4922867,0.0223230240380066,99.8026975043446,0.346473029045643
479.9,499,3,3,5730,5730,2024-02-01,2024-06-21,482.88,0,0,413696011,79729983,0.00138507499411204,99.9986540841942,0
229.99,230,5692,5692,5692,5692,2024-02-01,2024-02-16,482.88,0,0,187049931,90530418,0.00304303774375624,99.9798011152434,0
469.63,481,5,5,5685,5685,2024-02-01,2024-07-19,482.88,0,0,4933850,1821237,0.11522441906422,99.4198850796032,0
254.97,255,1876,1888,5628,5664,2024-02-01,2024-03-15,482.88,12,36,452229307,160916150,0.00125246195068026,99.9936649395436,0.00635593220338983
309.98,310,2786,2786,5572,5572,2024-02-01,2024-02-16,482.88,0,0,187049931,90530418,0.00297888375056391,99.982779998994,0
304.99,305,5544,5544,11088,5544,2024-02-01,2024-02-16,482.88,0,-5544,187049931,90530418,0.0029639144854857,99.9857439134794,-1
319.6,320,117,138,3978,5520,2024-02-01,2024-05-17,482.88,21,1542,66606452,19312622,0.00828748542258339,99.9733479273149,0.279347826086957
314.79,315,260,260,5460,5460,2024-02-01,2024-04-19,482.88,0,0,232702399,73324968,0.00234634452565313,99.992963974557,0
229.97,230,1797,1797,3594,5391,2024-02-01,2024-03-15,482.88,0,1797,452229307,160916150,0.0011920943460659,99.9948570338897,0.333333333333333
244.98,245,2681,2691,8043,5382,2024-02-01,2024-03-15,482.88,10,-2661,452229307,160916150,0.00119010420525444,99.9960471380949,-0.494425863991081
458.97,459,1719,1791,6876,5373,2024-02-01,2024-02-02,482.88,72,-1503,59097355,35805173,0.00909177745772209,99.8618347640093,-0.279731993299833
414.94,415,887,886,4435,5316,2024-02-01,2024-02-09,482.88,-1,881,48138698,26427571,0.0110430905297854,99.9569286232046,0.165726109857035
436.96,437,10,1316,50,5264,2024-02-01,2024-02-02,482.88,1306,5214,59097355,35805173,0.00890733603898178,99.8707421000483,0.990501519756839
483.88,497,40,4,28200,5248,2024-02-01,2024-02-02,482.88,-36,-22952,59097355,35805173,0.00888026206925843,99.8796223621176,-4.3734756097561
269.89,270,461,471,4610,5181,2024-02-01,2024-04-19,482.88,10,571,232702399,73324968,0.00222644889879283,99.9951904234558,0.110210384095734
424.98,425,1752,2589,1752,5178,2024-02-01,2024-02-02,482.88,837,3426,59097355,35805173,0.00876181345171878,99.8883841755693,0.661645422943221
425.98,426,0,2564,0,5128,2024-02-01,2024-02-02,482.88,2564,5128,59097355,35805173,0.00867720729633331,99.8970613828656,1
456.98,457,2543,2525,7629,5050,2024-02-01,2024-02-02,482.88,-18,-2579,59097355,35805173,0.00854522169393199,99.9056066045596,-0.510693069306931
405.99,406,4,5008,8,5008,2024-02-01,2024-02-02,482.88,5004,5000,59097355,35805173,0.0084741525234082,99.914080757083,0.998402555910543
374.97,375,1611,1611,3222,4833,2024-02-01,2024-02-09,482.88,0,1611,48138698,26427571,0.0100397397536593,99.9669683629582,0.333333333333333
299.99,300,4940,4740,9880,4740,2024-02-01,2024-02-16,482.88,-200,-5140,187049931,90530418,0.00253408273109708,99.9882779962105,-1.08438818565401
214.99,215,4620,4715,4620,4715,2024-02-01,2024-02-16,482.88,95,95,187049931,90530418,0.00252071731584868,99.9907987135264,0.0201484623541888
329.98,330,2203,2318,4406,4636,2024-02-01,2024-02-16,482.88,115,230,187049931,90530418,0.00247848260366372,99.9932771961301,0.049611734253667
468.6,484,2,3,2632,4620,2024-02-01,2024-08-16,482.88,1,1988,25910468,4922867,0.0178306312336774,99.8205281355783,0.43030303030303
475.67,491,3,3,4599,4599,2024-02-01,2024-08-16,482.88,0,0,25910468,4922867,0.017749582909888,99.8382777184882,0
484.41,530,1,1,4443,4559,2024-02-01,2024-04-19,482.88,0,116,232702399,73324968,0.0019591547055774,99.9971495781614,0.0254441763544637
465.92,481,0,3,0,4524,2024-02-01,2024-08-16,482.88,3,4524,25910468,4922867,0.01746012461064,99.8557378430988,1
486,530,1,1,4400,4400,2024-02-01,2024-09-20,482.88,0,0,275196706,45340715,0.00159885634677619,99.9942383031285,0
404.88,405,365,365,4380,4380,2024-02-01,2024-02-23,482.88,0,0,38550562,1795056,0.0113617020680529,99.9507659577051,0
480.1,502,3,2,5997,4380,2024-02-01,2024-06-21,482.88,-1,-1617,413696011,79729983,0.00105874842481863,99.999712832619,-0.369178082191781
373.01,375,22,22,4378,4378,2024-02-01,2024-08-16,482.88,0,0,25910468,4922867,0.0168966457881039,99.8726344888869,0
489.71,504,3,3,4287,4287,2024-02-01,2024-03-15,482.88,0,0,452229307,160916150,0.000947970406526528,99.9969951085015,0
209.67,210,128,128,4224,4224,2024-02-01,2024-09-20,482.88,0,0,275196706,45340715,0.00153490209290514,99.9957732052214,0
254.85,255,278,278,4170,4170,2024-02-01,2024-05-17,482.88,0,0,66606452,19312622,0.00626065474858201,99.9796085820635,0
483.56,525,1,1,3450,4144,2024-02-01,2024-03-15,482.88,0,694,452229307,160916150,0.000916349280299961,99.9979114577818,0.167471042471042
419.97,420,1448,1365,2896,4095,2024-02-01,2024-02-02,482.88,-83,1199,59097355,35805173,0.0069292441260696,99.921010001209,0.292796092796093
204.68,205,125,127,3625,4064,2024-02-01,2024-09-20,482.88,2,439,275196706,45340715,0.00147676186211328,99.9972499670836,0.108021653543307
348.51,350,15,26,2235,3874,2024-02-01,2024-08-16,482.88,11,1639,25910468,4922867,0.0149514860171572,99.887585974904,0.423076923076923
349.94,350,232,642,1160,3852,2024-02-01,2024-02-23,482.88,410,2692,38550562,1795056,0.00999207222971224,99.9607580299348,0.698857736240914
194.74,195,145,145,3770,3770,2024-02-01,2024-09-20,482.88,0,0,275196706,45340715,0.00136992918803323,99.9986198962716,0
399.95,400,605,741,2420,3705,2024-02-01,2024-02-09,482.88,136,1285,48138698,26427571,0.00769651061189898,99.9746648735701,0.346828609986505
379.85,380,92,243,1012,3645,2024-02-01,2024-03-01,482.88,151,2633,50809473,20654916,0.0071738590951337,99.9861010170289,0.722359396433471
382.99,385,14,18,2520,3618,2024-02-01,2024-07-19,482.88,4,1098,4933850,1821237,0.0733301579902105,99.4932152375934,0.303482587064676
204.98,205,1766,1766,3532,3532,2024-02-01,2024-03-15,482.88,0,0,452229307,160916150,0.000781019705120527,99.9986924774869,0
304.81,305,182,182,3458,3458,2024-02-01,2024-04-19,482.88,0,0,232702399,73324968,0.00148601819958031,99.998635596361,0
369.99,370,3434,3434,3434,3434,2024-02-01,2024-02-02,482.88,0,0,59097355,35805173,0.00581075075187375,99.9268207519609,0
486.7,520,1,1,3230,3330,2024-02-01,2024-02-23,482.88,0,100,38550562,1795056,0.00863800636680731,99.9693960363016,0.03003003003003
379.88,380,265,274,2915,3288,2024-02-01,2024-02-23,482.88,9,373,38550562,1795056,0.00852905853875749,99.9779250948404,0.113442822384428
214.99,215,3239,3239,3239,3239,2024-02-01,2024-03-15,482.88,0,0,452229307,160916150,0.000716229565369588,99.9994087070522,0
487.66,520,1,1,3234,3234,2024-02-01,2024-08-16,482.88,0,0,25910468,4922867,0.0124814418635742,99.9000674167676,0
483.25,515,4110,1,10094160,3175,2024-02-01,2024-04-19,482.88,-4109,-10090985,232702399,73324968,0.00136440363900159,100,-3178.26299212598
426.98,427,5,1535,10,3070,2024-02-01,2024-02-02,482.88,1530,3060,59097355,35805173,0.00519481794066757,99.9320155699016,0.996742671009772
483.74,499,13,2,11830,3052,2024-02-01,2024-02-16,482.88,-11,-8778,187049931,90530418,0.00163164989352495,99.9949088460236,-2.87614678899083
244.87,245,233,233,3029,3029,2024-02-01,2024-05-17,482.88,0,0,66606452,19312622,0.00454760749003715,99.9841561895535,0
244.44,245,63,54,3276,3024,2024-02-01,2024-09-20,482.88,-9,-252,275196706,45340715,0.00109885036196618,99.9997187466336,-0.0833333333333333
324.94,325,503,503,3018,3018,2024-02-01,2024-03-08,482.88,0,0,44041877,11919273,0.00685256897656746,99.9531491357646,0
451.97,452,977,973,3908,2919,2024-02-01,2024-02-02,482.88,-4,-989,59097355,35805173,0.00493930735140346,99.936954877253,-0.33881466255567
399.78,400,113,128,1808,2816,2024-02-01,2024-03-01,482.88,15,1008,50809473,20654916,0.0055422735835107,99.9916432906124,0.357954545454545
487.12,515,1,1,2773,2788,2024-02-01,2024-03-08,482.88,0,15,44041877,11919273,0.0063303387364712,99.9594794745011,0.00538020086083214
349.99,350,2782,2782,2782,2782,2024-02-01,2024-02-02,482.88,0,0,59097355,35805173,0.00470748648564728,99.9416623637386,0
289.34,290,42,42,2772,2772,2024-02-01,2024-08-16,482.88,0,0,25910468,4922867,0.0106983787402065,99.9107657955078,0
387.91,390,12,13,2496,2717,2024-02-01,2024-07-19,482.88,1,221,4933850,1821237,0.0550685570092321,99.5482837946026,0.0813397129186603
379.83,380,159,159,2703,2703,2024-02-01,2024-03-08,482.88,0,0,44041877,11919273,0.00613734060426171,99.9656168151053,0
209.99,210,2674,2674,2674,2674,2024-02-01,2024-03-15,482.88,0,0,452229307,160916150,0.000591292947761123,100,0
314.98,315,1331,1331,2662,2662,2024-02-01,2024-02-16,482.88,0,0,187049931,90530418,0.00142314941564988,99.9963319954392,0
323.94,325,25,25,2650,2650,2024-02-01,2024-08-16,482.88,0,0,25910468,4922867,0.0102275265734297,99.9209933220813,0
483.8,510,10,1,18800,2620,2024-02-01,2024-02-02,482.88,-9,-16180,59097355,35805173,0.00443336254219838,99.9460957262808,-6.17557251908397
489.35,498,3,3,2595,2595,2024-02-01,2024-02-23,482.88,0,0,38550562,1795056,0.00673141937593543,99.9846565142163,0
264.83,265,150,150,2550,2550,2024-02-01,2024-05-17,482.88,0,0,66606452,19312622,0.00382845793978037,99.9879846474933,0
438.97,439,545,849,2725,2547,2024-02-01,2024-02-02,482.88,304,-178,59097355,35805173,0.0043098375553356,99.9504055638361,-0.0698861405575187
389.79,390,101,121,1919,2541,2024-02-01,2024-03-08,482.88,20,622,44041877,11919273,0.00576950886993304,99.9713863239753,0.24478551751279
378.2,380,6,14,1002,2520,2024-02-01,2024-07-19,482.88,8,1518,4933850,1821237,0.0510757319334799,99.5993595265361,0.602380952380952
453.7,462,4,3,2920,2490,2024-02-01,2024-07-19,482.88,-1,-430,4933850,1821237,0.0504676875057004,99.6498272140418,-0.172690763052209
420.98,421,39,1233,117,2466,2024-02-01,2024-02-02,482.88,1194,2349,59097355,35805173,0.00417277558361115,99.9545783394198,0.952554744525547
463.88,476,0,2,0,2424,2024-02-01,2024-07-19,482.88,2,2424,4933850,1821237,0.0491299897645855,99.6989572038064,1
487.11,510,1388,1,2660796,2289,2024-02-01,2024-03-08,482.88,-1387,-2658507,44041877,11919273,0.00519732617208844,99.9765836501473,-1161.42726081258
234.99,235,2230,2230,2230,2230,2024-02-01,2024-02-16,482.88,0,0,187049931,90530418,0.00119219504015749,99.9975241904794,0
460.86,472,2,2,2228,2228,2024-02-01,2024-08-16,482.88,0,0,25910468,4922867,0.0085988412096609,99.9295921632909,0
318.95,320,1,21,101,2205,2024-02-01,2024-08-16,482.88,20,2104,25910468,4922867,0.00851007399789151,99.9381022372888,0.954195011337868
483.13,505,4421,1,6520975,2187,2024-02-01,2024-02-23,482.88,-4420,-6518788,38550562,1795056,0.00567306904630859,99.9903295832626,-2980.69867398262
460.41,471,2,2,2118,2118,2024-02-01,2024-08-16,482.88,0,0,25910468,4922867,0.00817430237076382,99.9462765396596,0
254.99,255,2082,2082,2082,2082,2024-02-01,2024-02-16,482.88,0,0,187049931,90530418,0.00111307178188694,99.9986372622613,0
334.6,335,52,52,2080,2080,2024-02-01,2024-05-17,482.88,0,0,66606452,19312622,0.00312282059401693,99.9911074680873,0
484.06,504,1,1,1994,1994,2024-02-01,2024-07-19,482.88,0,0,4933850,1821237,0.0404146862997456,99.7393718901061,0
358.25,360,7,11,1106,1925,2024-02-01,2024-08-16,482.88,4,819,25910468,4922867,0.00742942968069894,99.9537059693403,0.425454545454546
354.99,355,1921,1921,1921,1921,2024-02-01,2024-02-02,482.88,0,0,59097355,35805173,0.00325056848990957,99.9578289079097,0
419.58,420,35,45,1050,1890,2024-02-01,2024-03-08,482.88,10,840,44041877,11919273,0.00429137023383449,99.9808750203812,0.444444444444444
359.98,360,479,943,958,1886,2024-02-01,2024-02-09,482.88,464,928,48138698,26427571,0.00391784588773049,99.9785827194579,0.492046659597031
488.08,497.5,2,2,1884,1884,2024-02-01,2024-03-08,482.88,0,0,44041877,11919273,0.00427774683626677,99.9851527672175,0
384.89,385,170,170,1870,1870,2024-02-01,2024-02-23,482.88,0,0,38550562,1795056,0.00485077234412303,99.9951803556068,0
344.91,345,202,206,2020,1854,2024-02-01,2024-03-08,482.88,4,-166,44041877,11919273,0.00420962984842812,99.9893623970659,-0.0895361380798275
482.62,501,1,1,1838,1838,2024-02-01,2024-07-19,482.88,0,0,4933850,1821237,0.0372528552752921,99.7766247453814,0
483.72,502,75,1,83325,1828,2024-02-01,2024-02-09,482.88,-74,-81497,48138698,26427571,0.00379736070136338,99.9823800801592,-44.5826039387309
274.99,275,1776,1776,1776,1776,2024-02-01,2024-02-16,482.88,0,0,187049931,90530418,0.0009494790992465,99.9995867413605,0
483.35,501,2,1,2144,1765,2024-02-01,2024-02-02,482.88,-1,-379,59097355,35805173,0.00298659728510692,99.9608155051948,-0.214730878186969
430.98,431,773,845,1546,1690,2024-02-01,2024-02-02,482.88,72,144,59097355,35805173,0.00285968805202872,99.9636751932468,0.0852071005917158
455.66,464,4,2,3032,1668,2024-02-01,2024-07-19,482.88,-2,-1364,4933850,1821237,0.0338072701845415,99.810432015566,-0.817745803357314
384.99,385,1658,1658,1658,1658,2024-02-01,2024-02-02,482.88,0,0,59097355,35805173,0.00280554011258203,99.9664807333594,0
460.73,469,2,2,1654,1654,2024-02-01,2024-07-19,482.88,0,0,4933850,1821237,0.0335235161182444,99.8439555316842,0
354.35,355,24,25,1344,1625,2024-02-01,2024-05-17,482.88,1,281,66606452,19312622,0.00243970358907573,99.9935471716764,0.172923076923077
299.2,300,20,20,1600,1600,2024-02-01,2024-08-16,482.88,0,0,25910468,4922867,0.00617511038395756,99.9598810797242,0
404.72,405,5,55,150,1540,2024-02-01,2024-03-08,482.88,50,1390,44041877,11919273,0.00349667204238366,99.9928590691083,0.902597402597403
364.99,365,1536,1536,1536,1536,2024-02-01,2024-02-02,482.88,0,0,59097355,35805173,0.00259910109344149,99.9690798344528,0
442.97,443,403,512,1612,1536,2024-02-01,2024-02-02,482.88,109,-76,59097355,35805173,0.00259910109344149,99.9716789355463,-0.0494791666666667
379.97,380,507,507,1521,1521,2024-02-01,2024-02-09,482.88,0,0,48138698,26427571,0.00315962014593747,99.9855397003051,0
219.7,220,30,50,870,1500,2024-02-01,2024-08-16,482.88,20,630,25910468,4922867,0.00578916598496021,99.9656702457092,0.42
428.98,429,259,749,518,1498,2024-02-01,2024-02-02,482.88,490,980,59097355,35805173,0.00253480041534854,99.9742137359616,0.654205607476636
379.99,380,1455,1455,1455,1455,2024-02-01,2024-02-02,482.88,0,0,59097355,35805173,0.00246203912171704,99.9766757750833,0
358.7,360,2,11,270,1430,2024-02-01,2024-07-19,482.88,9,1160,4933850,1821237,0.0289834510574906,99.8729389827417,0.811188811188811
467.71,482,0,1,0,1429,2024-02-01,2024-08-16,482.88,1,1429,25910468,4922867,0.00551514546167209,99.9711853911709,1
409.99,410,1272,1340,2544,1340,2024-02-01,2024-02-02,482.88,68,-1204,59097355,35805173,0.00226744496433047,99.9789432200477,-0.898507462686567
359.9,360,131,132,1179,1320,2024-02-01,2024-03-01,482.88,1,141,50809473,20654916,0.00259794074227064,99.9942412313546,0.106818181818182
389.99,390,1314,1314,1314,1314,2024-02-01,2024-02-02,482.88,0,0,59097355,35805173,0.00222344976353003,99.9811666698112,0
462.94,476,1,1,1121,1306,2024-02-01,2024-08-16,482.88,0,185,25910468,4922867,0.00504043385090536,99.9762258250218,0.141653905053599
443.98,444,646,646,2584,1292,2024-02-01,2024-02-02,482.88,0,-1292,59097355,35805173,0.00218622305516042,99.9833528928664,-1
486.39,499,131,1,124450,1261,2024-02-01,2024-02-09,482.88,-130,-123189,48138698,26427571,0.00261951413808491,99.9881592144432,-97.6915146708961
394.8,395,61,61,1220,1220,2024-02-01,2024-03-08,482.88,0,0,44041877,11919273,0.00277009083877147,99.995629159947,0
299.71,300,23,41,667,1189,2024-02-01,2024-05-17,482.88,18,522,66606452,19312622,0.00178511234917602,99.9953322840256,0.439024390243902
446.06,452,0,2,0,1188,2024-02-01,2024-06-21,482.88,2,1188,413696011,79729983,0.000287167380978203,100,1
412.05,415,4,4,1180,1180,2024-02-01,2024-07-19,482.88,0,0,4933850,1821237,0.0239164141593279,99.896855396901,0
374.89,375,107,107,1177,1177,2024-02-01,2024-03-01,482.88,0,0,50809473,20654916,0.00231649716185799,99.9965577285165,0
461.54,473,1,1,1146,1146,2024-02-01,2024-08-16,482.88,0,0,25910468,4922867,0.0044229228125096,99.9806487478343,0
353.22,355,5,6,740,1068,2024-02-01,2024-08-16,482.88,1,328,25910468,4922867,0.00412188618129167,99.9847706340156,0.307116104868914
359.93,360,148,149,888,1043,2024-02-01,2024-02-23,482.88,1,155,38550562,1795056,0.00270553772990391,99.9978858933367,0.148609779482263
274.8,275,47,51,940,1020,2024-02-01,2024-05-17,482.88,4,80.0000000000001,66606452,19312622,0.00153138317591215,99.9968636672015,0.0784313725490197
440.98,441,16,506,112,1012,2024-02-01,2024-02-02,482.88,490,900,59097355,35805173,0.00171242858500182,99.9850653214514,0.889328063241107
423.98,424,20,475,40,950,2024-02-01,2024-02-02,482.88,455,910,59097355,35805173,0.00160751695232384,99.9866728384037,0.957894736842105
392.68,395,2,4,412,928,2024-02-01,2024-07-19,482.88,2,516,4933850,1821237,0.0188088409659799,99.915664237867,0.556034482758621
459.11,468,1,1,889,889,2024-02-01,2024-07-19,482.88,0,0,4933850,1821237,0.0180183832098665,99.9336826210769,0
348.75,350,2,7,236,875,2024-02-01,2024-07-19,482.88,5,639,4933850,1821237,0.0177346291435694,99.9514172502204,0.730285714285714
367.83,370,3,4,585,868,2024-02-01,2024-08-16,482.88,1,283,25910468,4922867,0.00334999738329697,99.9881206313989,0.326036866359447
402.12,405,2,3,500,864,2024-02-01,2024-07-19,482.88,1,364,4933850,1821237,0.0175116795200503,99.9689289297405,0.421296296296296
427.98,428,30,429,60,858,2024-02-01,2024-02-02,482.88,399,798,59097355,35805173,0.00145184162641458,99.9881246800301,0.93006993006993
279.78,280,36,37,756,814,2024-02-01,2024-05-17,482.88,1,58,66606452,19312622,0.00122210382862009,99.9980857710301,0.0712530712530713
435.98,436,14,405,98,810,2024-02-01,2024-02-02,482.88,391,712,59097355,35805173,0.00137061971724454,99.9894952997474,0.879012345679012
264.51,265,16,16,784,784,2024-02-01,2024-08-16,482.88,0,0,25910468,4922867,0.0030258040881392,99.991146435487,0
450.87,451,0,60,0,780,2024-02-01,2024-02-09,482.88,60,780,48138698,26427571,0.00162031802355768,99.9897795324668,1
294.75,295,31,31,775,775,2024-02-01,2024-05-17,482.88,0,0,66606452,19312622,0.00116355094248227,99.9992493219726,0
164.82,165,43,43,774,774,2024-02-01,2024-09-20,482.88,0,0,275196706,45340715,0.000281253366455629,100,0
224.99,225,773,773,773,773,2024-02-01,2024-02-16,482.88,0,0,187049931,90530418,0.0004132586394806,100,0
369.88,370,30,64,270,768,2024-02-01,2024-03-01,482.88,34,498,50809473,20654916,0.00151152915913928,99.9980692576757,0.6484375
364.98,365,108,378,216,756,2024-02-01,2024-02-09,482.88,270,540,48138698,26427571,0.00157046208437129,99.9913499945512,0.714285714285714
399.71,400,14,26,308,754,2024-02-01,2024-03-08,482.88,12,446,44041877,11919273,0.00171200696101122,99.997341166908,0.591511936339523
389.96,390,186,179,744,716,2024-02-01,2024-02-09,482.88,-7,-28,48138698,26427571,0.00148736885239397,99.9928373634036,-0.0391061452513967
441.96,442,172,174,688,696,2024-02-01,2024-02-02,482.88,2,8,59097355,35805173,0.00117771768296568,99.9906730174303,0.0114942528735632
415.98,416,319,336,638,672,2024-02-01,2024-02-02,482.88,17,34,59097355,35805173,0.00113710672838065,99.9918101241587,0.0505952380952381
427.93,428,0,93,0,651,2024-02-01,2024-02-09,482.88,93,651,48138698,26427571,0.00135234235043083,99.994189705754,1
199.8,200,32,32,640,640,2024-02-01,2024-08-16,482.88,0,0,25910468,4922867,0.00247004415358302,99.9936164796406,0
404.96,405,147,148,588,592,2024-02-01,2024-02-09,482.88,1,4,48138698,26427571,0.00122977983326429,99.9954194855873,0.00675675675675676
359.99,360,585,585,585,585,2024-02-01,2024-02-02,482.88,0,0,59097355,35805173,0.000989892018009943,99.9928000161767,0
354.98,355,210,270,420,540,2024-02-01,2024-02-09,482.88,60,120,48138698,26427571,0.00112175863169378,99.9965412442189,0.222222222222222
416.99,417,491,532,982,532,2024-02-01,2024-02-02,482.88,41,-450,59097355,35805173,0.00090020949330135,99.99370022567,-0.845864661654135
274.48,275,10,10,520,520,2024-02-01,2024-08-16,482.88,0,0,25910468,4922867,0.00200691087478621,99.9956233905154,0
284.75,285,20,20,500,500,2024-02-01,2024-05-17,482.88,0,0,66606452,19312622,0.000750678027407915,100,0
422.98,423,9,240,9,480,2024-02-01,2024-02-02,482.88,231,471,59097355,35805173,0.000812219091700466,99.9945124447617,0.98125
254.65,255,0,13,0,455,2024-02-01,2024-07-19,482.88,13,455,4933850,1821237,0.0092220071546561,99.9781509368951,1
432.98,433,201,221,402,442,2024-02-01,2024-02-02,482.88,20,39.9999999999999,59097355,35805173,0.000747918413607513,99.9952603631753,0.090497737556561
423.93,424,0,63,0,441,2024-02-01,2024-02-09,482.88,63,441,48138698,26427571,0.000916102882549919,99.9974573471015,1
374.99,375,400,400,400,400,2024-02-01,2024-02-02,482.88,0,0,59097355,35805173,0.000676849243083722,99.9959372124184,0
408.99,409,303,399,909,399,2024-02-01,2024-02-02,482.88,96,-510,59097355,35805173,0.000675157119976013,99.9966123695384,-1.2781954887218
414.64,415,10,11,280,396,2024-02-01,2024-03-08,482.88,1,116,44041877,11919273,0.000899144239470084,99.9982403111475,0.292929292929293
437.95,438,76,76,380,380,2024-02-01,2024-02-02,482.88,0,0,59097355,35805173,0.000643006780929536,99.9972553763193,0
406.99,407,354,358,354,358,2024-02-01,2024-02-02,482.88,4,4,59097355,35805173,0.000605780072559931,99.9978611563919,0.0111731843575419
359.86,360,22,25,242,350,2024-02-01,2024-03-08,482.88,3,108,44041877,11919273,0.000794698191450832,99.999035009339,0.308571428571429
389.84,390,10,21,140,336,2024-02-01,2024-03-01,482.88,11,196,50809473,20654916,0.000661294007123436,99.9987305516828,0.583333333333333
418.93,419,0,47,0,329,2024-02-01,2024-02-09,482.88,47,329,48138698,26427571,0.000683441833013432,99.9981407889345,1
369.84,370,4,20,56,320,2024-02-01,2024-03-08,482.88,16,264,44041877,11919273,0.000726581203612189,99.9997615905426,0.825
433.98,434,33,149,198,298,2024-02-01,2024-02-02,482.88,116,100,59097355,35805173,0.000504252686097373,99.998365409078,0.335570469798658
338.59,340,1,2,129,282,2024-02-01,2024-08-16,482.88,1,153,25910468,4922867,0.00108836320517252,99.9967117537206,0.542553191489362
369.91,370,32,31,256,279,2024-02-01,2024-02-23,482.88,-1,23,38550562,1795056,0.000723724857759532,99.9986096181944,0.0824372759856631
309.34,310,3,4,195,264,2024-02-01,2024-07-19,482.88,1,69,4933850,1821237,0.0053507909644598,99.9835017278596,0.261363636363636
364.89,365,12,23,132,253,2024-02-01,2024-03-01,482.88,11,121,50809473,20654916,0.000497938642268539,99.999228490325,0.478260869565217
354.94,355,12,42,60,252,2024-02-01,2024-02-23,482.88,30,192,38550562,1795056,0.000653686968298932,99.9992633051627,0.761904761904762
328.86,330,1,2,115,228,2024-02-01,2024-08-16,482.88,1,113,25910468,4922867,0.000879953229713952,99.9975917069503,0.495614035087719
445.98,446,87,108,261,216,2024-02-01,2024-02-02,482.88,21,-45,59097355,35805173,0.00036549859126521,99.9987309076692,-0.208333333333333
324.94,325,18,36,90,216,2024-02-01,2024-03-01,482.88,18,126,50809473,20654916,0.000425117576007923,99.999653607901,0.583333333333333
374.91,375,21,23,189,207,2024-02-01,2024-02-23,482.88,2,18,38550562,1795056,0.000536957152531265,99.9998002623153,0.0869565217391303
447.9,448,0,20,0,200,2024-02-01,2024-02-09,482.88,20,200,48138698,26427571,0.000415466159886584,99.9985562550944,1
418.98,419,82,92,246,184,2024-02-01,2024-02-02,482.88,10,-62,59097355,35805173,0.000311350651818512,99.999042258321,-0.33695652173913
446.87,447,0,13,0,169,2024-02-01,2024-02-09,482.88,13,169,48138698,26427571,0.000351068905104164,99.9989073239995,1
324.16,325,2,2,168,168,2024-02-01,2024-07-19,482.88,0,0,4933850,1821237,0.00340504879556533,99.9869067766551,0
412.99,413,158,161,316,161,2024-02-01,2024-02-02,482.88,3,-155,59097355,35805173,0.000272431820341198,99.9993146901414,-0.962732919254658
428.92,429,0,20,0,160,2024-02-01,2024-02-09,482.88,20,160,48138698,26427571,0.000332372927909268,99.9992396969274,1
244.6,245,4,4,160,160,2024-02-01,2024-08-16,482.88,0,0,25910468,4922867,0.000617511038395756,99.9982092179887,0
368.48,370,1,1,152,152,2024-02-01,2024-07-19,482.88,0,0,4933850,1821237,0.00308075843408292,99.9899875350892,0
438.9,439,0,15,0,150,2024-02-01,2024-02-09,482.88,15,150,48138698,26427571,0.000311599619914938,99.9995512965473,1
343.62,345,0,1,0,138,2024-02-01,2024-08-16,482.88,1,138,25910468,4922867,0.000532603270616339,99.9987418212593,1
363.63,365,1,1,137,137,2024-02-01,2024-07-19,482.88,0,0,4933850,1821237,0.00277673622019316,99.9927642713094,0
369.99,370,92,125,184,125,2024-02-01,2024-02-09,482.88,33,-59,48138698,26427571,0.000259666349929115,99.9998109628972,-0.472
333.77,335,0,1,0,123,2024-02-01,2024-08-16,482.88,1,123,25910468,4922867,0.000474711610766737,99.99921653287,1
413.98,414,52,60,104,120,2024-02-01,2024-02-02,482.88,8,16,59097355,35805173,0.000203054772925117,99.9995177449143,0.133333333333333
329.94,330,18,18,108,108,2024-02-01,2024-03-01,482.88,0,0,50809473,20654916,0.000212558788003961,99.999866166689,0
333.94,335,0,1,0,106,2024-02-01,2024-07-19,482.88,1,106,4933850,1821237,0.00214842364482098,99.9949126949543,1
343.95,345,1,1,105,105,2024-02-01,2024-07-19,482.88,0,0,4933850,1821237,0.00212815549722833,99.9970408504515,0
254.55,255,2,2,90,90,2024-02-01,2024-08-16,482.88,0,0,25910468,4922867,0.000347349959097613,99.9995638828291,0
410.99,411,87,88,261,88,2024-02-01,2024-02-02,482.88,1,-173,59097355,35805173,0.000148906833478419,99.9996666517478,-1.96590909090909
329.12,330,1,1,88,88,2024-02-01,2024-07-19,482.88,0,0,4933850,1821237,0.00178359698815327,99.9988244474396,0
364.93,365,11,11,88,77,2024-02-01,2024-02-23,482.88,0,-11,38550562,1795056,0.000199737684758007,100,-0.142857142857143
407.99,408,37,62,74,62,2024-02-01,2024-02-02,482.88,25,-12,59097355,35805173,0.000104911632677977,99.9997715633805,-0.193548387096774
431.98,432,30,31,60,62,2024-02-01,2024-02-02,482.88,1,2,59097355,35805173,0.000104911632677977,99.9998764750131,0.032258064516129
294.42,295,0,1,0,58,2024-02-01,2024-07-19,482.88,1,58,4933850,1821237,0.00117555256037374,100,1
411.99,412,33,57,66,57,2024-02-01,2024-02-02,482.88,24,-8.99999999999999,59097355,35805173,9.64510171394303e-05,99.9999729260303,-0.157894736842105
269.5,270,1,1,50,50,2024-02-01,2024-08-16,482.88,0,0,25910468,4922867,0.000192972199498674,99.9997568550286,0
354.92,355,5,5,40,40,2024-02-01,2024-03-01,482.88,0,0,50809473,20654916,7.87254770385042e-05,99.9999448921661,0
374.81,375,0,2,0,38,2024-02-01,2024-03-08,482.88,2,38,44041877,11919273,8.62815179289475e-05,99.9998478720605,1
229.67,230,1,1,33,33,2024-02-01,2024-08-16,482.88,0,0,25910468,4922867,0.000127361651669125,99.9998842166803,0
224.7,225,1,1,30,30,2024-02-01,2024-08-16,482.88,0,0,25910468,4922867,0.000115783319699204,100,0
349.89,350,0,2,0,22,2024-02-01,2024-03-08,482.88,2,22,44041877,11919273,4.9952457748338e-05,99.9998978245183,1
422.93,423,0,3,0,21,2024-02-01,2024-02-09,482.88,3,21,48138698,26427571,4.36239467880914e-05,99.999854586844,1
443.9,444,0,2,0,20,2024-02-01,2024-02-09,482.88,2,20,48138698,26427571,4.15466159886584e-05,99.99989613346,1
339.9,340,0,2,0,20,2024-02-01,2024-03-08,482.88,2,20,44041877,11919273,4.54113252257618e-05,99.9999432358435,1
339.92,340,2,2,16,16,2024-02-01,2024-03-01,482.88,0,0,50809473,20654916,3.14901908154017e-05,99.9999763823569,0
364.85,365,1,1,15,15,2024-02-01,2024-03-08,482.88,0,0,44041877,11919273,3.40584939193214e-05,99.9999772943374,0
417.99,418,13,13,13,13,2024-02-01,2024-02-02,482.88,0,0,59097355,35805173,2.1997600400221e-05,99.9999949236307,0
334.94,335,0,2,0,12,2024-02-01,2024-03-01,482.88,2,12,50809473,20654916,2.36176431115513e-05,100,1
440.9,441,0,1,0,10,2024-02-01,2024-02-09,482.88,1,10,48138698,26427571,2.07733079943292e-05,99.999916906768,1
354.9,355,1,1,10,10,2024-02-01,2024-03-08,482.88,0,0,44041877,11919273,2.27056626128809e-05,100,0
432.91,433,0,1,0,9,2024-02-01,2024-02-09,482.88,1,9,48138698,26427571,1.86959771948963e-05,99.9999356027452,1
433.91,434,0,1,0,9,2024-02-01,2024-02-09,482.88,1,9,48138698,26427571,1.86959771948963e-05,99.9999542987224,1
436.91,437,0,1,0,9,2024-02-01,2024-02-09,482.88,1,9,48138698,26427571,1.86959771948963e-05,99.9999729946996,1
425.93,426,0,1,0,7,2024-02-01,2024-02-09,482.88,1,7,48138698,26427571,1.45413155960305e-05,99.9999875360152,1
417.94,418,0,1,0,6,2024-02-01,2024-02-09,482.88,1,6,48138698,26427571,1.24639847965975e-05,100,1
421.99,422,3,3,9,3,2024-02-01,2024-02-02,482.88,0,-6,59097355,35805173,5.07636932312791e-06,100,-2
483.33,499,11,0,8756,0,2024-02-01,2024-02-02,482.88,-11,-8756,59097355,35805173,0,100,-Inf
491,502,0,0,0,0,2024-02-01,2024-02-02,482.88,0,0,59097355,35805173,0,100,
487.48,504,5,0,6500,0,2024-02-01,2024-02-02,482.88,-5,-6500,59097355,35805173,0,100,-Inf
487.74,506,1,0,1844,0,2024-02-01,2024-02-02,482.88,-1,-1844,59097355,35805173,0,100,-Inf
487.47,508,0,0,0,0,2024-02-01,2024-02-02,482.88,0,0,59097355,35805173,0,100,
512,512,0,0,0,0,2024-02-01,2024-02-02,482.88,0,0,59097355,35805173,0,100,
472.42,514,0,0,0,0,2024-02-01,2024-02-02,482.88,0,0,59097355,35805173,0,100,
477.5,515,0,0,0,0,2024-02-01,2024-02-02,482.88,0,0,59097355,35805173,0,100,
520,520,0,0,0,0,2024-02-01,2024-02-02,482.88,0,0,59097355,35805173,0,100,
525,525,0,0,0,0,2024-02-01,2024-02-02,482.88,0,0,59097355,35805173,0,100,
472.27,530,0,0,0,0,2024-02-01,2024-02-02,482.88,0,0,59097355,35805173,0,100,
472.25,535,0,0,0,0,2024-02-01,2024-02-02,482.88,0,0,59097355,35805173,0,100,
476.33,540,0,0,0,0,2024-02-01,2024-02-02,482.88,0,0,59097355,35805173,0,100,
491.21,545,0,0,0,0,2024-02-01,2024-02-02,482.88,0,0,59097355,35805173,0,100,
550,550,0,0,0,0,2024-02-01,2024-02-02,482.88,0,0,59097355,35805173,0,100,
555,555,0,0,0,0,2024-02-01,2024-02-02,482.88,0,0,59097355,35805173,0,100,
488.82,560,0,0,0,0,2024-02-01,2024-02-02,482.88,0,0,59097355,35805173,0,100,
421,421,0,0,0,0,2024-02-01,2024-02-09,482.88,0,0,48138698,26427571,0,100,
422,422,0,0,0,0,2024-02-01,2024-02-09,482.88,0,0,48138698,26427571,0,100,
427,427,0,0,0,0,2024-02-01,2024-02-09,482.88,0,0,48138698,26427571,0,100,
431,431,0,0,0,0,2024-02-01,2024-02-09,482.88,0,0,48138698,26427571,0,100,
432,432,0,0,0,0,2024-02-01,2024-02-09,482.88,0,0,48138698,26427571,0,100,
436,436,0,0,0,0,2024-02-01,2024-02-09,482.88,0,0,48138698,26427571,0,100,
438,438,0,0,0,0,2024-02-01,2024-02-09,482.88,0,0,48138698,26427571,0,100,
442,442,0,0,0,0,2024-02-01,2024-02-09,482.88,0,0,48138698,26427571,0,100,
443,443,0,0,0,0,2024-02-01,2024-02-09,482.88,0,0,48138698,26427571,0,100,
446,446,0,0,0,0,2024-02-01,2024-02-09,482.88,0,0,48138698,26427571,0,100,
449,449,0,0,0,0,2024-02-01,2024-02-09,482.88,0,0,48138698,26427571,0,100,
483.3,501,44,0,45980,0,2024-02-01,2024-02-09,482.88,-44,-45980,48138698,26427571,0,100,-Inf
483.72,504,501,0,648795,0,2024-02-01,2024-02-09,482.88,-501,-648795,48138698,26427571,0,100,-Inf
491.05,505,0,0,0,0,2024-02-01,2024-02-09,482.88,0,0,48138698,26427571,0,100,
486.16,506,0,0,0,0,2024-02-01,2024-02-09,482.88,0,0,48138698,26427571,0,100,
488.42,508,0,0,0,0,2024-02-01,2024-02-09,482.88,0,0,48138698,26427571,0,100,
488.82,510,0,0,0,0,2024-02-01,2024-02-09,482.88,0,0,48138698,26427571,0,100,
512,512,0,0,0,0,2024-02-01,2024-02-09,482.88,0,0,48138698,26427571,0,100,
514,514,0,0,0,0,2024-02-01,2024-02-09,482.88,0,0,48138698,26427571,0,100,
469.41,515,0,0,0,0,2024-02-01,2024-02-09,482.88,0,0,48138698,26427571,0,100,
468.3,520,0,0,0,0,2024-02-01,2024-02-09,482.88,0,0,48138698,26427571,0,100,
525,525,0,0,0,0,2024-02-01,2024-02-09,482.88,0,0,48138698,26427571,0,100,
530,530,0,0,0,0,2024-02-01,2024-02-09,482.88,0,0,48138698,26427571,0,100,
535,535,0,0,0,0,2024-02-01,2024-02-09,482.88,0,0,48138698,26427571,0,100,
486.5,540,2,0,9840,0,2024-02-01,2024-02-09,482.88,-2,-9840,48138698,26427571,0,100,-Inf
545,545,0,0,0,0,2024-02-01,2024-02-09,482.88,0,0,48138698,26427571,0,100,
550,550,0,0,0,0,2024-02-01,2024-02-09,482.88,0,0,48138698,26427571,0,100,
555,555,0,0,0,0,2024-02-01,2024-02-09,482.88,0,0,48138698,26427571,0,100,
560,560,0,0,0,0,2024-02-01,2024-02-09,482.88,0,0,48138698,26427571,0,100,
490.21,501,177,0,190983,0,2024-02-01,2024-02-16,482.88,-177,-190983,187049931,90530418,0,100,-Inf
483.73,506,57,0,84474,0,2024-02-01,2024-02-16,482.88,-57,-84474,187049931,90530418,0,100,-Inf
490.62,508,0,0,0,0,2024-02-01,2024-02-16,482.88,0,0,187049931,90530418,0,100,
491.12,510,0,0,0,0,2024-02-01,2024-02-16,482.88,0,0,187049931,90530418,0,100,
490.77,512,0,0,0,0,2024-02-01,2024-02-16,482.88,0,0,187049931,90530418,0,100,
514,514,0,0,0,0,2024-02-01,2024-02-16,482.88,0,0,187049931,90530418,0,100,
487.95,515,1,0,2477,0,2024-02-01,2024-02-16,482.88,-1,-2477,187049931,90530418,0,100,-Inf
516,516,0,0,0,0,2024-02-01,2024-02-16,482.88,0,0,187049931,90530418,0,100,
518,518,0,0,0,0,2024-02-01,2024-02-16,482.88,0,0,187049931,90530418,0,100,
483.44,520,0,0,0,0,2024-02-01,2024-02-16,482.88,0,0,187049931,90530418,0,100,
522,522,0,0,0,0,2024-02-01,2024-02-16,482.88,0,0,187049931,90530418,0,100,
474.69,524,0,0,0,0,2024-02-01,2024-02-16,482.88,0,0,187049931,90530418,0,100,
485.41,525,0,0,0,0,2024-02-01,2024-02-16,482.88,0,0,187049931,90530418,0,100,
526,526,0,0,0,0,2024-02-01,2024-02-16,482.88,0,0,187049931,90530418,0,100,
487.68,530,0,0,0,0,2024-02-01,2024-02-16,482.88,0,0,187049931,90530418,0,100,
475.12,535,0,0,0,0,2024-02-01,2024-02-16,482.88,0,0,187049931,90530418,0,100,
449.41,540,0,0,0,0,2024-02-01,2024-02-16,482.88,0,0,187049931,90530418,0,100,
486.91,550,0,0,0,0,2024-02-01,2024-02-16,482.88,0,0,187049931,90530418,0,100,
555,555,0,0,0,0,2024-02-01,2024-02-16,482.88,0,0,187049931,90530418,0,100,
560,560,0,0,0,0,2024-02-01,2024-02-16,482.88,0,0,187049931,90530418,0,100,
483.85,565,0,0,0,0,2024-02-01,2024-02-16,482.88,0,0,187049931,90530418,0,100,
570,570,0,0,0,0,2024-02-01,2024-02-16,482.88,0,0,187049931,90530418,0,100,
478.7,575,0,0,0,0,2024-02-01,2024-02-16,482.88,0,0,187049931,90530418,0,100,
490.23,501,358,0,385566,0,2024-02-01,2024-02-23,482.88,-358,-385566,38550562,1795056,0,100,-Inf
483.73,508,74,0,129870,0,2024-02-01,2024-02-23,482.88,-74,-129870,38550562,1795056,0,100,-Inf
490.59,510,0,0,0,0,2024-02-01,2024-02-23,482.88,0,0,38550562,1795056,0,100,
512,512,0,0,0,0,2024-02-01,2024-02-23,482.88,0,0,38550562,1795056,0,100,
483.31,514,0,0,0,0,2024-02-01,2024-02-23,482.88,0,0,38550562,1795056,0,100,
484.83,515,0,0,0,0,2024-02-01,2024-02-23,482.88,0,0,38550562,1795056,0,100,
525,525,0,0,0,0,2024-02-01,2024-02-23,482.88,0,0,38550562,1795056,0,100,
530,530,0,0,0,0,2024-02-01,2024-02-23,482.88,0,0,38550562,1795056,0,100,
535,535,0,0,0,0,2024-02-01,2024-02-23,482.88,0,0,38550562,1795056,0,100,
540,540,0,0,0,0,2024-02-01,2024-02-23,482.88,0,0,38550562,1795056,0,100,
485,545,0,0,0,0,2024-02-01,2024-02-23,482.88,0,0,38550562,1795056,0,100,
555,555,0,0,0,0,2024-02-01,2024-02-23,482.88,0,0,38550562,1795056,0,100,
560,560,0,0,0,0,2024-02-01,2024-02-23,482.88,0,0,38550562,1795056,0,100,
345,345,0,0,0,0,2024-02-01,2024-03-01,482.88,0,0,50809473,20654916,0,100,
491.1,510,0,0,0,0,2024-02-01,2024-03-01,482.88,0,0,50809473,20654916,0,100,
491.14,515,0,0,0,0,2024-02-01,2024-03-01,482.88,0,0,50809473,20654916,0,100,
487.94,520,0,0,0,0,2024-02-01,2024-03-01,482.88,0,0,50809473,20654916,0,100,
530,530,0,0,0,0,2024-02-01,2024-03-01,482.88,0,0,50809473,20654916,0,100,
483.33,535,0,0,0,0,2024-02-01,2024-03-01,482.88,0,0,50809473,20654916,0,100,
540,540,0,0,0,0,2024-02-01,2024-03-01,482.88,0,0,50809473,20654916,0,100,
545,545,0,0,0,0,2024-02-01,2024-03-01,482.88,0,0,50809473,20654916,0,100,
550,550,0,0,0,0,2024-02-01,2024-03-01,482.88,0,0,50809473,20654916,0,100,
555,555,0,0,0,0,2024-02-01,2024-03-01,482.88,0,0,50809473,20654916,0,100,
560,560,0,0,0,0,2024-02-01,2024-03-01,482.88,0,0,50809473,20654916,0,100,
330,330,0,0,0,0,2024-02-01,2024-03-08,482.88,0,0,44041877,11919273,0,100,
335,335,0,0,0,0,2024-02-01,2024-03-08,482.88,0,0,44041877,11919273,0,100,
525,525,0,0,0,0,2024-02-01,2024-03-08,482.88,0,0,44041877,11919273,0,100,
530,530,0,0,0,0,2024-02-01,2024-03-08,482.88,0,0,44041877,11919273,0,100,
535,535,0,0,0,0,2024-02-01,2024-03-08,482.88,0,0,44041877,11919273,0,100,
540,540,0,0,0,0,2024-02-01,2024-03-08,482.88,0,0,44041877,11919273,0,100,
545,545,0,0,0,0,2024-02-01,2024-03-08,482.88,0,0,44041877,11919273,0,100,
550,550,0,0,0,0,2024-02-01,2024-03-08,482.88,0,0,44041877,11919273,0,100,
555,555,0,0,0,0,2024-02-01,2024-03-08,482.88,0,0,44041877,11919273,0,100,
560,560,0,0,0,0,2024-02-01,2024-03-08,482.88,0,0,44041877,11919273,0,100,
486.8,506,21,0,34188,0,2024-02-01,2024-03-15,482.88,-21,-34188,452229307,160916150,0,100,-Inf
486.8,508,47,0,84036,0,2024-02-01,2024-03-15,482.88,-47,-84036,452229307,160916150,0,100,-Inf
490.41,512,1,0,2159,0,2024-02-01,2024-03-15,482.88,-1,-2159,452229307,160916150,0,100,-Inf
514,514,0,0,0,0,2024-02-01,2024-03-15,482.88,0,0,452229307,160916150,0,100,
483.52,515,0,0,0,0,2024-02-01,2024-03-15,482.88,0,0,452229307,160916150,0,100,
516,516,0,0,0,0,2024-02-01,2024-03-15,482.88,0,0,452229307,160916150,0,100,
518,518,0,0,0,0,2024-02-01,2024-03-15,482.88,0,0,452229307,160916150,0,100,
522,522,0,0,0,0,2024-02-01,2024-03-15,482.88,0,0,452229307,160916150,0,100,
524,524,0,0,0,0,2024-02-01,2024-03-15,482.88,0,0,452229307,160916150,0,100,
476.12,526,0,0,0,0,2024-02-01,2024-03-15,482.88,0,0,452229307,160916150,0,100,
471.47,530,0,0,0,0,2024-02-01,2024-03-15,482.88,0,0,452229307,160916150,0,100,
535,535,0,0,0,0,2024-02-01,2024-03-15,482.88,0,0,452229307,160916150,0,100,
490.37,540,0,0,0,0,2024-02-01,2024-03-15,482.88,0,0,452229307,160916150,0,100,
545,545,0,0,0,0,2024-02-01,2024-03-15,482.88,0,0,452229307,160916150,0,100,
490.71,555,0,0,0,0,2024-02-01,2024-03-15,482.88,0,0,452229307,160916150,0,100,
469,560,0,0,0,0,2024-02-01,2024-03-15,482.88,0,0,452229307,160916150,0,100,
487.26,570,0,0,0,0,2024-02-01,2024-03-15,482.88,0,0,452229307,160916150,0,100,
475.86,575,0,0,0,0,2024-02-01,2024-03-15,482.88,0,0,452229307,160916150,0,100,
580,580,0,0,0,0,2024-02-01,2024-03-15,482.88,0,0,452229307,160916150,0,100,
585,585,0,0,0,0,2024-02-01,2024-03-15,482.88,0,0,452229307,160916150,0,100,
590,590,0,0,0,0,2024-02-01,2024-03-15,482.88,0,0,452229307,160916150,0,100,
595,595,0,0,0,0,2024-02-01,2024-03-15,482.88,0,0,452229307,160916150,0,100,
437.6,600,0,0,0,0,2024-02-01,2024-03-15,482.88,0,0,452229307,160916150,0,100,
437.53,605,0,0,0,0,2024-02-01,2024-03-15,482.88,0,0,452229307,160916150,0,100,
437.54,610,0,0,0,0,2024-02-01,2024-03-15,482.88,0,0,452229307,160916150,0,100,
615,615,0,0,0,0,2024-02-01,2024-03-15,482.88,0,0,452229307,160916150,0,100,
427.75,620,0,0,0,0,2024-02-01,2024-03-15,482.88,0,0,452229307,160916150,0,100,
437.59,625,0,0,0,0,2024-02-01,2024-03-15,482.88,0,0,452229307,160916150,0,100,
630,630,0,0,0,0,2024-02-01,2024-03-15,482.88,0,0,452229307,160916150,0,100,
635,635,0,0,0,0,2024-02-01,2024-03-15,482.88,0,0,452229307,160916150,0,100,
640,640,0,0,0,0,2024-02-01,2024-03-15,482.88,0,0,452229307,160916150,0,100,
449.85,645,0,0,0,0,2024-02-01,2024-03-15,482.88,0,0,452229307,160916150,0,100,
450.05,650,0,0,0,0,2024-02-01,2024-03-15,482.88,0,0,452229307,160916150,0,100,
655,655,0,0,0,0,2024-02-01,2024-03-15,482.88,0,0,452229307,160916150,0,100,
487.59,660,0,0,0,0,2024-02-01,2024-03-15,482.88,0,0,452229307,160916150,0,100,
483.66,525,1,0,3670,0,2024-02-01,2024-04-19,482.88,-1,-3670,232702399,73324968,0,100,-Inf
484.73,535,0,0,0,0,2024-02-01,2024-04-19,482.88,0,0,232702399,73324968,0,100,
454.92,540,0,0,0,0,2024-02-01,2024-04-19,482.88,0,0,232702399,73324968,0,100,
545,545,0,0,0,0,2024-02-01,2024-04-19,482.88,0,0,232702399,73324968,0,100,
475,550,0,0,0,0,2024-02-01,2024-04-19,482.88,0,0,232702399,73324968,0,100,
555,555,0,0,0,0,2024-02-01,2024-04-19,482.88,0,0,232702399,73324968,0,100,
490.41,560,0,0,0,0,2024-02-01,2024-04-19,482.88,0,0,232702399,73324968,0,100,
472.53,565,0,0,0,0,2024-02-01,2024-04-19,482.88,0,0,232702399,73324968,0,100,
575,575,0,0,0,0,2024-02-01,2024-04-19,482.88,0,0,232702399,73324968,0,100,
487.54,580,0,0,0,0,2024-02-01,2024-04-19,482.88,0,0,232702399,73324968,0,100,
585,585,0,0,0,0,2024-02-01,2024-04-19,482.88,0,0,232702399,73324968,0,100,
468.35,590,0,0,0,0,2024-02-01,2024-04-19,482.88,0,0,232702399,73324968,0,100,
595,595,0,0,0,0,2024-02-01,2024-04-19,482.88,0,0,232702399,73324968,0,100,
490.88,600,0,0,0,0,2024-02-01,2024-04-19,482.88,0,0,232702399,73324968,0,100,
484.81,515,0,0,0,0,2024-02-01,2024-05-17,482.88,0,0,66606452,19312622,0,100,
487.91,525,0,0,0,0,2024-02-01,2024-05-17,482.88,0,0,66606452,19312622,0,100,
482.44,530,0,0,0,0,2024-02-01,2024-05-17,482.88,0,0,66606452,19312622,0,100,
535,535,0,0,0,0,2024-02-01,2024-05-17,482.88,0,0,66606452,19312622,0,100,
540,540,0,0,0,0,2024-02-01,2024-05-17,482.88,0,0,66606452,19312622,0,100,
545,545,0,0,0,0,2024-02-01,2024-05-17,482.88,0,0,66606452,19312622,0,100,
550,550,0,0,0,0,2024-02-01,2024-05-17,482.88,0,0,66606452,19312622,0,100,
555,555,0,0,0,0,2024-02-01,2024-05-17,482.88,0,0,66606452,19312622,0,100,
560,560,0,0,0,0,2024-02-01,2024-05-17,482.88,0,0,66606452,19312622,0,100,
565,565,0,0,0,0,2024-02-01,2024-05-17,482.88,0,0,66606452,19312622,0,100,
570,570,0,0,0,0,2024-02-01,2024-05-17,482.88,0,0,66606452,19312622,0,100,
575,575,0,0,0,0,2024-02-01,2024-05-17,482.88,0,0,66606452,19312622,0,100,
580,580,0,0,0,0,2024-02-01,2024-05-17,482.88,0,0,66606452,19312622,0,100,
488.6,520,43,0,126377,0,2024-02-01,2024-06-21,482.88,-43,-126377,413696011,79729983,0,100,-Inf
476.73,530,0,0,0,0,2024-02-01,2024-06-21,482.88,0,0,413696011,79729983,0,100,
488.98,535,0,0,0,0,2024-02-01,2024-06-21,482.88,0,0,413696011,79729983,0,100,
473.74,540,0,0,0,0,2024-02-01,2024-06-21,482.88,0,0,413696011,79729983,0,100,
434.94,545,0,0,0,0,2024-02-01,2024-06-21,482.88,0,0,413696011,79729983,0,100,
484.75,555,0,0,0,0,2024-02-01,2024-06-21,482.88,0,0,413696011,79729983,0,100,
560,560,0,0,0,0,2024-02-01,2024-06-21,482.88,0,0,413696011,79729983,0,100,
565,565,0,0,0,0,2024-02-01,2024-06-21,482.88,0,0,413696011,79729983,0,100,
435.31,570,0,0,0,0,2024-02-01,2024-06-21,482.88,0,0,413696011,79729983,0,100,
474.66,580,0,0,0,0,2024-02-01,2024-06-21,482.88,0,0,413696011,79729983,0,100,
434.43,585,0,0,0,0,2024-02-01,2024-06-21,482.88,0,0,413696011,79729983,0,100,
433.55,590,0,0,0,0,2024-02-01,2024-06-21,482.88,0,0,413696011,79729983,0,100,
595,595,0,0,0,0,2024-02-01,2024-06-21,482.88,0,0,413696011,79729983,0,100,
434.57,600,0,0,0,0,2024-02-01,2024-06-21,482.88,0,0,413696011,79729983,0,100,
434.52,605,0,0,0,0,2024-02-01,2024-06-21,482.88,0,0,413696011,79729983,0,100,
435.14,610,0,0,0,0,2024-02-01,2024-06-21,482.88,0,0,413696011,79729983,0,100,
457.59,615,0,0,0,0,2024-02-01,2024-06-21,482.88,0,0,413696011,79729983,0,100,
433.87,620,0,0,0,0,2024-02-01,2024-06-21,482.88,0,0,413696011,79729983,0,100,
434.09,625,0,0,0,0,2024-02-01,2024-06-21,482.88,0,0,413696011,79729983,0,100,
434.37,630,0,0,0,0,2024-02-01,2024-06-21,482.88,0,0,413696011,79729983,0,100,
433.88,635,0,0,0,0,2024-02-01,2024-06-21,482.88,0,0,413696011,79729983,0,100,
433.93,640,0,0,0,0,2024-02-01,2024-06-21,482.88,0,0,413696011,79729983,0,100,
433.93,645,0,0,0,0,2024-02-01,2024-06-21,482.88,0,0,413696011,79729983,0,100,
449.24,650,0,0,0,0,2024-02-01,2024-06-21,482.88,0,0,413696011,79729983,0,100,
434.02,655,0,0,0,0,2024-02-01,2024-06-21,482.88,0,0,413696011,79729983,0,100,
433.52,660,0,0,0,0,2024-02-01,2024-06-21,482.88,0,0,413696011,79729983,0,100,
433.78,665,0,0,0,0,2024-02-01,2024-06-21,482.88,0,0,413696011,79729983,0,100,
433.8,670,0,0,0,0,2024-02-01,2024-06-21,482.88,0,0,413696011,79729983,0,100,
433.94,675,0,0,0,0,2024-02-01,2024-06-21,482.88,0,0,413696011,79729983,0,100,
456.19,680,0,0,0,0,2024-02-01,2024-06-21,482.88,0,0,413696011,79729983,0,100,
250,250,0,0,0,0,2024-02-01,2024-07-19,482.88,0,0,4933850,1821237,0,100,
260,260,0,0,0,0,2024-02-01,2024-07-19,482.88,0,0,4933850,1821237,0,100,
265,265,0,0,0,0,2024-02-01,2024-07-19,482.88,0,0,4933850,1821237,0,100,
270,270,0,0,0,0,2024-02-01,2024-07-19,482.88,0,0,4933850,1821237,0,100,
275,275,0,0,0,0,2024-02-01,2024-07-19,482.88,0,0,4933850,1821237,0,100,
280,280,0,0,0,0,2024-02-01,2024-07-19,482.88,0,0,4933850,1821237,0,100,
285,285,0,0,0,0,2024-02-01,2024-07-19,482.88,0,0,4933850,1821237,0,100,
290,290,0,0,0,0,2024-02-01,2024-07-19,482.88,0,0,4933850,1821237,0,100,
305,305,0,0,0,0,2024-02-01,2024-07-19,482.88,0,0,4933850,1821237,0,100,
315,315,0,0,0,0,2024-02-01,2024-07-19,482.88,0,0,4933850,1821237,0,100,
320,320,0,0,0,0,2024-02-01,2024-07-19,482.88,0,0,4933850,1821237,0,100,
355,355,0,0,0,0,2024-02-01,2024-07-19,482.88,0,0,4933850,1821237,0,100,
375,375,0,0,0,0,2024-02-01,2024-07-19,482.88,0,0,4933850,1821237,0,100,
467,467,0,0,0,0,2024-02-01,2024-07-19,482.88,0,0,4933850,1821237,0,100,
471,471,0,0,0,0,2024-02-01,2024-07-19,482.88,0,0,4933850,1821237,0,100,
472,472,0,0,0,0,2024-02-01,2024-07-19,482.88,0,0,4933850,1821237,0,100,
499,499,0,0,0,0,2024-02-01,2024-07-19,482.88,0,0,4933850,1821237,0,100,
506,506,0,0,0,0,2024-02-01,2024-07-19,482.88,0,0,4933850,1821237,0,100,
486,520,1,0,3200,0,2024-02-01,2024-07-19,482.88,-1,-3200,4933850,1821237,0,100,-Inf
525,525,0,0,0,0,2024-02-01,2024-07-19,482.88,0,0,4933850,1821237,0,100,
486.41,530,0,0,0,0,2024-02-01,2024-07-19,482.88,0,0,4933850,1821237,0,100,
487.77,535,0,0,0,0,2024-02-01,2024-07-19,482.88,0,0,4933850,1821237,0,100,
487.77,540,0,0,0,0,2024-02-01,2024-07-19,482.88,0,0,4933850,1821237,0,100,
545,545,0,0,0,0,2024-02-01,2024-07-19,482.88,0,0,4933850,1821237,0,100,
487.83,550,0,0,0,0,2024-02-01,2024-07-19,482.88,0,0,4933850,1821237,0,100,
487.83,555,0,0,0,0,2024-02-01,2024-07-19,482.88,0,0,4933850,1821237,0,100,
560,560,0,0,0,0,2024-02-01,2024-07-19,482.88,0,0,4933850,1821237,0,100,
565,565,0,0,0,0,2024-02-01,2024-07-19,482.88,0,0,4933850,1821237,0,100,
570,570,0,0,0,0,2024-02-01,2024-07-19,482.88,0,0,4933850,1821237,0,100,
575,575,0,0,0,0,2024-02-01,2024-07-19,482.88,0,0,4933850,1821237,0,100,
580,580,0,0,0,0,2024-02-01,2024-07-19,482.88,0,0,4933850,1821237,0,100,
585,585,0,0,0,0,2024-02-01,2024-07-19,482.88,0,0,4933850,1821237,0,100,
590,590,0,0,0,0,2024-02-01,2024-07-19,482.88,0,0,4933850,1821237,0,100,
595,595,0,0,0,0,2024-02-01,2024-07-19,482.88,0,0,4933850,1821237,0,100,
600,600,0,0,0,0,2024-02-01,2024-07-19,482.88,0,0,4933850,1821237,0,100,
605,605,0,0,0,0,2024-02-01,2024-07-19,482.88,0,0,4933850,1821237,0,100,
610,610,0,0,0,0,2024-02-01,2024-07-19,482.88,0,0,4933850,1821237,0,100,
615,615,0,0,0,0,2024-02-01,2024-07-19,482.88,0,0,4933850,1821237,0,100,
620,620,0,0,0,0,2024-02-01,2024-07-19,482.88,0,0,4933850,1821237,0,100,
625,625,0,0,0,0,2024-02-01,2024-07-19,482.88,0,0,4933850,1821237,0,100,
630,630,0,0,0,0,2024-02-01,2024-07-19,482.88,0,0,4933850,1821237,0,100,
635,635,0,0,0,0,2024-02-01,2024-07-19,482.88,0,0,4933850,1821237,0,100,
640,640,0,0,0,0,2024-02-01,2024-07-19,482.88,0,0,4933850,1821237,0,100,
645,645,0,0,0,0,2024-02-01,2024-07-19,482.88,0,0,4933850,1821237,0,100,
650,650,0,0,0,0,2024-02-01,2024-07-19,482.88,0,0,4933850,1821237,0,100,
205,205,0,0,0,0,2024-02-01,2024-08-16,482.88,0,0,25910468,4922867,0,100,
210,210,0,0,0,0,2024-02-01,2024-08-16,482.88,0,0,25910468,4922867,0,100,
215,215,0,0,0,0,2024-02-01,2024-08-16,482.88,0,0,25910468,4922867,0,100,
235,235,0,0,0,0,2024-02-01,2024-08-16,482.88,0,0,25910468,4922867,0,100,
240,240,0,0,0,0,2024-02-01,2024-08-16,482.88,0,0,25910468,4922867,0,100,
260,260,0,0,0,0,2024-02-01,2024-08-16,482.88,0,0,25910468,4922867,0,100,
280,280,0,0,0,0,2024-02-01,2024-08-16,482.88,0,0,25910468,4922867,0,100,
285,285,0,0,0,0,2024-02-01,2024-08-16,482.88,0,0,25910468,4922867,0,100,
295,295,0,0,0,0,2024-02-01,2024-08-16,482.88,0,0,25910468,4922867,0,100,
305,305,0,0,0,0,2024-02-01,2024-08-16,482.88,0,0,25910468,4922867,0,100,
310,310,0,0,0,0,2024-02-01,2024-08-16,482.88,0,0,25910468,4922867,0,100,
315,315,0,0,0,0,2024-02-01,2024-08-16,482.88,0,0,25910468,4922867,0,100,
474,474,0,0,0,0,2024-02-01,2024-08-16,482.88,0,0,25910468,4922867,0,100,
493,493,0,0,0,0,2024-02-01,2024-08-16,482.88,0,0,25910468,4922867,0,100,
525,525,0,0,0,0,2024-02-01,2024-08-16,482.88,0,0,25910468,4922867,0,100,
530,530,0,0,0,0,2024-02-01,2024-08-16,482.88,0,0,25910468,4922867,0,100,
535,535,0,0,0,0,2024-02-01,2024-08-16,482.88,0,0,25910468,4922867,0,100,
540,540,0,0,0,0,2024-02-01,2024-08-16,482.88,0,0,25910468,4922867,0,100,
545,545,0,0,0,0,2024-02-01,2024-08-16,482.88,0,0,25910468,4922867,0,100,
550,550,0,0,0,0,2024-02-01,2024-08-16,482.88,0,0,25910468,4922867,0,100,
555,555,0,0,0,0,2024-02-01,2024-08-16,482.88,0,0,25910468,4922867,0,100,
560,560,0,0,0,0,2024-02-01,2024-08-16,482.88,0,0,25910468,4922867,0,100,
565,565,0,0,0,0,2024-02-01,2024-08-16,482.88,0,0,25910468,4922867,0,100,
570,570,0,0,0,0,2024-02-01,2024-08-16,482.88,0,0,25910468,4922867,0,100,
575,575,0,0,0,0,2024-02-01,2024-08-16,482.88,0,0,25910468,4922867,0,100,
580,580,0,0,0,0,2024-02-01,2024-08-16,482.88,0,0,25910468,4922867,0,100,
585,585,0,0,0,0,2024-02-01,2024-08-16,482.88,0,0,25910468,4922867,0,100,
590,590,0,0,0,0,2024-02-01,2024-08-16,482.88,0,0,25910468,4922867,0,100,
595,595,0,0,0,0,2024-02-01,2024-08-16,482.88,0,0,25910468,4922867,0,100,
600,600,0,0,0,0,2024-02-01,2024-08-16,482.88,0,0,25910468,4922867,0,100,
545,545,0,0,0,0,2024-02-01,2024-09-20,482.88,0,0,275196706,45340715,0,100,
488,550,0,0,0,0,2024-02-01,2024-09-20,482.88,0,0,275196706,45340715,0,100,
555,555,0,0,0,0,2024-02-01,2024-09-20,482.88,0,0,275196706,45340715,0,100,
560,560,0,0,0,0,2024-02-01,2024-09-20,482.88,0,0,275196706,45340715,0,100,
565,565,0,0,0,0,2024-02-01,2024-09-20,482.88,0,0,275196706,45340715,0,100,
570,570,0,0,0,0,2024-02-01,2024-09-20,482.88,0,0,275196706,45340715,0,100,
575,575,0,0,0,0,2024-02-01,2024-09-20,482.88,0,0,275196706,45340715,0,100,
580,580,0,0,0,0,2024-02-01,2024-09-20,482.88,0,0,275196706,45340715,0,100,
484.23,585,0,0,0,0,2024-02-01,2024-09-20,482.88,0,0,275196706,45340715,0,100,
590,590,0,0,0,0,2024-02-01,2024-09-20,482.88,0,0,275196706,45340715,0,100,
595,595,0,0,0,0,2024-02-01,2024-09-20,482.88,0,0,275196706,45340715,0,100,
461.5,600,0,0,0,0,2024-02-01,2024-09-20,482.88,0,0,275196706,45340715,0,100,
605,605,0,0,0,0,2024-02-01,2024-09-20,482.88,0,0,275196706,45340715,0,100,
610,610,0,0,0,0,2024-02-01,2024-09-20,482.88,0,0,275196706,45340715,0,100,
615,615,0,0,0,0,2024-02-01,2024-09-20,482.88,0,0,275196706,45340715,0,100,
620,620,0,0,0,0,2024-02-01,2024-09-20,482.88,0,0,275196706,45340715,0,100,
625,625,0,0,0,0,2024-02-01,2024-09-20,482.88,0,0,275196706,45340715,0,100,
630,630,0,0,0,0,2024-02-01,2024-09-20,482.88,0,0,275196706,45340715,0,100,
635,635,0,0,0,0,2024-02-01,2024-09-20,482.88,0,0,275196706,45340715,0,100,
435.01,640,0,0,0,0,2024-02-01,2024-09-20,482.88,0,0,275196706,45340715,0,100,
645,645,0,0,0,0,2024-02-01,2024-09-20,482.88,0,0,275196706,45340715,0,100,
434.57,650,0,0,0,0,2024-02-01,2024-09-20,482.88,0,0,275196706,45340715,0,100,
434.75,655,0,0,0,0,2024-02-01,2024-09-20,482.88,0,0,275196706,45340715,0,100,
660,660,0,0,0,0,2024-02-01,2024-09-20,482.88,0,0,275196706,45340715,0,100,
435,665,0,0,0,0,2024-02-01,2024-09-20,482.88,0,0,275196706,45340715,0,100,
434.73,670,0,0,0,0,2024-02-01,2024-09-20,482.88,0,0,275196706,45340715,0,100,
434.51,675,0,0,0,0,2024-02-01,2024-09-20,482.88,0,0,275196706,45340715,0,100,
434.79,680,0,0,0,0,2024-02-01,2024-09-20,482.88,0,0,275196706,45340715,0,100,
450.5,685,0,0,0,0,2024-02-01,2024-09-20,482.88,0,0,275196706,45340715,0,100,
434.75,690,0,0,0,0,2024-02-01,2024-09-20,482.88,0,0,275196706,45340715,0,100,
434.68,695,0,0,0,0,2024-02-01,2024-09-20,482.88,0,0,275196706,45340715,0,100,
483.83,700,0,0,0,0,2024-02-01,2024-09-20,482.88,0,0,275196706,45340715,0,100,
491.21,540,2,0,9758,0,2024-02-01,2024-12-20,482.88,-2,-9758,461752055,55002926,0,100,-Inf
555,555,0,0,0,0,2024-02-01,2024-12-20,482.88,0,0,461752055,55002926,0,100,
560,560,0,0,0,0,2024-02-01,2024-12-20,482.88,0,0,461752055,55002926,0,100,
473,565,0,0,0,0,2024-02-01,2024-12-20,482.88,0,0,461752055,55002926,0,100,
570,570,0,0,0,0,2024-02-01,2024-12-20,482.88,0,0,461752055,55002926,0,100,
575,575,0,0,0,0,2024-02-01,2024-12-20,482.88,0,0,461752055,55002926,0,100,
580,580,0,0,0,0,2024-02-01,2024-12-20,482.88,0,0,461752055,55002926,0,100,
585,585,0,0,0,0,2024-02-01,2024-12-20,482.88,0,0,461752055,55002926,0,100,
590,590,0,0,0,0,2024-02-01,2024-12-20,482.88,0,0,461752055,55002926,0,100,
595,595,0,0,0,0,2024-02-01,2024-12-20,482.88,0,0,461752055,55002926,0,100,
484.8,605,0,0,0,0,2024-02-01,2024-12-20,482.88,0,0,461752055,55002926,0,100,
418.08,610,0,0,0,0,2024-02-01,2024-12-20,482.88,0,0,461752055,55002926,0,100,
615,615,0,0,0,0,2024-02-01,2024-12-20,482.88,0,0,461752055,55002926,0,100,
475.93,620,0,0,0,0,2024-02-01,2024-12-20,482.88,0,0,461752055,55002926,0,100,
625,625,0,0,0,0,2024-02-01,2024-12-20,482.88,0,0,461752055,55002926,0,100,
630,630,0,0,0,0,2024-02-01,2024-12-20,482.88,0,0,461752055,55002926,0,100,
485,635,0,0,0,0,2024-02-01,2024-12-20,482.88,0,0,461752055,55002926,0,100,
484.92,640,0,0,0,0,2024-02-01,2024-12-20,482.88,0,0,461752055,55002926,0,100,
474.35,645,0,0,0,0,2024-02-01,2024-12-20,482.88,0,0,461752055,55002926,0,100,
457.01,650,0,0,0,0,2024-02-01,2024-12-20,482.88,0,0,461752055,55002926,0,100,
453.98,655,0,0,0,0,2024-02-01,2024-12-20,482.88,0,0,461752055,55002926,0,100,
418.16,660,0,0,0,0,2024-02-01,2024-12-20,482.88,0,0,461752055,55002926,0,100,
665,665,0,0,0,0,2024-02-01,2024-12-20,482.88,0,0,461752055,55002926,0,100,
670,670,0,0,0,0,2024-02-01,2024-12-20,482.88,0,0,461752055,55002926,0,100,
675,675,0,0,0,0,2024-02-01,2024-12-20,482.88,0,0,461752055,55002926,0,100,
680,680,0,0,0,0,2024-02-01,2024-12-20,482.88,0,0,461752055,55002926,0,100,
685,685,0,0,0,0,2024-02-01,2024-12-20,482.88,0,0,461752055,55002926,0,100,
690,690,0,0,0,0,2024-02-01,2024-12-20,482.88,0,0,461752055,55002926,0,100,
695,695,0,0,0,0,2024-02-01,2024-12-20,482.88,0,0,461752055,55002926,0,100,
472.95,700,0,0,0,0,2024-02-01,2024-12-20,482.88,0,0,461752055,55002926,0,100,
705,705,0,0,0,0,2024-02-01,2024-12-20,482.88,0,0,461752055,55002926,0,100,
418.57,710,0,0,0,0,2024-02-01,2024-12-20,482.88,0,0,461752055,55002926,0,100,
483.28,715,0,0,0,0,2024-02-01,2024-12-20,482.88,0,0,461752055,55002926,0,100,
