Watch,strike,open_interest.yt,open_interest.td,OI_Dollar.yt,OI_Dollar.td,Date.td,expiry,stkClose,diff_oi,diff_oi_d,totalOI,totalOIdiff,OI_pct,cum_sep_OI,pct
455.95,460,135427,135318,63650690,54803790,2024-06-06,2024-12-20,534.67,-109,-8846900,383807022,-51896645,14.2789961774071,14.2789961774071,-0.161428616524514
512.78,520,48964,49076,43822780,35432872,2024-06-06,2024-09-20,534.67,112,-8389908,244715238,-48165897,14.4792258502513,14.4792258502513,-0.236783176932426
465.29,470,63438,63514,34193082,29915094,2024-06-06,2024-12-20,534.67,76,-4277988,383807022,-51896645,7.79430606665659,22.0733022440637,-0.143004330857192
521.3,540,13311,13216,29284200,24713920,2024-06-06,2024-12-20,534.67,-95,-4570280,383807022,-51896645,6.43915264270491,28.5124548867686,-0.184927360774818
514.79,530,13610,13806,24021650,20998926,2024-06-06,2024-12-20,534.67,196,-3022724,383807022,-51896645,5.47121985694154,33.9836747437101,-0.143946599935635
483.24,490,29245,29821,23249775,20158996,2024-06-06,2024-12-20,534.67,576,-3090779,383807022,-51896645,5.2523781078711,39.2360528515812,-0.153320085980472
520.16,530,19413,18928,23703273,18625152,2024-06-06,2024-09-20,534.67,-485,-5078121,244715238,-48165897,7.61094901658719,22.0901748668385,-0.272648566841226
495.96,500,43732,44070,21822268,17804280,2024-06-06,2024-09-20,534.67,338,-4017988,244715238,-48165897,7.27550934118782,29.3656842080263,-0.225675399398347
518.09,535,10292,10422,20450204,17623602,2024-06-06,2024-12-20,534.67,130,-2826602,383807022,-51896645,4.59178727584614,43.8278401274274,-0.160387303344685
504.53,510,30041,31524,19887142,17243628,2024-06-06,2024-09-20,534.67,1483,-2643514,244715238,-48165897,7.04640550418033,36.4120897122066,-0.153303817502906
522.24,530,20262,20532,20606454,15932832,2024-06-06,2024-08-16,534.67,270,-4673622,116205577,-19412264,13.7109013279113,13.7109013279113,-0.293332786035778
491.8,500,18337,19142,17346802,15696440,2024-06-06,2024-12-20,534.67,805,-1650362,383807022,-51896645,4.08966983412826,47.9175099615556,-0.105142439941796
507.56,520,11791,11779,16707847,14653076,2024-06-06,2024-12-20,534.67,-12,-2054771,383807022,-51896645,3.81782384377532,51.735333805331,-0.14022796305704
508.87,515,20477,22544,15623951,13819472,2024-06-06,2024-09-20,534.67,2067,-1804479,244715238,-48165897,5.64716448102835,42.059254193235,-0.130575104461299
506.45,510,26205,38866,12290145,13797430,2024-06-06,2024-08-16,534.67,12661,1507285,116205577,-19412264,11.8732941707264,25.5841954986377,0.109243895421104
477.54,480,55267,53602,16524833,13186092,2024-06-06,2024-09-20,534.67,-1665,-3338741,244715238,-48165897,5.38834120333773,47.4475953965727,-0.25320170676801
472.77,475,55521,56516,14768586,12603068,2024-06-06,2024-09-20,534.67,995,-2165518,244715238,-48165897,5.15009531200505,52.5976907085778,-0.171824669993053
497.5,500,45689,48956,14803236,12239000,2024-06-06,2024-08-16,534.67,3267,-2564236,116205577,-19412264,10.5321967464608,36.1163922450985,-0.209513522346597
398.25,400,67252,67260,13114140,11770500,2024-06-06,2024-12-20,534.67,8,-1343640,383807022,-51896645,3.06677557348078,54.8021093788117,-0.114153179559067
498.73,500,90204,88409,16777944,11227943,2024-06-06,2024-07-19,534.67,-1795,-5550001,162615922,-53541395,6.90457789244032,6.90457789244032,-0.494302562811372
469.74,475,20395,20418,12277790,10739868,2024-06-06,2024-12-20,534.67,23,-1537922,383807022,-51896645,2.79824687522262,57.6003562540344,-0.143197476914986
491.44,495,30439,29774,13210526,10599544,2024-06-06,2024-09-20,534.67,-665,-2610982,244715238,-48165897,4.33137882488544,56.9290695334632,-0.2463296534266
474.37,480,18607,18740,12094550,10550620,2024-06-06,2024-12-20,534.67,133,-1543930,383807022,-51896645,2.7489387622512,60.3492950162856,-0.146335476019419
523.36,535,8972,9062,13054260,10548168,2024-06-06,2024-09-20,534.67,90,-2506092,244715238,-48165897,4.31038462754003,61.2394541610033,-0.237585521959832
511.38,525,7610,7733,11886820,10532346,2024-06-06,2024-12-20,534.67,123,-1354474,383807022,-51896645,2.74417751533478,63.0934725316203,-0.128601358139962
524.1,530,16073,17250,13485247,10177500,2024-06-06,2024-07-19,534.67,1177,-3307747,162615922,-53541395,6.25861224093419,13.1631901333745,-0.325005846229428
451.24,455,26492,26492,11206116,9960992,2024-06-06,2024-12-20,534.67,0,-1245124,383807022,-51896645,2.5953125995699,65.6887851311902,-0.125
526.38,550,3932,4100,10813000,9684200,2024-06-06,2024-12-20,534.67,168,-1128800,383807022,-51896645,2.52319510714945,68.2119802383397,-0.116560996261952
446.57,450,27715,27731,10836565,9511733,2024-06-06,2024-12-20,534.67,16,-1324832,383807022,-51896645,2.47825924352161,70.6902394818613,-0.139283976957722
524.11,545,4380,4529,10827360,9461081,2024-06-06,2024-12-20,534.67,149,-1366279,383807022,-51896645,2.46506198628122,73.1553014681425,-0.14441045373145
482.23,485,33971,33613,11380285,9310801,2024-06-06,2024-09-20,534.67,-358,-2069484,244715238,-48165897,3.80474917544775,65.044203336451,-0.222267020850301
513.68,515,70130,70039,16620810,9245148,2024-06-06,2024-06-28,534.67,-91,-7375662,66054797,-39996766,13.9961795658838,13.9961795658838,-0.797787336665676
468.01,470,45846,45909,10773810,9135891,2024-06-06,2024-09-20,534.67,63,-1637919,244715238,-48165897,3.73327426386092,68.7774776003119,-0.179283991019595
526.47,530,19968,24546,12480000,8664738,2024-06-06,2024-06-21,534.67,4578,-3815262,109509524,-65752697,7.91231454900671,7.91231454900671,-0.440320526714138
478.6,480,59138,59297,10290012,8301580,2024-06-06,2024-08-16,534.67,159,-1988432,116205577,-19412264,7.14387399840543,43.260266243504,-0.239524524247192
507.97,510,34849,40779,10350153,8278137,2024-06-06,2024-07-19,534.67,5930,-2072016,162615922,-53541395,5.09060668733287,18.2537968207074,-0.250299795714906
505.26,507,11145,46273,3154035,8051502,2024-06-06,2024-07-19,534.67,35128,4897467,162615922,-53541395,4.95123841563313,23.2050352363405,0.608267500896106
525.82,529,23912,25011,13725488,7953498,2024-06-06,2024-06-21,534.67,1099,-5771990,109509524,-65752697,7.26283679216796,15.1751513411747,-0.725717162435949
511.31,520,8635,8757,9049480,7609833,2024-06-06,2024-10-18,534.67,122,-1439647,52962163,-8353895,14.3684331774743,14.3684331774743,-0.189182469575876
500.4,505,16466,16532,9682008,7604720,2024-06-06,2024-09-20,534.67,66,-2077288,244715238,-48165897,3.10757926729516,71.8850568676071,-0.273157723098286
518.64,520,56877,55537,15641175,7553032,2024-06-06,2024-06-21,534.67,-1340,-8088143,109509524,-65752697,6.89714622446903,22.0722975656437,-1.07084717766322
496,505,7441,8382,7999075,7543800,2024-06-06,2024-12-20,534.67,941,-455275,383807022,-51896645,1.96551901543896,75.1208204835815,-0.0603508841697818
518.56,530,6077,6440,8428799,7367360,2024-06-06,2024-10-18,534.67,363,-1061439,52962163,-8353895,13.9106101085788,28.2790432860531,-0.14407318225253
458.36,460,44261,44360,8542373,7275040,2024-06-06,2024-09-20,534.67,99,-1267333,244715238,-48165897,2.97285941793294,74.85791628554,-0.174202890980668
514.87,520,13075,14159,8904075,7263567,2024-06-06,2024-08-16,534.67,1084,-1640508,116205577,-19412264,6.25061824700548,49.5108844905094,-0.225854321988081
516.63,520,19630,21236,9716850,7156532,2024-06-06,2024-07-19,534.67,1606,-2560318,162615922,-53541395,4.40088025328787,27.6059154896284,-0.357759596407869
516.6,525,6540,8408,6814680,7062720,2024-06-06,2024-09-20,534.67,1868,248040,244715238,-48165897,2.88609735042327,77.7440136359633,0.0351196139730869
522.78,525,27767,28820,11495538,6398040,2024-06-06,2024-06-21,534.67,1053,-5097498,109509524,-65752697,5.84245074428412,27.9147483099278,-0.796728060468518
486.88,490,20081,20311,7650861,6337032,2024-06-06,2024-09-20,534.67,230,-1313829,244715238,-48165897,2.58955349564296,80.3335671316063,-0.207325606056589
515,525,6122,6311,7364766,6311000,2024-06-06,2024-10-18,534.67,189,-1053766,52962163,-8353895,11.9160541082886,40.1950973943417,-0.166972904452543
518.7,525,9509,9671,7968542,6092730,2024-06-06,2024-08-16,534.67,162,-1875812,116205577,-19412264,5.24306161312723,54.7539461036367,-0.307877092863134
441.68,445,17349,17357,6297687,5762524,2024-06-06,2024-12-20,534.67,8,-535163,383807022,-51896645,1.50141182148564,76.6222323050671,-0.0928695481355045
437,440,18857,18942,6222810,5682600,2024-06-06,2024-12-20,534.67,85,-540210,383807022,-51896645,1.48058781477948,78.1028201198466,-0.0950638792102207
448.63,450,38721,41329,6234081,5662073,2024-06-06,2024-09-20,534.67,2608,-572008.000000001,244715238,-48165897,2.31373944927778,82.647306580884,-0.101024483435661
510.79,515,13041,13424,7302960,5651504,2024-06-06,2024-08-16,534.67,383,-1651456,116205577,-19412264,4.86336727195116,59.6173133755878,-0.292215311180882
483.42,485,8420,35289,1768200,5575662,2024-06-06,2024-08-16,534.67,26869,3807462,116205577,-19412264,4.79810190177017,64.415415277358,0.682871737920986
500.02,510,5560,5546,6360640,5534908,2024-06-06,2024-12-20,534.67,-14,-825731.999999999,383807022,-51896645,1.442107018042,79.5449271378886,-0.149186219536079
500.58,502,45800,37378,9297400,5307676,2024-06-06,2024-07-19,534.67,-8422,-3989724,162615922,-53541395,3.26393377396341,30.8698492635918,-0.751689439973352
502.47,504,35125,34424,7832875,5266872,2024-06-06,2024-07-19,534.67,-701,-2566003,162615922,-53541395,3.2388415200819,34.1086907836737,-0.487196764986884
512.4,515,16791,19845,6414162,5159700,2024-06-06,2024-07-19,534.67,3054,-1254462,162615922,-53541395,3.17293653446801,37.2816273181417,-0.243126925984069
499.63,501,37071,37233,7265916,5100921,2024-06-06,2024-07-19,534.67,162,-2164995,162615922,-53541395,3.136790627427,40.4184179455687,-0.424432176071733
417.76,420,22184,22193,5546000,4971232,2024-06-06,2024-12-20,534.67,9,-574767.999999999,383807022,-51896645,1.29524258678102,80.8401697246696,-0.115618824468462
502.07,505,16855,16802,6573450,4922986,2024-06-06,2024-08-16,534.67,-53,-1650464,116205577,-19412264,4.2364455537276,68.6518608310856,-0.335256691772026
495.81,497,40044,40492,6967656,4818548,2024-06-06,2024-07-19,534.67,448,-2149108,162615922,-53541395,2.96314649927084,43.3815644448395,-0.446007386457497
522.11,525,16029,16335,7918326,4720815,2024-06-06,2024-06-28,534.67,306,-3197511,66054797,-39996766,7.14681630162303,21.1429958675068,-0.677321818372463
487.58,495,6273,6264,5338323,4647888,2024-06-06,2024-12-20,534.67,-9,-690435,383807022,-51896645,1.2109960822968,82.0511658069664,-0.148548114756638
460.55,465,10311,10304,5248299,4585280,2024-06-06,2024-12-20,534.67,-7,-663019,383807022,-51896645,1.19468371790238,83.2458495248688,-0.144597276502198
422.61,425,19039,19038,5140530,4550082,2024-06-06,2024-12-20,534.67,-1,-590448,383807022,-51896645,1.185512963335,84.4313624882038,-0.129766452560635
527.24,535,5488,5703,6217904,4425528,2024-06-06,2024-07-19,534.67,215,-1792376,162615922,-53541395,2.72146044838094,46.1030248932205,-0.405008396738197
520.56,525,8841,9952,5684763,4418688,2024-06-06,2024-07-19,534.67,1111,-1266075,162615922,-53541395,2.71725421819396,48.8202791114145,-0.286527358347093
526.25,540,2854,3117,4914588,4285875,2024-06-06,2024-09-20,534.67,263,-628713,244715238,-48165897,1.75137234404668,84.3986789249307,-0.146694198967539
503.96,515,3786,3792,4830936,4186368,2024-06-06,2024-12-20,534.67,6,-644568,383807022,-51896645,1.09074815207524,85.522110640279,-0.153968308567235
509.43,510,75890,73122,8347900,4167954,2024-06-06,2024-06-21,534.67,-2768,-4179946,109509524,-65752697,3.80601964811755,31.7207679580454,-1.00287719106305
432.25,435,15088,15089,4903600,4149475,2024-06-06,2024-12-20,534.67,1,-754125,383807022,-51896645,1.08113576931899,86.603246409598,-0.181739858656818
526.06,528,20247,20825,8422752,4040050,2024-06-06,2024-06-14,534.67,578,-4382702,23468414,-20040476,17.2148403381669,17.2148403381669,-1.08481380180938
525.09,528,11328,13824,6015168,4022784,2024-06-06,2024-06-21,534.67,2496,-1992384,109509524,-65752697,3.6734558356769,35.3942237937223,-0.495274914089347
527.17,531,10016,10477,6780832,4012691,2024-06-06,2024-06-21,534.67,461,-2768141,109509524,-65752697,3.66423928570815,39.0584630794304,-0.689846539392143
518.07,520,19631,20781,6674540,4010733,2024-06-06,2024-06-28,534.67,1150,-2663807,66054797,-39996766,6.07182700145154,27.2148228689583,-0.664169616875519
501.52,503,26726,26533,5665912,3926884,2024-06-06,2024-07-19,534.67,-193,-1739028,162615922,-53541395,2.41482134818262,51.2351004595971,-0.442851889691674
488.16,490,21255,21338,4973670,3926192,2024-06-06,2024-08-16,534.67,83,-1047478,116205577,-19412264,3.37866056118804,72.0305213922736,-0.266792352488111
443.73,445,30539,30561,4428155,3881247,2024-06-06,2024-09-20,534.67,22,-546908,244715238,-48165897,1.58602587714624,85.9847048020769,-0.140910382668251
378.59,380,27384,27466,4217136,3872706,2024-06-06,2024-12-20,534.67,82,-344430,383807022,-51896645,1.00902426949343,87.6122706790915,-0.088937812475308
449.67,450,115987,116036,4871454,3829188,2024-06-06,2024-07-19,534.67,49,-1042266,162615922,-53541395,2.35474359023712,53.5898440498342,-0.272189821967477
489.13,490,43934,43975,5403882,3825825,2024-06-06,2024-07-19,534.67,41,-1578057,162615922,-53541395,2.35267552706186,55.9425195768961,-0.412474956381957
412.78,415,17225,17227,4151225,3824394,2024-06-06,2024-12-20,534.67,2,-326831,383807022,-51896645,0.996436693646528,88.608707372738,-0.0854595525461027
478.85,485,5973,6195,4342371,3809925,2024-06-06,2024-12-20,534.67,222,-532446,383807022,-51896645,0.992666830363515,89.6013742031015,-0.139752357329869
503.34,510,5433,5698,4552854,3794868,2024-06-06,2024-10-18,534.67,265,-757986,52962163,-8353895,7.16524360985785,47.3603410041995,-0.199739753793808
492.89,495,16744,17057,4537624,3599027,2024-06-06,2024-08-16,534.67,313,-938597.000000001,116205577,-19412264,3.09712071736454,75.1276421096382,-0.260791875137364
525.42,535,3662,3742,4742290,3584836,2024-06-06,2024-08-16,534.67,80,-1157454,116205577,-19412264,3.08490873893256,78.2125508485707,-0.322875021339888
453.5,455,23036,23023,4054336,3453450,2024-06-06,2024-09-20,534.67,-13,-600886,244715238,-48165897,1.41121167125686,87.3959164733338,-0.173995859213251
388.42,390,15476,21432,2723776,3386256,2024-06-06,2024-12-20,534.67,5956,662480.000000001,383807022,-51896645,0.882280887502887,90.4836550906044,0.195637896248837
427.37,430,13145,12852,3917210,3380076,2024-06-06,2024-12-20,534.67,-293,-537134,383807022,-51896645,0.880670703309852,91.3643257939142,-0.158911811450393
525.8,530,6776,7973,4702544,3348660,2024-06-06,2024-06-28,534.67,1197,-1353884,66054797,-39996766,5.06951826678084,32.2843411357392,-0.404306200091977
496.77,498,25944,25946,4773696,3191358,2024-06-06,2024-07-19,534.67,2,-1582338,162615922,-53541395,1.96251262530123,57.9050322021973,-0.495819647936709
399.85,400,212732,212737,3829176,3191055,2024-06-06,2024-07-19,534.67,5,-638121,162615922,-53541395,1.9623262966833,59.8673584988806,-0.199971796161458
463.19,465,17628,17580,3860532,3181980,2024-06-06,2024-09-20,534.67,-48,-678552,244715238,-48165897,1.3002786528561,88.6961951261899,-0.213248354797956
429.02,430,32248,32245,3676272,3160010,2024-06-06,2024-09-20,534.67,-3,-516262,244715238,-48165897,1.29130087109655,89.9874959972865,-0.163373533628058
491.06,492,33421,33398,4478414,3139412,2024-06-06,2024-07-19,534.67,-23,-1339002,162615922,-53541395,1.93056864382566,61.7979271427062,-0.426513627392646
408,410,15334,15284,3465484,3056800,2024-06-06,2024-12-20,534.67,-50,-408684,383807022,-51896645,0.796441916062703,92.1607677099769,-0.133696676262758
438.8,440,24927,24938,3365145,2992560,2024-06-06,2024-09-20,534.67,11,-372585.000000001,244715238,-48165897,1.22287440065338,91.2103703979398,-0.124503769347983
468.89,470,26576,26574,3667488,2949714,2024-06-06,2024-08-16,534.67,-2,-717773.999999999,116205577,-19412264,2.53835837844512,80.7509092270158,-0.243336811636653
449.26,450,39430,39448,3390980,2919152,2024-06-06,2024-08-16,534.67,18,-471828.000000001,116205577,-19412264,2.51205843588729,83.2629676629031,-0.161631871173546
497.69,499,22027,22022,3986887,2884882,2024-06-06,2024-07-19,534.67,-5,-1102005,162615922,-53541395,1.77404645530344,63.5719735980097,-0.381993093651664
518.26,522,7185,7622,3994860,2850628,2024-06-06,2024-07-19,534.67,437,-1144232,162615922,-53541395,1.75298209728811,65.3249556952978,-0.401396464217709
524.34,527,10916,10681,5512580,2841146,2024-06-06,2024-06-21,534.67,-235,-2671434,109509524,-65752697,2.59442822525646,41.6528913046869,-0.940266357307931
494.75,500,5129,5327,3205625,2796675,2024-06-06,2024-10-18,534.67,198,-408950,52962163,-8353895,5.28051507261892,52.6408560768185,-0.146227216247866
516.85,518,19268,24201,4296764,2783115,2024-06-06,2024-06-21,534.67,4933,-1513649,109509524,-65752697,2.54143648729584,44.1943277919827,-0.543868650774402
403.09,405,13953,13955,3139425,2665405,2024-06-06,2024-12-20,534.67,2,-474020,383807022,-51896645,0.694464886575212,92.8552325965521,-0.177841641326553
404.28,405,36599,36478,3074316,2626416,2024-06-06,2024-09-20,534.67,-121,-447900,244715238,-48165897,1.07325396712729,92.2836243650671,-0.170536579125318
511.54,514,10115,10622,3671745,2613012,2024-06-06,2024-07-19,534.67,507,-1058733,162615922,-53541395,1.60686110428965,66.9318167995874,-0.40517724373252
509.04,510,26881,27139,4408484,2605344,2024-06-06,2024-06-28,534.67,258,-1803140,66054797,-39996766,3.94421619371565,36.2285573294548,-0.692092867582937
383.32,385,15423,15423,2591064,2591064,2024-06-06,2024-12-20,534.67,0,0,383807022,-51896645,0.675095517142467,93.5303281136946,0
521.87,535,2160,1960,3510000,2573480,2024-06-06,2024-10-18,534.67,-200,-936520,52962163,-8353895,4.85909157448876,57.4999476513072,-0.363911901394221
469.5,470,51231,51142,3278784,2557100,2024-06-06,2024-07-19,534.67,-89,-721684.000000001,162615922,-53541395,1.57247824724076,68.5042950468282,-0.282227523366314
473.78,475,20521,20551,3119192,2507222,2024-06-06,2024-08-16,534.67,30,-611970,116205577,-19412264,2.15757458869638,85.4205422515995,-0.244082893337726
523.58,526,9405,10342,4194630,2502764,2024-06-06,2024-06-21,534.67,937,-1691866,109509524,-65752697,2.28543044347449,46.4797582354572,-0.675999015488476
481.31,485,6730,6727,2994850,2482263,2024-06-06,2024-10-18,534.67,-3,-512587,52962163,-8353895,4.6868610709876,62.1868087222948,-0.206499875315388
514.15,515,29808,28422,5126976,2415870,2024-06-06,2024-06-21,534.67,-1386,-2711106,109509524,-65752697,2.20608209382775,48.685840329285,-1.1222069068286
504.09,505,26164,26351,3976928,2397941,2024-06-06,2024-07-05,534.67,187,-1578987,14823040,-3756140,16.1771202128578,16.1771202128578,-0.658476167678855
459.11,460,27107,26937,2900449,2397393,2024-06-06,2024-08-16,534.67,-170,-503056,116205577,-19412264,2.06306191311283,87.4836041647123,-0.209834599500374
319.27,320,32719,32718,2617520,2388414,2024-06-06,2024-12-20,534.67,-1,-229106,383807022,-51896645,0.622295545181557,94.1526236588762,-0.0959239059894976
499.69,500,77930,76181,3974430,2361611,2024-06-06,2024-06-21,534.67,-1749,-1612819,109509524,-65752697,2.15653480513713,50.8423751344221,-0.682931693661657
523.49,529,4409,4162,3566881,2293262,2024-06-06,2024-07-19,534.67,-247,-1273619,162615922,-53541395,1.41023214196701,69.9145271887952,-0.555374396819901
521.31,524,8869,8522,3999919,2292418,2024-06-06,2024-06-28,534.67,-347,-1707501,66054797,-39996766,3.47047921440134,39.6990365438562,-0.744847143932738
509.39,520,123,2156,149814,2287516,2024-06-06,2024-11-15,534.67,2033,2137702,10201073,1977879,22.4242685058719,22.4242685058719,0.934507999069733
520.53,523,9035,9060,3821805,2237820,2024-06-06,2024-06-28,534.67,25,-1583985,66054797,-39996766,3.38782359742927,43.0868601412854,-0.707825026141513
498.98,505,3603,3684,2561733,2217768,2024-06-06,2024-10-18,534.67,81,-343965.000000001,52962163,-8353895,4.18745737405022,66.374266096345,-0.155095122663868
527.8,532,2682,5270,1947132,2213400,2024-06-06,2024-06-21,534.67,2588,266268,109509524,-65752697,2.021194065276,52.8635691996981,0.120298183789645
525.49,532,2949,3381,2786805,2201031,2024-06-06,2024-07-19,534.67,432,-585774,162615922,-53541395,1.35351506354956,71.2680422523448,-0.266136187995535
507.18,515,2623,2813,2428898,2199766,2024-06-06,2024-10-18,534.67,190,-229132,52962163,-8353895,4.15346707044423,70.5277331667893,-0.104161988138738
348.97,350,20262,20330,2269344,2093990,2024-06-06,2024-12-20,534.67,68,-175354,383807022,-51896645,0.545584077406484,94.6982077362826,-0.0837415651459653
409.26,410,27993,27991,2379405,2071334,2024-06-06,2024-09-20,534.67,-2,-308071,244715238,-48165897,0.846426245021979,93.1300506100891,-0.14873072136121
530.13,550,1032,1041,2474736,2068467,2024-06-06,2024-09-20,534.67,9,-406269,244715238,-48165897,0.845254679236607,93.9753052893257,-0.196410675152178
503.39,505,12106,12837,2796486,2066757,2024-06-06,2024-07-19,534.67,731,-729729,162615922,-53541395,1.27094381323866,72.5389860655834,-0.353079244439477
515.03,516,21066,21274,4065738,2063578,2024-06-06,2024-06-21,534.67,208,-2002160,109509524,-65752697,1.8843822204907,54.7479514201888,-0.970237131816679
513.27,516,6899,7209,2773398,1968057,2024-06-06,2024-07-19,534.67,310,-805341,162615922,-53541395,1.21024864957565,73.7492347151591,-0.409206135797896
399.35,400,29981,30009,2248575,1950585,2024-06-06,2024-09-20,534.67,28,-297990,244715238,-48165897,0.797083588231641,94.7723888775574,-0.15276955374926
521.18,523,7393,10715,2639301,1950130,2024-06-06,2024-06-21,534.67,3322,-689171,109509524,-65752697,1.78078575156623,56.528737171755,-0.353397465809972
467.2,470,6892,6898,2219224,1931440,2024-06-06,2024-10-18,534.67,6,-287784,52962163,-8353895,3.64682990760781,74.1745630743971,-0.148999710060887
523.64,525,12896,13864,3933280,1885504,2024-06-06,2024-06-14,534.67,968,-2047776,23468414,-20040476,8.0342199519746,25.2490602901415,-1.08606293065408
419.13,420,21356,21272,2114244,1850664,2024-06-06,2024-09-20,534.67,-84,-263580,244715238,-48165897,0.756252048350173,95.5286409259075,-0.142424556807719
526.44,531,3983,4033,2947420,1839048,2024-06-06,2024-06-28,534.67,50,-1108372,66054797,-39996766,2.78412482291029,45.8709849641957,-0.602687912441655
484.25,485,23747,24366,2374700,1827450,2024-06-06,2024-07-19,534.67,619,-547250,162615922,-53541395,1.12378294666619,74.8730176618253,-0.299460997564913
522.85,528,3408,3544,2620752,1825160,2024-06-06,2024-07-19,534.67,136,-795592,162615922,-53541395,1.12237472047786,75.9953923823031,-0.435902605798943
519.05,523,4017,4575,2378064,1807125,2024-06-06,2024-07-19,534.67,558,-570939,162615922,-53541395,1.11128417056234,77.1066765528655,-0.315937746420419
464,465,17587,18057,2251136,1805700,2024-06-06,2024-08-16,534.67,470,-445436,116205577,-19412264,1.55388411349655,89.0374882782089,-0.246683280722158
514.54,516,12505,12282,3188775,1793172,2024-06-06,2024-06-28,534.67,-223,-1395603,66054797,-39996766,2.71467339457572,48.5856583587714,-0.778287303170025
464.54,465,29547,38578,1743273,1774588,2024-06-06,2024-07-19,534.67,9031,31315,162615922,-53541395,1.0912756747153,78.1979522275808,0.0176463494625231
393.32,395,10338,10339,2139966,1736952,2024-06-06,2024-12-20,534.67,1,-403014,383807022,-51896645,0.452558681951369,95.150766418234,-0.232023682865157
459.85,460,115675,115661,2197825,1734915,2024-06-06,2024-06-28,534.67,-14,-462910,66054797,-39996766,2.62647843728897,51.2121367960604,-0.266819988299139
522.85,526,5209,5480,2797233,1726200,2024-06-06,2024-06-28,534.67,271,-1071033,66054797,-39996766,2.61328484591361,53.825421641974,-0.620457073340285
504.32,506,10456,10228,2561720,1718304,2024-06-06,2024-07-19,534.67,-228,-843416,162615922,-53541395,1.05666405777904,79.2546162853598,-0.4908421327076
485.84,490,3985,4113,2084155,1711008,2024-06-06,2024-10-18,534.67,128,-373147,52962163,-8353895,3.23062334142206,77.4051864158192,-0.218086063887486
530.8,532,3046,14208,1382884,1704960,2024-06-06,2024-06-07,534.67,11162,322076,11090657,-11742034,15.3729395832907,15.3729395832907,0.188905311561561
521.32,526,3431,3607,2336511,1688076,2024-06-06,2024-07-19,534.67,176,-648435,162615922,-53541395,1.03807547209307,80.2926917574529,-0.38412666254363
499.48,500,30893,32283,2595012,1678716,2024-06-06,2024-06-28,534.67,1390,-916296,66054797,-39996766,2.54139907507399,56.366820717048,-0.545831456899202
527.33,545,945,949,2166885,1676883,2024-06-06,2024-10-18,534.67,4,-490002,52962163,-8353895,3.16619055003475,80.5713769658539,-0.292210011074118
530.7,535,3756,3884,3200112,1670120,2024-06-06,2024-06-14,534.67,128,-1529992,23468414,-20040476,7.11645874322824,32.3655190333697,-0.916097046918784
526.73,534,2291,2292,2375767,1666284,2024-06-06,2024-07-19,534.67,1,-709483,162615922,-53541395,1.02467457030438,81.3173663277573,-0.425787560823965
522.12,527,3469,3413,2542777,1665544,2024-06-06,2024-07-19,534.67,-56,-877233,162615922,-53541395,1.02421951031339,82.3415858380706,-0.526694581470078
517.77,519,11815,13505,2918305,1661115,2024-06-06,2024-06-21,534.67,1690,-1257190,109509524,-65752697,1.51686806710985,58.0456052388649,-0.756835017443103
519.5,521,10137,10952,3051237,1642800,2024-06-06,2024-06-21,534.67,815,-1408437,109509524,-65752697,1.50014349436858,59.5457487332335,-0.857339298758218
493.94,495,15405,15336,2326155,1625616,2024-06-06,2024-07-19,534.67,-69,-700539,162615922,-53541395,0.999665949069858,83.3412517871405,-0.4309375645909
489.79,490,74813,74818,2169577,1571178,2024-06-06,2024-06-21,534.67,5,-598399,109509524,-65752697,1.43474096371746,60.9804896969509,-0.380860093509456
525.23,530,1722,3287,1300110,1567899,2024-06-06,2024-07-05,534.67,1565,267789,14823040,-3756140,10.5774456521739,26.7545658650317,0.170794802471333
368.73,370,12309,12299,1747878,1561973,2024-06-06,2024-12-20,534.67,-10,-185905,383807022,-51896645,0.406968322742151,95.5577347409762,-0.119019342843954
529.29,530,8523,21858,2761452,1551918,2024-06-06,2024-06-07,534.67,13335,-1209534,11090657,-11742034,13.9930213331816,29.3659609164723,-0.779380096113326
528.12,545,917,919,1964214,1551272,2024-06-06,2024-09-20,534.67,2,-412942,244715238,-48165897,0.633909033486505,96.162549959394,-0.266195741301332
528.97,534,2552,3060,2095192,1539180,2024-06-06,2024-06-21,534.67,508,-556012,109509524,-65752697,1.40552158732787,62.3860112842788,-0.361239101339675
522.01,524,7702,7734,2903654,1539066,2024-06-06,2024-06-21,534.67,32,-1364588,109509524,-65752697,1.4054174867932,63.791428771072,-0.88663384156365
510.67,513,6204,6472,2165196,1507976,2024-06-06,2024-07-19,534.67,268,-657220.000000001,162615922,-53541395,0.927323709421271,84.2685754965618,-0.435829217441127
373.66,375,11244,11240,1697844,1506160,2024-06-06,2024-12-20,534.67,-4,-191684,383807022,-51896645,0.39242637931726,95.9501611202934,-0.127266691453763
524.4,528,3060,4122,1842120,1483920,2024-06-06,2024-06-28,534.67,1062,-358200,66054797,-39996766,2.24649846399498,58.613319181043,-0.241387675885492
527.51,530,3621,5921,1821363,1474329,2024-06-06,2024-06-14,534.67,2300,-347034,23468414,-20040476,6.28218421577189,38.6477032491416,-0.23538436807524
517.43,521,3366,4101,1773882,1464057,2024-06-06,2024-07-19,534.67,735,-309825,162615922,-53541395,0.900315898956069,85.1688913955178,-0.211620859023931
529.48,535,2313,2648,2104830,1461696,2024-06-06,2024-06-21,534.67,335,-643134,109509524,-65752697,1.33476609760444,65.1261948686765,-0.439991626165769
504.6,505,38892,36353,2839116,1454120,2024-06-06,2024-06-21,534.67,-2539,-1384996,109509524,-65752697,1.32784797786172,66.4540428465382,-0.952463345528567
501.64,510,2014,1737,1973720,1452132,2024-06-06,2024-11-15,534.67,-277,-521588,10201073,1977879,14.2350907595701,36.659359265442,-0.359187732244727
479.36,480,22955,22360,1974130,1431040,2024-06-06,2024-07-19,534.67,-595,-543090,162615922,-53541395,0.880012229060817,86.0489036245787,-0.379507211538462
528.42,533,2621,3104,1999823,1421632,2024-06-06,2024-06-21,534.67,483,-578191,109509524,-65752697,1.29818115180557,67.7522239983438,-0.406709331247468
520.35,522,8118,8586,2597760,1416690,2024-06-06,2024-06-21,534.67,468,-1181070,109509524,-65752697,1.29366830231131,69.0458923006551,-0.833682739343117
533.65,550,646,860,1421200,1406100,2024-06-06,2024-06-21,534.67,214,-15099.9999999998,109509524,-65752697,1.2839979105379,70.329890211193,-0.0107389232629257
508.9,511,5915,6667,1845480,1400070,2024-06-06,2024-07-19,534.67,752,-445410,162615922,-53541395,0.860967353491991,86.9098709780707,-0.318134093295335
515.97,517,13941,13519,2885787,1392457,2024-06-06,2024-06-21,534.67,-422,-1493330,109509524,-65752697,1.27153963339298,71.6014298445859,-1.07244245244198
515.81,519,4261,4363,2023975,1391797,2024-06-06,2024-07-19,534.67,102,-632178,162615922,-53541395,0.85587990578192,87.7657508838526,-0.454217102063016
514.09,517,4648,4744,1993992,1380504,2024-06-06,2024-07-19,534.67,96,-613488,162615922,-53541395,0.848935321351866,88.6146862052044,-0.444394221240938
489.6,492,5682,5682,1392090,1363680,2024-06-06,2024-08-16,534.67,0,-28410.0000000002,116205577,-19412264,1.17350650046684,90.2109947786757,-0.0208333333333335
530.25,560,445,445,1575300,1323875,2024-06-06,2024-12-20,534.67,0,-251425,383807022,-51896645,0.344932459312847,96.2950935796063,-0.189915966386555
433.94,435,12392,12396,1598568,1313976,2024-06-06,2024-09-20,534.67,4,-284592,244715238,-48165897,0.53694081771892,96.6994907771129,-0.216588430838919
531.49,533,1053,8414,554931,1270514,2024-06-06,2024-06-07,534.67,7361,715583,11090657,-11742034,11.4557144811169,40.8216753975892,0.563223230912843
329.2,330,15703,15765,1444676,1261200,2024-06-06,2024-12-20,534.67,62,-183476,383807022,-51896645,0.328602638228959,96.6236962178352,-0.145477323184269
494.6,495,31328,31203,2036320,1248120,2024-06-06,2024-06-28,534.67,-125,-788200,66054797,-39996766,1.88952211903702,60.50284130008,-0.631509790725251
358.87,360,11176,11014,1397000,1244582,2024-06-06,2024-12-20,534.67,-162,-152418,383807022,-51896645,0.324272858144841,96.9479690759801,-0.122465213220182
511.32,512,13112,17958,1717672,1221144,2024-06-06,2024-06-21,534.67,4846,-496528,109509524,-65752697,1.11510301149697,72.7165328560829,-0.406608884783449
494.44,495,21731,21785,1868866,1219960,2024-06-06,2024-07-05,534.67,54,-648906,14823040,-3756140,8.23016061482665,34.9847264798584,-0.531907603527985
409.94,410,201859,201853,1614872,1211118,2024-06-06,2024-06-28,534.67,-6,-403754,66054797,-39996766,1.83350499131804,62.336346291398,-0.333372966135422
494.75,495,47208,48325,1746696,1208125,2024-06-06,2024-06-21,534.67,1117,-538571,109509524,-65752697,1.10321454780499,73.8197474038879,-0.445790791515779
461.61,465,3462,3485,1350180,1181415,2024-06-06,2024-11-15,534.67,23,-168765,10201073,1977879,11.5812816945825,48.2406409600245,-0.142849887634743
512.25,513,10680,15724,1559280,1179300,2024-06-06,2024-06-21,534.67,5044,-379980,109509524,-65752697,1.0768926362971,74.896640040185,-0.322208089544645
523.91,528,1601,2815,1042251,1151335,2024-06-06,2024-07-05,534.67,1214,109084,14823040,-3756140,7.76719890117007,42.7519253810285,0.0947456648151928
519.83,524,2440,2755,1488400,1148835,2024-06-06,2024-07-19,534.67,315,-339565,162615922,-53541395,0.706471411821531,89.321157617026,-0.295573341689625
524.84,531,1806,1829,1695834,1126664,2024-06-06,2024-07-19,534.67,23,-569170,162615922,-53541395,0.692837445523938,90.0139950625499,-0.505181669069039
527.7,533,2349,2119,1954368,1123070,2024-06-06,2024-06-28,534.67,-230,-831298,66054797,-39996766,1.70020960022025,64.0365558916183,-0.740201412200486
419.53,420,23638,23706,1300090,1114182,2024-06-06,2024-08-16,534.67,68,-185908,116205577,-19412264,0.958802519435018,91.1697972981107,-0.166856043267617
476.6,480,3143,3266,1247771,1110440,2024-06-06,2024-10-18,534.67,123,-137331,52962163,-8353895,2.09666663349833,82.6680435993522,-0.123672598249343
444.88,445,92251,91919,1291514,1103028,2024-06-06,2024-06-28,534.67,-332,-188486,66054797,-39996766,1.66986812479342,65.7064240164117,-0.170880521618672
479.85,480,77993,73281,1559860,1099215,2024-06-06,2024-06-21,534.67,-4712,-460645,109509524,-65752697,1.0037620106905,75.9004020508755,-0.419067243441911
399.05,400,9945,11550,1064115,1097250,2024-06-06,2024-10-18,534.67,1605,33134.9999999998,52962163,-8353895,2.07176206153061,84.7398056608829,0.0301982228298016
509.78,512,4839,4930,1606548,1094460,2024-06-06,2024-07-19,534.67,91,-512088,162615922,-53541395,0.673033726672841,90.6870287892227,-0.467891014746999
493.29,500,1613,1631,1272657,1094401,2024-06-06,2024-11-15,534.67,18,-178256,10201073,1977879,10.7282929942762,58.9689339543007,-0.162879968128684
530.07,531,7189,11690,2803710,1087170,2024-06-06,2024-06-07,534.67,4501,-1716540,11090657,-11742034,9.80257526673127,50.6242506643204,-1.57890670272359
519.3,520,14686,15261,2555364,1068270,2024-06-06,2024-06-14,534.67,575,-1487094,23468414,-20040476,4.55194799273611,43.1996512418777,-1.39205818753686
519.76,522,5091,4656,2036400,1042944,2024-06-06,2024-06-28,534.67,-435,-993456,66054797,-39996766,1.57890728208581,67.2853312984975,-0.95254970544919
472,475,3442,3459,1221910,1037700,2024-06-06,2024-10-18,534.67,17,-184210,52962163,-8353895,1.95932330029648,86.6991289611793,-0.177517586971186
399.96,400,258008,258147,1032032,1032588,2024-06-06,2024-06-21,534.67,139,556.000000000116,109509524,-65752697,0.942920727150636,76.8433227780261,0.000538452896992911
444.92,445,127671,127341,1149039,1018728,2024-06-06,2024-06-21,534.67,-330,-130311,109509524,-65752697,0.930264293724809,77.773587071751,-0.127915400381652
454.19,455,11879,12547,1187900,1016307,2024-06-06,2024-08-16,534.67,668,-171593,116205577,-19412264,0.874576785587494,92.0443740836983,-0.1688397305145
353.91,355,9255,9252,1092090,1008468,2024-06-06,2024-12-20,534.67,-3,-83622,383807022,-51896645,0.262753921161974,97.210722997142,-0.0829198348385869
530.05,536,1577,1686,1513920,1003170,2024-06-06,2024-06-21,534.67,109,-510750,109509524,-65752697,0.91605731022993,78.6896443819809,-0.50913603875714
529.49,533,1205,2848,824220,999648,2024-06-06,2024-06-14,534.67,1643,175428,23468414,-20040476,4.25954646956543,47.4591977114431,0.175489772399885
504.32,505,14471,14481,1750991,984708,2024-06-06,2024-06-28,534.67,10,-766283,66054797,-39996766,1.49074411658551,68.776075415083,-0.778182974039004
528.19,531,2632,3461,1513400,972541,2024-06-06,2024-06-14,534.67,829,-540859,23468414,-20040476,4.14404228594229,51.6032399973854,-0.556129767279734
515.01,518,3204,3233,1441800,966667,2024-06-06,2024-07-19,534.67,29,-475133,162615922,-53541395,0.594447940958697,91.2814767301814,-0.491516727063198
518.8,521,4315,4329,1605180,952380,2024-06-06,2024-06-28,534.67,14,-652800,66054797,-39996766,1.4418029321928,70.2178783472758,-0.685440685440685
514.62,515,25602,24629,2432190,935902,2024-06-06,2024-06-14,534.67,-973,-1496288,23468414,-20040476,3.9879218084358,55.5911618058212,-1.59876568273174
528.32,534,1416,1638,1319712,930384,2024-06-06,2024-06-28,534.67,222,-389328,66054797,-39996766,1.40850330673183,71.6263816540077,-0.418459474797503
339.08,340,10105,10105,1131760,929660,2024-06-06,2024-12-20,534.67,0,-202100,383807022,-51896645,0.242220685581933,97.452943682724,-0.217391304347826
494.66,497,4115,3940,1209810,921960,2024-06-06,2024-08-16,534.67,-175,-287850,116205577,-19412264,0.793387050606014,92.8377611343043,-0.312215280489392
489.66,490,27163,27069,1330987,920346,2024-06-06,2024-06-28,534.67,-94,-410641,66054797,-39996766,1.39330683281034,73.019688486818,-0.446181110147705
474.86,475,65164,65591,1107788,918274,2024-06-06,2024-06-21,534.67,427,-189514,109509524,-65752697,0.838533459427693,79.5281778414086,-0.206380666337063
501.4,502,15014,14963,1426330,897780,2024-06-06,2024-06-28,534.67,-51,-528550,66054797,-39996766,1.35914428743154,74.3788327742496,-0.588729978391143
525.12,529,2281,2296,1603543,890848,2024-06-06,2024-06-28,534.67,15,-712695,66054797,-39996766,1.34864997011496,75.7274827443645,-0.800018633930817
414.14,415,10356,10356,994176,890616,2024-06-06,2024-09-20,534.67,0,-103560,244715238,-48165897,0.363939739625041,97.063430516738,-0.116279069767442
523.62,527,2801,2602,1571361,879476,2024-06-06,2024-06-28,534.67,-199,-691885,66054797,-39996766,1.33143396080681,77.0589167051713,-0.786701399469684
424.08,425,9444,9456,1001064,869952,2024-06-06,2024-09-20,534.67,12,-131112,244715238,-48165897,0.355495639384745,97.4189261561227,-0.150711763407636
497.73,498,32645,32150,1469025,868050,2024-06-06,2024-06-21,534.67,-495,-600975,109509524,-65752697,0.79267078176689,80.3208486231755,-0.692327630896838
532.11,534,400,4561,242400,862029,2024-06-06,2024-06-07,534.67,4161,619629,11090657,-11742034,7.7725692896282,58.3968199539486,0.718802963705397
527.19,533,722,1481,654854,860461,2024-06-06,2024-07-05,534.67,759,205607,14823040,-3756140,5.80488887569621,48.5568142567247,0.238949818759944
528.92,532,1561,2782,1052114,856856,2024-06-06,2024-06-14,534.67,1221,-195258,23468414,-20040476,3.65110313803055,59.2422649438518,-0.227877262923992
525.31,527,3728,5051,1409184,853619,2024-06-06,2024-06-14,534.67,1323,-555565,23468414,-20040476,3.63731013097008,62.8795750748219,-0.650834857237245
349.92,350,106472,106441,851776,851528,2024-06-06,2024-07-19,534.67,-31,-247.999999999884,162615922,-53541395,0.523643681090466,91.8051204112719,-0.000291241157072796
299.42,300,14660,14660,952900,850280,2024-06-06,2024-12-20,534.67,0,-102620,383807022,-51896645,0.221538416772375,97.6744820994963,-0.120689655172414
533.3,560,25,316,78750,843720,2024-06-06,2024-06-21,534.67,291,764970,109509524,-65752697,0.77045353607783,81.0913021592533,0.906663348030152
496.73,497,30406,30373,1368270,820071,2024-06-06,2024-06-21,534.67,-33,-548199,109509524,-65752697,0.748858154109044,81.8401603133623,-0.668477485486013
469.87,470,63115,63046,883610,819598,2024-06-06,2024-06-21,534.67,-69,-64012,109509524,-65752697,0.748426228206416,82.5885865415688,-0.0781017035180662
454.61,455,20582,20664,946772,805896,2024-06-06,2024-07-19,534.67,82,-140876,162615922,-53541395,0.495582468240718,92.3007028795126,-0.174806674806675
527.82,534,1076,1296,1040492,800928,2024-06-06,2024-07-05,534.67,220,-239564,14823040,-3756140,5.40326410776737,53.960078364492,-0.299108034679771
329.73,330,29564,29562,1005176,798174,2024-06-06,2024-09-20,534.67,-2,-207002,244715238,-48165897,0.326164405013471,97.7450905611362,-0.259344453715606
526.07,533,908,1125,895288,779625,2024-06-06,2024-07-19,534.67,217,-115663,162615922,-53541395,0.479427223614672,92.7801301031273,-0.14835722302389
529.56,540,412,737,605640,769428,2024-06-06,2024-07-19,534.67,325,163788,162615922,-53541395,0.473156619928029,93.2532867230553,0.212869820178106
374.52,375,15684,15688,846936,753024,2024-06-06,2024-09-20,534.67,4,-93912,244715238,-48165897,0.307714389244531,98.0528049503807,-0.124713156552779
488.79,489,35554,35533,1066620,746193,2024-06-06,2024-06-21,534.67,-21,-320427,109509524,-65752697,0.681395528666529,83.2699820702353,-0.429415714165102
528.8,535,1067,1197,1057397,742140,2024-06-06,2024-06-28,534.67,130,-315257,66054797,-39996766,1.12352173302417,78.1824384381955,-0.424794513164632
530.1,534,1467,1875,1549152,731250,2024-06-06,2024-06-14,534.67,408,-817902,23468414,-20040476,3.11589014920224,65.9954652240241,-1.11849846153846
389.32,390,10724,10724,729232,729232,2024-06-06,2024-09-20,534.67,0,0,244715238,-48165897,0.297992068642656,98.3507970190234,0
448.09,450,2189,3807,483769,727137,2024-06-06,2024-10-18,534.67,1618,243368,52962163,-8353895,1.37293675109153,88.0720657122709,0.334693462167377
324.13,325,8329,8329,724623,724623,2024-06-06,2024-12-20,534.67,0,0,383807022,-51896645,0.188798786490154,97.8632808859865,0
333.98,335,7083,7083,722466,722466,2024-06-06,2024-12-20,534.67,0,0,383807022,-51896645,0.188236785308217,98.0515176712947,0
513.2,514,8713,8970,1376654,717600,2024-06-06,2024-06-21,534.67,257,-659054,109509524,-65752697,0.655285470878314,83.9252675411136,-0.918414158305463
515.43,517,4195,4478,1283670,703046,2024-06-06,2024-06-28,534.67,283,-580624,66054797,-39996766,1.06433753781728,79.2467759760128,-0.825869146542332
459.9,460,70484,69990,845808,699900,2024-06-06,2024-06-21,534.67,-494,-145908,109509524,-65752697,0.639122493126717,84.5643900342403,-0.208469781397343
343.92,345,6304,6304,680832,680832,2024-06-06,2024-12-20,534.67,0,0,383807022,-51896645,0.177389146361163,98.2289068176559,0
531.28,536,46,1432,52256,675904,2024-06-06,2024-06-14,534.67,1386,623648,23468414,-20040476,2.88005827747883,68.8755235015029,0.922687245525992
533.59,550,425,410,966875,672810,2024-06-06,2024-06-28,534.67,-15,-294065,66054797,-39996766,1.01856342091249,80.2653393969253,-0.437069900863543
474.43,475,11662,11764,851326,670548,2024-06-06,2024-07-19,534.67,102,-180778,162615922,-53541395,0.412350765996948,93.6656374890523,-0.26959740391441
517.19,519,3464,3657,1091160,661917,2024-06-06,2024-06-28,534.67,193,-429243,66054797,-39996766,1.00207256711424,81.2674119640395,-0.64848462873744
510.37,511,11004,10460,1320480,658980,2024-06-06,2024-06-21,534.67,-544,-661500,109509524,-65752697,0.601755880155228,85.1661459143955,-1.0038240917782
363.8,365,5655,5460,774735,655200,2024-06-06,2024-12-20,534.67,-195,-119535,383807022,-51896645,0.170710790174131,98.39961760783,-0.182440476190476
528.39,555,247,246,850174,654606,2024-06-06,2024-12-20,534.67,-1,-195568,383807022,-51896645,0.170556024897325,98.5701736327273,-0.298756809439571
429.46,430,12063,12062,747906,651348,2024-06-06,2024-08-16,534.67,-1,-96558,116205577,-19412264,0.560513545748325,93.3982746800526,-0.1482433353599
506.54,507,9878,13864,839630,637744,2024-06-06,2024-06-21,534.67,3986,-201886,109509524,-65752697,0.58236395950365,85.7485098738992,-0.316562758724504
481.83,482,37252,36878,782292,626926,2024-06-06,2024-06-21,534.67,-374,-155366,109509524,-65752697,0.572485366660894,86.3209952405601,-0.247821911995993
394.96,395,156212,156192,937272,624768,2024-06-06,2024-06-28,534.67,-20,-312504,66054797,-39996766,0.945832896890138,82.2132448609296,-0.500192071296865
490.03,491,6345,6335,850230,614495,2024-06-06,2024-07-19,534.67,-10,-235735,162615922,-53541395,0.377881201571394,94.0435186906237,-0.383623951374706
531.48,540,677,712,880100,606624,2024-06-06,2024-06-21,534.67,35,-273476,109509524,-65752697,0.553946339863554,86.8749415804236,-0.450816321147861
507.51,508,10302,12370,968388,606130,2024-06-06,2024-06-21,534.67,2068,-362258,109509524,-65752697,0.553495237546645,87.4284368179703,-0.597657268242786
506.15,508,2894,3257,804532,602545,2024-06-06,2024-07-19,534.67,363,-201987,162615922,-53541395,0.370532597662854,94.4140512882865,-0.33522309537047
525.93,531,991,1170,795773,593190,2024-06-06,2024-07-05,534.67,179,-202583,14823040,-3756140,4.0018106947023,57.9618890591943,-0.341514523171328
472.41,473,10084,10025,796636,591475,2024-06-06,2024-07-19,534.67,-59,-205161,162615922,-53541395,0.363725146176031,94.7777764344626,-0.346863350099328
488.81,495,950,952,671650,589288,2024-06-06,2024-11-15,534.67,2,-82362,10201073,1977879,5.77672564444936,64.7456595987501,-0.13976527606196
516.65,530,383,439,612800,586065,2024-06-06,2024-11-15,534.67,56,-26735,10201073,1977879,5.74513092887386,70.4907905276239,-0.0456178068985522
519.83,535,53,375,103244,568875,2024-06-06,2024-11-15,534.67,322,465631,10201073,1977879,5.57661924387758,76.0674097715015,0.818511975390024
516.3,518,3242,3318,956390,564060,2024-06-06,2024-06-28,534.67,76,-392330,66054797,-39996766,0.853927383956687,83.0671722448863,-0.695546573059604
526.82,529,2451,2555,1125009,556990,2024-06-06,2024-06-14,534.67,104,-568019,23468414,-20040476,2.37336021087748,71.2488837123804,-1.01980107362789
524.79,540,324,364,584820,553644,2024-06-06,2024-10-18,534.67,40,-31176,52962163,-8353895,1.04535760746781,89.1174233197387,-0.0563105533519735
454.9,455,55381,54864,553810,548640,2024-06-06,2024-06-21,534.67,-517,-5170,109509524,-65752697,0.500997520544423,87.9294343385147,-0.00942330125400992
527.11,532,892,1111,830452,543279,2024-06-06,2024-06-28,534.67,219,-287173,66054797,-39996766,0.82246714042585,83.8896393853122,-0.528592123015983
521.09,522,5587,5952,1217966,541632,2024-06-06,2024-06-14,534.67,365,-676334,23468414,-20040476,2.30791906091311,73.5568027732935,-1.24869653196266
512.8,515,202,2441,70094,537020,2024-06-06,2024-07-12,534.67,2239,466926,3646557,868777,14.7267682912951,14.7267682912951,0.869475997169565
481.3,482,7605,7581,790920,530670,2024-06-06,2024-07-19,534.67,-24,-260250,162615922,-53541395,0.326333358673205,95.1041097931357,-0.490417773757703
528.45,529,4256,9631,1187424,529705,2024-06-06,2024-06-07,534.67,5375,-657719,11090657,-11742034,4.77613724777531,63.1729572017239,-1.241670363693
449.97,450,176146,176088,528438,528264,2024-06-06,2024-06-14,534.67,-58,-174,23468414,-20040476,2.25095739320092,75.8077601664944,-0.000329380764163373
524.43,526,3469,3337,1165584,523909,2024-06-06,2024-06-14,534.67,-132,-641675,23468414,-20040476,2.23240053631234,78.0401607028068,-1.22478331160564
531.13,540,469,583,658007,517121,2024-06-06,2024-06-28,534.67,114,-140886,66054797,-39996766,0.782866685670081,84.6725060709823,-0.272443006569062
527.59,528,8134,12572,1903356,515452,2024-06-06,2024-06-07,534.67,4438,-1387904,11090657,-11742034,4.64762367098721,67.8205808727112,-2.69259601281982
524.53,529,945,1144,655830,511368,2024-06-06,2024-07-05,534.67,199,-144462,14823040,-3756140,3.44981866067959,61.4117077198739,-0.282501055990989
508.14,509,5853,5902,936480,507572,2024-06-06,2024-06-28,534.67,49,-428908,66054797,-39996766,0.768410506204417,85.4409165771867,-0.845019031782683
507.06,509,2526,2601,737592,504594,2024-06-06,2024-07-19,534.67,75,-232998,162615922,-53541395,0.310298028504244,95.41440782164,-0.461753409671935
449.91,450,55651,55563,556510,500067,2024-06-06,2024-06-21,534.67,-88,-56443,109509524,-65752697,0.456642474311184,88.3860768128259,-0.112870875302709
484.82,485,27736,27677,637928,498186,2024-06-06,2024-06-21,534.67,-59,-139742,109509524,-65752697,0.454924815489108,88.841001628315,-0.280501660022562
429.94,430,82746,82799,579222,496794,2024-06-06,2024-06-21,534.67,53,-82428.0000000001,109509524,-65752697,0.453653693171016,89.294655321486,-0.165919878259399
490.26,495,1032,1042,575856,493908,2024-06-06,2024-10-18,534.67,10,-81948,52962163,-8353895,0.932567652117985,90.0499909718567,-0.165917539298817
457.7,460,2108,2129,558620,489670,2024-06-06,2024-10-18,534.67,21,-68950,52962163,-8353895,0.924565713073312,90.97455668493,-0.14080911634366
384.43,385,8545,8548,563970,487236,2024-06-06,2024-09-20,534.67,3,-76734.0000000001,244715238,-48165897,0.19910325322692,98.5499002722503,-0.157488362928848
478.35,479,7484,7480,688528,486200,2024-06-06,2024-07-19,534.67,-4,-202328,162615922,-53541395,0.298986712998497,95.7133945346385,-0.416141505553271
524.82,525,19066,26831,2478580,482958,2024-06-06,2024-06-07,534.67,7765,-1995622,11090657,-11742034,4.35463832304975,72.1752191957609,-4.1320818787555
495.49,498,1954,1916,635050,480916,2024-06-06,2024-08-16,534.67,-38,-154134,116205577,-19412264,0.413849328419065,93.8121240084716,-0.320500877492119
434.42,435,8177,8180,556036,474440,2024-06-06,2024-08-16,534.67,3,-81596.0000000001,116205577,-19412264,0.408276446146814,94.2204004546185,-0.171983812494731
459.58,460,11560,11232,601120,471744,2024-06-06,2024-07-19,534.67,-328,-129376,162615922,-53541395,0.290097054579932,96.0034915892184,-0.274250440917108
487.16,489,2533,2544,643382,468096,2024-06-06,2024-08-16,534.67,11,-175286,116205577,-19412264,0.402817155668871,94.6232176102873,-0.374465921520372
522.82,524,4769,3874,1297168,457132,2024-06-06,2024-06-14,534.67,-895,-840036,23468414,-20040476,1.94786064367196,79.9880213464787,-1.83762239353185
389.13,390,5146,5147,540330,447789,2024-06-06,2024-10-18,534.67,1,-92540.9999999999,52962163,-8353895,0.84548850468966,91.8200451896196,-0.206662066285684
499.29,500,6077,6238,680624,442898,2024-06-06,2024-07-05,534.67,161,-237726,14823040,-3756140,2.98790261646734,64.3996103363413,-0.536751125541322
533.14,536,56,1526,42840,436436,2024-06-06,2024-06-07,534.67,1470,393596,11090657,-11742034,3.93516813296092,76.1103873287218,0.901841277988067
517.62,520,1715,1833,667135,436254,2024-06-06,2024-07-05,534.67,118,-230881,14823040,-3756140,2.94308050170545,67.3426908380467,-0.529235262026251
349.64,350,12110,12111,508620,435996,2024-06-06,2024-09-20,534.67,1,-72624,244715238,-48165897,0.178164630679843,98.7280649029302,-0.166570335507665
492.76,493,18886,18025,642124,432600,2024-06-06,2024-06-21,534.67,-861,-209524,109509524,-65752697,0.395034134200054,89.6896894556861,-0.484336569579288
434.94,435,72005,71864,504035,431184,2024-06-06,2024-06-21,534.67,-141,-72851.0000000001,109509524,-65752697,0.393741095979926,90.083430551666,-0.168955712642399
498.71,499,14837,14801,712176,429229,2024-06-06,2024-06-21,534.67,-36,-282947,109509524,-65752697,0.391955863126571,90.4753864147926,-0.65919823683861
505.58,506,8948,10188,733736,427896,2024-06-06,2024-06-21,534.67,1240,-305840,109509524,-65752697,0.390738617400985,90.8661250321935,-0.714753117579973
473.87,474,32901,32898,559317,427674,2024-06-06,2024-06-21,534.67,-3,-131643,109509524,-65752697,0.390535895307152,91.2566609275007,-0.307811557401198
462.34,465,1569,1600,451872,425600,2024-06-06,2024-10-18,534.67,31,-26272,52962163,-8353895,0.80359255719975,92.6236377468194,-0.0617293233082707
269.61,270,10888,10884,479072,424476,2024-06-06,2024-12-20,534.67,-4,-54596,383807022,-51896645,0.110596204777098,98.6807698375044,-0.128619757065182
464.83,465,25560,24691,536760,419747,2024-06-06,2024-06-28,534.67,-869,-117013,66054797,-39996766,0.6354527136008,86.0763692907875,-0.278770306875332
444.3,445,5996,5996,509660,419720,2024-06-06,2024-08-16,534.67,0,-89939.9999999999,116205577,-19412264,0.361187484142865,94.9844050944302,-0.214285714285714
439.93,440,60590,59875,484720,419125,2024-06-06,2024-06-21,534.67,-715,-65595,109509524,-65752697,0.382729268369389,91.6393901958701,-0.156504622725917
414.56,415,9528,9524,504984,419056,2024-06-06,2024-08-16,534.67,-4,-85928,116205577,-19412264,0.360616082995741,95.3450211774259,-0.205051353518384
439.37,440,6901,6649,545179,418887,2024-06-06,2024-08-16,534.67,-252,-126292,116205577,-19412264,0.360470651077271,95.7054918285032,-0.301494197719194
503.62,504,11330,10961,838420,416518,2024-06-06,2024-06-21,534.67,-369,-421902,109509524,-65752697,0.380348653510721,92.0197388493808,-1.01292621207247
502.64,503,11356,11145,715428,401220,2024-06-06,2024-06-21,534.67,-211,-314208,109509524,-65752697,0.3663790922879,92.3861179416687,-0.783131449080305
532.67,535,151,1658,101170,386314,2024-06-06,2024-06-07,534.67,1507,285144,11090657,-11742034,3.4832381886844,79.5936255174062,0.738114590721537
521.97,523,3524,3745,866904,385735,2024-06-06,2024-06-14,534.67,221,-481169,23468414,-20040476,1.64363471685816,81.6316560633369,-1.2474081947451
496.56,499,1576,1576,501168,384544,2024-06-06,2024-08-16,534.67,0,-116624,116205577,-19412264,0.330916992047636,96.0364088205509,-0.30327868852459
526.62,532,394,710,376664,381980,2024-06-06,2024-07-05,534.67,316,5315.99999999994,14823040,-3756140,2.57693428608437,69.9196251241311,0.013916959003089
493.74,494,14602,14463,540274,376038,2024-06-06,2024-06-21,534.67,-139,-164236,109509524,-65752697,0.34338383207656,92.7295017737453,-0.436753732335562
521.66,525,882,1122,474516,374748,2024-06-06,2024-07-05,534.67,240,-99768,14823040,-3756140,2.52814537368853,72.4477704978196,-0.26622690447981
501.65,502,10854,10627,651240,371945,2024-06-06,2024-06-21,534.67,-227,-279295,109509524,-65752697,0.339646257616826,93.0691480313621,-0.750904031510035
492.02,493,3769,3790,520122,371420,2024-06-06,2024-07-19,534.67,21,-148702,162615922,-53541395,0.228403218720489,96.2318948079389,-0.400360777556405
512.75,514,2287,2932,500853,366500,2024-06-06,2024-06-28,534.67,645,-134353,66054797,-39996766,0.554842368223462,86.6312116590109,-0.366583901773533
528.35,537,392,423,511952,365895,2024-06-06,2024-07-19,534.67,31,-146057,162615922,-53541395,0.225005642436415,96.4569004503753,-0.399177359625029
249.7,250,12126,12127,412284,363810,2024-06-06,2024-12-20,534.67,1,-48474,383807022,-51896645,0.0947898238297474,98.7755596613342,-0.133239877958275
508.48,509,7406,6981,755412,363012,2024-06-06,2024-06-21,534.67,-425,-392400,109509524,-65752697,0.331488976246486,93.4006370076086,-1.0809560014545
500.67,501,11856,10777,652080,355641,2024-06-06,2024-06-21,534.67,-1079,-296439,109509524,-65752697,0.32475805483366,93.7253950624422,-0.833534378769602
404.99,405,352501,352582,705002,352582,2024-06-06,2024-06-14,534.67,81,-352420,23468414,-20040476,1.50236824695525,83.1340243102921,-0.999540532415154
497.51,505,429,467,380094,349783,2024-06-06,2024-11-15,534.67,38,-30310.9999999999,10201073,1977879,3.42888439284769,79.4962941643492,-0.0866565842250765
274.53,275,7416,7416,348552,348552,2024-06-06,2024-12-20,534.67,0,0,383807022,-51896645,0.0908143884871392,98.8663740498213,0
284.39,285,5653,5653,344833,344833,2024-06-06,2024-12-20,534.67,0,0,383807022,-51896645,0.0898454119476741,98.956219461769,0
529.81,537,423,477,612927,342963,2024-06-06,2024-06-28,534.67,54,-269964,66054797,-39996766,0.519209831195152,87.1504214902061,-0.787151966830241
505.6,515,346,364,377140,342160,2024-06-06,2024-11-15,534.67,18,-34980,10201073,1977879,3.35415695976296,82.8504511241122,-0.102232873509469
510.92,512,2755,3167,520695,342036,2024-06-06,2024-06-28,534.67,412,-178659,66054797,-39996766,0.517806450907721,87.6682279411138,-0.522339753710136
394.38,395,5476,5476,383320,339512,2024-06-06,2024-09-20,534.67,0,-43808,244715238,-48165897,0.138737580370864,98.866802483301,-0.129032258064516
520.21,521,4459,4241,860587,335039,2024-06-06,2024-06-14,534.67,-218,-525548,23468414,-20040476,1.4276167106989,84.561641020991,-1.56861738484176
476.85,477,22110,22109,397980,331635,2024-06-06,2024-06-21,534.67,-1,-66345,109509524,-65752697,0.302836673822087,94.0282317362643,-0.200054276538966
533.75,575,5,80,25750,330000,2024-06-06,2024-12-20,534.67,75,304250,383807022,-51896645,0.0859807093367875,99.0422001711058,0.921969696969697
389.97,390,107820,107813,323460,323439,2024-06-06,2024-06-21,534.67,-7,-21,109509524,-65752697,0.295352393276771,94.3235841295411,-6.4927235120069e-05
487.17,488,3858,3886,482250,322538,2024-06-06,2024-07-19,534.67,28,-159712,162615922,-53541395,0.198343431585992,96.6552438819613,-0.495172661825894
529.05,536,419,464,475984,322480,2024-06-06,2024-06-28,534.67,45,-153504,66054797,-39996766,0.488200728252938,88.1564286693668,-0.476010915405607
477.86,478,22985,22981,413730,321734,2024-06-06,2024-06-21,534.67,-4,-91996,109509524,-65752697,0.293795451069626,94.6173795806107,-0.285938073066571
528.15,540,223,271,335392,321135,2024-06-06,2024-08-16,534.67,48,-14256.9999999999,116205577,-19412264,0.276350764128988,96.3127595846798,-0.0443956591464647
483.86,490,166,508,109560,311912,2024-06-06,2024-11-15,534.67,342,202352,10201073,1977879,3.05763913266771,85.9080902567799,0.648747082510452
423.42,425,1960,1960,309680,309680,2024-06-06,2024-10-18,534.67,0,0,52962163,-8353895,0.584719321225608,93.208357068045,0
526.7,527,8611,10191,1679145,305730,2024-06-06,2024-06-07,534.67,1580,-1373415,11090657,-11742034,2.7566446243897,82.3502701417959,-4.4922480620155
359.97,360,101783,101782,407132,305346,2024-06-06,2024-06-28,534.67,-1,-101786,66054797,-39996766,0.462261658301667,88.6186903276684,-0.333346433226569
530.65,540,10,326,13480,304810,2024-06-06,2024-07-05,534.67,316,291330,14823040,-3756140,2.05632582790035,74.50409632572,0.955775729142745
525.66,527.5,1652,1647,657496,303048,2024-06-06,2024-06-14,534.67,-5,-354448,23468414,-20040476,1.29130157666385,85.8529425976549,-1.16961009477047
289.48,290,5818,5807,314172,301964,2024-06-06,2024-12-20,534.67,-11,-12207.9999999999,383807022,-51896645,0.0786759967096173,99.1208761678154,-0.0404286603701101
509.77,510,13022,13031,677144,299713,2024-06-06,2024-06-14,534.67,9,-377431,23468414,-20040476,1.27709098706031,87.1300335847152,-1.25930807138829
494.88,496,2584,2614,421192,292768,2024-06-06,2024-07-19,534.67,30,-128424,162615922,-53541395,0.180036491137688,96.835280373099,-0.438654497759318
505.27,506,4270,3981,542290,290613,2024-06-06,2024-06-28,534.67,-289,-251677,66054797,-39996766,0.439957449267462,89.0586477769359,-0.866021134636097
479.75,480,11832,11587,378624,289675,2024-06-06,2024-06-28,534.67,-245,-88949,66054797,-39996766,0.438537416139512,89.4971851930754,-0.307064814015707
264.58,265,6895,6895,289590,289590,2024-06-06,2024-12-20,534.67,0,0,383807022,-51896645,0.0754519806570918,99.1963281484725,0
464.88,465,23691,23680,307983,284160,2024-06-06,2024-06-21,534.67,-11,-23823,109509524,-65752697,0.259484280106998,94.8768638607177,-0.083836570945946
519.3,522,986,1044,433840,281880,2024-06-06,2024-07-05,534.67,58,-151960,14823040,-3756140,1.90163421268512,76.4057305384051,-0.539094650205762
485.26,487,1599,1600,394953,278400,2024-06-06,2024-08-16,534.67,1,-116553,116205577,-19412264,0.239575420721847,96.5523350054017,-0.418653017241379
511.82,513,1478,2340,304468,276120,2024-06-06,2024-06-28,534.67,862,-28348,66054797,-39996766,0.418016574935504,89.9152017680109,-0.102665507750254
299.81,300,14408,14412,288160,273828,2024-06-06,2024-09-20,534.67,4,-14332.0000000001,244715238,-48165897,0.111896587330618,98.9786990706316,-0.0523394247483824
522.45,526,936,771,548496,273705,2024-06-06,2024-07-05,534.67,-165,-274791,14823040,-3756140,1.8464835823151,78.2522141207202,-1.00396777552474
484.71,485,9391,9345,375640,271005,2024-06-06,2024-06-28,534.67,-46,-104635,66054797,-39996766,0.410273004093859,90.3254747721047,-0.386099887455951
294.39,295,4396,4396,268156,268156,2024-06-06,2024-12-20,534.67,0,0,383807022,-51896645,0.0698674033118654,99.2661955517844,0
314.25,315,3519,3519,263925,263925,2024-06-06,2024-12-20,534.67,0,0,383807022,-51896645,0.0687650263991262,99.3349605781835,0
531.76,545,197,199,401486,263476,2024-06-06,2024-06-28,534.67,2,-138010,66054797,-39996766,0.398874891705443,90.7243496638102,-0.523804824727869
530.53,537,391,407,392955,263329,2024-06-06,2024-06-21,534.67,16,-129626,109509524,-65752697,0.240462190302279,95.11732605102,-0.492258733371562
474.79,475,12530,12411,363370,260631,2024-06-06,2024-06-28,534.67,-119,-102739,66054797,-39996766,0.39456786158922,91.1189175253994,-0.394193323127333
511,513,1281,1297,411201,259400,2024-06-06,2024-07-12,534.67,16,-151801,3646557,868777,7.11355944799437,21.8403277392894,-0.585200462606014
309.35,310,4013,3955,325053,257075,2024-06-06,2024-12-20,534.67,-58,-67978,383807022,-51896645,0.0669802753113777,99.4019408534949,-0.264428668676456
449.87,450,19868,19741,317888,256633,2024-06-06,2024-06-28,534.67,-127,-61255,66054797,-39996766,0.388515311007617,91.507432836407,-0.238687152470649
500.45,501,4355,4570,391950,251350,2024-06-06,2024-06-28,534.67,215,-140600,66054797,-39996766,0.380517405874399,91.8879502422814,-0.55937935150189
525.3,565,63,63,250110,250110,2024-06-06,2024-12-20,534.67,0,0,383807022,-51896645,0.0651655612491634,99.467106414744,0
424.76,425,10403,10410,291284,249840,2024-06-06,2024-07-19,534.67,7,-41444,162615922,-53541395,0.153638092092852,96.9889184651919,-0.165882164585335
506.22,507,3185,3124,509600,243672,2024-06-06,2024-06-28,534.67,-61,-265928,66054797,-39996766,0.368893723191671,92.2568439654731,-1.0913358941528
525.77,526,9301,10542,1497461,242466,2024-06-06,2024-06-07,534.67,1241,-1254995,11090657,-11742034,2.18621854413134,84.5364886859273,-5.17596281540505
502.4,503,3855,4016,404775,240960,2024-06-06,2024-06-28,534.67,161,-163815,66054797,-39996766,0.364788041056276,92.6216320065294,-0.67984312749004
523.2,527,450,634,275400,240920,2024-06-06,2024-07-05,534.67,184,-34480,14823040,-3756140,1.62530762920427,79.8775217499244,-0.143118047484642
499.89,500,21400,21746,406600,239206,2024-06-06,2024-06-14,534.67,346,-167394,23468414,-20040476,1.01926785508386,88.1493014397991,-0.699790139043335
379.5,380,4708,4725,301312,236250,2024-06-06,2024-09-20,534.67,17,-65062,244715238,-48165897,0.096540780186316,99.075239850818,-0.275394708994709
480.84,481,14642,14642,292840,234272,2024-06-06,2024-06-21,534.67,0,-58568,109509524,-65752697,0.213928425074699,95.3312544760947,-0.25
507.18,508,2864,2839,455376,232798,2024-06-06,2024-06-28,534.67,-25,-222578,66054797,-39996766,0.352431633390683,92.9740636399201,-0.95609927920343
475.45,480,342,505,177156,229775,2024-06-06,2024-11-15,534.67,163,52619,10201073,1977879,2.25245912856422,88.1605493853441,0.229002284843869
520.1,523,792,790,377784,229100,2024-06-06,2024-07-05,534.67,-2,-148684,14823040,-3756140,1.54556690125642,81.4230886511809,-0.648991706678306
517.91,521,91,740,43680,228660,2024-06-06,2024-07-12,534.67,649,184980,3646557,868777,6.27057248796605,28.1109002272555,0.808974022566256
419.95,420,45613,45580,273678,227900,2024-06-06,2024-06-21,534.67,-33,-45778,109509524,-65752697,0.208109753084124,95.5393642291788,-0.200868802106187
429.75,430,9013,9067,261377,226675,2024-06-06,2024-07-19,534.67,54,-34702,162615922,-53541395,0.139392869537092,97.128311334729,-0.153091430462115
518.27,521,693,828,286902,226044,2024-06-06,2024-07-05,534.67,135,-60858,14823040,-3756140,1.52495034756703,82.9480389987479,-0.269230769230769
369.55,370,5015,5014,275825,225630,2024-06-06,2024-09-20,534.67,-1,-50195,244715238,-48165897,0.0922010422579407,99.1674408930759,-0.222465984133315
429.88,430,18759,18783,262626,225396,2024-06-06,2024-07-05,534.67,24,-37230,14823040,-3756140,1.52057877466431,84.4686177734122,-0.165175956982378
522.09,540,63,125,138600,223875,2024-06-06,2024-11-15,534.67,62,85275,10201073,1977879,2.19462207554048,90.3551714608846,0.380904522613065
532.8,550,95,130,213750,223600,2024-06-06,2024-07-19,534.67,35,9850,162615922,-53541395,0.137501910790753,97.2658132455197,0.0440518783542039
493.78,496,1003,988,289867,219336,2024-06-06,2024-08-16,534.67,-15,-70531,116205577,-19412264,0.188748256032497,96.7410832614342,-0.321565999197578
491.87,494,894,1027,253002,218751,2024-06-06,2024-08-16,534.67,133,-34251,116205577,-19412264,0.188244837853178,96.9293280992873,-0.156575284227272
486.25,488,1299,1249,298770,218575,2024-06-06,2024-08-16,534.67,-50,-80195,116205577,-19412264,0.188093382127434,97.1174214814148,-0.366899233672652
339.56,340,4839,4839,212916,212916,2024-06-06,2024-09-20,534.67,0,0,244715238,-48165897,0.0870056158905805,99.2544465089665,0
509.98,511,2096,2069,400336,211038,2024-06-06,2024-06-28,534.67,-27,-189298,66054797,-39996766,0.319489287053596,93.2935529269736,-0.896985377041101
434.73,435,6670,7782,213440,210114,2024-06-06,2024-07-19,534.67,1112,-3325.99999999997,162615922,-53541395,0.129208749927944,97.3950219954477,-0.0158295020798232
493.58,494,5126,5002,410080,210084,2024-06-06,2024-06-28,534.67,-124,-199996,66054797,-39996766,0.318045031612163,93.6115979585858,-0.951981112316978
491.02,493,1059,1058,273222,209484,2024-06-06,2024-08-16,534.67,-1,-63738,116205577,-19412264,0.180270177566435,97.2976916589812,-0.304261900670218
532.54,540,264,280,310200,208880,2024-06-06,2024-06-14,534.67,16,-101320,23468414,-20040476,0.890047363234687,89.0393488030337,-0.485063194178476
520.92,524,668,675,340012,207900,2024-06-06,2024-07-05,534.67,7,-132112,14823040,-3756140,1.40254630629075,85.871164079703,-0.635459355459356
517.45,518,3634,3761,497858,206855,2024-06-06,2024-06-14,534.67,127,-291003,23468414,-20040476,0.881418744359973,89.9207675473937,-1.40679703173721
466.18,470,512,532,216064,203224,2024-06-06,2024-11-15,534.67,20,-12840,10201073,1977879,1.99218258706707,92.3473540479516,-0.0631815139944101
486.16,487,2743,2418,331903,203112,2024-06-06,2024-07-19,534.67,-325,-128791,162615922,-53541395,0.124902898499693,97.5199248939474,-0.634088581669227
434.9,435,20149,20158,282086,201580,2024-06-06,2024-06-28,534.67,9,-80506,66054797,-39996766,0.305170871995867,93.9167688305817,-0.39937493798988
492.93,494,1823,1857,284388,198699,2024-06-06,2024-07-19,534.67,34,-85689,162615922,-53541395,0.12218914209397,97.6421140360413,-0.43125028309151
469.83,471,1683,1686,264231,197262,2024-06-06,2024-08-16,534.67,3,-66969,116205577,-19412264,0.169752610066211,97.4674442690474,-0.339492654439274
490.79,491,10551,9389,327081,197169,2024-06-06,2024-06-21,534.67,-1162,-129912,109509524,-65752697,0.180047353689529,95.7194115828684,-0.658886538958964
279.54,280,4252,4253,216852,195638,2024-06-06,2024-12-20,534.67,1,-21214,383807022,-51896645,0.0509730121613043,99.5180794269053,-0.108434966622026
508.75,510,1421,1548,289884,193500,2024-06-06,2024-07-05,534.67,127,-96384,14823040,-3756140,1.30540024178576,87.1765643214887,-0.498108527131783
399.83,401,1639,1639,191763,191763,2024-06-06,2024-10-18,534.67,0,0,52962163,-8353895,0.362075468858778,93.5704325369038,0
517.06,520,306,641,145044,188454,2024-06-06,2024-07-12,534.67,335,43410,3646557,868777,5.16799819665509,33.2788984239106,0.230347989429781
515.08,517,898,980,292748,188160,2024-06-06,2024-07-05,534.67,82,-104588,14823040,-3756140,1.26937524286516,88.4459395643539,-0.555846088435374
483.25,484,2507,2500,308361,187500,2024-06-06,2024-07-19,534.67,-7,-120861,162615922,-53541395,0.115302362581691,97.757416398623,-0.644592
520.31,524,373,506,210745,186714,2024-06-06,2024-07-12,534.67,133,-24031,3646557,868777,5.12028195363462,38.3991803775452,-0.12870486412374
304.32,305,2728,2728,185504,185504,2024-06-06,2024-12-20,534.67,0,0,383807022,-51896645,0.0483326227418528,99.5664120496472,0
495.73,496,7500,6852,3e+05,185004,2024-06-06,2024-06-21,534.67,-648,-114996,109509524,-65752697,0.168938730844999,95.8883503137134,-0.621586560290588
479.98,485,358,361,205134,181222,2024-06-06,2024-11-15,534.67,3,-23912,10201073,1977879,1.77649939374025,94.1238534416919,-0.131948659655009
476.68,478,1372,1372,230496,181104,2024-06-06,2024-08-16,534.67,0,-49392,116205577,-19412264,0.155847941790264,97.6232922108377,-0.272727272727273
264.9,265,17807,18109,213684,181090,2024-06-06,2024-09-20,534.67,302,-32594,244715238,-48165897,0.0740002958050369,99.3284468047715,-0.179987851344635
426.37,428,1105,1105,180115,180115,2024-06-06,2024-10-18,534.67,0,0,52962163,-8353895,0.340082409398574,93.9105149463023,0
380.1,381,2001,2001,180090,180090,2024-06-06,2024-10-18,534.67,0,0,52962163,-8353895,0.3400352058884,94.2505501521907,0
530.57,539,11,211,15169,177873,2024-06-06,2024-06-28,534.67,200,162704,66054797,-39996766,0.269280972886799,94.1860498034685,0.914720053071574
391,392,1754,1754,175400,175400,2024-06-06,2024-10-18,534.67,0,0,52962163,-8353895,0.331179827379784,94.5817299795705,0
359.99,360,175248,175255,175248,175255,2024-06-06,2024-06-14,534.67,7,7,23468414,-20040476,0.746769679450857,90.6675372268446,3.99417990927506e-05
259.64,260,4851,4838,184338,174168,2024-06-06,2024-12-20,534.67,-13,-10170,383807022,-51896645,0.0453790551023321,99.6117911047495,-0.058391897478297
481.41,483,1111,1091,263307,173469,2024-06-06,2024-08-16,534.67,-20,-89838,116205577,-19412264,0.149277689142235,97.7725698999799,-0.517890804697093
519.95,520,28056,34443,1094184,172215,2024-06-06,2024-06-07,534.67,6387,-921969,11090657,-11742034,1.55279349095369,86.0892821768809,-5.35359289260517
518.36,519,2967,2689,483621,172096,2024-06-06,2024-06-14,534.67,-278,-311525,23468414,-20040476,0.733309034006303,91.4008462608509,-1.81018152658981
484.37,486,1034,1055,214038,171965,2024-06-06,2024-08-16,534.67,21,-42073,116205577,-19412264,0.147983431122243,97.9205533311022,-0.244660250632396
528.35,535,33,258,32340,171570,2024-06-06,2024-07-05,534.67,225,139230,14823040,-3756140,1.15745488105004,89.6033944454039,0.811505507955936
470.8,472,1425,1426,200925,171120,2024-06-06,2024-08-16,534.67,1,-29805,116205577,-19412264,0.147256271529894,98.0678096026321,-0.174176016830294
494.91,495,19550,18931,273700,170379,2024-06-06,2024-06-14,534.67,-619,-103321,23468414,-20040476,0.725992817409817,92.1268390782607,-0.606418631404105
527.15,527.5,3111,4826,662643,168910,2024-06-06,2024-06-07,534.67,1715,-493733,11090657,-11742034,1.52299363328971,87.6122758101707,-2.92305369723521
475.65,477,1244,1244,204016,167940,2024-06-06,2024-08-16,534.67,0,-36076,116205577,-19412264,0.144519741939752,98.2123293445718,-0.214814814814815
478.76,479,6941,6939,284581,166536,2024-06-06,2024-06-28,534.67,-2,-118045,66054797,-39996766,0.252117949889393,94.4381677533579,-0.708825719363981
489.12,491,863,876,244229,164688,2024-06-06,2024-08-16,534.67,13,-79541,116205577,-19412264,0.141721253189079,98.3540505977609,-0.482979937821821
364.58,365,3910,3910,203320,164220,2024-06-06,2024-09-20,534.67,0,-39100,244715238,-48165897,0.0671065689828436,99.3955533737544,-0.238095238095238
523.88,524,10054,13590,1045616,163080,2024-06-06,2024-06-07,534.67,3536,-882536,11090657,-11742034,1.47042686470242,89.0827026748731,-5.41167525141035
491.77,492,7067,7068,289747,162564,2024-06-06,2024-06-21,534.67,1,-127183,109509524,-65752697,0.14844736244128,96.0367976761546,-0.782356487291159
488.67,489,4896,4890,244800,161370,2024-06-06,2024-06-28,534.67,-6,-83430,66054797,-39996766,0.24429717042352,94.6824649237814,-0.517010596765198
119.97,120,51758,53290,155274,159870,2024-06-06,2024-12-20,534.67,1532,4596,383807022,-51896645,0.0416537454596128,99.6534448502091,0.0287483580409082
515.59,516,3142,3893,336194,159613,2024-06-06,2024-06-14,534.67,751,-176581,23468414,-20040476,0.680118392320845,92.8069574705815,-1.10630713037159
485.22,486,2057,2016,220099,157248,2024-06-06,2024-07-19,534.67,-41,-62851,162615922,-53541395,0.0966990181933107,97.8541154168163,-0.399693477818478
513.32,515,943,935,265926,157080,2024-06-06,2024-07-05,534.67,-8,-108846,14823040,-3756140,1.0597016536419,90.6630960990458,-0.692933537051184
528.75,538,165,169,250965,156325,2024-06-06,2024-07-19,534.67,4,-94640,162615922,-53541395,0.0961314230964419,97.9502468399128,-0.605405405405405
527.12,534,1,223,1096,153424,2024-06-06,2024-07-12,534.67,222,152328,3646557,868777,4.20736601676595,42.6065463943111,0.992856397955991
474.71,475,5270,5279,194990,153091,2024-06-06,2024-07-05,534.67,9,-41899,14823040,-3756140,1.03279084452312,91.6958869435689,-0.273686892109922
465.51,466,2833,3082,198310,151018,2024-06-06,2024-07-19,534.67,249,-47292,162615922,-53541395,0.0928679050259298,98.0431147449387,-0.31315472327802
526.46,533,2,230,2034,150420,2024-06-06,2024-07-12,534.67,228,148386,3646557,868777,4.12498693973521,46.7315333340463,0.986477861986438
503.36,504,2601,2334,280908,149376,2024-06-06,2024-06-28,534.67,-267,-131532,66054797,-39996766,0.226139518678712,94.9086044424601,-0.880543059125964
397.74,399,1182,1182,148932,148932,2024-06-06,2024-10-18,534.67,0,0,52962163,-8353895,0.281204527088518,94.862934506659,0
410.69,412,1125,1125,147375,147375,2024-06-06,2024-10-18,534.67,0,0,52962163,-8353895,0.27826469247489,95.1411991991339,0
505.96,507,508,1403,87884,145912,2024-06-06,2024-07-05,534.67,895,58028,14823040,-3756140,0.984359483614697,92.6802464271836,0.397691759416635
530.98,538,203,206,229796,144612,2024-06-06,2024-06-21,534.67,3,-85184,109509524,-65752697,0.132054267718304,96.1688519438729,-0.589052084197715
399.64,400,5072,3946,207952,142056,2024-06-06,2024-08-16,534.67,-1126,-65896,116205577,-19412264,0.122245423728674,98.4762960214896,-0.463873402038633
219.78,220,6405,6405,140910,140910,2024-06-06,2024-12-20,534.67,0,0,383807022,-51896645,0.0367137628868083,99.6901586130959,0
444.68,445,4397,4400,171483,140800,2024-06-06,2024-07-19,534.67,3,-30683,162615922,-53541395,0.0865843874746779,98.1296991324134,-0.217919034090909
512.87,525,112,116,156464,140708,2024-06-06,2024-11-15,534.67,4,-15756,10201073,1977879,1.3793450943837,95.5031985360756,-0.111976575603377
529.36,550,60,67,159600,138288,2024-06-06,2024-10-18,534.67,7,-21312,52962163,-8353895,0.261107160596896,95.4023063597308,-0.15411315515446
524.63,530,125,256,97500,137472,2024-06-06,2024-07-12,534.67,131,39972,3646557,868777,3.76991227615529,50.5014456102016,0.290764664804469
469.81,470,7160,7164,179000,136116,2024-06-06,2024-06-28,534.67,4,-42884,66054797,-39996766,0.206065276379549,95.1146697188397,-0.315054806194716
359.6,360,3395,3395,162960,135800,2024-06-06,2024-09-20,534.67,0,-27160,244715238,-48165897,0.055493070684875,99.4510464444392,-0.2
486.81,487,7113,7112,177825,135128,2024-06-06,2024-06-21,534.67,-1,-42697,109509524,-65752697,0.123393833763719,96.2922457776367,-0.315974483452726
516.52,517,3235,2800,404375,134400,2024-06-06,2024-06-14,534.67,-435,-269975,23468414,-20040476,0.57268463049953,93.3796421010811,-2.00874255952381
424.95,425,26841,26833,161046,134165,2024-06-06,2024-06-21,534.67,-8,-26881,109509524,-65752697,0.122514458194522,96.4147602358312,-0.200357768419483
527.83,536,144,163,181872,133171,2024-06-06,2024-07-19,534.67,19,-48701,162615922,-53541395,0.0818929649459541,98.2115920973593,-0.365702743089712
522.9,523,8979,13194,736278,131940,2024-06-06,2024-06-07,534.67,4215,-604338,11090657,-11742034,1.18964999097889,90.272352665852,-4.58040018190086
354.62,355,3465,3465,152460,131670,2024-06-06,2024-09-20,534.67,0,-20790,244715238,-48165897,0.0538053948238401,99.5048518392631,-0.157894736842105
334.71,335,4407,4412,145431,127948,2024-06-06,2024-09-20,534.67,5,-17483,244715238,-48165897,0.0522844433577937,99.5571362826209,-0.136641448088286
199.86,200,9125,9098,136875,127372,2024-06-06,2024-12-20,534.67,-27,-9503,383807022,-51896645,0.0331864694231676,99.7233450825191,-0.0746082341487925
471.45,472,2315,2313,157420,127215,2024-06-06,2024-07-19,534.67,-2,-30205,162615922,-53541395,0.0782303469644258,98.2898224443237,-0.237432692685611
471.75,473,1010,1010,170690,126250,2024-06-06,2024-08-16,534.67,0,-44440,116205577,-19412264,0.108643666904214,98.5849396883938,-0.352
482.83,483,7374,7388,162228,125596,2024-06-06,2024-06-21,534.67,14,-36632,109509524,-65752697,0.114689568005062,96.5294498038362,-0.291665339660499
527.7,535,27,170,34317,124100,2024-06-06,2024-07-12,534.67,143,89783,3646557,868777,3.40321020623015,53.9046558164318,0.723473005640613
475.28,476,1723,1723,158516,124056,2024-06-06,2024-07-19,534.67,0,-34460,162615922,-53541395,0.0762877327596495,98.3661101770834,-0.277777777777778
391.95,393,1171,1171,122955,122955,2024-06-06,2024-10-18,534.67,0,0,52962163,-8353895,0.232156303737066,95.6344626634679,0
533.75,538,20,287,21320,121975,2024-06-06,2024-06-07,534.67,267,100655,11090657,-11742034,1.09979958806769,91.3721522539197,0.825210084033613
518.77,522.5,298,325,172244,121225,2024-06-06,2024-07-12,534.67,27,-51019,3646557,868777,3.32436871273368,57.2290245291655,-0.42086203340895
412.59,414,854,854,120414,120414,2024-06-06,2024-10-18,534.67,0,0,52962163,-8353895,0.227358538962995,95.8618212024309,0
349.48,350,2221,2283,135481,118716,2024-06-06,2024-10-18,534.67,62,-16765,52962163,-8353895,0.224152476551987,96.0859736789829,-0.141219380706897
523.28,528,188,249,136864,117528,2024-06-06,2024-07-12,534.67,61,-19336,3646557,868777,3.22298540787927,60.4520099370447,-0.164522496766728
364.9,365,11942,11746,143304,117460,2024-06-06,2024-07-19,534.67,-196,-25844,162615922,-53541395,0.072231549380509,98.4383417264639,-0.220023837902264
414.79,415,5525,5534,138125,116214,2024-06-06,2024-07-19,534.67,9,-21911,162615922,-53541395,0.0714653267470328,98.5098070532109,-0.188540107043902
519.51,523,274,331,164400,115519,2024-06-06,2024-07-12,534.67,57,-48881,3646557,868777,3.16789234338035,63.6199022804251,-0.423142513352782
439.7,440,3763,3849,127942,115470,2024-06-06,2024-07-19,534.67,86,-12472,162615922,-53541395,0.0710078069723087,98.5808148601833,-0.108010738720014
239.7,240,3833,3833,114990,114990,2024-06-06,2024-12-20,534.67,0,0,383807022,-51896645,0.0299603689898097,99.7533054515089,0
433.41,435,712,723,130296,114957,2024-06-06,2024-10-18,534.67,11,-15339,52962163,-8353895,0.217054956762246,96.3030286357451,-0.133432500848143
472.87,473,8811,8808,140976,114504,2024-06-06,2024-06-21,534.67,-3,-26472,109509524,-65752697,0.104560768614061,96.6340105724503,-0.231188430098512
354.99,355,113870,113862,113870,113862,2024-06-06,2024-06-21,534.67,-8,-7.99999999998545,109509524,-65752697,0.103974518234597,96.7379850906849,-7.02604907694002e-05
473.42,474,1957,1957,168302,113506,2024-06-06,2024-07-19,534.67,0,-54796,162615922,-53541395,0.0698000531583863,98.6506149133417,-0.482758620689655
511.94,514,529,543,178273,111858,2024-06-06,2024-07-12,534.67,14,-66415,3646557,868777,3.06749627114015,66.6873985515652,-0.593743853814658
530.3,545,69,76,135723,111720,2024-06-06,2024-08-16,534.67,7,-24003,116205577,-19412264,0.0961399640913964,98.6810796524852,-0.21484962406015
388.06,389,1183,1183,111202,111202,2024-06-06,2024-10-18,534.67,0,0,52962163,-8353895,0.209964989534132,96.5129936252792,0
452.91,453,12265,12265,122650,110385,2024-06-06,2024-06-21,534.67,0,-12265,109509524,-65752697,0.100799451927122,96.838784542612,-0.111111111111111
529.25,539,104,111,154128,108225,2024-06-06,2024-07-19,534.67,7,-45903,162615922,-53541395,0.0665525236821521,98.7171674370238,-0.424144144144144
515.93,518,323,520,112404,107640,2024-06-06,2024-07-05,534.67,197,-4764.00000000001,14823040,-3756140,0.726166832174776,93.4064132593584,-0.044258639910814
189.89,190,9785,9785,127205,107635,2024-06-06,2024-12-20,534.67,0,-19570,383807022,-51896645,0.0280440413620155,99.7813494928709,-0.181818181818182
344.98,345,50835,53792,50835,107584,2024-06-06,2024-06-21,534.67,2957,56749,109509524,-65752697,0.0982416835269962,96.937026226139,0.527485499702558
389.86,390,7729,7681,123664,107534,2024-06-06,2024-07-19,534.67,-48,-16130,162615922,-53541395,0.0661275960419177,98.7832950330657,-0.149999070061562
488.11,489,1196,1203,166244,107067,2024-06-06,2024-07-19,534.67,7,-59177,162615922,-53541395,0.0658404162908476,98.8491354493566,-0.552709985336285
516.77,519,438,480,159870,107040,2024-06-06,2024-07-05,534.67,42,-52830,14823040,-3756140,0.722119079487069,94.1285323388455,-0.493553811659193
533.64,537,11,317,11319,106512,2024-06-06,2024-06-07,534.67,306,95193,11090657,-11742034,0.960375927233166,92.3325281811528,0.893730283911672
450.91,451,11769,11768,141228,105912,2024-06-06,2024-06-21,534.67,-1,-35316,109509524,-65752697,0.0967148756851504,97.0337411018242,-0.333446634942216
492.63,493,2837,2855,158872,105635,2024-06-06,2024-06-28,534.67,18,-53237.0000000001,66054797,-39996766,0.159920255299551,95.2745899741392,-0.503971221659488
482.73,483,3889,3886,143893,104922,2024-06-06,2024-06-28,534.67,-3,-38971,66054797,-39996766,0.158840848454958,95.4334308225942,-0.37142829911744
456.83,460,323,326,114988,103342,2024-06-06,2024-11-15,534.67,3,-11646,10201073,1977879,1.01305029382693,96.5162488299025,-0.112693774070562
485.82,486,5726,5708,131698,102744,2024-06-06,2024-06-21,534.67,-18,-28954,109509524,-65752697,0.09382197661639,97.1275630784406,-0.281807210153391
504.84,505,7430,6406,222900,102496,2024-06-06,2024-06-14,534.67,-1024,-120404,23468414,-20040476,0.436740207497618,93.8163823085787,-1.17471901342491
513.67,514,3169,3083,266196,101739,2024-06-06,2024-06-14,534.67,-86,-164457,23468414,-20040476,0.4335145954047,94.2498969039834,-1.61645976469201
409.96,410,25396,25417,126980,101668,2024-06-06,2024-06-21,534.67,21,-25312,109509524,-65752697,0.0928394136751065,97.2204024921157,-0.248967226659323
530.84,539,100,124,120800,101184,2024-06-06,2024-06-21,534.67,24,-19616,109509524,-65752697,0.0923974429840458,97.3127999350997,-0.193864642631246
403.96,405,1026,961,115938,99944,2024-06-06,2024-10-18,534.67,-65,-15994,52962163,-8353895,0.188708304832641,96.7017019301119,-0.160029616585288
269.89,270,9002,9052,126028,99572,2024-06-06,2024-09-20,534.67,50,-26456,244715238,-48165897,0.0406889251416375,99.5978252077625,-0.265697183947295
512.33,514,575,595,151800,99365,2024-06-06,2024-07-05,534.67,20,-52435,14823040,-3756140,0.670341576356807,94.7988739152023,-0.527700900719569
479.49,481,666,656,119880,99056,2024-06-06,2024-08-16,534.67,-10,-20824,116205577,-19412264,0.0852420361890204,98.7663216886742,-0.210224519463738
404.82,405,5501,5499,104519,98982,2024-06-06,2024-07-19,534.67,-2,-5537,162615922,-53541395,0.0608685784163251,98.9100040277729,-0.0559394637408822
496.54,497,2099,2138,151128,98348,2024-06-06,2024-06-28,534.67,39,-52780,66054797,-39996766,0.148888505402568,95.5823193279967,-0.536665717655672
404.97,405,32727,32600,130908,97800,2024-06-06,2024-06-21,534.67,-127,-33108,109509524,-65752697,0.0893073007969608,97.4021072358967,-0.338527607361963
424.5,425,1937,1954,112346,97700,2024-06-06,2024-08-16,534.67,17,-14646,116205577,-19412264,0.084075138665677,98.8503968273399,-0.149907881269191
491.64,492,2716,2712,154812,97632,2024-06-06,2024-06-28,534.67,-4,-57180,66054797,-39996766,0.147804556874196,95.7301238848709,-0.585668633235005
476.41,477,1641,1642,127998,96878,2024-06-06,2024-07-19,534.67,1,-31120,162615922,-53541395,0.0595747321716751,98.9695787599446,-0.321228761948017
409.82,410,5392,5360,113232,96480,2024-06-06,2024-07-19,534.67,-32,-16752,162615922,-53541395,0.059329983690035,99.0289087436346,-0.17363184079602
498.5,499,1833,1898,146640,94900,2024-06-06,2024-06-28,534.67,65,-51740,66054797,-39996766,0.143668596846948,95.8737924817179,-0.545205479452055
149.93,150,13491,13491,94437,94437,2024-06-06,2024-12-20,534.67,0,0,383807022,-51896645,0.0246053340837521,99.8059548269547,0
402.6,404,669,669,93660,93660,2024-06-06,2024-10-18,534.67,0,0,52962163,-8353895,0.17684323051534,96.8785451606272,0
394.97,395,31083,31083,93249,93249,2024-06-06,2024-06-21,534.67,0,0,109509524,-65752697,0.0851514978733722,97.48725873377,0
477.64,479,682,681,125488,92616,2024-06-06,2024-08-16,534.67,-1,-32872,116205577,-19412264,0.0797001334970352,98.9300969608369,-0.354927874233394
477.39,478,1486,1479,132254,90219,2024-06-06,2024-07-19,534.67,-7,-42035,162615922,-53541395,0.0554798071987072,99.0843885508333,-0.465921812478524
487.81,488,4717,4714,122642,89566,2024-06-06,2024-06-21,534.67,-3,-33076,109509524,-65752697,0.0817883200734212,97.5690470538435,-0.369291918808476
495.57,496,2071,2058,138757,88494,2024-06-06,2024-06-28,534.67,-13,-50263,66054797,-39996766,0.133970588086131,96.007763069804,-0.56798201007978
487.69,488,2905,2852,130725,88412,2024-06-06,2024-06-28,534.67,-53,-42313,66054797,-39996766,0.13384644872953,96.1416095185335,-0.478588879337647
384.72,385,3113,3113,121407,87164,2024-06-06,2024-08-16,534.67,0,-34243,116205577,-19412264,0.0750084481745657,99.0051054090115,-0.392857142857143
448.91,449,9654,9654,86886,86886,2024-06-06,2024-06-21,534.67,0,0,109509524,-65752697,0.0793410443460607,97.6483880981895,0
314.77,315,3777,3775,98202,86825,2024-06-06,2024-09-20,534.67,-2,-11377,244715238,-48165897,0.035480013712918,99.6333052214754,-0.131033688453786
415.81,416,4452,4452,84588,84588,2024-06-06,2024-06-28,534.67,0,0,66054797,-39996766,0.128057315807056,96.2696668343406,0
482.3,483,1229,1204,124129,84280,2024-06-06,2024-07-19,534.67,-25,-39849,162615922,-53541395,0.0518276432980529,99.1362161941314,-0.47281680113906
454.85,455,5631,5616,95727,84240,2024-06-06,2024-06-28,534.67,-15,-11487,66054797,-39996766,0.127530480488798,96.3971973148294,-0.136360398860399
379.88,380,6841,6844,95774,82128,2024-06-06,2024-07-19,534.67,3,-13646,162615922,-53541395,0.050504279648582,99.1867204737799,-0.166155269822716
465.83,466,4963,4813,109186,81821,2024-06-06,2024-06-28,534.67,-150,-27365,66054797,-39996766,0.123868369469064,96.5210656842985,-0.334449591180748
512.7,513,3044,2726,240476,81780,2024-06-06,2024-06-14,534.67,-318,-158696,23468414,-20040476,0.348468371147705,94.5983652751311,-1.94052335534361
414.96,415,20543,20403,82172,81612,2024-06-06,2024-06-21,534.67,-140,-560,109509524,-65752697,0.0745250248736357,97.7229131230632,-0.00686173601921286
409.59,410,1991,1990,101541,81590,2024-06-06,2024-08-16,534.67,-1,-19951,116205577,-19412264,0.0702117764967511,99.0753171855082,-0.244527515626915
532.55,539,66,126,72270,81270,2024-06-06,2024-06-14,534.67,60,9000,23468414,-20040476,0.346295237505185,94.9446605126363,0.110741971207087
470.48,471,1548,1549,114552,80548,2024-06-06,2024-07-19,534.67,1,-34004,162615922,-53541395,0.049532665073227,99.2362531388532,-0.422158216218901
411.8,413,658,661,90804,79320,2024-06-06,2024-10-18,534.67,3,-11484,52962163,-8353895,0.149767297079615,97.0283124577068,-0.144780635400908
497.54,498,1788,1724,141252,79304,2024-06-06,2024-06-28,534.67,-64,-61948,66054797,-39996766,0.120057896779245,96.6411235810777,-0.781145969938464
394.85,395,5240,5251,99560,78765,2024-06-06,2024-07-19,534.67,11,-20795,162615922,-53541395,0.0484362164733168,99.2846893553265,-0.26401320383419
515.39,518,297,301,128304,78561,2024-06-06,2024-07-12,534.67,4,-49743,3646557,868777,2.15438837237427,68.8417869239395,-0.633176767098179
129.96,130,19519,19519,78076,78076,2024-06-06,2024-12-20,534.67,0,0,383807022,-51896645,0.0203425147338758,99.8262973416886,0
404.52,405,1626,1626,78048,78048,2024-06-06,2024-08-16,534.67,0,0,116205577,-19412264,0.0671637300161592,99.1424809155244,0
470.87,471,5943,5949,95088,77337,2024-06-06,2024-06-21,534.67,6,-17751,109509524,-65752697,0.0706212548234617,97.7935343778866,-0.229527910314597
532.55,560,17,28,54230,76860,2024-06-06,2024-09-20,534.67,11,22630,244715238,-48165897,0.0314079338206148,99.664713155296,0.294431433775696
532,550,38,42,88008,75600,2024-06-06,2024-08-16,534.67,4,-12408,116205577,-19412264,0.0650571185580878,99.2075380340825,-0.164126984126984
344.99,345,75594,75594,226782,75594,2024-06-06,2024-06-28,534.67,0,-151188,66054797,-39996766,0.114441347840339,96.755564928918,-2
511.73,512,2138,2771,143246,74817,2024-06-06,2024-06-14,534.67,633,-68429,23468414,-20040476,0.318798705357763,95.263459217994,-0.914618335405055
484.62,485,1951,1968,117060,74784,2024-06-06,2024-07-05,534.67,17,-42276,14823040,-3756140,0.504511894995898,95.3033858101982,-0.565308087291399
468.49,469,1444,1446,89528,73746,2024-06-06,2024-07-19,534.67,2,-15782,162615922,-53541395,0.0453498028317301,99.3300391581582,-0.214004827380468
468.82,469,4043,4092,113204,73656,2024-06-06,2024-06-28,534.67,49,-39548,66054797,-39996766,0.111507420119692,96.8670723490377,-0.536928424025199
419.79,420,3528,3495,95256,73395,2024-06-06,2024-07-19,534.67,-33,-21861,162615922,-53541395,0.0451339568089772,99.3751731149672,-0.297854077253219
374.88,375,6024,6022,72288,72264,2024-06-06,2024-07-19,534.67,-2,-24,162615922,-53541395,0.0444384529578844,99.4196115679251,-0.000332115576220525
169.91,170,8014,8013,80140,72117,2024-06-06,2024-12-20,534.67,-1,-8023.00000000001,383807022,-51896645,0.0187899115613367,99.8450872532499,-0.111249774671714
204.84,205,4452,4452,71232,71232,2024-06-06,2024-12-20,534.67,0,0,383807022,-51896645,0.0185593269317517,99.8636465801816,0
489.92,490,9439,8902,94390,71216,2024-06-06,2024-06-14,534.67,-537,-23174,23468414,-20040476,0.303454677423025,95.566913895417,-0.325404403504831
521.06,525,98,180,58702,70920,2024-06-06,2024-07-12,534.67,82,12218,3646557,868777,1.94484825000679,70.7866351739463,0.172278623801466
229.77,230,3072,3073,79872,70679,2024-06-06,2024-12-20,534.67,1,-9192.99999999999,383807022,-51896645,0.0184152441067115,99.8820618242884,-0.130066922282432
507.85,509,558,609,109368,70035,2024-06-06,2024-07-05,534.67,51,-39333,14823040,-3756140,0.472473932472691,95.7758597426709,-0.561619190404798
465.88,466,5747,5715,86205,68580,2024-06-06,2024-06-21,534.67,-32,-17625,109509524,-65752697,0.0626246900680529,97.8561590679547,-0.256999125109361
349.27,350,320,936,25600,68328,2024-06-06,2024-11-15,534.67,616,42728,10201073,1977879,0.669811891356919,97.1860607212594,0.625336611637982
420.88,421,5687,5687,68244,68244,2024-06-06,2024-06-21,534.67,0,0,109509524,-65752697,0.062317867439548,97.9184769353942,0
364.13,365,780,780,67860,67860,2024-06-06,2024-10-18,534.67,0,0,52962163,-8353895,0.128129208015919,97.1564416657228,0
441.88,444,320,320,67840,67840,2024-06-06,2024-10-18,534.67,0,0,52962163,-8353895,0.12809144520778,97.2845331109305,0
514.03,516,311,344,93611,67768,2024-06-06,2024-07-05,534.67,33,-25843,14823040,-3756140,0.457180173567635,96.2330399162385,-0.381345177664974
474.73,476,534,533,90246,67691,2024-06-06,2024-08-16,534.67,-1,-22555,116205577,-19412264,0.0582510768824804,99.265789110965,-0.333205300556942
359.79,360,3176,3184,79400,66864,2024-06-06,2024-08-16,534.67,8,-12536,116205577,-19412264,0.0575394070802643,99.3233285180452,-0.187485044268964
462.55,463,1480,1480,106560,66600,2024-06-06,2024-07-19,534.67,0,-39960,162615922,-53541395,0.0409553991890167,99.4605669671141,-0.6
532.51,545,40,53,66800,66197,2024-06-06,2024-06-21,534.67,13,-603,109509524,-65752697,0.0604486236283887,97.9789255590226,-0.00910917413175824
521.93,522,6149,9448,399685,66136,2024-06-06,2024-06-07,534.67,3299,-333549,11090657,-11742034,0.596321750821435,92.9288499319743,-5.04338030724568
510.77,511,3003,2865,174174,65895,2024-06-06,2024-06-14,534.67,-138,-108279,23468414,-20040476,0.280781649752727,95.8476955451698,-1.64320509902117
533.37,542,0,76,0,65588,2024-06-06,2024-06-14,534.67,76,65588,23468414,-20040476,0.279473508520857,96.1271690536906,1
436.79,437,3120,3120,65520,65520,2024-06-06,2024-06-28,534.67,0,0,66054797,-39996766,0.0991903737135094,96.9662627227513,0
520.94,521,8268,10904,421668,65424,2024-06-06,2024-06-07,534.67,2636,-356244,11090657,-11742034,0.58990193277098,93.5187518647453,-5.4451577402788
319.76,320,2723,2723,92582,65352,2024-06-06,2024-09-20,534.67,0,-27230,244715238,-48165897,0.0267053251502058,99.6914184804463,-0.416666666666667
531.8,546,45,46,88425,65320,2024-06-06,2024-06-21,534.67,1,-23105,109509524,-65752697,0.0596477800414875,98.0385733390641,-0.353720146968769
389.88,391,583,583,65296,65296,2024-06-06,2024-10-18,534.67,0,0,52962163,-8353895,0.123288016012488,97.407821126943,0
244.68,245,2040,2040,65280,65280,2024-06-06,2024-12-20,534.67,0,0,383807022,-51896645,0.0170085475924409,99.8990703718808,0
480.31,481,1010,945,98980,65205,2024-06-06,2024-07-19,534.67,-65,-33775,162615922,-53541395,0.0400975496114089,99.5006645167255,-0.517981749865808
442.76,443,2715,2715,65160,65160,2024-06-06,2024-06-28,534.67,0,0,66054797,-39996766,0.0986453716601385,97.0649080944114,0
482.41,484,407,405,91168,64395,2024-06-06,2024-08-16,534.67,-2,-26773,116205577,-19412264,0.0554147242003712,99.3787432422456,-0.415762093330227
528.37,544,40,41,69840,64083,2024-06-06,2024-06-21,534.67,1,-5757.00000000001,109509524,-65752697,0.0585181979240454,98.0970915369882,-0.0898366181358552
460.57,461,1500,1488,79500,63984,2024-06-06,2024-07-19,534.67,-12,-15516,162615922,-53541395,0.0393467006262769,99.5400112173518,-0.242498124531133
521.95,580,11,11,63855,63855,2024-06-06,2024-06-21,534.67,0,0,109509524,-65752697,0.0583099968547028,98.1554015338429,0
415.39,417,396,396,63756,63756,2024-06-06,2024-10-18,534.67,0,0,52962163,-8353895,0.120380279785778,97.5282014067288,0
489.54,490,1269,1385,85023,63710,2024-06-06,2024-07-05,534.67,116,-21313,14823040,-3756140,0.429803872889772,96.6628437891283,-0.334531470726731
514.97,515,23760,21019,213840,63057,2024-06-06,2024-06-07,534.67,-2741,-150783,11090657,-11742034,0.568559644392573,94.0873115091378,-2.39121746990818
309.78,310,2866,2866,65918,63052,2024-06-06,2024-09-20,534.67,0,-2866,244715238,-48165897,0.0257654572372808,99.7171839376835,-0.0454545454545455
525.89,532,23,103,19688,62933,2024-06-06,2024-07-12,534.67,80,43245,3646557,868777,1.72581972529156,72.5124548992378,0.687159359954237
533,570,13,17,56407,62900,2024-06-06,2024-11-15,534.67,4,6492.99999999999,10201073,1977879,0.616601802575082,97.8026625238345,0.103227344992051
483.82,484,3689,3488,88536,62784,2024-06-06,2024-06-21,534.67,-201,-25752,109509524,-65752697,0.0573319997263434,98.2127335335692,-0.410168195718654
528.1,536,4,79,4996,62410,2024-06-06,2024-07-12,534.67,75,57414,3646557,868777,1.71147742925724,74.2239323284951,0.919948726165679
522.89,527.5,77,135,59598,62235,2024-06-06,2024-07-12,534.67,58,2637,3646557,868777,1.70667838182702,75.9306107103221,0.0423716558206797
485.72,486,2257,2220,94794,62160,2024-06-06,2024-06-28,534.67,-37,-32634,66054797,-39996766,0.0941036878820474,97.1590117822934,-0.525
441.9,442,6140,6139,79820,61390,2024-06-06,2024-06-28,534.67,-1,-18430,66054797,-39996766,0.0929379890456707,97.2519497713391,-0.300211760873106
528.87,536,97,86,103790,61318,2024-06-06,2024-07-05,534.67,-11,-42472,14823040,-3756140,0.413666832174776,97.076510621303,-0.692651423725497
480.75,481,2440,2437,107360,60925,2024-06-06,2024-06-28,534.67,-3,-46435,66054797,-39996766,0.0922340280600666,97.3441837993992,-0.762166598276569
438.32,440,355,362,70290,60816,2024-06-06,2024-10-18,534.67,7,-9474,52962163,-8353895,0.114829146989333,97.6430305537181,-0.15578137332281
471.8,472,2956,3016,73900,60320,2024-06-06,2024-06-28,534.67,60,-13580,66054797,-39996766,0.0913181218314848,97.4355019212306,-0.225132625994695
344.65,345,1720,1721,67080,60235,2024-06-06,2024-09-20,534.67,1,-6845.00000000001,244715238,-48165897,0.0246143233630592,99.7417982610466,-0.113638250186769
475.85,476,3910,3996,66470,59940,2024-06-06,2024-06-21,534.67,86,-6530,109509524,-65752697,0.0547349653350699,98.2674684989043,-0.108942275608942
508.33,510,338,358,87204,59786,2024-06-06,2024-07-12,534.67,20,-27418,3646557,868777,1.63951914093212,77.5701298512542,-0.458602348375874
467.49,468,1167,1166,79356,59466,2024-06-06,2024-07-19,534.67,-1,-19890,162615922,-53541395,0.0365683748975085,99.5765795922493,-0.334476843910806
530.62,560,20,20,69980,58760,2024-06-06,2024-10-18,534.67,0,-11220,52962163,-8353895,0.110947130312635,97.7539776840308,-0.190946221919673
406.56,408,406,406,58464,58464,2024-06-06,2024-10-18,534.67,0,0,52962163,-8353895,0.110388240752176,97.864365924783,0
369.9,370,5942,5838,65362,58380,2024-06-06,2024-07-19,534.67,-104,-6981.99999999999,162615922,-53541395,0.0359005436134354,99.6124801358627,-0.119595751969853
532.21,590,0,10,0,57790,2024-06-06,2024-11-15,534.67,10,57790,10201073,1977879,0.566509032922321,98.3691715567568,1
509.7,511,201,441,47436,57330,2024-06-06,2024-07-05,534.67,240,9894.00000000001,14823040,-3756140,0.386762769310479,97.4632733906135,0.17257980115123
414.67,416,430,430,57190,57190,2024-06-06,2024-10-18,534.67,0,0,52962163,-8353895,0.107982749873716,97.9723486746567,0
466.5,467,1142,1141,75372,57050,2024-06-06,2024-07-19,534.67,-1,-18322,162615922,-53541395,0.0350826655215225,99.6475628013842,-0.321156879929886
438.84,439,3547,3547,56752,56752,2024-06-06,2024-06-28,534.67,0,0,66054797,-39996766,0.0859165459247419,97.5214184671554,0
244.96,245,14006,13981,70030,55924,2024-06-06,2024-08-16,534.67,-25,-14106,116205577,-19412264,0.0481250568550595,99.4268682991007,-0.252235176310707
524.93,531,4,91,3428,55237,2024-06-06,2024-07-12,534.67,87,51809,3646557,868777,1.51477133087458,79.0849011821288,0.937940148813295
480.51,482,368,368,69184,54832,2024-06-06,2024-08-16,534.67,0,-14352,116205577,-19412264,0.0471853429203316,99.474053642021,-0.261744966442953
498.97,500,493,526,75922,54178,2024-06-06,2024-07-12,534.67,33,-21744,3646557,868777,1.4857302381397,80.5706314202685,-0.401343718852671
214.81,215,2828,2827,53732,53713,2024-06-06,2024-12-20,534.67,-1,-19.0000000000073,383807022,-51896645,0.0139947934563844,99.9130651653372,-0.000353731871241734
416.92,417,6666,6666,53328,53328,2024-06-06,2024-06-28,534.67,0,0,66054797,-39996766,0.0807329708393472,97.6021514379947,0
467.82,468,2948,2948,70752,53064,2024-06-06,2024-06-28,534.67,0,-17688,66054797,-39996766,0.0803333026668752,97.6824847406616,-0.333333333333333
534.18,539,0,110,0,53020,2024-06-06,2024-06-07,534.67,110,53020,11090657,-11742034,0.478060046397612,94.5653715555354,1
458.85,459,3524,3524,52860,52860,2024-06-06,2024-06-21,534.67,0,0,109509524,-65752697,0.048269774234431,98.3157382731387,0
486.69,487,1698,1704,96786,52824,2024-06-06,2024-06-28,534.67,6,-43962,66054797,-39996766,0.0799699679646279,97.7624547086262,-0.832235347569286
523.97,529,52,103,39832,51809,2024-06-06,2024-07-12,534.67,51,11977,3646557,868777,1.42076484749861,81.9913962677671,0.231176050493158
463.85,464,3450,3450,51750,51750,2024-06-06,2024-06-21,534.67,0,0,109509524,-65752697,0.047256163765263,98.362994436904,0
249.92,250,6425,6427,70675,51416,2024-06-06,2024-09-20,534.67,2,-19259,244715238,-48165897,0.0210105428743264,99.7628088039209,-0.374572117628754
304.81,305,2611,2699,60053,51281,2024-06-06,2024-09-20,534.67,88,-8771.99999999999,244715238,-48165897,0.02095537671422,99.7837641806351,-0.171057506678887
445.92,446,6337,6339,69707,50712,2024-06-06,2024-06-21,534.67,2,-18995,109509524,-65752697,0.0463083010022032,98.4093027379062,-0.374566177630541
507.8,508,2565,2510,105165,50200,2024-06-06,2024-06-14,534.67,-55,-54965,23468414,-20040476,0.213904527165747,96.3410735808564,-1.0949203187251
324.74,325,1916,1916,63228,49816,2024-06-06,2024-09-20,534.67,0,-13412,244715238,-48165897,0.0203567217175091,99.8041209023526,-0.269230769230769
329.99,330,49799,49795,99598,49795,2024-06-06,2024-06-21,534.67,-4,-49803,109509524,-65752697,0.0454709309119086,98.4547736688181,-1.00016065870067
461.53,462,1060,1059,67840,49773,2024-06-06,2024-07-19,534.67,-1,-18067,162615922,-53541395,0.0306077039614854,99.6781705053457,-0.362987965362747
349.82,350,2757,2761,57897,49698,2024-06-06,2024-08-16,534.67,4,-8199.00000000001,116205577,-19412264,0.0427673105568763,99.5168209525779,-0.164976457805143
500.88,501,5699,4122,125378,49464,2024-06-06,2024-06-14,534.67,-1577,-75914,23468414,-20040476,0.210768397046345,96.5518419779027,-1.53473233058386
534.1,560,10,19,34200,49210,2024-06-06,2024-07-19,534.67,9,15010,162615922,-53541395,0.0302614894007734,99.7084319947465,0.305019305019305
462.83,463,2868,2868,57360,48756,2024-06-06,2024-06-28,534.67,0,-8603.99999999999,66054797,-39996766,0.0738114447615364,97.8362661533878,-0.176470588235294
470.8,471,2436,2437,73080,48740,2024-06-06,2024-06-28,534.67,1,-24340,66054797,-39996766,0.0737872224480532,97.9100533758358,-0.499384489125975
529.57,555,24,19,77808,48317,2024-06-06,2024-10-18,534.67,-5,-29491,52962163,-8353895,0.0912292800428109,98.0635779546995,-0.610364881925616
294.88,295,4020,4020,48240,48240,2024-06-06,2024-08-16,534.67,0,0,116205577,-19412264,0.0415126375561132,99.558333590134,0
436.08,438,248,248,47616,47616,2024-06-06,2024-10-18,534.67,0,0,52962163,-8353895,0.089905693617536,98.153483648317,0
522.56,527,45,107,30735,47508,2024-06-06,2024-07-12,534.67,62,16773,3646557,868777,1.3028179732279,83.294214240995,0.353056327355393
463.84,464,2946,2958,70704,47328,2024-06-06,2024-06-28,534.67,12,-23376,66054797,-39996766,0.071649603283165,97.981702979119,-0.493914807302231
523.05,570,10,10,46950,46950,2024-06-06,2024-10-18,534.67,0,0,52962163,-8353895,0.0886481921065044,98.2421318404235,0
508.79,509,2716,2219,127652,46599,2024-06-06,2024-06-14,534.67,-497,-81053,23468414,-20040476,0.198560499231009,96.7504024771337,-1.73937208952982
534.32,540,11,82,13992,46576,2024-06-06,2024-06-07,534.67,71,32584,11090657,-11742034,0.419957086401644,94.9853286419371,0.699587770525593
384.98,385,23241,23241,69723,46482,2024-06-06,2024-06-21,534.67,0,-23241,109509524,-65752697,0.042445623268347,98.4972192920864,-0.5
505.84,506,2754,2885,101898,46160,2024-06-06,2024-06-14,534.67,131,-55738,23468414,-20040476,0.196689899879898,96.9470923770136,-1.20749566724437
533.98,580,0,10,0,46020,2024-06-06,2024-07-19,534.67,10,46020,162615922,-53541395,0.0282998118720503,99.7367318066186,1
455.91,456,5103,5112,117369,46008,2024-06-06,2024-06-21,534.67,9,-71361,109509524,-65752697,0.0420127842031347,98.5392320762896,-1.55105633802817
224.79,225,2189,2189,52536,45969,2024-06-06,2024-12-20,534.67,0,-6567,383807022,-51896645,0.0119771128106145,99.9250422781478,-0.142857142857143
503.71,505,385,356,76230,45924,2024-06-06,2024-07-12,534.67,-29,-30306,3646557,868777,1.25937973820236,84.5535939791974,-0.65991638359028
464.76,465,1881,1890,56430,45360,2024-06-06,2024-07-05,534.67,9,-11070,14823040,-3756140,0.306010103190709,97.7692834938042,-0.244047619047619
483.73,484,1686,1677,82614,45279,2024-06-06,2024-06-28,534.67,-9,-37335,66054797,-39996766,0.0685476332627288,98.0502506123817,-0.824554429205592
463.53,464,960,959,64320,45073,2024-06-06,2024-07-19,534.67,-1,-19247,162615922,-53541395,0.027717458072771,99.7644492646913,-0.427018392385686
467.89,468,4088,4081,69496,44891,2024-06-06,2024-06-21,534.67,-7,-24605,109509524,-65752697,0.0409927815958729,98.5802248578854,-0.548105410884142
139.96,140,11209,11212,56045,44848,2024-06-06,2024-12-20,534.67,3,-11197,383807022,-51896645,0.0116850389464735,99.9367273170943,-0.249665536924724
224.93,225,6373,6373,44611,44611,2024-06-06,2024-09-20,534.67,0,0,244715238,-48165897,0.0182297597667375,99.8223506621194,0
460.9,461,4398,4403,52776,44030,2024-06-06,2024-06-21,534.67,5,-8746,109509524,-65752697,0.0402065486103291,98.6204314064958,-0.19863729275494
472.79,473,2048,2093,55296,43953,2024-06-06,2024-06-28,534.67,45,-11343,66054797,-39996766,0.0665402090328126,98.1167908214145,-0.258071121425159
441.92,442,5461,5459,49149,43672,2024-06-06,2024-06-21,534.67,-2,-5477,109509524,-65752697,0.0398796364049578,98.6603110429007,-0.12541216339989
349.99,350,43675,43671,43675,43671,2024-06-06,2024-06-21,534.67,-4,-4,109509524,-65752697,0.039878723242373,98.7001897661431,-9.15939639577752e-05
531.61,542,12,42,21192,43638,2024-06-06,2024-06-28,534.67,30,22446,66054797,-39996766,0.066063332236113,98.1828541536506,0.51436821119208
430.87,431,3355,3355,43615,43615,2024-06-06,2024-06-21,534.67,0,0,109509524,-65752697,0.0398275861376222,98.7400173522807,0
446.88,447,3632,3632,65376,43584,2024-06-06,2024-06-28,534.67,0,-21792,66054797,-39996766,0.0659815819281074,98.2488357355788,-0.5
461.75,462,1742,1742,43550,43550,2024-06-06,2024-06-28,534.67,0,0,66054797,-39996766,0.0659301095119557,98.3147658450907,0
367.33,368,325,650,25350,43550,2024-06-06,2024-10-18,534.67,325,18200,52962163,-8353895,0.0822285147228598,98.3243603551464,0.417910447761194
509.97,510,15373,14471,76865,43413,2024-06-06,2024-06-07,534.67,-902,-33452,11090657,-11742034,0.391437585708403,95.3767662276455,-0.770552599451778
421.94,422,7212,7205,43272,43230,2024-06-06,2024-06-21,534.67,-7,-42,109509524,-65752697,0.0394760185424603,98.7794933708232,-0.000971547536433033
428.5,430,288,288,48384,43200,2024-06-06,2024-10-18,534.67,0,-5184,52962163,-8353895,0.0815676655804258,98.4059280207268,-0.12
413.2,415,237,237,42660,42660,2024-06-06,2024-11-15,534.67,0,0,10201073,1977879,0.418191302032639,98.7873628587895,0
468.88,469,3529,3527,52935,42324,2024-06-06,2024-06-21,534.67,-2,-10611,109509524,-65752697,0.0386486932405989,98.8181420640638,-0.25070881769209
464.96,465,10480,10426,52400,41704,2024-06-06,2024-06-14,534.67,-54,-10696,23468414,-20040476,0.17770267730917,97.1247950543228,-0.256474199117591
456.85,457,2775,2775,55500,41625,2024-06-06,2024-06-28,534.67,0,-13875,66054797,-39996766,0.0630158624210139,98.3777817075117,-0.333333333333333
259.9,260,4160,4160,49920,41600,2024-06-06,2024-09-20,534.67,0,-8320,244715238,-48165897,0.0169993500772518,99.8393500121966,-0.2
452.87,455,189,191,45549,40683,2024-06-06,2024-10-18,534.67,2,-4866,52962163,-8353895,0.0768152161761218,98.4827432369029,-0.119607698547305
534,615,4,5,34280,40500,2024-06-06,2024-08-16,534.67,1,6220,116205577,-19412264,0.0348520277989756,99.593185617933,0.15358024691358
359.98,360,20049,19998,40098,39996,2024-06-06,2024-06-21,534.67,-51,-102,109509524,-65752697,0.0365228507431007,98.8546649148069,-0.00255025502550255
531.21,545,38,29,72770,39991,2024-06-06,2024-07-19,534.67,-9,-32779,162615922,-53541395,0.0245923028373568,99.7890415675287,-0.819659423370258
513.97,514,13316,13226,106528,39678,2024-06-06,2024-06-07,534.67,-90,-66850,11090657,-11742034,0.357760590738673,95.7345268183842,-1.68481274257775
521.95,720,2,2,39610,39610,2024-06-06,2024-12-20,534.67,0,0,383807022,-51896645,0.010320290596455,99.9470476076907,0
443.91,444,4385,4385,39465,39465,2024-06-06,2024-06-21,534.67,0,0,109509524,-65752697,0.0360379614105527,98.8907028762174,0
478.85,479,2594,2631,51880,39465,2024-06-06,2024-06-21,534.67,37,-12415,109509524,-65752697,0.0360379614105527,98.926740837628,-0.314582541492462
394.67,395,1156,1182,43928,39006,2024-06-06,2024-08-16,534.67,26,-4922,116205577,-19412264,0.0335663752179467,99.6267519931509,-0.126185715018202
461.9,462,3870,3876,42570,38760,2024-06-06,2024-06-21,534.67,6,-3810,109509524,-65752697,0.0353941817882434,98.9621350194162,-0.098297213622291
509.17,511,15,211,4020,38613,2024-06-06,2024-07-12,534.67,196,34593,3646557,868777,1.05888924813187,85.6124832273292,0.895889985238132
383.1,384,429,429,38610,38610,2024-06-06,2024-10-18,534.67,0,0,52962163,-8353895,0.0729011011125055,98.5556443380154,0
439.9,440,3837,3835,49881,38350,2024-06-06,2024-06-28,534.67,-2,-11531,66054797,-39996766,0.0580578576299311,98.4358395651417,-0.300677966101695
490.65,491,1151,1094,78268,38290,2024-06-06,2024-06-28,534.67,-57,-39978,66054797,-39996766,0.0579670239543693,98.493806589096,-1.04408461739358
489.3,490,494,547,47918,38290,2024-06-06,2024-07-12,534.67,53,-9628,3646557,868777,1.05003157773209,86.6625148050613,-0.25144946461217
477.76,478,1637,1590,62206,38160,2024-06-06,2024-06-28,534.67,-47,-24046,66054797,-39996766,0.0577702176573187,98.5515768067533,-0.630136268343816
506.82,507,1883,2110,71554,37980,2024-06-06,2024-06-14,534.67,227,-33574,23468414,-20040476,0.161834540672412,97.2866295949952,-0.883991574512902
417.85,418,2515,2515,37725,37725,2024-06-06,2024-06-28,534.67,0,0,66054797,-39996766,0.0571116735094955,98.6086884802629,0
438.92,439,4683,4683,37464,37464,2024-06-06,2024-06-21,534.67,0,0,109509524,-65752697,0.0342107230782959,98.9963457424945,0
299.99,300,36914,36909,36914,36909,2024-06-06,2024-06-21,534.67,-5,-5,109509524,-65752697,0.0337039178437119,99.0300496603382,-0.000135468313961364
501.88,502,3049,3070,70127,36840,2024-06-06,2024-06-14,534.67,21,-33287,23468414,-20040476,0.156976947824425,97.4436065428196,-0.903555917480999
429.98,430,18313,18323,36626,36646,2024-06-06,2024-06-14,534.67,10,20,23468414,-20040476,0.156150304830995,97.5997568476506,0.000545762156852044
512.2,512.5,1314,1219,97236,36570,2024-06-06,2024-06-14,534.67,-95,-60666,23468414,-20040476,0.155826465307796,97.7555833129584,-1.65890073831009
451.88,452,3021,3021,36252,36252,2024-06-06,2024-06-21,534.67,0,0,109509524,-65752697,0.0331039700254747,99.0631536303637,0
395.93,397,337,337,36059,36059,2024-06-06,2024-10-18,534.67,0,0,52962163,-8353895,0.0680844549343651,98.6237287929498,0
473.79,474,1711,1713,46197,35973,2024-06-06,2024-06-28,534.67,2,-10224,66054797,-39996766,0.0544593301830903,98.6631478104459,-0.284213159869903
389.68,390,1118,1118,42484,35776,2024-06-06,2024-08-16,534.67,0,-6708,116205577,-19412264,0.0307868184329914,99.6575388115839,-0.1875
466.89,467,3244,3246,45416,35706,2024-06-06,2024-06-21,534.67,2,-9710,109509524,-65752697,0.0326053832541542,99.0957590136179,-0.271943090797065
521.63,526,80,80,51840,34960,2024-06-06,2024-07-12,534.67,0,-16880,3646557,868777,0.958712560917051,87.6212273659784,-0.482837528604119
470.8,475,76,83,38684,34860,2024-06-06,2024-11-15,534.67,7,-3824,10201073,1977879,0.341728757357192,99.1290916161467,-0.109695926563396
418.72,420,135,271,19845,34688,2024-06-06,2024-10-18,534.67,136,14843,52962163,-8353895,0.0654958144364308,98.6892246073862,0.427900138376384
448.83,449,2031,2031,34527,34527,2024-06-06,2024-06-28,534.67,0,0,66054797,-39996766,0.0522702386020504,98.715418049048,0
407.7,409,264,264,34320,34320,2024-06-06,2024-10-18,534.67,0,0,52962163,-8353895,0.0648009787666716,98.7540255861529,0
442.92,443,4284,4284,34272,34272,2024-06-06,2024-06-21,534.67,0,0,109509524,-65752697,0.0312959081074994,99.1270549217253,0
472.8,474,284,285,45440,34200,2024-06-06,2024-08-16,534.67,1,-11240,116205577,-19412264,0.0294306012524683,99.6869694128364,-0.328654970760234
294.84,295,2103,2103,44163,33648,2024-06-06,2024-09-20,534.67,0,-10515,244715238,-48165897,0.0137498589278695,99.8530998711245,-0.3125
399.95,400,6650,6641,46550,33205,2024-06-06,2024-06-28,534.67,-9,-13345,66054797,-39996766,0.0502688699505049,98.7656869189985,-0.401897304622798
511.53,513,102,224,27642,32928,2024-06-06,2024-07-05,534.67,122,5286,14823040,-3756140,0.222140667501403,97.9914241613056,0.160532069970845
369.98,370,16464,16326,32928,32652,2024-06-06,2024-06-21,534.67,-138,-276,109509524,-65752697,0.0298165847200651,99.1568715064454,-0.00845277471517824
401.74,403,259,259,32634,32634,2024-06-06,2024-10-18,534.67,0,0,52962163,-8353895,0.0616175740405466,98.8156431601934,0
481.73,482,1210,1207,42350,32589,2024-06-06,2024-06-28,534.67,-3,-9761,66054797,-39996766,0.0493363108814035,98.8150232298799,-0.299518242351714
289.85,290,2160,2168,43200,32520,2024-06-06,2024-09-20,534.67,8,-10680,244715238,-48165897,0.0132889150123132,99.8663887861368,-0.328413284132841
517.97,518,11674,10757,256828,32271,2024-06-06,2024-06-07,534.67,-917,-224557,11090657,-11742034,0.290974646497498,96.0255014648817,-6.95847665086301
532.16,538,24,55,24432,32120,2024-06-06,2024-06-14,534.67,31,7688,23468414,-20040476,0.136864809015215,97.8924481219737,0.239352428393524
354.8,355,1595,1590,36685,31800,2024-06-06,2024-08-16,534.67,-5,-4885,116205577,-19412264,0.0273652959014179,99.7143347087378,-0.153616352201258
531.92,543,27,28,49275,31024,2024-06-06,2024-06-28,534.67,1,-18251,66054797,-39996766,0.0469670658438327,98.8619902957237,-0.588286487880351
279.86,280,2197,2198,32955,30772,2024-06-06,2024-09-20,534.67,1,-2183,244715238,-48165897,0.0125746153984902,99.8789634015353,-0.0709411152996229
440.86,441,2186,2186,30604,30604,2024-06-06,2024-06-28,534.67,0,0,66054797,-39996766,0.0463312301148999,98.9083215258386,0
364.78,365,1372,1377,37044,30294,2024-06-06,2024-08-16,534.67,5,-6750,116205577,-19412264,0.0260693167936338,99.7404040255314,-0.222816399286988
532.17,541,29,34,57768,30022,2024-06-06,2024-06-21,534.67,5,-27746,109509524,-65752697,0.0274149671219464,99.1842864735674,-0.924188928119379
479.51,480,459,611,30753,29939,2024-06-06,2024-07-12,534.67,152,-814.000000000004,3646557,868777,0.821021034362002,88.4422484003404,-0.0271886168542705
529.93,538,36,37,59112,29859,2024-06-06,2024-06-28,534.67,1,-29253,66054797,-39996766,0.0452033786433406,98.953524904482,-0.979704611674872
476.77,477,1299,1285,37671,29555,2024-06-06,2024-06-28,534.67,-14,-8116,66054797,-39996766,0.0447431546871607,98.9982680591691,-0.274606665538826
436.88,437,2457,2457,29484,29484,2024-06-06,2024-06-21,534.67,0,0,109509524,-65752697,0.0269236856513046,99.2112101592187,0
469.75,470,1123,1170,37059,29250,2024-06-06,2024-07-05,534.67,47,-7809,14823040,-3756140,0.197327943525755,98.1887521048314,-0.266974358974359
422.94,423,4870,4870,29220,29220,2024-06-06,2024-06-21,534.67,0,0,109509524,-65752697,0.0266826107289079,99.2378927699476,0
452.78,453,1309,1309,28798,28798,2024-06-06,2024-06-28,534.67,0,0,66054797,-39996766,0.0435971364804891,99.0418651956496,0
518.97,519,9210,9596,257880,28788,2024-06-06,2024-06-07,534.67,386,-229092,11090657,-11742034,0.259569834320906,96.2850712992026,-7.95789912463527
446.9,447,2867,2867,28670,28670,2024-06-06,2024-06-21,534.67,0,0,109509524,-65752697,0.0261803713072481,99.2640731412548,0
494.15,495,317,336,42161,28560,2024-06-06,2024-07-12,534.67,19,-13601,3646557,868777,0.78320454061187,89.2254529409523,-0.476225490196079
419.99,420,28461,28461,28461,28461,2024-06-06,2024-06-07,534.67,0,0,11090657,-11742034,0.256621406648858,96.5416927058514,0
533.25,555,4,13,12336,28275,2024-06-06,2024-07-19,534.67,9,15939,162615922,-53541395,0.017387596277319,99.806429163806,0.563713527851459
304.91,305,2962,3080,29620,27720,2024-06-06,2024-08-16,534.67,118,-1900,116205577,-19412264,0.0238542768046322,99.7642583023361,-0.0685425685425685
299.97,300,9190,9236,36760,27708,2024-06-06,2024-07-19,534.67,46,-9052,162615922,-53541395,0.017038921932872,99.8234680857389,-0.326692651941678
518.71,522,57,84,31920,27636,2024-06-06,2024-07-12,534.67,27,-4284,3646557,868777,0.75786557018031,89.9833185111326,-0.155015197568389
531.62,537,5,51,5700,27438,2024-06-06,2024-06-14,534.67,46,21738,23468414,-20040476,0.116914589967605,98.0093627119413,0.792258910999344
469.95,470,5407,5483,32442,27415,2024-06-06,2024-06-14,534.67,76,-5027,23468414,-20040476,0.116816585901374,98.1261792978426,-0.183366770016414
471.87,472,2105,2102,33680,27326,2024-06-06,2024-06-21,534.67,-3,-6354,109509524,-65752697,0.0249530807932285,99.2890262220481,-0.232525799604772
469.61,470,698,699,35598,27261,2024-06-06,2024-07-12,534.67,1,-8337,3646557,868777,0.747581897115553,90.7309004082481,-0.305821503246396
234.72,235,971,971,27188,27188,2024-06-06,2024-12-20,534.67,0,0,383807022,-51896645,0.00708376825893509,99.9541313759497,0
214.95,215,5383,5348,32298,26740,2024-06-06,2024-09-20,534.67,-35,-5557.99999999999,244715238,-48165897,0.0109269860833104,99.8898903876186,-0.207853403141361
179.91,180,2928,2928,35136,26352,2024-06-06,2024-12-20,534.67,0,-8784,383807022,-51896645,0.00686595046194856,99.9609973264116,-0.333333333333333
447.92,448,3323,3291,39876,26328,2024-06-06,2024-06-21,534.67,-32,-13548,109509524,-65752697,0.0240417445335622,99.3130679665816,-0.514585232452142
479.94,480,4936,4351,34552,26106,2024-06-06,2024-06-14,534.67,-585,-8446.00000000001,23468414,-20040476,0.111238876218904,98.2374181740615,-0.323527158507623
379.98,380,12018,13017,36054,26034,2024-06-06,2024-06-21,534.67,999,-10020,109509524,-65752697,0.0237732747336204,99.3368412413152,-0.384881309057386
453.91,454,2878,2879,60438,25911,2024-06-06,2024-06-21,534.67,1,-34527,109509524,-65752697,0.0236609557356856,99.3605021970509,-1.33252286673614
488.93,489,3698,3694,55470,25858,2024-06-06,2024-06-14,534.67,-4,-29612,23468414,-20040476,0.110182136722149,98.3476003107837,-1.14517750792791
479.68,480,755,794,36995,25408,2024-06-06,2024-07-05,534.67,39,-11587,14823040,-3756140,0.171408833815466,98.3601609386469,-0.456037468513854
456.91,457,2820,2822,31020,25398,2024-06-06,2024-06-21,534.67,2,-5622,109509524,-65752697,0.0231925033296647,99.3836947003806,-0.221356012284432
274.85,275,1689,1689,25335,25335,2024-06-06,2024-09-20,534.67,0,0,244715238,-48165897,0.0103528493799802,99.9002432369986,0
474.56,475,573,575,35526,25300,2024-06-06,2024-07-12,534.67,2,-10226,3646557,868777,0.693805142768919,91.424705551017,-0.404189723320158
394.92,396,230,230,24840,24840,2024-06-06,2024-10-18,534.67,0,0,52962163,-8353895,0.0469014077087448,98.8625445679022,0
374.99,375,24769,24796,49538,24796,2024-06-06,2024-06-21,534.67,27,-24742,109509524,-65752697,0.0226427794535935,99.4063374798342,-0.997822229391837
533.8,575,0,6,0,24720,2024-06-06,2024-07-19,534.67,6,24720,162615922,-53541395,0.0152014634827702,99.8386695492216,1
430.33,432,146,146,24382,24382,2024-06-06,2024-10-18,534.67,0,0,52962163,-8353895,0.0460366394023598,98.9085812073045,0
149.98,150,12132,12132,24264,24264,2024-06-06,2024-09-20,534.67,0,0,244715238,-48165897,0.00991519784313554,99.9101584348417,0
426.92,427,3031,3031,24248,24248,2024-06-06,2024-06-21,534.67,0,0,109509524,-65752697,0.0221423663571033,99.4284798461913,0
457.9,458,2417,2421,31421,24210,2024-06-06,2024-06-21,534.67,4,-7211,109509524,-65752697,0.0221076661788796,99.4505875123702,-0.297852127220157
462.9,463,2403,2411,31239,24110,2024-06-06,2024-06-21,534.67,8,-7129,109509524,-65752697,0.022016349920396,99.4726038622906,-0.295686437163003
374.7,375,800,800,24000,24000,2024-06-06,2024-08-16,534.67,0,0,116205577,-19412264,0.0206530535105041,99.7849113558465,0
284.85,285,1595,1600,31900,24000,2024-06-06,2024-09-20,534.67,5,-7900,244715238,-48165897,0.00980731735226067,99.919965752194,-0.329166666666667
530.61,541,22,23,30646,23897,2024-06-06,2024-06-28,534.67,1,-6748.99999999999,66054797,-39996766,0.0361775390816809,99.0780427347313,-0.282420387496338
299.91,300,2644,2644,26440,23796,2024-06-06,2024-08-16,534.67,0,-2644.00000000001,116205577,-19412264,0.0204775025556648,99.8053888584022,-0.111111111111111
443.19,445,119,131,25585,23711,2024-06-06,2024-10-18,534.67,12,-1874,52962163,-8353895,0.0447696971892934,98.9533509044938,-0.0790350470245878
474.95,475,4734,4682,33138,23410,2024-06-06,2024-06-14,534.67,-52,-9728,23468414,-20040476,0.0997510952380506,98.4473514060217,-0.415548910721914
506.91,508,198,214,36432,23326,2024-06-06,2024-07-05,534.67,16,-13106,14823040,-3756140,0.15736313198912,98.517524070636,-0.561862299579868
424.91,425,2583,2582,25830,23238,2024-06-06,2024-06-28,534.67,-1,-2592,66054797,-39996766,0.0351798825450936,99.1132226172764,-0.11154144074361
515.97,516,8117,7745,105521,23235,2024-06-06,2024-06-07,534.67,-372,-82286,11090657,-11742034,0.209500663486392,96.7511933693378,-3.5414676135141
429.5,431,154,154,26334,23100,2024-06-06,2024-10-18,534.67,0,-3234,52962163,-8353895,0.0436160434006443,98.9969669478945,-0.14
274.81,275,810,1211,19440,23009,2024-06-06,2024-10-18,534.67,401,3569,52962163,-8353895,0.0434442226236115,99.0404111705181,0.15511321656743
532,555,8,10,22240,23000,2024-06-06,2024-09-20,534.67,2,760,244715238,-48165897,0.00939867912924981,99.9293644313232,0.0330434782608696
413.7,415,176,176,22880,22880,2024-06-06,2024-10-18,534.67,0,0,52962163,-8353895,0.0432006525111144,99.0836118230292,0
516.97,517,7034,7615,119578,22845,2024-06-06,2024-06-07,534.67,581,-96733,11090657,-11742034,0.205984190116059,96.9571775594539,-4.23431823156052
259.99,260,22711,22711,22711,22711,2024-06-06,2024-06-21,534.67,0,0,109509524,-65752697,0.0207388354642104,99.4933426977548,0
527.92,537,11,25,16676,22700,2024-06-06,2024-07-12,534.67,14,6024,3646557,868777,0.622505009519939,92.047210560537,0.265374449339207
530.15,542,6,19,10074,22515,2024-06-06,2024-07-05,534.67,13,12441,14823040,-3756140,0.151891919606235,98.6694159902422,0.552564956695536
511.98,512,18207,11252,91035,22504,2024-06-06,2024-06-07,534.67,-6955,-68531,11090657,-11742034,0.202909530066614,97.1600870895205,-3.04528083896196
530.1,575,0,5,0,22450,2024-06-06,2024-07-12,534.67,5,22450,3646557,868777,0.615649227476768,92.6628597880137,1
532.2,544,2,19,3540,22420,2024-06-06,2024-06-28,534.67,17,18880,66054797,-39996766,0.0339415167682674,99.1471641340446,0.842105263157895
403.75,404,895,895,22375,22375,2024-06-06,2024-06-28,534.67,0,0,66054797,-39996766,0.033873391511596,99.1810375255563,0
440.68,443,96,96,22272,22272,2024-06-06,2024-10-18,534.67,0,0,52962163,-8353895,0.0420526631436862,99.1256644861729,0
502.86,503,1625,1550,40625,21700,2024-06-06,2024-06-14,534.67,-75,-18925,23468414,-20040476,0.09246470596607,98.5398161119878,-0.872119815668203
416.95,417,4340,4340,21700,21700,2024-06-06,2024-06-21,534.67,0,0,109509524,-65752697,0.0198156280909412,99.5131583258457,0
516.19,519,72,77,30960,21637,2024-06-06,2024-07-12,534.67,5,-9323,3646557,868777,0.593354224272375,93.2562140122861,-0.430882284974811
371.33,372,317,317,24409,21239,2024-06-06,2024-10-18,534.67,0,-3170,52962163,-8353895,0.0401022141033024,99.1657667002762,-0.149253731343284
264.84,265,1323,1323,25137,21168,2024-06-06,2024-10-18,534.67,0,-3969,52962163,-8353895,0.0399681561344086,99.2057348564106,-0.1875
400.68,402,160,160,21120,21120,2024-06-06,2024-10-18,534.67,0,0,52962163,-8353895,0.0398775253948748,99.2456123818055,0
254.9,255,2099,2099,20990,20990,2024-06-06,2024-09-20,534.67,0,0,244715238,-48165897,0.00857731630099798,99.9379417476242,0
530.1,560,0,7,0,20930,2024-06-06,2024-07-05,534.67,7,20930,14823040,-3756140,0.141199106256207,98.8106150964984,1
309.96,310,5125,5203,25625,20812,2024-06-06,2024-07-19,534.67,78,-4813,162615922,-53541395,0.0127982547736008,99.8514678039952,-0.231260811070536
254.67,255,628,629,26376,20757,2024-06-06,2024-12-20,534.67,1,-5619,383807022,-51896645,0.00540818661728393,99.9664055130289,-0.270703858939153
365.24,366,273,273,20748,20748,2024-06-06,2024-10-18,534.67,0,0,52962163,-8353895,0.0391751371634878,99.284787518969,0
533.14,585,0,4,0,20744,2024-06-06,2024-07-05,534.67,4,20744,14823040,-3756140,0.139944302923017,98.9505593994214,1
457.85,458,1380,1380,27600,20700,2024-06-06,2024-06-28,534.67,0,-6900,66054797,-39996766,0.0313376180688285,99.2123751436251,-0.333333333333333
433.95,434,4075,4074,57050,20370,2024-06-06,2024-06-21,534.67,-1,-36680,109509524,-65752697,0.0186011218531093,99.5317594476988,-1.80068728522337
404.76,406,164,164,20336,20336,2024-06-06,2024-10-18,534.67,0,0,52962163,-8353895,0.0383972233158227,99.3231847422848,0
194.84,195,1266,1266,20256,20256,2024-06-06,2024-12-20,534.67,0,0,383807022,-51896645,0.00527765226765445,99.9716831652965,0
529.37,539,15,21,21870,20223,2024-06-06,2024-07-12,534.67,6,-1647,3646557,868777,0.554577921036199,93.8107919333223,-0.0814419225634179
408.89,410,181,181,26064,20091,2024-06-06,2024-10-18,534.67,0,-5973,52962163,-8353895,0.0379346289161189,99.3611193712009,-0.297297297297297
184.9,185,2005,2004,24060,20040,2024-06-06,2024-12-20,534.67,-1,-4020,383807022,-51896645,0.00522137398517946,99.9769045392817,-0.20059880239521
514.56,517.5,67,68,27336,19992,2024-06-06,2024-07-12,534.67,1,-7344,3646557,868777,0.548243178428309,94.3590351117506,-0.36734693877551
329.95,330,4002,3997,20010,19985,2024-06-06,2024-07-19,534.67,-5,-25,162615922,-53541395,0.0122896944863739,99.8637574984816,-0.00125093820365274
527.55,537.5,0,20,0,19900,2024-06-06,2024-07-12,534.67,20,19900,3646557,868777,0.545720250636422,94.904755362387,1
486.93,487,2714,2834,27140,19838,2024-06-06,2024-06-14,534.67,120,-7302,23468414,-20040476,0.0845306376476911,98.6243467496355,-0.368081459824579
199.97,200,6594,6594,26376,19782,2024-06-06,2024-09-20,534.67,0,-6594,244715238,-48165897,0.00808368132760086,99.9460254289518,-0.333333333333333
249.97,250,6555,6557,26220,19671,2024-06-06,2024-08-16,534.67,2,-6549,116205577,-19412264,0.0169277589835469,99.8223166173858,-0.332926643281989
374.02,375,200,200,19600,19600,2024-06-06,2024-10-18,534.67,0,0,52962163,-8353895,0.0370075519763043,99.3981269231772,0
496.89,497,1624,1774,25984,19514,2024-06-06,2024-06-14,534.67,150,-6470,23468414,-20040476,0.0831500586277368,98.7074968082632,-0.331556830993133
329.87,330,854,1491,12810,19383,2024-06-06,2024-08-16,534.67,637,6573,116205577,-19412264,0.0166799223414208,99.8389965397272,0.339111592632719
379.73,380,714,713,24276,19251,2024-06-06,2024-08-16,534.67,-1,-5025,116205577,-19412264,0.0165663305471131,99.8555628702743,-0.261025401277856
416.79,418,158,158,25280,19118,2024-06-06,2024-10-18,534.67,0,-6162,52962163,-8353895,0.0360974683001523,99.4342243914774,-0.322314049586777
423.89,424,1736,1736,19096,19096,2024-06-06,2024-06-28,534.67,0,0,66054797,-39996766,0.0289093311421425,99.2412844747672,0
491.91,492,2111,2113,27443,19017,2024-06-06,2024-06-14,534.67,2,-8426,23468414,-20040476,0.0810323185878688,98.7885291268511,-0.443077246674029
244.93,245,2714,2716,24426,19012,2024-06-06,2024-09-20,534.67,2,-5414,244715238,-48165897,0.0077690298958825,99.9537944588477,-0.284767515253524
435.94,436,3143,3143,28287,18858,2024-06-06,2024-06-21,534.67,0,-9429,109509524,-65752697,0.0172204200248373,99.5489798677237,-0.5
405.73,407,148,148,18796,18796,2024-06-06,2024-10-18,534.67,0,0,52962163,-8353895,0.035489487089113,99.4697138785665,0
412.91,413,2069,2069,18621,18621,2024-06-06,2024-06-28,534.67,0,0,66054797,-39996766,0.0281902312106114,99.2694747059778,0
319.99,320,18569,18569,18569,18569,2024-06-06,2024-06-21,534.67,0,0,109509524,-65752697,0.0169565160378197,99.5659363837615,0
503.85,504,1327,1237,42464,18555,2024-06-06,2024-06-14,534.67,-90,-23909,23468414,-20040476,0.0790637151705266,98.8675928420216,-1.28854756130423
507.32,507.5,1087,1028,44567,18504,2024-06-06,2024-06-14,534.67,-59,-26063,23468414,-20040476,0.0788464018062746,98.9464392438279,-1.40850626891483
413.96,414,3626,4626,39886,18504,2024-06-06,2024-06-21,534.67,1000,-21382,109509524,-65752697,0.0168971604698053,99.5828335442313,-1.15553393860787
447.32,450,44,69,13068,18492,2024-06-06,2024-11-15,534.67,25,5424,10201073,1977879,0.181275048222868,99.3103666643695,0.293316028552888
454.82,455,1024,1026,24576,18468,2024-06-06,2024-07-05,534.67,2,-6108,14823040,-3756140,0.124589827727646,99.0751492271491,-0.330734243014945
425.95,426,3687,3687,25809,18435,2024-06-06,2024-06-21,534.67,0,-7374,109509524,-65752697,0.0168341522514517,99.5996676964827,-0.4
450.81,451,965,965,18335,18335,2024-06-06,2024-06-28,534.67,0,0,66054797,-39996766,0.0277572573571,99.2972319633349,0
269.99,270,18265,18265,18265,18265,2024-06-06,2024-06-21,534.67,0,0,109509524,-65752697,0.0166789146120295,99.6163466110948,0
427.9,428,1812,1812,18120,18120,2024-06-06,2024-06-28,534.67,0,0,66054797,-39996766,0.0274317700196702,99.3246637333546,0
354.91,355,2010,2010,18090,18090,2024-06-06,2024-07-19,534.67,0,0,162615922,-53541395,0.0111243719418816,99.8748818704235,0
529.15,537,10,23,11440,18055,2024-06-06,2024-07-05,534.67,13,6615,14823040,-3756140,0.121803624627607,99.1969528517767,0.366380504015508
334.95,335,3602,3602,21612,18010,2024-06-06,2024-07-19,534.67,0,-3602,162615922,-53541395,0.01107517626718,99.8859570466907,-0.2
466.82,467,1003,1000,23069,18000,2024-06-06,2024-06-28,534.67,-3,-5069,66054797,-39996766,0.0272501026685465,99.3519138360232,-0.281611111111111
532,550,9,10,21483,18000,2024-06-06,2024-07-05,534.67,1,-3483,14823040,-3756140,0.121432580631234,99.3183854324079,-0.1935
417.49,419,118,118,17818,17818,2024-06-06,2024-10-18,534.67,0,0,52962163,-8353895,0.0336428857711117,99.5033567643376,0
425.89,426,1606,1606,17666,17666,2024-06-06,2024-06-28,534.67,0,0,66054797,-39996766,0.0267444618745857,99.3786582978977,0
533.55,547,7,13,15400,17485,2024-06-06,2024-06-21,534.67,6,2085,109509524,-65752697,0.0159666477958575,99.6323132588906,0.119245067200458
427.95,428,3495,3495,48930,17475,2024-06-06,2024-06-21,534.67,0,-31455,109509524,-65752697,0.0159575161700091,99.6482707750606,-1.8
529.87,540,0,17,0,17221,2024-06-06,2024-07-12,534.67,17,17221,3646557,868777,0.4722536902618,95.3770090526488,1
429.91,430,1998,1910,21978,17190,2024-06-06,2024-06-28,534.67,-88,-4788,66054797,-39996766,0.026023848048462,99.4046821459462,-0.278534031413613
334.99,335,17110,17166,34220,17166,2024-06-06,2024-06-21,534.67,56,-17054,109509524,-65752697,0.0156753489312948,99.6639461239919,-0.993475474775719
159.94,160,2845,2846,22760,17076,2024-06-06,2024-12-20,534.67,1,-5684,383807022,-51896645,0.00444911088677268,99.9813536501685,-0.332864839540876
384.86,385,1253,1208,18795,16912,2024-06-06,2024-07-19,534.67,-45,-1883,162615922,-53541395,0.0103999656319017,99.8963570123226,-0.111341059602649
475.78,476,792,761,34848,16742,2024-06-06,2024-06-28,534.67,-31,-18106,66054797,-39996766,0.0253456232709337,99.4300277692171,-1.08147174770039
439.95,442,81,81,16605,16605,2024-06-06,2024-10-18,534.67,0,0,52962163,-8353895,0.0313525714574762,99.5347093357951,0
364.99,365,16488,16433,16488,16433,2024-06-06,2024-06-21,534.67,-55,-55,109509524,-65752697,0.01500600075661,99.6789521247485,-0.00334692387269519
440.93,441,2327,2327,18616,16289,2024-06-06,2024-06-21,534.67,0,-2327,109509524,-65752697,0.0148745053443936,99.6938266300929,-0.142857142857143
532.57,565,0,5,0,16215,2024-06-06,2024-06-21,534.67,5,16215,109509524,-65752697,0.0148069313131157,99.708633561406,1
489.98,490,9047,8103,18094,16206,2024-06-06,2024-06-07,534.67,-944,-1888,11090657,-11742034,0.146122993434925,97.3062100829554,-0.116500061705541
512.98,513,8387,8073,58709,16146,2024-06-06,2024-06-07,534.67,-314,-42563,11090657,-11742034,0.145581997531796,97.4517920804872,-2.6361327883067
458.85,459,1070,1075,23540,16125,2024-06-06,2024-06-28,534.67,5,-7415,66054797,-39996766,0.0244115503072396,99.4544393195244,-0.45984496124031
339.93,340,2278,2278,15946,15946,2024-06-06,2024-07-19,534.67,0,0,162615922,-53541395,0.00980592785988078,99.9061629401825,0
484.94,485,2681,2646,24129,15876,2024-06-06,2024-06-14,534.67,-35,-8253,23468414,-20040476,0.067648371977757,99.0140876158057,-0.51984126984127
514.53,517,65,64,24245,15808,2024-06-06,2024-07-12,534.67,-1,-8437,3646557,868777,0.433504810153797,95.8105138628026,-0.533717105263158
528.4,560,5,5,15800,15800,2024-06-06,2024-06-14,534.67,0,0,23468414,-20040476,0.0673245324545579,99.0814121482602,0
529.26,538,0,18,0,15732,2024-06-06,2024-07-12,534.67,18,15732,3646557,868777,0.431420652412673,96.2419345152153,1
412.95,413,3141,3141,15705,15705,2024-06-06,2024-06-21,534.67,0,0,109509524,-65752697,0.0143412183948494,99.7229747798009,0
449.82,450,855,872,18810,15696,2024-06-06,2024-07-05,534.67,17,-3114,14823040,-3756140,0.105889210310436,99.4242746427184,-0.198394495412844
219.95,220,4191,3136,29337,15680,2024-06-06,2024-09-20,534.67,-1055,-13657,244715238,-48165897,0.00640744733681031,99.9602019061845,-0.870982142857143
499.98,500,8148,7802,16296,15604,2024-06-06,2024-06-07,534.67,-346,-692,11090657,-11742034,0.140695001206872,97.5924870816941,-0.0443476031786721
432.93,433,2220,2220,15540,15540,2024-06-06,2024-06-21,534.67,0,0,109509524,-65752697,0.0141905465683514,99.7371653263692,0
405.9,406,1553,1553,15530,15530,2024-06-06,2024-06-28,534.67,0,0,66054797,-39996766,0.0235107830245849,99.4779501025489,0
510.5,512,61,103,14457,15450,2024-06-06,2024-07-05,534.67,42,993,14823040,-3756140,0.104229631708475,99.5285042744268,0.0642718446601942
530.21,542,0,13,0,15327,2024-06-06,2024-07-19,534.67,13,15327,162615922,-53541395,0.00942527632687776,99.9155882165093,1
523.55,600,2,2,15290,15290,2024-06-06,2024-12-20,534.67,0,0,383807022,-51896645,0.00398377286593782,99.9853374230344,0
459.79,460,703,712,20387,14952,2024-06-06,2024-07-05,534.67,9,-5435,14823040,-3756140,0.100869996977678,99.6293742714045,-0.363496522204387
513.7,516,65,65,24115,14950,2024-06-06,2024-07-12,534.67,0,-9165,3646557,868777,0.409975766181634,96.651910281397,-0.61304347826087
520.3,570,3,3,14910,14910,2024-06-06,2024-12-20,534.67,0,0,383807022,-51896645,0.00388476477639849,99.9892221878108,0
264.99,265,14828,14824,14828,14824,2024-06-06,2024-06-21,534.67,-4,-4,109509524,-65752697,0.0135367221576089,99.7507020485268,-0.000269832703723691
498.89,499,1555,1320,29545,14520,2024-06-06,2024-06-14,534.67,-235,-15025,23468414,-20040476,0.0618703931164671,99.1432825413767,-1.03477961432507
239.91,240,1602,1602,14418,14418,2024-06-06,2024-09-20,534.67,0,0,244715238,-48165897,0.0058917458993706,99.9660936520839,0
503.99,504,14309,14202,28618,14202,2024-06-06,2024-06-07,534.67,-107,-14416,11090657,-11742034,0.128053730270443,97.7205408119645,-1.0150683002394
502.38,502.5,1240,1178,37200,14136,2024-06-06,2024-06-14,534.67,-62,-23064,23468414,-20040476,0.0602341513150399,99.2035166926917,-1.63157894736842
344.92,345,1760,1760,14080,14080,2024-06-06,2024-07-19,534.67,0,0,162615922,-53541395,0.00865843874746779,99.9242466552568,0
409.66,411,105,105,14070,14070,2024-06-06,2024-10-18,534.67,0,0,52962163,-8353895,0.026566135525847,99.5612754713209,0
376.1,377,156,156,14040,14040,2024-06-06,2024-10-18,534.67,0,0,52962163,-8353895,0.0265094913136384,99.5877849626346,0
419.93,420,1971,1971,21681,13797,2024-06-06,2024-06-28,534.67,0,-7884,66054797,-39996766,0.0208872036954409,99.4988373062444,-0.571428571428571
284.92,285,1724,1724,13792,13792,2024-06-06,2024-08-16,534.67,0,0,116205577,-19412264,0.0118686214173697,99.8674314916917,0
526.48,595,2,2,13704,13704,2024-06-06,2024-12-20,534.67,0,0,383807022,-51896645,0.00357054436591314,99.9927927321768,0
460.84,461,852,854,23856,13664,2024-06-06,2024-06-28,534.67,2,-10192,66054797,-39996766,0.0206858557146122,99.519523161959,-0.745901639344262
532.05,600,1,2,7428,13590,2024-06-06,2024-06-28,534.67,1,6162,66054797,-39996766,0.0205738275147526,99.5400969894738,0.453421633554084
254.95,255,2718,2718,13590,13590,2024-06-06,2024-08-16,534.67,0,0,116205577,-19412264,0.0116947915503229,99.879126283242,0
418.95,419,2689,2708,18823,13540,2024-06-06,2024-06-21,534.67,19,-5283,109509524,-65752697,0.0123642213986794,99.7630662699255,-0.390177252584934
453.81,454,711,711,13509,13509,2024-06-06,2024-06-28,534.67,0,0,66054797,-39996766,0.0204512020527442,99.5605481915265,0
526.25,560,4,4,13500,13500,2024-06-06,2024-08-16,534.67,0,0,116205577,-19412264,0.0116173425996585,99.8907436258416,0
229.92,230,1685,1685,13480,13480,2024-06-06,2024-09-20,534.67,0,0,244715238,-48165897,0.00550844324618641,99.9716020953301,0
369.97,370,4487,4459,17948,13377,2024-06-06,2024-06-28,534.67,-28,-4571,66054797,-39996766,0.0202513679665082,99.580799559493,-0.341705913134485
209.79,210,633,633,13293,13293,2024-06-06,2024-12-20,534.67,0,0,383807022,-51896645,0.00346345930064823,99.9962561914774,0
199.98,200,6619,6620,13238,13240,2024-06-06,2024-08-16,534.67,1,2,116205577,-19412264,0.0113936011866281,99.9021372270283,0.000151057401812689
355.26,356,176,176,13024,13024,2024-06-06,2024-10-18,534.67,0,0,52962163,-8353895,0.0245911406601728,99.6123761032947,0
443.87,444,1000,1000,13000,13000,2024-06-06,2024-06-28,534.67,0,0,66054797,-39996766,0.0196806297050614,99.6004801891981,0
531.11,544,0,10,0,12890,2024-06-06,2024-07-12,534.67,10,12890,3646557,868777,0.353484122145904,97.0053944035429,1
497.89,498,1056,1170,31680,12870,2024-06-06,2024-06-14,534.67,114,-18810,23468414,-20040476,0.0548396666259595,99.2583563593177,-1.46153846153846
401.87,402,989,989,12857,12857,2024-06-06,2024-06-28,534.67,0,0,66054797,-39996766,0.0194641427783057,99.6199443319764,0
447.89,448,1169,1168,17535,12848,2024-06-06,2024-06-28,534.67,-1,-4687,66054797,-39996766,0.0194505177269714,99.6393948497034,-0.364803860523039
339.99,340,12669,12766,25338,12766,2024-06-06,2024-06-21,534.67,97,-12572,109509524,-65752697,0.0116574335580164,99.7747237034836,-0.98480338398872
477.97,478,4235,4235,12705,12705,2024-06-06,2024-06-07,534.67,0,0,11090657,-11742034,0.114555882487395,97.8350966944519,0
492.41,492.5,1413,1402,19782,12618,2024-06-06,2024-06-14,534.67,-11,-7164,23468414,-20040476,0.0537658829437729,99.3121222422615,-0.567760342368046
533.7,565,0,4,0,12520,2024-06-06,2024-07-19,534.67,4,12520,162615922,-53541395,0.00769912309078812,99.9319457783476,1
533.65,544,0,12,0,12420,2024-06-06,2024-06-14,534.67,12,12420,23468414,-20040476,0.0529221957649119,99.3650444380264,1
411.96,412,3094,3094,12376,12376,2024-06-06,2024-06-21,534.67,0,0,109509524,-65752697,0.0113013001499303,99.7860250036335,0
374.97,375,4101,4101,32808,12303,2024-06-06,2024-06-28,534.67,0,-20505,66054797,-39996766,0.0186254451739516,99.6580202948773,-1.66666666666667
533.83,545,4,11,9412,12287,2024-06-06,2024-06-14,534.67,7,2875,23468414,-20040476,0.0523554765993135,99.4173999146257,0.233987140880606
274.99,275,12156,12156,12156,12156,2024-06-06,2024-06-21,534.67,0,0,109509524,-65752697,0.0111004043812664,99.7971254080148,0
154.98,155,6042,6042,12084,12084,2024-06-06,2024-09-20,534.67,0,0,244715238,-48165897,0.00493798428686325,99.9765400796169,0
437.9,438,1202,1202,15626,12020,2024-06-06,2024-06-28,534.67,0,-3606,66054797,-39996766,0.0181970130042183,99.6762173078815,-0.3
431.44,433,67,77,14740,12012,2024-06-06,2024-10-18,534.67,10,-2728,52962163,-8353895,0.0226803425683351,99.6350564458631,-0.227106227106227
506.48,508,58,78,13456,11856,2024-06-06,2024-07-12,534.67,20,-1600,3646557,868777,0.325128607615348,97.3305230111582,-0.134952766531714
254.99,255,11711,11811,23422,11811,2024-06-06,2024-07-19,534.67,100,-11611,162615922,-53541395,0.00726312642374589,99.9392089047713,-0.983066632799932
529.67,538,2,14,2750,11662,2024-06-06,2024-07-05,534.67,12,8912,14823040,-3756140,0.0786748197400803,99.7080490911446,0.764191390842051
459.65,460,332,331,12616,11585,2024-06-06,2024-07-12,534.67,-1,-1031,3646557,868777,0.31769693988055,97.6482199510388,-0.0889943892965041
398.95,399,2296,2296,16072,11480,2024-06-06,2024-06-28,534.67,0,-4592,66054797,-39996766,0.0173795099241619,99.6935968178057,-0.4
381.07,382,122,122,11346,11346,2024-06-06,2024-10-18,534.67,0,0,52962163,-8353895,0.0214228410573035,99.6564792869204,0
324.99,325,11314,11296,22628,11296,2024-06-06,2024-06-21,534.67,-18,-11332,109509524,-65752697,0.0103150845583075,99.8074404925731,-1.00318696883853
428.95,429,2247,2253,24717,11265,2024-06-06,2024-06-21,534.67,6,-13452,109509524,-65752697,0.0102867765181775,99.8177272690912,-1.19414114513981
384.96,385,2794,2794,13970,11176,2024-06-06,2024-06-28,534.67,0,-2794,66054797,-39996766,0.016919285967982,99.7105161037737,-0.25
264.94,265,1959,1854,9795,11124,2024-06-06,2024-08-16,534.67,-105,1329,116205577,-19412264,0.00957269030211863,99.9117099173304,0.119471413160734
234.91,235,1228,1228,11052,11052,2024-06-06,2024-09-20,534.67,0,0,244715238,-48165897,0.00451626964071604,99.9810563492577,0
506.99,507,13452,11018,40356,11018,2024-06-06,2024-06-07,534.67,-2434,-29338,11090657,-11742034,0.0993448810111069,97.934441575463,-2.66273370847704
439.85,440,555,734,11100,11010,2024-06-06,2024-07-05,534.67,179,-90,14823040,-3756140,0.0742762618194379,99.782325352964,-0.00817438692098093
485.93,486,1570,1566,18840,10962,2024-06-06,2024-06-14,534.67,-4,-7878,23468414,-20040476,0.0467095901751179,99.4641095048008,-0.718664477285167
229.99,230,10745,10745,10745,10745,2024-06-06,2024-06-21,534.67,0,0,109509524,-65752697,0.00981193197406282,99.8275392010653,0
289.93,290,1516,1516,12128,10612,2024-06-06,2024-08-16,534.67,0,-1516,116205577,-19412264,0.00913209182722788,99.9208420091576,-0.142857142857143
368.32,369,0,156,0,10608,2024-06-06,2024-10-18,534.67,156,10608,52962163,-8353895,0.0200293934369712,99.6765086803573,1
529.39,635,1,1,10561,10561,2024-06-06,2024-07-19,534.67,0,0,162615922,-53541395,0.00649444400653461,99.9457033487779,0
375.11,376,117,117,10413,10413,2024-06-06,2024-10-18,534.67,0,0,52962163,-8353895,0.0196612060576151,99.696169886415,0
426.79,427,492,492,10332,10332,2024-06-06,2024-06-28,534.67,0,0,66054797,-39996766,0.0156415589317457,99.7261576627054,0
174.97,175,3413,3413,10239,10239,2024-06-06,2024-09-20,534.67,0,0,244715238,-48165897,0.00418404676540821,99.9852403960231,0
369.75,370,409,408,11452,10200,2024-06-06,2024-08-16,534.67,-1,-1252,116205577,-19412264,0.00877754774196423,99.9296195568996,-0.122745098039216
389.95,390,2023,2023,10115,10115,2024-06-06,2024-06-28,534.67,0,0,66054797,-39996766,0.0153130438051305,99.7414707065106,0
359.91,360,1120,1120,10080,10080,2024-06-06,2024-07-19,534.67,0,0,162615922,-53541395,0.00619865501239171,99.9519020037903,0
359.17,360,111,121,10212,10043,2024-06-06,2024-11-15,534.67,10,-169,10201073,1977879,0.09845042771481,99.4088170920843,-0.0168276411430847
493.91,494,1118,1112,19006,10008,2024-06-06,2024-06-14,534.67,-6,-8998,23468414,-20040476,0.0426445519496972,99.5067540567505,-0.899080735411671
510.98,511,5162,4999,20648,9998,2024-06-06,2024-06-07,534.67,-163,-10650,11090657,-11742034,0.0901479506579277,98.024589526121,-1.06521304260852
517.47,517.5,3048,3316,57912,9948,2024-06-06,2024-06-07,534.67,268,-47964,11090657,-11742034,0.0896971207386542,98.1142866468596,-4.82147165259349
279.92,280,1233,1233,9864,9864,2024-06-06,2024-08-16,534.67,0,0,116205577,-19412264,0.00848840499281717,99.9381079618924,0
414.94,415,1640,1640,16400,9840,2024-06-06,2024-06-28,534.67,0,-6560,66054797,-39996766,0.0148967227921388,99.7563674293027,-0.666666666666667
284.72,285,350,350,9800,9800,2024-06-06,2024-10-18,534.67,0,0,52962163,-8353895,0.0185037759881521,99.7146736624031,0
423.96,424,2414,2412,24140,9648,2024-06-06,2024-06-21,534.67,-2,-14492,109509524,-65752697,0.00881019261849773,99.8363493936838,-1.50207296849088
435.91,436,1268,1068,25360,9612,2024-06-06,2024-06-28,534.67,-200,-15748,66054797,-39996766,0.0145515548250039,99.7709189841277,-1.63836870578444
510.04,512,36,49,10296,9604,2024-06-06,2024-07-12,534.67,13,-692,3646557,868777,0.263371722970462,97.9115916740092,-0.0720533111203665
259.98,260,4801,4801,9602,9602,2024-06-06,2024-07-19,534.67,0,0,162615922,-53541395,0.00590471085605012,99.9578067146463,0
279.99,280,9523,9518,9523,9518,2024-06-06,2024-06-21,534.67,-5,-5,109509524,-65752697,0.00869148148246905,99.8450408751663,-0.000525320445471738
533.4,565,1,3,3540,9480,2024-06-06,2024-09-20,534.67,2,5940,244715238,-48165897,0.00387389035414297,99.9891142863772,0.626582278481013
422.9,423,942,942,9420,9420,2024-06-06,2024-06-28,534.67,0,0,66054797,-39996766,0.014260887063206,99.7851798711909,0
369.33,370,140,140,10780,9380,2024-06-06,2024-10-18,534.67,0,-1400,52962163,-8353895,0.0177107570172313,99.7323844194203,-0.149253731343283
504.99,505,9059,9274,18118,9274,2024-06-06,2024-06-07,534.67,215,-8844,11090657,-11742034,0.0836199334268475,98.1979065802864,-0.953633814966573
532.7,543,8,9,15808,9270,2024-06-06,2024-06-21,534.67,1,-6538,109509524,-65752697,0.00846501716142972,99.8535058923277,-0.705285868392665
419.35,421,56,56,9240,9240,2024-06-06,2024-10-18,534.67,0,0,52962163,-8353895,0.0174464173602577,99.7498308367806,0
431.93,432,1318,1318,9226,9226,2024-06-06,2024-06-21,534.67,0,0,109509524,-65752697,0.00842483800769694,99.8619307303354,0
529.17,620,1,1,9083,9083,2024-06-06,2024-12-20,534.67,0,0,383807022,-51896645,0.00236655388759406,99.998622745365,0
483.94,484,1519,1511,12152,9066,2024-06-06,2024-06-14,534.67,-8,-3086,23468414,-20040476,0.038630646280571,99.5453847030311,-0.340392675932054
490.92,491,996,1124,17928,8992,2024-06-06,2024-06-14,534.67,128,-8936,23468414,-20040476,0.0383153288500876,99.5837000318812,-0.993772241992883
527.74,550,0,4,0,8904,2024-06-06,2024-11-15,534.67,4,8904,10201073,1977879,0.0872849356141261,99.4961020276985,1
345.4,346,148,148,8880,8880,2024-06-06,2024-10-18,534.67,0,0,52962163,-8353895,0.0167666868137542,99.7665975235943,0
279.97,280,2918,2956,8754,8868,2024-06-06,2024-07-19,534.67,38,114,162615922,-53541395,0.00545334054066366,99.963260055187,0.0128552097428958
429.8,430,277,438,6925,8760,2024-06-06,2024-07-12,534.67,161,1835,3646557,868777,0.240226602792717,98.1518182768019,0.209474885844749
484.38,485,138,141,10902,8742,2024-06-06,2024-07-12,534.67,3,-2160,3646557,868777,0.239732986485608,98.3915512632876,-0.247083047357584
359.41,360,59,144,3953,8496,2024-06-06,2024-10-18,534.67,85,4543,52962163,-8353895,0.0160416408974837,99.7826391644918,0.534722222222222
349.98,350,4189,4189,12567,8378,2024-06-06,2024-06-28,534.67,0,-4189,66054797,-39996766,0.0126834088976157,99.7978632800885,-0.5
454.7,455,273,278,11466,8340,2024-06-06,2024-07-12,534.67,5,-3126,3646557,868777,0.228708888960189,98.6202601522477,-0.374820143884892
479.98,480,4096,4138,4096,8276,2024-06-06,2024-06-07,534.67,42,4180,11090657,-11742034,0.0746213682381486,98.2725279485246,0.505074915418076
184.95,185,1589,1589,7945,7945,2024-06-06,2024-09-20,534.67,0,0,244715238,-48165897,0.00324663068182129,99.992360917059,0
437.95,438,1587,1573,12696,7865,2024-06-06,2024-06-21,534.67,-14,-4831,109509524,-65752697,0.00718202372973514,99.8691127540651,-0.614240305149396
492.91,493,770,871,10780,7839,2024-06-06,2024-06-14,534.67,101,-2941,23468414,-20040476,0.033402342399448,99.6171023742806,-0.375175405026152
525.44,545,0,4,0,7824,2024-06-06,2024-11-15,534.67,4,7824,10201073,1977879,0.0766978140436795,99.5727998417421,1
531.92,610,0,1,0,7808,2024-06-06,2024-06-07,534.67,1,7808,11090657,-11742034,0.0704016001937487,98.3429295487183,1
530.21,543,4,6,5596,7674,2024-06-06,2024-07-05,534.67,2,2078,14823040,-3756140,0.0517707568757826,99.8340961098398,0.270784467031535
530.1,541,2,7,2982,7630,2024-06-06,2024-07-19,534.67,5,4648,162615922,-53541395,0.00469203747465762,99.9679520926616,0.609174311926606
404.93,405,1087,1085,8696,7595,2024-06-06,2024-06-28,534.67,-2,-1101,66054797,-39996766,0.0114980294315339,99.80936130952,-0.1449637919684
379.96,380,1896,1896,9480,7584,2024-06-06,2024-06-28,534.67,0,-1896,66054797,-39996766,0.0114813765910143,99.8208426861111,-0.25
500.98,501,3855,3738,7710,7476,2024-06-06,2024-06-07,534.67,-117,-234,11090657,-11742034,0.0674080895297727,98.4103376382481,-0.0313001605136437
449.73,450,250,275,8000,7425,2024-06-06,2024-07-12,534.67,25,-575,3646557,868777,0.203616726682183,98.8238768789299,-0.0774410774410774
417.95,418,1481,1481,7405,7405,2024-06-06,2024-06-21,534.67,0,0,109509524,-65752697,0.00676196894071058,99.8758747230058,0
487.93,488,1057,1056,21140,7392,2024-06-06,2024-06-14,534.67,-1,-13748,23468414,-20040476,0.0314976546774742,99.6486000289581,-1.85984848484848
234.99,235,7394,7387,7394,7387,2024-06-06,2024-06-21,534.67,-7,-7,109509524,-65752697,0.00674553201418353,99.88262025502,-0.000947610667388656
494.99,495,7553,7339,15106,7339,2024-06-06,2024-06-07,534.67,-214,-7767,11090657,-11742034,0.0661728155509633,98.4765104537991,-1.05831857201254
358.34,359,111,111,7326,7326,2024-06-06,2024-10-18,534.67,0,0,52962163,-8353895,0.0138325166213472,99.7964716811132,0
289.99,290,7302,7302,7302,7302,2024-06-06,2024-06-21,534.67,0,0,109509524,-65752697,0.00666791319447247,99.8892881682145,0
531.89,544,5,6,8815,7266,2024-06-06,2024-07-05,534.67,1,-1549,14823040,-3756140,0.0490182850481413,99.883114394888,-0.213184695843655
329.4,330,0,120,0,7200,2024-06-06,2024-11-15,534.67,120,7200,10201073,1977879,0.0705808104696437,99.6433806522118,1
304.99,305,7159,7159,7159,7159,2024-06-06,2024-06-21,534.67,0,0,109509524,-65752697,0.00653733094484093,99.8958254991593,0
530.11,539,7,8,8575,7112,2024-06-06,2024-07-05,534.67,1,-1463,14823040,-3756140,0.0479793618582963,99.9310937567463,-0.205708661417323
474.98,475,3428,3547,6856,7094,2024-06-06,2024-06-07,534.67,119,238,11090657,-11742034,0.0639637489465232,98.5404742027456,0.0335494784324782
344.83,345,413,415,7847,7055,2024-06-06,2024-08-16,534.67,2,-791.999999999999,116205577,-19412264,0.00607113718819192,99.9441790990806,-0.112260807937633
319.89,320,640,640,9600,7040,2024-06-06,2024-08-16,534.67,0,-2560,116205577,-19412264,0.00605822902974786,99.9502373281103,-0.363636363636364
529.73,600,1,1,7027,7027,2024-06-06,2024-07-19,534.67,0,0,162615922,-53541395,0.0043212250765949,99.9722733177382,0
451.87,452,540,539,8100,7007,2024-06-06,2024-06-28,534.67,-1,-1093,66054797,-39996766,0.0106078594110281,99.8314505455221,-0.155986870272584
459.96,460,1633,1724,6532,6896,2024-06-06,2024-06-14,534.67,91,364,23468414,-20040476,0.029384175683964,99.6779842046421,0.052784222737819
249.99,250,6888,6888,6888,6888,2024-06-06,2024-06-21,534.67,0,0,109509524,-65752697,0.00628986388435037,99.9021153630437,0
179.99,180,6889,6886,6889,6886,2024-06-06,2024-06-21,534.67,-3,-3,109509524,-65752697,0.0062880375591807,99.9084034006029,-0.000435666569851873
219.99,220,6844,6844,6844,6844,2024-06-06,2024-06-21,534.67,0,0,109509524,-65752697,0.00624968473061759,99.9146530853335,0
501.98,502,3214,3403,6428,6806,2024-06-06,2024-06-07,534.67,189,378,11090657,-11742034,0.0613669686115079,98.6018411713571,0.0555392300910961
512.48,512.5,4760,3373,28560,6746,2024-06-06,2024-06-07,534.67,-1387,-21814,11090657,-11742034,0.0608259727083797,98.6626671440655,-3.23361992291728
442.51,445,27,27,7695,6723,2024-06-06,2024-11-15,534.67,0,-972,10201073,1977879,0.0659048317760298,99.7092854839878,-0.144578313253012
533.21,550,3,4,7110,6716,2024-06-06,2024-07-12,534.67,1,-393.999999999999,3646557,868777,0.184173728807749,99.0080506077377,-0.0586658725431803
324.85,325,446,446,6690,6690,2024-06-06,2024-08-16,534.67,0,0,116205577,-19412264,0.00575703866605301,99.9559943667764,0
294.75,295,67,267,1809,6675,2024-06-06,2024-10-18,534.67,200,4866,52962163,-8353895,0.01260333721642,99.8090750183296,0.728988764044944
279.8,280,228,328,5244,6560,2024-06-06,2024-10-18,534.67,100,1316,52962163,-8353895,0.0123862010696202,99.8214612193992,0.200609756097561
309.99,310,6558,6558,6558,6558,2024-06-06,2024-06-21,534.67,0,0,109509524,-65752697,0.00598852023135449,99.9206416055648,0
455.86,456,464,464,8816,6496,2024-06-06,2024-06-28,534.67,0,-2320,66054797,-39996766,0.00983425927415991,99.8412848047962,-0.357142857142857
533.72,555,0,3,0,6384,2024-06-06,2024-07-12,534.67,3,6384,3646557,868777,0.175069250254418,99.1831198579921,1
534.1,550,1,4,2574,6360,2024-06-06,2024-06-14,534.67,3,3786,23468414,-20040476,0.0271002548361385,99.7050844594782,0.595283018867925
363.32,364,93,93,6324,6324,2024-06-06,2024-10-18,534.67,0,0,52962163,-8353895,0.011940599933579,99.8334018193328,0
495.9,496,627,625,11286,6250,2024-06-06,2024-06-14,534.67,-2,-5036,23468414,-20040476,0.0266315397367713,99.7317159992149,-0.80576
274.93,275,889,889,6223,6223,2024-06-06,2024-08-16,534.67,0,0,116205577,-19412264,0.00535516466649445,99.9613495314429,0
344.49,345,121,121,6897,6171,2024-06-06,2024-10-18,534.67,0,-726,52962163,-8353895,0.011651714451315,99.8450535337841,-0.117647058823529
505.98,506,3044,3066,9132,6132,2024-06-06,2024-06-07,534.67,22,-3000,11090657,-11742034,0.0552897812997012,98.7179569253652,-0.489236790606654
392.94,394,57,57,6042,6042,2024-06-06,2024-10-18,534.67,0,0,52962163,-8353895,0.0114081443388179,99.8564616781229,0
319.96,320,747,1502,4482,6008,2024-06-06,2024-07-19,534.67,755,1526,162615922,-53541395,0.00369459517008427,99.9759679129083,0.253994673768309
339.43,340,103,103,5871,5871,2024-06-06,2024-10-18,534.67,0,0,52962163,-8353895,0.0110852723292287,99.8675469504522,0
444.84,445,360,363,6840,5808,2024-06-06,2024-07-05,534.67,3,-1032,14823040,-3756140,0.0391822460170114,99.9702760027633,-0.177685950413223
339.84,340,355,355,6745,5680,2024-06-06,2024-08-16,534.67,0,-1065,116205577,-19412264,0.00488788933081929,99.9662374207737,-0.1875
284.97,285,1883,1883,5649,5649,2024-06-06,2024-07-19,534.67,0,0,162615922,-53541395,0.00347382957986119,99.9794417424882,0
502.99,503,5940,5639,11880,5639,2024-06-06,2024-06-07,534.67,-301,-6241,11090657,-11742034,0.0508445982956645,98.7688015236609,-1.10675651711296
354.99,355,5591,5591,5591,5591,2024-06-06,2024-06-07,534.67,0,0,11090657,-11742034,0.050411801573162,98.819213325234,0
314.99,315,5560,5560,5560,5560,2024-06-06,2024-06-21,534.67,0,0,109509524,-65752697,0.00507718397168816,99.9257187895365,0
481.94,482,926,925,6482,5550,2024-06-06,2024-06-14,534.67,-1,-932.000000000001,23468414,-20040476,0.0236488072862529,99.7553648065012,-0.167927927927928
239.99,240,5538,5537,5538,5537,2024-06-06,2024-06-21,534.67,-1,-1,109509524,-65752697,0.00505618123223693,99.9307749707688,-0.000180603214737222
299.99,300,5492,5512,10984,5512,2024-06-06,2024-06-28,534.67,20,-5472,66054797,-39996766,0.00834458699494603,99.8496293917912,-0.992743105950653
478.94,479,909,909,9999,5454,2024-06-06,2024-06-14,534.67,0,-4545,23468414,-20040476,0.0232397468358961,99.7786045533371,-0.833333333333333
259.95,260,1088,1088,6528,5440,2024-06-06,2024-08-16,534.67,0,-1088,116205577,-19412264,0.00468135879571426,99.9709187795694,-0.2
199.99,200,5421,5422,5421,5422,2024-06-06,2024-06-21,534.67,1,1,109509524,-65752697,0.00495116753498079,99.9357261383037,0.000184433788270011
531.56,545,1,4,2514,5376,2024-06-06,2024-07-12,534.67,3,2862,3646557,868777,0.147426737056352,99.3305465950484,0.532366071428571
527,580,1,1,5300,5300,2024-06-06,2024-10-18,534.67,0,0,52962163,-8353895,0.0100071441568578,99.877554094609,0
507.98,508,2700,2646,10800,5292,2024-06-06,2024-06-07,534.67,-54,-5508,11090657,-11742034,0.0477158386559065,98.8669291638899,-1.04081632653061
427.53,429,34,36,5882,5292,2024-06-06,2024-10-18,534.67,2,-590,52962163,-8353895,0.00999203903360216,99.8875461336426,-0.111489040060469
527.14,580,1,1,5286,5286,2024-06-06,2024-12-20,534.67,0,0,383807022,-51896645,0.00137725463501291,100,0
432.91,433,580,578,7540,5202,2024-06-06,2024-06-28,534.67,-2,-2338,66054797,-39996766,0.00787527967120995,99.8575046714624,-0.449442522106882
294.99,295,5185,5185,5185,5185,2024-06-06,2024-06-21,534.67,0,0,109509524,-65752697,0.00473474800237466,99.9404608863061,0
531.04,544,3,4,5208,5184,2024-06-06,2024-07-19,534.67,1,-24,162615922,-53541395,0.0031878797206586,99.9826296222088,-0.00462962962962963
529.85,580,1,1,5015,5015,2024-06-06,2024-08-16,534.67,0,0,116205577,-19412264,0.00431562763979908,99.9752344072092,0
330.51,331,102,102,4998,4998,2024-06-06,2024-10-18,534.67,0,0,52962163,-8353895,0.0094369257539576,99.8969830593966,0
532.09,542,3,5,5283,4955,2024-06-06,2024-06-21,534.67,2,-328,109509524,-65752697,0.00452472060786238,99.944985606914,-0.0661957618567104
204.99,205,4921,4921,4921,4921,2024-06-06,2024-06-21,534.67,0,0,109509524,-65752697,0.00449367307997796,99.949479279994,0
524.57,549,2,2,4886,4886,2024-06-06,2024-06-28,534.67,0,0,66054797,-39996766,0.00739688897991769,99.8649015604423,0
468.99,469,295,4871,590,4871,2024-06-06,2024-06-07,534.67,4576,4281,11090657,-11742034,0.0439198507356237,98.9108490146256,0.878874974337918
214.99,215,4857,4857,4857,4857,2024-06-06,2024-06-21,534.67,0,0,109509524,-65752697,0.00443523067454845,99.9539145106685,0
433.89,436,23,23,4853,4853,2024-06-06,2024-10-18,534.67,0,0,52962163,-8353895,0.00916314539494922,99.9061462047915,0
329.49,330,95,95,4845,4845,2024-06-06,2024-10-18,534.67,0,0,52962163,-8353895,0.00914804027169358,99.9152942450632,0
254.99,255,4829,4829,4829,4829,2024-06-06,2024-06-21,534.67,0,0,109509524,-65752697,0.00440966212217305,99.9583241727907,0
533.37,543,0,5,0,4815,2024-06-06,2024-06-14,534.67,5,4815,23468414,-20040476,0.0205169382132086,99.7991214915503,1
319.98,320,2392,2397,4784,4794,2024-06-06,2024-06-28,534.67,5,10,66054797,-39996766,0.00725761067738956,99.8721591711197,0.00208594075928244
482.93,483,690,680,6900,4760,2024-06-06,2024-06-14,534.67,-10,-2140,23468414,-20040476,0.020282580663525,99.8194040722138,-0.449579831932773
488.98,489,2343,2336,4686,4672,2024-06-06,2024-06-07,534.67,-7,-14,11090657,-11742034,0.0421255476569152,98.9529745622825,-0.00299657534246575
408.93,409,665,665,4655,4655,2024-06-06,2024-06-28,534.67,0,0,66054797,-39996766,0.00704717932900468,99.8792063504487,0
284.99,285,4608,4608,4608,4608,2024-06-06,2024-06-21,534.67,0,0,109509524,-65752697,0.00420785319092429,99.9625320259816,0
204.96,205,1146,1146,4584,4584,2024-06-06,2024-09-20,534.67,0,0,244715238,-48165897,0.00187319761428179,99.9942341146733,0
529.25,575,0,1,0,4575,2024-06-06,2024-06-21,534.67,1,4575,109509524,-65752697,0.0041777188256247,99.9667097448072,1
387,388,45,45,4500,4500,2024-06-06,2024-10-18,534.67,0,0,52962163,-8353895,0.00849663183129435,99.9237908768945,0
400.95,401,923,898,11076,4490,2024-06-06,2024-06-28,534.67,-25,-6586,66054797,-39996766,0.00679738672120967,99.8860037371699,-1.46681514476615
404.99,405,4482,4482,4482,4482,2024-06-06,2024-06-07,534.67,0,0,11090657,-11742034,0.0404123939636759,98.9933869562461,0
480.98,481,2235,2221,4470,4442,2024-06-06,2024-06-07,534.67,-14,-28,11090657,-11742034,0.0400517300282571,99.0334386862744,-0.00630346690679874
532.45,547,0,3,0,4365,2024-06-06,2024-06-14,534.67,3,4365,23468414,-20040476,0.0185994673521611,99.838003539566,1
407.87,408,331,331,4303,4303,2024-06-06,2024-06-28,534.67,0,0,66054797,-39996766,0.00651428843237532,99.8925180256023,0
249.99,250,3468,4260,6936,4260,2024-06-06,2024-07-19,534.67,792,-2676,162615922,-53541395,0.00261966967785602,99.9852492918867,-0.628169014084507
507.49,507.5,4045,4224,12135,4224,2024-06-06,2024-06-07,534.67,179,-7911,11090657,-11742034,0.0380861115802247,99.0715247978546,-1.87286931818182
427.89,430,19,20,4142,4220,2024-06-06,2024-11-15,534.67,1,78,10201073,1977879,0.0413681972474856,99.7506536812353,0.0184834123222749
294.98,295,2123,2108,10615,4216,2024-06-06,2024-07-19,534.67,-15,-6399,162615922,-53541395,0.00259261205677019,99.9878419039435,-1.51778937381404
413.9,414,417,417,4170,4170,2024-06-06,2024-06-28,534.67,0,0,66054797,-39996766,0.00631294045154662,99.8988309660538,0
415.95,416,832,832,4160,4160,2024-06-06,2024-06-21,534.67,0,0,109509524,-65752697,0.00379875635291776,99.9705085011601,0
269.94,270,723,693,4338,4158,2024-06-06,2024-08-16,534.67,-30,-180,116205577,-19412264,0.00357814152069483,99.9788125487299,-0.0432900432900433
454.97,455,1374,1385,5496,4155,2024-06-06,2024-06-14,534.67,11,-1341,23468414,-20040476,0.0177046476170056,99.855708187183,-0.322743682310469
189.99,190,4142,4142,4142,4142,2024-06-06,2024-06-21,534.67,0,0,109509524,-65752697,0.00378231942639071,99.9742908205865,0
529.19,570,0,1,0,4081,2024-06-06,2024-06-21,534.67,1,4081,109509524,-65752697,0.00372661650871572,99.9780174370953,1
420.56,422,28,28,4032,4032,2024-06-06,2024-10-18,534.67,0,0,52962163,-8353895,0.00761298212083974,99.9314038590154,0
528.95,549,2,2,4010,4010,2024-06-06,2024-06-21,534.67,0,0,109509524,-65752697,0.00366178196519236,99.9816792190605,0
532.69,546,1,3,1758,3993,2024-06-06,2024-06-28,534.67,2,2235,66054797,-39996766,0.00604498110863924,99.9048759471625,0.559729526671675
339.98,340,1931,1978,3862,3956,2024-06-06,2024-06-28,534.67,47,94.0000000000005,66054797,-39996766,0.00598896700870945,99.9108649141712,0.0237613751263904
438.94,441,19,19,3914,3914,2024-06-06,2024-10-18,534.67,0,0,52962163,-8353895,0.00739018155281913,99.9387940405682,0
428.9,429,391,391,3910,3910,2024-06-06,2024-06-28,534.67,0,0,66054797,-39996766,0.00591932785744539,99.9167842420286,0
420.9,421,390,390,3900,3900,2024-06-06,2024-06-28,534.67,0,0,66054797,-39996766,0.00590418891151842,99.9226884309402,0
526.16,532.5,0,6,0,3804,2024-06-06,2024-07-12,534.67,6,3804,3646557,868777,0.104317579568892,99.4348641746173,1
309.9,310,360,380,4320,3800,2024-06-06,2024-08-16,534.67,20,-520,116205577,-19412264,0.00327006680582981,99.9820826155358,-0.136842105263158
433.91,434,423,421,4653,3789,2024-06-06,2024-06-28,534.67,-2,-864,66054797,-39996766,0.00573614661172905,99.9284245775519,-0.228028503562945
269.83,270,220,221,4400,3757,2024-06-06,2024-10-18,534.67,1,-643,52962163,-8353895,0.00709374350892731,99.9458877840771,-0.171147191908438
497.38,497.5,312,313,6864,3756,2024-06-06,2024-06-14,534.67,1,-3108,23468414,-20040476,0.0160044901202101,99.8717126773032,-0.827476038338658
483.97,484,1250,1250,3750,3750,2024-06-06,2024-06-07,534.67,0,0,11090657,-11742034,0.033812243945512,99.1053370418001,0
459.99,460,3731,3731,3731,3731,2024-06-06,2024-06-07,534.67,0,0,11090657,-11742034,0.033640928576188,99.1389779703763,0
507.33,509,5,22,1230,3674,2024-06-06,2024-07-12,534.67,17,2444,3646557,868777,0.100752572906443,99.5356167475238,0.665215024496462
430.9,431,366,366,4392,3660,2024-06-06,2024-06-28,534.67,0,-732,66054797,-39996766,0.00554085420927113,99.9339654317612,-0.2
379.26,380,44,49,3608,3626,2024-06-06,2024-10-18,534.67,5,18,52962163,-8353895,0.00684639711561629,99.9527341811927,0.00496414782129068
184.99,185,3607,3607,3607,3607,2024-06-06,2024-06-21,534.67,0,0,109509524,-65752697,0.00329377744350345,99.984972996504,0
496.99,497,3679,3596,7358,3596,2024-06-06,2024-06-07,534.67,-83,-3762,11090657,-11742034,0.0324236877941496,99.1714016581705,-1.04616240266963
505.51,507,13,24,2860,3576,2024-06-06,2024-07-12,534.67,11,716,3646557,868777,0.0980651063455199,99.6336818538693,0.200223713646532
530.22,548,1,2,2830,3556,2024-06-06,2024-06-28,534.67,1,726,66054797,-39996766,0.00538340917163064,99.9393488409328,0.204161979752531
224.97,225,1161,1161,3483,3483,2024-06-06,2024-08-16,534.67,0,0,116205577,-19412264,0.0029972743907119,99.9850798899265,0
169.98,170,1634,1726,4902,3452,2024-06-06,2024-09-20,534.67,92,-1450,244715238,-48165897,0.00141061914583349,99.9956447338192,-0.420046349942062
475.95,476,689,686,5512,3430,2024-06-06,2024-06-14,534.67,-3,-2082,23468414,-20040476,0.0146153890075401,99.8863280663108,-0.606997084548105
406.93,407,488,488,20984,3416,2024-06-06,2024-06-28,534.67,0,-17568,66054797,-39996766,0.00517146392865306,99.9445203048614,-5.14285714285714
532.47,541,1,4,1415,3412,2024-06-06,2024-06-14,534.67,3,1997,23468414,-20040476,0.0145386901730982,99.9008667564839,0.585287221570926
398.64,400,2,25,306,3400,2024-06-06,2024-11-15,534.67,23,3094,10201073,1977879,0.0333298271662206,99.7839835084015,0.91
421.94,422,563,563,6756,3378,2024-06-06,2024-06-28,534.67,0,-3378,66054797,-39996766,0.00511393593413057,99.9496342407956,-1
379.98,380,1688,1688,3376,3376,2024-06-06,2024-06-07,534.67,0,0,11090657,-11742034,0.0304400361493462,99.2018416943198,0
532.27,565,0,1,0,3273,2024-06-06,2024-11-15,534.67,1,3273,10201073,1977879,0.0320848600926589,99.8160683684942,1
324.96,325,814,818,4884,3272,2024-06-06,2024-07-19,534.67,4,-1612,162615922,-53541395,0.00201210309529223,99.9898540070387,-0.492665036674817
209.95,210,649,648,3894,3240,2024-06-06,2024-09-20,534.67,-1,-654,244715238,-48165897,0.00132398784255519,99.9969687216617,-0.201851851851852
437.32,440,12,12,3216,3216,2024-06-06,2024-11-15,534.67,0,0,10201073,1977879,0.0315260953431075,99.8475944638373,0
309.98,310,1606,1606,3212,3212,2024-06-06,2024-06-28,534.67,0,0,66054797,-39996766,0.00486262943174286,99.9544968702273,0
432.48,434,19,21,3933,3192,2024-06-06,2024-10-18,534.67,2,-741,52962163,-8353895,0.00602694417899813,99.9587611253717,-0.232142857142857
224.99,225,3189,3189,3189,3189,2024-06-06,2024-06-21,534.67,0,0,109509524,-65752697,0.00291207548304201,99.987885071987,0
402.95,403,620,620,8060,3100,2024-06-06,2024-06-28,534.67,0,-4960,66054797,-39996766,0.00469307323736079,99.9591899434647,-1.6
534.3,542,0,4,0,3080,2024-06-06,2024-06-07,534.67,4,3080,11090657,-11742034,0.0277711230272472,99.2296128173471,1
524.4,555,1,1,3060,3060,2024-06-06,2024-08-16,534.67,0,0,116205577,-19412264,0.00263326432258927,99.987713154249,0
410.91,411,334,334,3006,3006,2024-06-06,2024-06-28,534.67,0,0,66054797,-39996766,0.00455076714564727,99.9637407106103,0
314.9,315,293,296,3809,2960,2024-06-06,2024-08-16,534.67,3,-849.000000000001,116205577,-19412264,0.00254720993296217,99.990260364182,-0.286824324324325
476.99,477,2935,2935,2935,2935,2024-06-06,2024-06-07,534.67,0,0,11090657,-11742034,0.026463716261354,99.2560765336084,0
334.86,335,198,209,3960,2926,2024-06-06,2024-08-16,534.67,11,-1034,116205577,-19412264,0.00251795144048895,99.9927783156225,-0.353383458646617
159.98,160,1454,1454,2908,2908,2024-06-06,2024-09-20,534.67,0,0,244715238,-48165897,0.00118831995251559,99.9981570416142,0
480.94,481,480,484,3840,2904,2024-06-06,2024-06-14,534.67,4,-936,23468414,-20040476,0.0123740786232934,99.9132408351071,-0.322314049586777
304.97,305,953,953,2859,2859,2024-06-06,2024-07-19,534.67,0,0,162615922,-53541395,0.00175813042464563,99.9916121374634,0
324.61,325,67,73,3283,2847,2024-06-06,2024-10-18,534.67,6,-436,52962163,-8353895,0.00537553573859889,99.9641366611103,-0.153143659992975
418.13,420,14,15,2800,2805,2024-06-06,2024-11-15,534.67,1,5,10201073,1977879,0.027497107412132,99.8750915712494,0.0017825311942959
219.97,220,933,933,2799,2799,2024-06-06,2024-08-16,534.67,0,0,116205577,-19412264,0.00240866236566254,99.9951869779882,0
460.98,461,1389,1389,2778,2778,2024-06-06,2024-06-07,534.67,0,0,11090657,-11742034,0.0250481103148353,99.2811246439233,0
462.99,463,2766,2766,2766,2766,2024-06-06,2024-06-07,534.67,0,0,11090657,-11742034,0.0249399111342096,99.3060645550575,0
490.99,491,2713,2713,5426,2713,2024-06-06,2024-06-07,534.67,0,-2713,11090657,-11742034,0.0244620314197797,99.3305265864772,-1
486.98,487,1350,1350,2700,2700,2024-06-06,2024-06-07,534.67,0,0,11090657,-11742034,0.0243448156407686,99.354871402118,0
528.23,555,1,1,2677,2677,2024-06-06,2024-06-21,534.67,0,0,109509524,-65752697,0.00244453623960597,99.9903296082266,0
478.99,479,2639,2638,5278,2638,2024-06-06,2024-06-07,534.67,-1,-2640,11090657,-11742034,0.0237857865408695,99.3786571886589,-1.00075815011372
408.47,410,16,17,3120,2601,2024-06-06,2024-11-15,534.67,1,-519,10201073,1977879,0.0254973177821588,99.9005888890316,-0.199538638985006
529.2,555,0,1,0,2580,2024-06-06,2024-11-15,534.67,1,2580,10201073,1977879,0.0252914570849557,99.9258803461165,1
529.26,555,1,1,2574,2574,2024-06-06,2024-06-28,534.67,0,0,66054797,-39996766,0.00389676468160216,99.9676374752919,0
457.99,458,2518,2518,2518,2518,2024-06-06,2024-06-07,534.67,0,0,11090657,-11742034,0.0227037947346131,99.4013609833935,0
431.9,432,251,251,2510,2510,2024-06-06,2024-06-28,534.67,0,0,66054797,-39996766,0.00379987542766955,99.9714373507196,0
244.99,245,2472,2472,2472,2472,2024-06-06,2024-06-21,534.67,0,0,109509524,-65752697,0.00225733790971459,99.9925869461363,0
389.99,390,2389,2435,2389,2435,2024-06-06,2024-06-14,534.67,46,46,23468414,-20040476,0.0103756478814461,99.9236164829886,0.0188911704312115
498.98,499,1485,1206,2970,2412,2024-06-06,2024-06-07,534.67,-279,-558,11090657,-11742034,0.0217480353057533,99.4231090186993,-0.23134328358209
414.99,415,2360,2360,2360,2360,2024-06-06,2024-06-07,534.67,0,0,11090657,-11742034,0.0212791721897089,99.444388190889,0
533.4,557,0,1,0,2360,2024-06-06,2024-06-28,534.67,1,2360,66054797,-39996766,0.00357279123876499,99.9750101419584,1
528.53,552,1,1,2347,2347,2024-06-06,2024-06-21,534.67,0,0,109509524,-65752697,0.00214319258661009,99.9947301387229,0
469.99,470,2333,2336,2333,2336,2024-06-06,2024-06-07,534.67,3,3,11090657,-11742034,0.0210627738284576,99.4654509647174,0.00128424657534247
314.96,315,572,573,4004,2292,2024-06-06,2024-07-19,534.67,1,-1712,162615922,-53541395,0.00140945608019859,99.9930215935436,-0.74694589877836
528.43,551,1,1,2257,2257,2024-06-06,2024-06-21,534.67,0,0,109509524,-65752697,0.00206100795397485,99.9967911466769,0
289.97,290,807,751,2421,2253,2024-06-06,2024-07-19,534.67,-56,-168,162615922,-53541395,0.0013854731887816,99.9944070667324,-0.0745672436751001
470.99,471,2408,2250,7224,2250,2024-06-06,2024-06-07,534.67,-158,-4974,11090657,-11742034,0.0202873463673072,99.4857383110847,-2.21066666666667
508.99,509,2304,2242,9216,2242,2024-06-06,2024-06-07,534.67,-62,-6974,11090657,-11742034,0.0202152135802234,99.5059535246649,-3.11061552185549
418.92,419,282,278,2538,2224,2024-06-06,2024-06-28,534.67,-4,-314,66054797,-39996766,0.00336690157415819,99.9783770435325,-0.141187050359712
463.98,464,1059,1059,2118,2118,2024-06-06,2024-06-07,534.67,0,0,11090657,-11742034,0.0190971553804252,99.5250506800454,0
458.99,459,2097,2097,2097,2097,2024-06-06,2024-06-07,534.67,0,0,11090657,-11742034,0.0189078068143303,99.5439584868597,0
533.65,544,0,2,0,2070,2024-06-06,2024-06-07,534.67,2,2070,11090657,-11742034,0.0186643586579226,99.5626228455176,1
334.98,335,933,1031,1866,2062,2024-06-06,2024-06-28,534.67,98,196,66054797,-39996766,0.00312165065014128,99.9814986941827,0.0950533462657614
526.6,547,1,1,2040,2040,2024-06-06,2024-07-19,534.67,0,0,162615922,-53541395,0.0012544897048888,99.9956615564373,0
209.99,210,2026,2026,2026,2026,2024-06-06,2024-06-21,534.67,0,0,109509524,-65752697,0.00185006739687774,99.9986412140738,0
409.99,410,2017,2017,4034,2017,2024-06-06,2024-06-14,534.67,0,-2017,23468414,-20040476,0.00859453050385084,99.9322110134924,-1
354.98,355,1009,1003,3027,2006,2024-06-06,2024-06-28,534.67,-6,-1021,66054797,-39996766,0.00303687255295024,99.9845355667356,-0.508973080757727
492.99,493,2004,1975,6012,1975,2024-06-06,2024-06-07,534.67,-29,-4037,11090657,-11742034,0.017807781811303,99.5804306273289,-2.04405063291139
533.24,543,0,2,0,1952,2024-06-06,2024-06-07,534.67,2,1952,11090657,-11742034,0.0176004000484372,99.5980310273774,1
419.83,420,107,114,2568,1938,2024-06-06,2024-07-12,534.67,7,-630,3646557,868777,0.0531460223986626,99.686827876268,-0.325077399380805
364.99,365,1934,1934,1934,1934,2024-06-06,2024-06-07,534.67,0,0,11090657,-11742034,0.0174381012774987,99.6154691286549,0
466.99,467,340,1932,680,1932,2024-06-06,2024-06-07,534.67,1592,1252,11090657,-11742034,0.0174200680807278,99.6328891967356,0.648033126293996
482.99,483,1929,1929,1929,1929,2024-06-06,2024-06-07,534.67,0,0,11090657,-11742034,0.0173930182855714,99.6502822150212,0
424.12,426,10,10,1880,1880,2024-06-06,2024-10-18,534.67,0,0,52962163,-8353895,0.00354970396507408,99.9676863650754,0
324.99,325,1852,1852,1852,1852,2024-06-06,2024-06-28,534.67,0,0,66054797,-39996766,0.0028037327856749,99.9873392995213,0
444.98,445,908,906,2724,1812,2024-06-06,2024-06-14,534.67,-2,-912,23468414,-20040476,0.00772101600048474,99.9399320294929,-0.503311258278146
445.89,446,163,162,2282,1782,2024-06-06,2024-06-28,534.67,-1,-500,66054797,-39996766,0.00269776016418611,99.9900370596855,-0.280583613916948
319.59,320,43,43,1763,1763,2024-06-06,2024-10-18,534.67,0,0,52962163,-8353895,0.00332879153746043,99.9710151566129,0
528.5,546,0,1,0,1750,2024-06-06,2024-07-19,534.67,1,1750,162615922,-53541395,0.00107615538409578,99.9967377118214,1
334.3,335,25,25,1750,1750,2024-06-06,2024-11-15,534.67,0,0,10201073,1977879,0.0171550581002606,99.9430354042168,0
425.41,427,11,11,1749,1749,2024-06-06,2024-10-18,534.67,0,0,52962163,-8353895,0.00330235757176307,99.9743175141846,0
497.99,498,1758,1747,3516,1747,2024-06-06,2024-06-07,534.67,-11,-1769,11090657,-11742034,0.0157519973794158,99.6660342124006,-1.01259301659989
525.66,543,1,1,1734,1734,2024-06-06,2024-07-19,534.67,0,0,162615922,-53541395,0.00106631624915548,99.9978040280705,0
465.99,466,297,1714,594,1714,2024-06-06,2024-06-07,534.67,1417,1120,11090657,-11742034,0.0154544496326953,99.6814886620333,0.653442240373396
289.73,290,63,63,1701,1701,2024-06-06,2024-10-18,534.67,0,0,52962163,-8353895,0.00321172683222927,99.9775292410168,0
434.99,435,1693,1693,1693,1693,2024-06-06,2024-06-07,534.67,0,0,11090657,-11742034,0.0152651010666005,99.6967537630999,0
264.97,265,563,563,1689,1689,2024-06-06,2024-07-19,534.67,0,0,162615922,-53541395,0.00103864368213587,99.9988426717526,0
524.18,541,1,1,1682,1682,2024-06-06,2024-07-05,534.67,0,0,14823040,-3756140,0.0113472000345408,99.9816232027978,0
439.98,440,840,840,1680,1680,2024-06-06,2024-06-07,534.67,0,0,11090657,-11742034,0.0151478852875894,99.7119016483875,0
234.95,235,333,333,1665,1665,2024-06-06,2024-08-16,534.67,0,0,116205577,-19412264,0.00143280558729122,99.9966197835754,0
374.99,375,1611,1611,1611,1611,2024-06-06,2024-06-07,534.67,0,0,11090657,-11742034,0.0145257399989919,99.7264273883865,0
411.86,412,114,114,1596,1596,2024-06-06,2024-06-28,534.67,0,0,66054797,-39996766,0.00241617576994446,99.9924532354554,0
533.15,549,0,1,0,1585,2024-06-06,2024-06-07,534.67,1,1585,11090657,-11742034,0.0142913084409697,99.7407186968274,1
364.98,365,794,785,2382,1570,2024-06-06,2024-06-28,534.67,-9,-812,66054797,-39996766,0.00237681451053434,99.9948300499659,-0.517197452229299
477.95,478,323,313,2261,1565,2024-06-06,2024-06-14,534.67,-10,-696,23468414,-20040476,0.00666853755008754,99.946600567043,-0.444728434504793
497.48,497.5,779,779,1558,1558,2024-06-06,2024-06-07,534.67,0,0,11090657,-11742034,0.014047860284562,99.754766557112,0
464.63,465,32,42,1376,1554,2024-06-06,2024-07-12,534.67,10,178,3646557,868777,0.0426155411803518,99.7294434174483,0.114543114543115
229.97,230,481,511,1924,1533,2024-06-06,2024-08-16,534.67,30,-391,116205577,-19412264,0.00131921379298345,99.9979389973684,-0.255055446836269
529.72,545,0,1,0,1528,2024-06-06,2024-07-05,534.67,1,1528,14823040,-3756140,0.0103082768446958,99.9919314796425,1
314.97,315,505,505,1515,1515,2024-06-06,2024-06-28,534.67,0,0,66054797,-39996766,0.002293550307936,99.9971236002739,0
449.98,450,747,747,1494,1494,2024-06-06,2024-06-07,534.67,0,0,11090657,-11742034,0.013470797987892,99.7682373550999,0
194.99,195,1488,1488,1488,1488,2024-06-06,2024-06-21,534.67,0,0,109509524,-65752697,0.00135878592623597,100,0
456.99,457,1486,1486,1486,1486,2024-06-06,2024-06-07,534.67,0,0,11090657,-11742034,0.0133986652008082,99.7816360203007,0
502.49,502.5,1492,1482,4476,1482,2024-06-06,2024-06-07,534.67,-10,-2994,11090657,-11742034,0.0133625988072663,99.794998619108,-2.02024291497976
464.99,465,1490,1480,2980,1480,2024-06-06,2024-06-07,534.67,-10,-1500,11090657,-11742034,0.0133445656104954,99.8083431847185,-1.01351351351351
194.96,195,369,369,1476,1476,2024-06-06,2024-09-20,534.67,0,0,244715238,-48165897,0.000603150017164031,99.9987601916314,0
487.99,488,1466,1464,2932,1464,2024-06-06,2024-06-07,534.67,-2,-1468,11090657,-11742034,0.0132003000363279,99.8215434847548,-1.00273224043716
304.72,305,15,51,510,1428,2024-06-06,2024-10-18,534.67,36,918,52962163,-8353895,0.00269626450113074,99.980225505518,0.642857142857143
323.49,324,28,28,1428,1428,2024-06-06,2024-10-18,534.67,0,0,52962163,-8353895,0.00269626450113074,99.9829217700191,0
419.98,420,696,696,1392,1392,2024-06-06,2024-06-14,534.67,0,0,23468414,-20040476,0.00593137653017371,99.9525319435732,0
304.99,305,1284,1384,3852,1384,2024-06-06,2024-06-28,534.67,100,-2468,66054797,-39996766,0.00209523011629269,99.9992188303902,-1.78323699421965
414.98,415,623,683,1246,1366,2024-06-06,2024-06-14,534.67,60,120,23468414,-20040476,0.00582058932486874,99.958352532898,0.0878477306002928
179.97,180,451,451,1353,1353,2024-06-06,2024-09-20,534.67,0,0,244715238,-48165897,0.000552887515733695,99.9993130791471,0
485.98,486,674,674,1348,1348,2024-06-06,2024-06-07,534.67,0,0,11090657,-11742034,0.0121543746236134,99.8336978593784,0
299.73,300,12,48,372,1296,2024-06-06,2024-10-18,534.67,36,924,52962163,-8353895,0.00244702996741277,99.9853687999865,0.712962962962963
269.98,270,544,644,2176,1288,2024-06-06,2024-07-19,534.67,100,-888,162615922,-53541395,0.000792050362694497,99.9996347221153,-0.68944099378882
189.97,190,425,425,1275,1275,2024-06-06,2024-09-20,534.67,0,0,244715238,-48165897,0.000521013734338848,99.9998340928815,0
309.49,310,25,25,1275,1275,2024-06-06,2024-11-15,534.67,0,0,10201073,1977879,0.0124986851873327,99.9555340894041,0
349.94,350,200,200,1200,1200,2024-06-06,2024-07-12,534.67,0,0,3646557,868777,0.0329077538072214,99.7623511712555,0
434.87,435,88,92,1320,1196,2024-06-06,2024-07-05,534.67,4,-124,14823040,-3756140,0.00806852035749752,100,-0.103678929765886
249.99,250,1186,1186,1186,1186,2024-06-06,2024-07-12,534.67,0,0,3646557,868777,0.0325238300128039,99.7948750012683,0
435.06,437,6,6,1164,1164,2024-06-06,2024-10-18,534.67,0,0,52962163,-8353895,0.00219779543369481,99.9875665954202,0
493.99,494,1131,1131,1131,1131,2024-06-06,2024-06-07,534.67,0,0,11090657,-11742034,0.0101977727739664,99.8438956321524,0
444.99,445,1125,1125,1125,1125,2024-06-06,2024-06-07,534.67,0,0,11090657,-11742034,0.0101436731836536,99.854039305336,0
363.99,365,11,11,1111,1111,2024-06-06,2024-11-15,534.67,0,0,10201073,1977879,0.0108910111710797,99.9664251005752,0
239.96,240,274,274,1096,1096,2024-06-06,2024-08-16,534.67,0,0,116205577,-19412264,0.000943156110313019,99.9988821534787,0
492.49,492.5,1038,1066,2076,1066,2024-06-06,2024-06-07,534.67,28,-1010,11090657,-11742034,0.00961169387891087,99.8636509992149,-0.947467166979362
399.99,400,656,1052,656,1052,2024-06-06,2024-06-14,534.67,396,396,23468414,-20040476,0.00448262076849335,99.9628351536666,0.376425855513308
495.99,496,1147,1050,2294,1050,2024-06-06,2024-06-07,534.67,-97,-1244,11090657,-11742034,0.00946742830474335,99.8731184275197,-1.1847619047619
299.98,300,519,518,1557,1036,2024-06-06,2024-07-12,534.67,-1,-521,3646557,868777,0.0284103607869012,99.8232853620552,-0.502895752895753
349.99,350,1033,1033,1033,1033,2024-06-06,2024-06-07,534.67,0,0,11090657,-11742034,0.00931414613219036,99.8824325736519,0
451.57,455,3,3,1029,1029,2024-06-06,2024-11-15,534.67,0,0,10201073,1977879,0.0100871741629533,99.9765122747382,0
349.99,350,1022,1018,1022,1018,2024-06-06,2024-06-14,534.67,-4,-4.00000000000011,23468414,-20040476,0.00433774519232531,99.9671728988589,-0.00392927308447948
467.99,468,1040,1013,2080,1013,2024-06-06,2024-06-07,534.67,-27,-1067,11090657,-11742034,0.00913381416448097,99.8915663878164,-1.0533070088845
454.99,455,1003,1003,1003,1003,2024-06-06,2024-06-07,534.67,0,0,11090657,-11742034,0.00904364818062627,99.900610035997,0
314.5,315,0,20,0,1000,2024-06-06,2024-11-15,534.67,20,1000,10201073,1977879,0.00980289034300607,99.9863151650812,1
209.97,210,325,325,975,975,2024-06-06,2024-08-16,534.67,0,0,116205577,-19412264,0.000839030298864228,99.9997211837776,0
481.99,482,959,959,959,959,2024-06-06,2024-06-07,534.67,0,0,11090657,-11742034,0.0086469178516656,99.9092569538486,0
384.98,385,473,473,946,946,2024-06-06,2024-06-07,534.67,0,0,11090657,-11742034,0.00852970207265449,99.9177866559213,0
476.95,477,329,189,2303,945,2024-06-06,2024-06-14,534.67,-140,-1358,23468414,-20040476,0.00402668880819982,99.9711995876671,-1.43703703703704
424.98,425,454,452,908,904,2024-06-06,2024-06-14,534.67,-2,-3.99999999999989,23468414,-20040476,0.0038519859075266,99.9750515735746,-0.00442477876106182
532,541,0,1,0,900,2024-06-06,2024-06-07,534.67,1,900,11090657,-11742034,0.00811493854692287,99.9259015944682,1
269.98,270,444,444,888,888,2024-06-06,2024-07-12,534.67,0,0,3646557,868777,0.0243517378173439,99.8476370998726,0
384.99,385,653,877,653,877,2024-06-06,2024-06-14,534.67,224,224,23468414,-20040476,0.00373693765586375,99.9787885112305,0.255416191562144
421.32,423,5,5,840,840,2024-06-06,2024-10-18,534.67,0,0,52962163,-8353895,0.00158603794184161,99.989152633362,0
409.86,410,3,59,54,826,2024-06-06,2024-07-12,534.67,56,772,3646557,868777,0.0226515038706374,99.8702886037432,0.934624697336562
491.99,492,810,802,1620,802,2024-06-06,2024-06-07,534.67,-8,-818,11090657,-11742034,0.00723131190514683,99.9331329063734,-1.01995012468828
444.77,445,34,34,1054,782,2024-06-06,2024-07-12,534.67,0,-272,3646557,868777,0.0214448862310393,99.8917334899743,-0.347826086956522
409.99,410,780,780,780,780,2024-06-06,2024-06-07,534.67,0,0,11090657,-11742034,0.00703294674066649,99.940165853114,0
439.68,440,24,24,768,768,2024-06-06,2024-07-12,534.67,0,0,3646557,868777,0.0210609624366217,99.9127944524109,0
424.99,425,742,742,742,742,2024-06-06,2024-06-07,534.67,0,0,11090657,-11742034,0.00669031600201864,99.946856169116,0
394.98,395,351,351,702,702,2024-06-06,2024-06-07,534.67,0,0,11090657,-11742034,0.00632965206659984,99.9531858211826,0
460.96,461,70,170,350,680,2024-06-06,2024-06-14,534.67,100,330,23468414,-20040476,0.00289751152336072,99.9816860227538,0.485294117647059
461.99,462,725,676,725,676,2024-06-06,2024-06-07,534.67,-49,-49,11090657,-11742034,0.00609522050857763,99.9592810416912,-0.0724852071005917
484.99,485,644,634,1288,634,2024-06-06,2024-06-07,534.67,-10,-654,11090657,-11742034,0.00571652337638789,99.9649975650676,-1.03154574132492
473.99,474,451,603,1353,603,2024-06-06,2024-06-07,534.67,152,-750,11090657,-11742034,0.00543700882643833,99.970434573894,-1.24378109452736
389.9,390,0,60,0,600,2024-06-06,2024-07-12,534.67,60,600,3646557,868777,0.0164538769036107,99.9292483293145,1
274.97,275,198,198,594,594,2024-06-06,2024-07-19,534.67,0,0,162615922,-53541395,0.000365277884658797,100,0
455.99,456,591,591,591,591,2024-06-06,2024-06-07,534.67,0,0,11090657,-11742034,0.00532880964581269,99.9757633835399,0
399.88,400,48,49,672,588,2024-06-06,2024-07-12,534.67,1,-84.0000000000001,3646557,868777,0.0161247993655385,99.94537312868,-0.142857142857143
437.13,439,3,3,561,561,2024-06-06,2024-10-18,534.67,0,0,52962163,-8353895,0.00105924676830136,99.9902118801304,0
439.97,440,187,184,561,552,2024-06-06,2024-06-14,534.67,-3,-9,23468414,-20040476,0.00235209758955164,99.9840381203434,-0.016304347826087
289.98,290,263,263,526,526,2024-06-06,2024-07-12,534.67,0,0,3646557,868777,0.0144245654188321,99.9597976940989,0
329.99,330,516,516,1032,516,2024-06-06,2024-06-28,534.67,0,-516,66054797,-39996766,0.000781169609831668,100,-1
331.49,332,10,10,510,510,2024-06-06,2024-10-18,534.67,0,0,52962163,-8353895,0.000962951607546693,99.9911748317379,0
314.61,315,13,13,507,507,2024-06-06,2024-10-18,534.67,0,0,52962163,-8353895,0.00095728718632583,99.9921321189242,0
393.76,395,4,4,496,496,2024-06-06,2024-10-18,534.67,0,0,52962163,-8353895,0.000936517641849333,99.9930686365661,0
338.46,339,9,9,486,486,2024-06-06,2024-10-18,534.67,0,0,52962163,-8353895,0.00091763623777979,99.9939862728039,0
354.99,355,474,466,948,466,2024-06-06,2024-06-14,534.67,-8,-482,23468414,-20040476,0.00198564760277367,99.9860237679462,-1.0343347639485
451.97,452,150,154,600,462,2024-06-06,2024-06-14,534.67,4,-138,23468414,-20040476,0.00196860341734214,99.9879923713635,-0.298701298701299
332.58,333,12,11,588,462,2024-06-06,2024-10-18,534.67,-1,-126,52962163,-8353895,0.000872320868012887,99.9948585936719,-0.272727272727273
394.99,395,454,444,454,444,2024-06-06,2024-06-14,534.67,-10,-9.99999999999994,23468414,-20040476,0.00189190458290023,99.9898842759464,-0.0225225225225224
369.98,370,214,214,428,428,2024-06-06,2024-06-07,534.67,0,0,11090657,-11742034,0.0038591041089811,99.9796224876489,0
369.97,370,140,140,420,420,2024-06-06,2024-06-14,534.67,0,0,23468414,-20040476,0.00178963947031103,99.9916739154167,0
458.96,459,0,105,0,420,2024-06-06,2024-06-14,534.67,105,420,23468414,-20040476,0.00178963947031103,99.993463554887,1
472.99,473,70,407,70,407,2024-06-06,2024-06-07,534.67,337,337,11090657,-11742034,0.00366975554288623,99.9832922431917,0.828009828009828
164.98,165,203,203,609,406,2024-06-06,2024-09-20,534.67,0,-203,244715238,-48165897,0.00016590711854241,100,-0.5
389.99,390,394,394,394,394,2024-06-06,2024-06-07,534.67,0,0,11090657,-11742034,0.00355253976387512,99.9868447829556,0
379.99,380,388,384,388,384,2024-06-06,2024-06-14,534.67,-4,-4,23468414,-20040476,0.00163624180142723,99.9950997966884,-0.0104166666666667
450.96,451,93,91,372,364,2024-06-06,2024-06-14,534.67,-2,-8,23468414,-20040476,0.00155102087426956,99.9966508175627,-0.021978021978022
383.86,385,2,3,248,342,2024-06-06,2024-11-15,534.67,1,94,10201073,1977879,0.00335258849730808,99.9896677535785,0.274853801169591
434.78,435,10,15,420,330,2024-06-06,2024-07-12,534.67,5,-90,3646557,868777,0.0090496322969859,99.9688473263958,-0.272727272727273
475.99,476,280,328,560,328,2024-06-06,2024-06-07,534.67,48,-232,11090657,-11742034,0.00295744427043411,99.989802227226,-0.707317073170732
339.96,340,62,78,372,312,2024-06-06,2024-07-12,534.67,16,-60,3646557,868777,0.00855601598987758,99.9774033423857,-0.192307692307692
399.99,400,305,305,305,305,2024-06-06,2024-06-07,534.67,0,0,11090657,-11742034,0.00275006250756831,99.9925522897336,0
385.04,386,3,3,288,288,2024-06-06,2024-10-18,534.67,0,0,52962163,-8353895,0.000543784437202839,99.9954023781091,0
388.57,390,2,2,286,286,2024-06-06,2024-11-15,534.67,0,0,10201073,1977879,0.00280362663809974,99.9924713802166,0
372.05,373,3,3,285,285,2024-06-06,2024-10-18,534.67,0,0,52962163,-8353895,0.000538120015981976,99.9959404981251,0
339.36,340,0,4,0,256,2024-06-06,2024-11-15,534.67,4,256,10201073,1977879,0.00250953992780956,99.9949809201444,1
385.8,387,2,2,240,240,2024-06-06,2024-10-18,534.67,0,0,52962163,-8353895,0.000453153697669032,99.9963936518227,0
204.98,205,114,114,228,228,2024-06-06,2024-08-16,534.67,0,0,116205577,-19412264,0.000196204008349789,99.999917387786,0
471.99,472,114,225,456,225,2024-06-06,2024-06-07,534.67,111,-231,11090657,-11742034,0.00202873463673072,99.9945810243703,-1.02666666666667
341.44,342,4,4,224,224,2024-06-06,2024-10-18,534.67,0,0,52962163,-8353895,0.000422943451157764,99.9968165952739,0
422.9,425,1,1,210,210,2024-06-06,2024-11-15,534.67,0,0,10201073,1977879,0.00205860697203128,99.9970395271164,0
328.5,329,4,4,200,200,2024-06-06,2024-10-18,534.67,0,0,52962163,-8353895,0.00037762808139086,99.9971942233553,0
357.35,358,3,3,195,195,2024-06-06,2024-10-18,534.67,0,0,52962163,-8353895,0.000368187379356089,99.9975624107346,0
264.76,265,0,8,0,192,2024-06-06,2024-11-15,534.67,8,192,10201073,1977879,0.00188215494585717,99.9989216820623,1
453.99,454,181,181,181,181,2024-06-06,2024-06-07,534.67,0,0,11090657,-11742034,0.00163200430777004,99.9962130286781,0
309.65,310,5,5,175,175,2024-06-06,2024-10-18,534.67,0,0,52962163,-8353895,0.000330424571217003,99.9978928353058,0
348.42,349,3,3,174,174,2024-06-06,2024-10-18,534.67,0,0,52962163,-8353895,0.000328536430810048,99.9982213717367,0
342.44,343,3,3,168,168,2024-06-06,2024-10-18,534.67,0,0,52962163,-8353895,0.000317207588368323,99.998538579325,0
434.99,435,191,162,573,162,2024-06-06,2024-06-14,534.67,-29,-411,23468414,-20040476,0.000690289509977112,99.9973411070727,-2.53703703703704
465.96,466,0,40,0,160,2024-06-06,2024-06-14,534.67,40,160,23468414,-20040476,0.000681767417261345,99.99802287449,1
370.2,371,2,2,160,160,2024-06-06,2024-10-18,534.67,0,0,52962163,-8353895,0.000302102465112688,99.9988406817901,0
451.99,452,153,153,153,153,2024-06-06,2024-06-07,534.67,0,0,11090657,-11742034,0.00137953955297689,99.9975925682311,0
333.5,334,3,3,150,150,2024-06-06,2024-10-18,534.67,0,0,52962163,-8353895,0.000283221061043145,99.9991239028512,0
259.98,260,74,74,148,148,2024-06-06,2024-07-12,534.67,0,0,3646557,868777,0.00405862296955731,99.9814619653553,0
359.94,360,8,24,96,144,2024-06-06,2024-07-12,534.67,16,48,3646557,868777,0.00394893045686657,99.9854108958121,0.333333333333333
455.96,456,0,35,0,140,2024-06-06,2024-06-14,534.67,35,140,23468414,-20040476,0.000596546490103677,99.9986194209801,1
309.97,310,41,43,123,129,2024-06-06,2024-07-12,534.67,2,6,3646557,868777,0.00353758353427631,99.9889484793464,0.0465116279069768
473.95,474,1,25,8,125,2024-06-06,2024-06-14,534.67,24,117,23468414,-20040476,0.000532630794735426,99.9991520517748,0.936
396.79,398,1,1,121,121,2024-06-06,2024-10-18,534.67,0,0,52962163,-8353895,0.00022846498924147,99.9993523678404,0
369.92,370,15,15,120,120,2024-06-06,2024-07-12,534.67,0,0,3646557,868777,0.00329077538072214,99.9922392547271,0
373.9,375,1,1,110,110,2024-06-06,2024-11-15,534.67,0,0,10201073,1977879,0.00107831793773067,100,0
377.98,379,1,1,102,102,2024-06-06,2024-10-18,534.67,0,0,52962163,-8353895,0.000192590321509339,99.9995449581619,0
379.91,380,8,11,88,99,2024-06-06,2024-07-12,534.67,3,11,3646557,868777,0.00271488968909577,99.9949541444162,0.111111111111111
429.99,430,98,98,98,98,2024-06-06,2024-06-07,534.67,0,0,11090657,-11742034,0.000883626641776046,99.9984761948729,0
450.99,451,98,98,98,98,2024-06-06,2024-06-07,534.67,0,0,11090657,-11742034,0.000883626641776046,99.9993598215146,0
319.97,320,8,32,32,96,2024-06-06,2024-07-12,534.67,24,64,3646557,868777,0.00263262030457772,99.9975867647208,0.666666666666667
214.97,215,32,32,96,96,2024-06-06,2024-08-16,534.67,0,0,116205577,-19412264,8.26122140420162e-05,100,0
382.1,383,1,1,90,90,2024-06-06,2024-10-18,534.67,0,0,52962163,-8353895,0.000169932636625887,99.9997148907985,0
329.96,330,22,22,88,88,2024-06-06,2024-07-12,534.67,0,0,3646557,868777,0.00241323527919624,100,0
359.99,360,61,61,61,61,2024-06-06,2024-06-07,534.67,0,0,11090657,-11742034,0.000550012501513661,99.9999098340161,0
374.97,375,17,17,51,51,2024-06-06,2024-06-14,534.67,0,0,23468414,-20040476,0.000217313364252054,99.999369365139,0
347.49,348,0,1,0,51,2024-06-06,2024-10-18,534.67,1,51,52962163,-8353895,9.62951607546693e-05,99.9998111859593,1
334.5,335,1,1,50,50,2024-06-06,2024-10-18,534.67,0,0,52962163,-8353895,9.4407020347715e-05,99.9999055929796,0
335.5,336,1,1,50,50,2024-06-06,2024-10-18,534.67,0,0,52962163,-8353895,9.4407020347715e-05,100,0
364.98,365,16,16,32,32,2024-06-06,2024-06-14,534.67,0,0,23468414,-20040476,0.000136353483452269,99.9995057186225,0
448.98,449,15,15,60,30,2024-06-06,2024-06-14,534.67,0,-30,23468414,-20040476,0.000127831390736502,99.9996335500132,-1
461.95,462,5,5,25,25,2024-06-06,2024-06-14,534.67,0,0,23468414,-20040476,0.000106526158947085,99.9997400761722,0
463.96,464,2,4,10,16,2024-06-06,2024-06-14,534.67,2,6,23468414,-20040476,6.81767417261345e-05,99.9998082529139,0.375
472.95,473,0,3,0,15,2024-06-06,2024-06-14,534.67,3,15,23468414,-20040476,6.39156953682511e-05,99.9998721686093,1
456.94,457,2,2,12,12,2024-06-06,2024-06-14,534.67,0,0,23468414,-20040476,5.11325562946009e-05,99.9999233011656,0
470.93,471,1,1,7,7,2024-06-06,2024-06-14,534.67,0,0,23468414,-20040476,2.98273245051839e-05,99.9999531284901,0
447.98,448,3,3,6,6,2024-06-06,2024-06-07,534.67,0,0,11090657,-11742034,5.40995903128192e-05,99.9999639336065,0
467.94,468,1,1,6,6,2024-06-06,2024-06-14,534.67,0,0,23468414,-20040476,2.55662781473005e-05,99.9999786947682,0
462.95,463,1,1,5,5,2024-06-06,2024-06-14,534.67,0,0,23468414,-20040476,2.1305231789417e-05,100,0
452.96,453,1,1,4,4,2024-06-06,2024-06-07,534.67,0,0,11090657,-11742034,3.60663935418794e-05,100,0
449,449,0,0,0,0,2024-06-06,2024-06-07,534.67,0,0,11090657,-11742034,0,100,
525.76,545,0,0,0,0,2024-06-06,2024-06-07,534.67,0,0,11090657,-11742034,0,100,
529.77,546,0,0,0,0,2024-06-06,2024-06-07,534.67,0,0,11090657,-11742034,0,100,
525.7,547,0,0,0,0,2024-06-06,2024-06-07,534.67,0,0,11090657,-11742034,0,100,
525.4,548,0,0,0,0,2024-06-06,2024-06-07,534.67,0,0,11090657,-11742034,0,100,
533.95,550,0,0,0,0,2024-06-06,2024-06-07,534.67,0,0,11090657,-11742034,0,100,
526,555,0,0,0,0,2024-06-06,2024-06-07,534.67,0,0,11090657,-11742034,0,100,
522.13,560,0,0,0,0,2024-06-06,2024-06-07,534.67,0,0,11090657,-11742034,0,100,
527.26,565,0,0,0,0,2024-06-06,2024-06-07,534.67,0,0,11090657,-11742034,0,100,
525.99,570,0,0,0,0,2024-06-06,2024-06-07,534.67,0,0,11090657,-11742034,0,100,
575,575,0,0,0,0,2024-06-06,2024-06-07,534.67,0,0,11090657,-11742034,0,100,
528.15,580,0,0,0,0,2024-06-06,2024-06-07,534.67,0,0,11090657,-11742034,0,100,
585,585,0,0,0,0,2024-06-06,2024-06-07,534.67,0,0,11090657,-11742034,0,100,
529.2,590,0,0,0,0,2024-06-06,2024-06-07,534.67,0,0,11090657,-11742034,0,100,
529.18,595,0,0,0,0,2024-06-06,2024-06-07,534.67,0,0,11090657,-11742034,0,100,
600,600,0,0,0,0,2024-06-06,2024-06-07,534.67,0,0,11090657,-11742034,0,100,
605,605,0,0,0,0,2024-06-06,2024-06-07,534.67,0,0,11090657,-11742034,0,100,
448,448,0,0,0,0,2024-06-06,2024-06-14,534.67,0,0,23468414,-20040476,0,100,
453,453,0,0,0,0,2024-06-06,2024-06-14,534.67,0,0,23468414,-20040476,0,100,
454,454,0,0,0,0,2024-06-06,2024-06-14,534.67,0,0,23468414,-20040476,0,100,
458,458,0,0,0,0,2024-06-06,2024-06-14,534.67,0,0,23468414,-20040476,0,100,
467,467,0,0,0,0,2024-06-06,2024-06-14,534.67,0,0,23468414,-20040476,0,100,
469,469,0,0,0,0,2024-06-06,2024-06-14,534.67,0,0,23468414,-20040476,0,100,
472,472,0,0,0,0,2024-06-06,2024-06-14,534.67,0,0,23468414,-20040476,0,100,
546,546,0,0,0,0,2024-06-06,2024-06-14,534.67,0,0,23468414,-20040476,0,100,
548,548,0,0,0,0,2024-06-06,2024-06-14,534.67,0,0,23468414,-20040476,0,100,
549,549,0,0,0,0,2024-06-06,2024-06-14,534.67,0,0,23468414,-20040476,0,100,
532.1,555,0,0,0,0,2024-06-06,2024-06-14,534.67,0,0,23468414,-20040476,0,100,
528.39,565,0,0,0,0,2024-06-06,2024-06-14,534.67,0,0,23468414,-20040476,0,100,
528.38,570,0,0,0,0,2024-06-06,2024-06-14,534.67,0,0,23468414,-20040476,0,100,
575,575,0,0,0,0,2024-06-06,2024-06-14,534.67,0,0,23468414,-20040476,0,100,
580,580,0,0,0,0,2024-06-06,2024-06-14,534.67,0,0,23468414,-20040476,0,100,
585,585,0,0,0,0,2024-06-06,2024-06-14,534.67,0,0,23468414,-20040476,0,100,
590,590,0,0,0,0,2024-06-06,2024-06-14,534.67,0,0,23468414,-20040476,0,100,
517.37,595,0,0,0,0,2024-06-06,2024-06-14,534.67,0,0,23468414,-20040476,0,100,
517.35,600,0,0,0,0,2024-06-06,2024-06-14,534.67,0,0,23468414,-20040476,0,100,
605,605,0,0,0,0,2024-06-06,2024-06-14,534.67,0,0,23468414,-20040476,0,100,
610,610,0,0,0,0,2024-06-06,2024-06-14,534.67,0,0,23468414,-20040476,0,100,
525.5,548,0,0,0,0,2024-06-06,2024-06-21,534.67,0,0,109509524,-65752697,0,100,
520.76,585,0,0,0,0,2024-06-06,2024-06-21,534.67,0,0,109509524,-65752697,0,100,
503.78,590,0,0,0,0,2024-06-06,2024-06-21,534.67,0,0,109509524,-65752697,0,100,
529.32,595,0,0,0,0,2024-06-06,2024-06-21,534.67,0,0,109509524,-65752697,0,100,
525.67,600,0,0,0,0,2024-06-06,2024-06-21,534.67,0,0,109509524,-65752697,0,100,
525.66,605,0,0,0,0,2024-06-06,2024-06-21,534.67,0,0,109509524,-65752697,0,100,
528.55,610,0,0,0,0,2024-06-06,2024-06-21,534.67,0,0,109509524,-65752697,0,100,
519.19,615,0,0,0,0,2024-06-06,2024-06-21,534.67,0,0,109509524,-65752697,0,100,
517.45,620,0,0,0,0,2024-06-06,2024-06-21,534.67,0,0,109509524,-65752697,0,100,
434.09,625,0,0,0,0,2024-06-06,2024-06-21,534.67,0,0,109509524,-65752697,0,100,
509.24,630,0,0,0,0,2024-06-06,2024-06-21,534.67,0,0,109509524,-65752697,0,100,
517.47,635,0,0,0,0,2024-06-06,2024-06-21,534.67,0,0,109509524,-65752697,0,100,
499.02,640,0,0,0,0,2024-06-06,2024-06-21,534.67,0,0,109509524,-65752697,0,100,
433.93,645,0,0,0,0,2024-06-06,2024-06-21,534.67,0,0,109509524,-65752697,0,100,
508.54,650,0,0,0,0,2024-06-06,2024-06-21,534.67,0,0,109509524,-65752697,0,100,
434.02,655,0,0,0,0,2024-06-06,2024-06-21,534.67,0,0,109509524,-65752697,0,100,
433.52,660,0,0,0,0,2024-06-06,2024-06-21,534.67,0,0,109509524,-65752697,0,100,
433.78,665,0,0,0,0,2024-06-06,2024-06-21,534.67,0,0,109509524,-65752697,0,100,
433.8,670,0,0,0,0,2024-06-06,2024-06-21,534.67,0,0,109509524,-65752697,0,100,
510.44,675,0,0,0,0,2024-06-06,2024-06-21,534.67,0,0,109509524,-65752697,0,100,
530.05,680,0,0,0,0,2024-06-06,2024-06-21,534.67,0,0,109509524,-65752697,0,100,
522.76,547,0,0,0,0,2024-06-06,2024-06-28,534.67,0,0,66054797,-39996766,0,100,
525.9,551,0,0,0,0,2024-06-06,2024-06-28,534.67,0,0,66054797,-39996766,0,100,
552,552,0,0,0,0,2024-06-06,2024-06-28,534.67,0,0,66054797,-39996766,0,100,
553,553,0,0,0,0,2024-06-06,2024-06-28,534.67,0,0,66054797,-39996766,0,100,
554,554,0,0,0,0,2024-06-06,2024-06-28,534.67,0,0,66054797,-39996766,0,100,
501.26,556,0,0,0,0,2024-06-06,2024-06-28,534.67,0,0,66054797,-39996766,0,100,
558,558,0,0,0,0,2024-06-06,2024-06-28,534.67,0,0,66054797,-39996766,0,100,
559,559,0,0,0,0,2024-06-06,2024-06-28,534.67,0,0,66054797,-39996766,0,100,
531.13,560,0,0,0,0,2024-06-06,2024-06-28,534.67,0,0,66054797,-39996766,0,100,
561,561,0,0,0,0,2024-06-06,2024-06-28,534.67,0,0,66054797,-39996766,0,100,
562,562,0,0,0,0,2024-06-06,2024-06-28,534.67,0,0,66054797,-39996766,0,100,
563,563,0,0,0,0,2024-06-06,2024-06-28,534.67,0,0,66054797,-39996766,0,100,
530.25,564,0,0,0,0,2024-06-06,2024-06-28,534.67,0,0,66054797,-39996766,0,100,
565,565,0,0,0,0,2024-06-06,2024-06-28,534.67,0,0,66054797,-39996766,0,100,
566,566,0,0,0,0,2024-06-06,2024-06-28,534.67,0,0,66054797,-39996766,0,100,
567,567,0,0,0,0,2024-06-06,2024-06-28,534.67,0,0,66054797,-39996766,0,100,
568,568,0,0,0,0,2024-06-06,2024-06-28,534.67,0,0,66054797,-39996766,0,100,
569,569,0,0,0,0,2024-06-06,2024-06-28,534.67,0,0,66054797,-39996766,0,100,
516.8,570,0,0,0,0,2024-06-06,2024-06-28,534.67,0,0,66054797,-39996766,0,100,
575,575,0,0,0,0,2024-06-06,2024-06-28,534.67,0,0,66054797,-39996766,0,100,
580,580,0,0,0,0,2024-06-06,2024-06-28,534.67,0,0,66054797,-39996766,0,100,
585,585,0,0,0,0,2024-06-06,2024-06-28,534.67,0,0,66054797,-39996766,0,100,
590,590,0,0,0,0,2024-06-06,2024-06-28,534.67,0,0,66054797,-39996766,0,100,
595,595,0,0,0,0,2024-06-06,2024-06-28,534.67,0,0,66054797,-39996766,0,100,
605,605,0,0,0,0,2024-06-06,2024-06-28,534.67,0,0,66054797,-39996766,0,100,
610,610,0,0,0,0,2024-06-06,2024-06-28,534.67,0,0,66054797,-39996766,0,100,
555,555,0,0,0,0,2024-06-06,2024-07-05,534.67,0,0,14823040,-3756140,0,100,
565,565,0,0,0,0,2024-06-06,2024-07-05,534.67,0,0,14823040,-3756140,0,100,
570,570,0,0,0,0,2024-06-06,2024-07-05,534.67,0,0,14823040,-3756140,0,100,
575,575,0,0,0,0,2024-06-06,2024-07-05,534.67,0,0,14823040,-3756140,0,100,
580,580,0,0,0,0,2024-06-06,2024-07-05,534.67,0,0,14823040,-3756140,0,100,
590,590,0,0,0,0,2024-06-06,2024-07-05,534.67,0,0,14823040,-3756140,0,100,
595,595,0,0,0,0,2024-06-06,2024-07-05,534.67,0,0,14823040,-3756140,0,100,
600,600,0,0,0,0,2024-06-06,2024-07-05,534.67,0,0,14823040,-3756140,0,100,
605,605,0,0,0,0,2024-06-06,2024-07-05,534.67,0,0,14823040,-3756140,0,100,
610,610,0,0,0,0,2024-06-06,2024-07-05,534.67,0,0,14823040,-3756140,0,100,
280,280,0,0,0,0,2024-06-06,2024-07-12,534.67,0,0,3646557,868777,0,100,
541,541,0,0,0,0,2024-06-06,2024-07-12,534.67,0,0,3646557,868777,0,100,
542,542,0,0,0,0,2024-06-06,2024-07-12,534.67,0,0,3646557,868777,0,100,
543,543,0,0,0,0,2024-06-06,2024-07-12,534.67,0,0,3646557,868777,0,100,
560,560,0,0,0,0,2024-06-06,2024-07-12,534.67,0,0,3646557,868777,0,100,
565,565,0,0,0,0,2024-06-06,2024-07-12,534.67,0,0,3646557,868777,0,100,
570,570,0,0,0,0,2024-06-06,2024-07-12,534.67,0,0,3646557,868777,0,100,
580,580,0,0,0,0,2024-06-06,2024-07-12,534.67,0,0,3646557,868777,0,100,
585,585,0,0,0,0,2024-06-06,2024-07-12,534.67,0,0,3646557,868777,0,100,
590,590,0,0,0,0,2024-06-06,2024-07-12,534.67,0,0,3646557,868777,0,100,
595,595,0,0,0,0,2024-06-06,2024-07-12,534.67,0,0,3646557,868777,0,100,
600,600,0,0,0,0,2024-06-06,2024-07-12,534.67,0,0,3646557,868777,0,100,
605,605,0,0,0,0,2024-06-06,2024-07-12,534.67,0,0,3646557,868777,0,100,
610,610,0,0,0,0,2024-06-06,2024-07-12,534.67,0,0,3646557,868777,0,100,
527.41,548,0,0,0,0,2024-06-06,2024-07-19,534.67,0,0,162615922,-53541395,0,100,
549,549,0,0,0,0,2024-06-06,2024-07-19,534.67,0,0,162615922,-53541395,0,100,
525.74,570,0,0,0,0,2024-06-06,2024-07-19,534.67,0,0,162615922,-53541395,0,100,
585,585,0,0,0,0,2024-06-06,2024-07-19,534.67,0,0,162615922,-53541395,0,100,
511,590,0,0,0,0,2024-06-06,2024-07-19,534.67,0,0,162615922,-53541395,0,100,
513.9,595,0,0,0,0,2024-06-06,2024-07-19,534.67,0,0,162615922,-53541395,0,100,
529.71,605,0,0,0,0,2024-06-06,2024-07-19,534.67,0,0,162615922,-53541395,0,100,
610,610,0,0,0,0,2024-06-06,2024-07-19,534.67,0,0,162615922,-53541395,0,100,
523.73,615,0,0,0,0,2024-06-06,2024-07-19,534.67,0,0,162615922,-53541395,0,100,
530.06,620,0,0,0,0,2024-06-06,2024-07-19,534.67,0,0,162615922,-53541395,0,100,
625,625,0,0,0,0,2024-06-06,2024-07-19,534.67,0,0,162615922,-53541395,0,100,
630,630,0,0,0,0,2024-06-06,2024-07-19,534.67,0,0,162615922,-53541395,0,100,
529.37,640,0,0,0,0,2024-06-06,2024-07-19,534.67,0,0,162615922,-53541395,0,100,
645,645,0,0,0,0,2024-06-06,2024-07-19,534.67,0,0,162615922,-53541395,0,100,
650,650,0,0,0,0,2024-06-06,2024-07-19,534.67,0,0,162615922,-53541395,0,100,
531.18,565,0,0,0,0,2024-06-06,2024-08-16,534.67,0,0,116205577,-19412264,0,100,
528.74,570,0,0,0,0,2024-06-06,2024-08-16,534.67,0,0,116205577,-19412264,0,100,
514.41,575,0,0,0,0,2024-06-06,2024-08-16,534.67,0,0,116205577,-19412264,0,100,
585,585,0,0,0,0,2024-06-06,2024-08-16,534.67,0,0,116205577,-19412264,0,100,
590,590,0,0,0,0,2024-06-06,2024-08-16,534.67,0,0,116205577,-19412264,0,100,
516.43,595,0,0,0,0,2024-06-06,2024-08-16,534.67,0,0,116205577,-19412264,0,100,
527.67,600,0,0,0,0,2024-06-06,2024-08-16,534.67,0,0,116205577,-19412264,0,100,
529.7,605,0,0,0,0,2024-06-06,2024-08-16,534.67,0,0,116205577,-19412264,0,100,
610,610,0,0,0,0,2024-06-06,2024-08-16,534.67,0,0,116205577,-19412264,0,100,
529.26,620,0,0,0,0,2024-06-06,2024-08-16,534.67,0,0,116205577,-19412264,0,100,
528.48,625,0,0,0,0,2024-06-06,2024-08-16,534.67,0,0,116205577,-19412264,0,100,
514.22,630,0,0,0,0,2024-06-06,2024-08-16,534.67,0,0,116205577,-19412264,0,100,
504.99,635,0,0,0,0,2024-06-06,2024-08-16,534.67,0,0,116205577,-19412264,0,100,
512.31,640,0,0,0,0,2024-06-06,2024-08-16,534.67,0,0,116205577,-19412264,0,100,
645,645,0,0,0,0,2024-06-06,2024-08-16,534.67,0,0,116205577,-19412264,0,100,
650,650,0,0,0,0,2024-06-06,2024-08-16,534.67,0,0,116205577,-19412264,0,100,
526.6,570,0,0,0,0,2024-06-06,2024-09-20,534.67,0,0,244715238,-48165897,0,100,
522.01,575,0,0,0,0,2024-06-06,2024-09-20,534.67,0,0,244715238,-48165897,0,100,
580,580,0,0,0,0,2024-06-06,2024-09-20,534.67,0,0,244715238,-48165897,0,100,
529.3,585,0,0,0,0,2024-06-06,2024-09-20,534.67,0,0,244715238,-48165897,0,100,
590,590,0,0,0,0,2024-06-06,2024-09-20,534.67,0,0,244715238,-48165897,0,100,
595,595,0,0,0,0,2024-06-06,2024-09-20,534.67,0,0,244715238,-48165897,0,100,
503.9,600,0,0,0,0,2024-06-06,2024-09-20,534.67,0,0,244715238,-48165897,0,100,
504.79,605,0,0,0,0,2024-06-06,2024-09-20,534.67,0,0,244715238,-48165897,0,100,
610,610,0,0,0,0,2024-06-06,2024-09-20,534.67,0,0,244715238,-48165897,0,100,
615,615,0,0,0,0,2024-06-06,2024-09-20,534.67,0,0,244715238,-48165897,0,100,
620,620,0,0,0,0,2024-06-06,2024-09-20,534.67,0,0,244715238,-48165897,0,100,
498,625,0,0,0,0,2024-06-06,2024-09-20,534.67,0,0,244715238,-48165897,0,100,
630,630,0,0,0,0,2024-06-06,2024-09-20,534.67,0,0,244715238,-48165897,0,100,
635,635,0,0,0,0,2024-06-06,2024-09-20,534.67,0,0,244715238,-48165897,0,100,
435.01,640,0,0,0,0,2024-06-06,2024-09-20,534.67,0,0,244715238,-48165897,0,100,
645,645,0,0,0,0,2024-06-06,2024-09-20,534.67,0,0,244715238,-48165897,0,100,
434.57,650,0,0,0,0,2024-06-06,2024-09-20,534.67,0,0,244715238,-48165897,0,100,
434.75,655,0,0,0,0,2024-06-06,2024-09-20,534.67,0,0,244715238,-48165897,0,100,
660,660,0,0,0,0,2024-06-06,2024-09-20,534.67,0,0,244715238,-48165897,0,100,
435,665,0,0,0,0,2024-06-06,2024-09-20,534.67,0,0,244715238,-48165897,0,100,
434.73,670,0,0,0,0,2024-06-06,2024-09-20,534.67,0,0,244715238,-48165897,0,100,
434.51,675,0,0,0,0,2024-06-06,2024-09-20,534.67,0,0,244715238,-48165897,0,100,
434.79,680,0,0,0,0,2024-06-06,2024-09-20,534.67,0,0,244715238,-48165897,0,100,
450.5,685,0,0,0,0,2024-06-06,2024-09-20,534.67,0,0,244715238,-48165897,0,100,
434.75,690,0,0,0,0,2024-06-06,2024-09-20,534.67,0,0,244715238,-48165897,0,100,
434.68,695,0,0,0,0,2024-06-06,2024-09-20,534.67,0,0,244715238,-48165897,0,100,
530,700,0,0,0,0,2024-06-06,2024-09-20,534.67,0,0,244715238,-48165897,0,100,
326,326,0,0,0,0,2024-06-06,2024-10-18,534.67,0,0,52962163,-8353895,0,100,
327,327,0,0,0,0,2024-06-06,2024-10-18,534.67,0,0,52962163,-8353895,0,100,
328,328,0,0,0,0,2024-06-06,2024-10-18,534.67,0,0,52962163,-8353895,0,100,
337,337,0,0,0,0,2024-06-06,2024-10-18,534.67,0,0,52962163,-8353895,0,100,
338,338,0,0,0,0,2024-06-06,2024-10-18,534.67,0,0,52962163,-8353895,0,100,
341,341,0,0,0,0,2024-06-06,2024-10-18,534.67,0,0,52962163,-8353895,0,100,
344,344,0,0,0,0,2024-06-06,2024-10-18,534.67,0,0,52962163,-8353895,0,100,
347,347,0,0,0,0,2024-06-06,2024-10-18,534.67,0,0,52962163,-8353895,0,100,
351,351,0,0,0,0,2024-06-06,2024-10-18,534.67,0,0,52962163,-8353895,0,100,
352,352,0,0,0,0,2024-06-06,2024-10-18,534.67,0,0,52962163,-8353895,0,100,
353,353,0,0,0,0,2024-06-06,2024-10-18,534.67,0,0,52962163,-8353895,0,100,
354,354,0,0,0,0,2024-06-06,2024-10-18,534.67,0,0,52962163,-8353895,0,100,
355,355,0,0,0,0,2024-06-06,2024-10-18,534.67,0,0,52962163,-8353895,0,100,
357,357,0,0,0,0,2024-06-06,2024-10-18,534.67,0,0,52962163,-8353895,0,100,
361,361,0,0,0,0,2024-06-06,2024-10-18,534.67,0,0,52962163,-8353895,0,100,
362,362,0,0,0,0,2024-06-06,2024-10-18,534.67,0,0,52962163,-8353895,0,100,
363,363,0,0,0,0,2024-06-06,2024-10-18,534.67,0,0,52962163,-8353895,0,100,
367,367,0,0,0,0,2024-06-06,2024-10-18,534.67,0,0,52962163,-8353895,0,100,
374,374,0,0,0,0,2024-06-06,2024-10-18,534.67,0,0,52962163,-8353895,0,100,
378,378,0,0,0,0,2024-06-06,2024-10-18,534.67,0,0,52962163,-8353895,0,100,
385,385,0,0,0,0,2024-06-06,2024-10-18,534.67,0,0,52962163,-8353895,0,100,
424,424,0,0,0,0,2024-06-06,2024-10-18,534.67,0,0,52962163,-8353895,0,100,
525.55,565,0,0,0,0,2024-06-06,2024-10-18,534.67,0,0,52962163,-8353895,0,100,
528.74,575,0,0,0,0,2024-06-06,2024-10-18,534.67,0,0,52962163,-8353895,0,100,
521.88,585,0,0,0,0,2024-06-06,2024-10-18,534.67,0,0,52962163,-8353895,0,100,
590,590,0,0,0,0,2024-06-06,2024-10-18,534.67,0,0,52962163,-8353895,0,100,
595,595,0,0,0,0,2024-06-06,2024-10-18,534.67,0,0,52962163,-8353895,0,100,
600,600,0,0,0,0,2024-06-06,2024-10-18,534.67,0,0,52962163,-8353895,0,100,
605,605,0,0,0,0,2024-06-06,2024-10-18,534.67,0,0,52962163,-8353895,0,100,
610,610,0,0,0,0,2024-06-06,2024-10-18,534.67,0,0,52962163,-8353895,0,100,
615,615,0,0,0,0,2024-06-06,2024-10-18,534.67,0,0,52962163,-8353895,0,100,
620,620,0,0,0,0,2024-06-06,2024-10-18,534.67,0,0,52962163,-8353895,0,100,
625,625,0,0,0,0,2024-06-06,2024-10-18,534.67,0,0,52962163,-8353895,0,100,
630,630,0,0,0,0,2024-06-06,2024-10-18,534.67,0,0,52962163,-8353895,0,100,
635,635,0,0,0,0,2024-06-06,2024-10-18,534.67,0,0,52962163,-8353895,0,100,
640,640,0,0,0,0,2024-06-06,2024-10-18,534.67,0,0,52962163,-8353895,0,100,
645,645,0,0,0,0,2024-06-06,2024-10-18,534.67,0,0,52962163,-8353895,0,100,
521.61,650,0,0,0,0,2024-06-06,2024-10-18,534.67,0,0,52962163,-8353895,0,100,
655,655,0,0,0,0,2024-06-06,2024-10-18,534.67,0,0,52962163,-8353895,0,100,
660,660,0,0,0,0,2024-06-06,2024-10-18,534.67,0,0,52962163,-8353895,0,100,
665,665,0,0,0,0,2024-06-06,2024-10-18,534.67,0,0,52962163,-8353895,0,100,
670,670,0,0,0,0,2024-06-06,2024-10-18,534.67,0,0,52962163,-8353895,0,100,
675,675,0,0,0,0,2024-06-06,2024-10-18,534.67,0,0,52962163,-8353895,0,100,
680,680,0,0,0,0,2024-06-06,2024-10-18,534.67,0,0,52962163,-8353895,0,100,
270,270,0,0,0,0,2024-06-06,2024-11-15,534.67,0,0,10201073,1977879,0,100,
275,275,0,0,0,0,2024-06-06,2024-11-15,534.67,0,0,10201073,1977879,0,100,
280,280,0,0,0,0,2024-06-06,2024-11-15,534.67,0,0,10201073,1977879,0,100,
285,285,0,0,0,0,2024-06-06,2024-11-15,534.67,0,0,10201073,1977879,0,100,
290,290,0,0,0,0,2024-06-06,2024-11-15,534.67,0,0,10201073,1977879,0,100,
295,295,0,0,0,0,2024-06-06,2024-11-15,534.67,0,0,10201073,1977879,0,100,
300,300,0,0,0,0,2024-06-06,2024-11-15,534.67,0,0,10201073,1977879,0,100,
305,305,0,0,0,0,2024-06-06,2024-11-15,534.67,0,0,10201073,1977879,0,100,
320,320,0,0,0,0,2024-06-06,2024-11-15,534.67,0,0,10201073,1977879,0,100,
325,325,0,0,0,0,2024-06-06,2024-11-15,534.67,0,0,10201073,1977879,0,100,
345,345,0,0,0,0,2024-06-06,2024-11-15,534.67,0,0,10201073,1977879,0,100,
355,355,0,0,0,0,2024-06-06,2024-11-15,534.67,0,0,10201073,1977879,0,100,
370,370,0,0,0,0,2024-06-06,2024-11-15,534.67,0,0,10201073,1977879,0,100,
380,380,0,0,0,0,2024-06-06,2024-11-15,534.67,0,0,10201073,1977879,0,100,
395,395,0,0,0,0,2024-06-06,2024-11-15,534.67,0,0,10201073,1977879,0,100,
405,405,0,0,0,0,2024-06-06,2024-11-15,534.67,0,0,10201073,1977879,0,100,
435,435,0,0,0,0,2024-06-06,2024-11-15,534.67,0,0,10201073,1977879,0,100,
523.24,560,0,0,0,0,2024-06-06,2024-11-15,534.67,0,0,10201073,1977879,0,100,
523.62,575,0,0,0,0,2024-06-06,2024-11-15,534.67,0,0,10201073,1977879,0,100,
580,580,0,0,0,0,2024-06-06,2024-11-15,534.67,0,0,10201073,1977879,0,100,
585,585,0,0,0,0,2024-06-06,2024-11-15,534.67,0,0,10201073,1977879,0,100,
595,595,0,0,0,0,2024-06-06,2024-11-15,534.67,0,0,10201073,1977879,0,100,
600,600,0,0,0,0,2024-06-06,2024-11-15,534.67,0,0,10201073,1977879,0,100,
605,605,0,0,0,0,2024-06-06,2024-11-15,534.67,0,0,10201073,1977879,0,100,
610,610,0,0,0,0,2024-06-06,2024-11-15,534.67,0,0,10201073,1977879,0,100,
615,615,0,0,0,0,2024-06-06,2024-11-15,534.67,0,0,10201073,1977879,0,100,
620,620,0,0,0,0,2024-06-06,2024-11-15,534.67,0,0,10201073,1977879,0,100,
625,625,0,0,0,0,2024-06-06,2024-11-15,534.67,0,0,10201073,1977879,0,100,
630,630,0,0,0,0,2024-06-06,2024-11-15,534.67,0,0,10201073,1977879,0,100,
635,635,0,0,0,0,2024-06-06,2024-11-15,534.67,0,0,10201073,1977879,0,100,
640,640,0,0,0,0,2024-06-06,2024-11-15,534.67,0,0,10201073,1977879,0,100,
645,645,0,0,0,0,2024-06-06,2024-11-15,534.67,0,0,10201073,1977879,0,100,
650,650,0,0,0,0,2024-06-06,2024-11-15,534.67,0,0,10201073,1977879,0,100,
655,655,0,0,0,0,2024-06-06,2024-11-15,534.67,0,0,10201073,1977879,0,100,
660,660,0,0,0,0,2024-06-06,2024-11-15,534.67,0,0,10201073,1977879,0,100,
665,665,0,0,0,0,2024-06-06,2024-11-15,534.67,0,0,10201073,1977879,0,100,
670,670,0,0,0,0,2024-06-06,2024-11-15,534.67,0,0,10201073,1977879,0,100,
675,675,0,0,0,0,2024-06-06,2024-11-15,534.67,0,0,10201073,1977879,0,100,
680,680,0,0,0,0,2024-06-06,2024-11-15,534.67,0,0,10201073,1977879,0,100,
505.75,585,0,0,0,0,2024-06-06,2024-12-20,534.67,0,0,383807022,-51896645,0,100,
532.25,590,1,0,6630,0,2024-06-06,2024-12-20,534.67,-1,-6630,383807022,-51896645,0,100,-Inf
505.66,605,0,0,0,0,2024-06-06,2024-12-20,534.67,0,0,383807022,-51896645,0,100,
513.01,610,0,0,0,0,2024-06-06,2024-12-20,534.67,0,0,383807022,-51896645,0,100,
519.93,615,0,0,0,0,2024-06-06,2024-12-20,534.67,0,0,383807022,-51896645,0,100,
529.15,625,0,0,0,0,2024-06-06,2024-12-20,534.67,0,0,383807022,-51896645,0,100,
501.25,630,0,0,0,0,2024-06-06,2024-12-20,534.67,0,0,383807022,-51896645,0,100,
514.35,635,0,0,0,0,2024-06-06,2024-12-20,534.67,0,0,383807022,-51896645,0,100,
484.92,640,0,0,0,0,2024-06-06,2024-12-20,534.67,0,0,383807022,-51896645,0,100,
493.79,645,0,0,0,0,2024-06-06,2024-12-20,534.67,0,0,383807022,-51896645,0,100,
497.5,650,0,0,0,0,2024-06-06,2024-12-20,534.67,0,0,383807022,-51896645,0,100,
453.98,655,0,0,0,0,2024-06-06,2024-12-20,534.67,0,0,383807022,-51896645,0,100,
418.16,660,0,0,0,0,2024-06-06,2024-12-20,534.67,0,0,383807022,-51896645,0,100,
665,665,0,0,0,0,2024-06-06,2024-12-20,534.67,0,0,383807022,-51896645,0,100,
670,670,0,0,0,0,2024-06-06,2024-12-20,534.67,0,0,383807022,-51896645,0,100,
675,675,0,0,0,0,2024-06-06,2024-12-20,534.67,0,0,383807022,-51896645,0,100,
680,680,0,0,0,0,2024-06-06,2024-12-20,534.67,0,0,383807022,-51896645,0,100,
685,685,0,0,0,0,2024-06-06,2024-12-20,534.67,0,0,383807022,-51896645,0,100,
690,690,0,0,0,0,2024-06-06,2024-12-20,534.67,0,0,383807022,-51896645,0,100,
493.35,695,0,0,0,0,2024-06-06,2024-12-20,534.67,0,0,383807022,-51896645,0,100,
498.41,700,0,0,0,0,2024-06-06,2024-12-20,534.67,0,0,383807022,-51896645,0,100,
705,705,0,0,0,0,2024-06-06,2024-12-20,534.67,0,0,383807022,-51896645,0,100,
418.57,710,0,0,0,0,2024-06-06,2024-12-20,534.67,0,0,383807022,-51896645,0,100,
494.27,715,0,0,0,0,2024-06-06,2024-12-20,534.67,0,0,383807022,-51896645,0,100,
521.91,725,0,0,0,0,2024-06-06,2024-12-20,534.67,0,0,383807022,-51896645,0,100,
730,730,0,0,0,0,2024-06-06,2024-12-20,534.67,0,0,383807022,-51896645,0,100,
735,735,0,0,0,0,2024-06-06,2024-12-20,534.67,0,0,383807022,-51896645,0,100,
740,740,0,0,0,0,2024-06-06,2024-12-20,534.67,0,0,383807022,-51896645,0,100,
512.87,745,0,0,0,0,2024-06-06,2024-12-20,534.67,0,0,383807022,-51896645,0,100,
750,750,0,0,0,0,2024-06-06,2024-12-20,534.67,0,0,383807022,-51896645,0,100,
755,755,0,0,0,0,2024-06-06,2024-12-20,534.67,0,0,383807022,-51896645,0,100,
760,760,0,0,0,0,2024-06-06,2024-12-20,534.67,0,0,383807022,-51896645,0,100,
765,765,0,0,0,0,2024-06-06,2024-12-20,534.67,0,0,383807022,-51896645,0,100,
770,770,0,0,0,0,2024-06-06,2024-12-20,534.67,0,0,383807022,-51896645,0,100,
