Watch,strike,open_interest.yt,open_interest.td,OI_Dollar.yt,OI_Dollar.td,Date.td,expiry,stkClose,diff_oi,diff_oi_d,totalOI,totalOIdiff,OI_pct,cum_sep_OI,pct
640.98,650,48440,49091,59871840,44280082,2025-10-21,2025-12-19,671.3,651,-15591758,452890228,-117820487,9.77722177745906,9.77722177745906,-0.352116737272528
648.75,660,33773,33928,50727046,38169000,2025-10-21,2025-12-19,671.3,155,-12558046,452890228,-117820487,8.42787007539496,18.205091852854,-0.329011658675889
644.74,650,56877,60116,47662926,31621016,2025-10-21,2025-11-21,671.3,3239,-16041910,432623087,-236699682,7.30913743398997,7.30913743398997,-0.507317981180618
636.05,640,69615,71669,44762445,28309255,2025-10-21,2025-11-21,671.3,2054,-16453190,432623087,-236699682,6.5436302062169,13.8527676402069,-0.581194736491653
632.65,640,36943,38382,37681860,28210770,2025-10-21,2025-12-19,671.3,1439,-9471090,452890228,-117820487,6.22905248465639,24.4341443375104,-0.335726036545617
614.94,620,53157,53813,37954098,27229378,2025-10-21,2025-12-19,671.3,656,-10724720,452890228,-117820487,6.01235714893809,30.4465014864485,-0.393865772475596
660.17,670,26962,27279,38987052,26815257,2025-10-21,2025-11-21,671.3,317,-12171795,432623087,-236699682,6.19829542291625,20.0510630631231,-0.453913046591349
652.88,660,34116,36699,37254672,26129688,2025-10-21,2025-11-21,671.3,2583,-11124984,432623087,-236699682,6.03982745839914,26.0908905215223,-0.425760307585762
619.44,625,44112,46200,34892592,25687200,2025-10-21,2025-12-19,671.3,2088,-9205392,452890228,-117820487,5.67183798896186,36.1183394754104,-0.35836494440811
623.87,630,37164,37823,31700892,23185499,2025-10-21,2025-12-19,671.3,659,-8515393,452890228,-117820487,5.11945225720348,41.2377917326138,-0.367272362781582
655.93,670,13604,15163,25099380,21334341,2025-10-21,2025-12-19,671.3,1559,-3765039,452890228,-117820487,4.71070905950305,45.9485007921169,-0.176477867303237
605.82,610,50222,50376,30032756,21057168,2025-10-21,2025-12-19,671.3,154,-8975588,452890228,-117820487,4.64950813643963,50.5980089285565,-0.42624858195556
626.98,630,66731,66966,33498962,20223732,2025-10-21,2025-11-21,671.3,235,-13275230,432623087,-236699682,4.67467701278735,30.7655675343096,-0.656418409816744
553.3,555,14573,114599,4226170,19481830,2025-10-21,2025-12-19,671.3,100026,15255660,452890228,-117820487,4.30166711391265,54.8996760424692,0.783071200190126
504.08,505,11557,211657,2034032,19472444,2025-10-21,2025-12-19,671.3,200100,17438412,452890228,-117820487,4.2995946470278,59.199270689497,0.895543055612331
661.92,680,10132,9146,23911520,16535968,2025-10-21,2025-12-19,671.3,-986,-7375552,452890228,-117820487,3.65120883111658,62.8504795206136,-0.446030858308386
656.68,660,55836,49427,38638512,16409764,2025-10-21,2025-10-31,671.3,-6409,-22228748,118384054,-132327608,13.861464821943,13.861464821943,-1.35460497786562
622.35,625,61525,61688,27194050,16347320,2025-10-21,2025-11-21,671.3,163,-10846730,432623087,-236699682,3.77865178517392,34.5442193194835,-0.663517322717118
596.51,600,43516,42982,21888548,15000718,2025-10-21,2025-12-19,671.3,-534,-6887830,452890228,-117820487,3.31221940165156,66.1626989222651,-0.459166687887873
636.85,645,17706,17774,19883838,14485810,2025-10-21,2025-12-19,671.3,68,-5398028,452890228,-117820487,3.19852562594925,69.3612245482144,-0.372642468733195
644.94,655,13854,13973,18827586,14056838,2025-10-21,2025-12-19,671.3,119,-4770748,452890228,-117820487,3.10380686774279,72.4650314159572,-0.339389840019498
655.25,660,13045,29154,11062160,13848150,2025-10-21,2025-11-07,671.3,16109,2785990,75641782,-43457618,18.3075406658188,18.3075406658188,0.201181385239184
640.39,645,28602,29090,21079674,13410490,2025-10-21,2025-11-21,671.3,488,-7669184,432623087,-236699682,3.09980914171601,37.6440284611995,-0.571879476439712
648.9,655,20512,21924,19609472,13373640,2025-10-21,2025-11-21,671.3,1412,-6235832,432623087,-236699682,3.0912913346208,40.7353197958203,-0.466277842083382
617.63,620,51758,54395,20340894,12891615,2025-10-21,2025-11-21,671.3,2637,-7449279,432623087,-236699682,2.97987217681705,43.7151919726374,-0.577839083776548
631.55,635,36997,36959,21051293,12750855,2025-10-21,2025-11-21,671.3,-38,-8300438,432623087,-236699682,2.94733577174997,46.6625277443874,-0.650971091742476
656.64,665,13978,14498,17542390,12120328,2025-10-21,2025-11-21,671.3,520,-5422062,432623087,-236699682,2.80159066037084,49.4641184047582,-0.447352744909214
519.43,520,201191,201694,18308381,11496558,2025-10-21,2025-11-28,671.3,503,-6811823,134798008,-74418053,8.52872989042983,8.52872989042983,-0.592509775534556
568.9,570,101583,101690,17777025,11185900,2025-10-21,2025-11-28,671.3,107,-6591125,134798008,-74418053,8.29826802781834,16.8269979182482,-0.589235108484789
608.17,610,56084,55634,17666460,10181022,2025-10-21,2025-11-21,671.3,-450,-7485438,432623087,-236699682,2.35332378366576,51.8174421884239,-0.735234439135875
643.87,650,15530,15742,14209950,9649846,2025-10-21,2025-11-28,671.3,212,-4560104,134798008,-74418053,7.15874525386162,23.9857431721098,-0.472557178632695
577.47,580,36500,37177,13140000,9405781,2025-10-21,2025-12-19,671.3,677,-3734219,452890228,-117820487,2.07683460990905,74.5418660258662,-0.397013177321479
634.2,638,24437,24457,15395310,9293660,2025-10-21,2025-11-21,671.3,20,-6101650,432623087,-236699682,2.14821175273986,53.9656539411638,-0.656538973881119
564.19,565,113877,113923,15259518,9227763,2025-10-21,2025-11-21,671.3,46,-6031755,432623087,-236699682,2.13297978709121,56.098633728255,-0.653653003441896
610.38,615,19077,19493,12476358,9005766,2025-10-21,2025-12-19,671.3,416,-3470592,452890228,-117820487,1.98850967479917,76.5303757006654,-0.385374436777505
598.52,600,60513,60240,15309789,8915520,2025-10-21,2025-11-21,671.3,-273,-6394269,432623087,-236699682,2.06080541420574,58.1594391424607,-0.717206511790675
635.11,639,709,22532,468649,8764948,2025-10-21,2025-11-21,671.3,21823,8296299,432623087,-236699682,2.02600098408525,60.185440126546,0.946531456889419
648.07,650,42648,45286,19447488,8740198,2025-10-21,2025-10-31,671.3,2638,-10707290,118384054,-132327608,7.38291831094076,21.2443831328838,-1.22506263588079
514.58,515,206431,206525,14450170,8674050,2025-10-21,2025-11-21,671.3,94,-5776120,432623087,-236699682,2.00499008505295,62.1904302115989,-0.665908082153089
652.49,665,6071,6256,10102144,7826256,2025-10-21,2025-12-19,671.3,185,-2275888,452890228,-117820487,1.7280690807928,78.2584447814582,-0.290801629795908
499.66,500,223861,224198,12983938,7622732,2025-10-21,2025-11-21,671.3,337,-5361206,432623087,-236699682,1.76197993797774,63.9524101495767,-0.703318180410907
635.29,640,12763,15574,9240412,7335354,2025-10-21,2025-11-28,671.3,2811,-1905058,134798008,-74418053,5.44173768502573,29.4274808571355,-0.259709074708597
579.28,580,100708,100703,13494872,7250616,2025-10-21,2025-11-14,671.3,-5,-6244256,44392815,-28335435,16.3328592701319,16.3328592701319,-0.861203517052896
548.41,550,45394,45576,10803772,7246584,2025-10-21,2025-12-19,671.3,182,-3557188,452890228,-117820487,1.60007515110262,79.8585199325608,-0.490877908818831
572.69,575,31204,31204,10765380,7208124,2025-10-21,2025-12-19,671.3,0,-3557256,452890228,-117820487,1.59158302704646,81.4501029596073,-0.493506493506493
529.65,530,201311,201342,13085215,7046970,2025-10-21,2025-11-14,671.3,31,-6038245,44392815,-28335435,15.8741228732623,32.2069821433942,-0.856856918647305
549.35,550,108134,108126,11570338,7028190,2025-10-21,2025-11-21,671.3,-8,-4542148,432623087,-236699682,1.62455269059647,65.5769628401732,-0.646275641381351
628.83,632,37744,21570,20042064,6837690,2025-10-21,2025-11-21,671.3,-16174,-13204374,432623087,-236699682,1.58051897956153,67.1574818197347,-1.93111621029909
669.25,690,3162,3290,8237010,6826750,2025-10-21,2025-11-21,671.3,128,-1410260,432623087,-236699682,1.57799021946325,68.735472039198,-0.206578532976893
660.74,671,6495,6578,9937350,6749028,2025-10-21,2025-11-21,671.3,83,-3188322,432623087,-236699682,1.56002492765718,70.2954969668551,-0.472412027331936
651.08,655,27614,16898,19716396,6624016,2025-10-21,2025-11-07,671.3,-10716,-13092380,75641782,-43457618,8.75708612999096,27.0646267958098,-1.97650186835298
663.2,675,3847,5536,6520665,6532480,2025-10-21,2025-11-21,671.3,1689,11815.0000000009,432623087,-236699682,1.50997027118897,71.8054672380441,0.0018086545997846
660.58,665,13665,14133,11615250,6246786,2025-10-21,2025-10-31,671.3,468,-5368464,118384054,-132327608,5.27671235181725,26.521095484701,-0.85939617588949
454.45,455,10578,110619,920286,6084045,2025-10-21,2025-12-19,671.3,100041,5163759,452890228,-117820487,1.34338182275816,82.7934847823654,0.848737805193749
612.88,615,27976,27705,9847552,5873460,2025-10-21,2025-11-21,671.3,-271,-3974092,432623087,-236699682,1.35763905729793,73.163106295342,-0.676618551926803
625.14,628,20472,20455,9806088,5850130,2025-10-21,2025-11-21,671.3,-17,-3955958,432623087,-236699682,1.35224637237171,74.5153526677137,-0.676217109705254
628.31,635,7991,8439,7487567,5645691,2025-10-21,2025-12-19,671.3,448,-1841876,452890228,-117820487,1.24659148088309,84.0400762632485,-0.326244564217206
632.41,636,20983,15181,12212106,5449979,2025-10-21,2025-11-21,671.3,-5802,-6762127,432623087,-236699682,1.25975223324131,75.7751049009551,-1.24076202862433
664.1,670,6625,8870,7062250,5233300,2025-10-21,2025-10-31,671.3,2245,-1828950,118384054,-132327608,4.42061225576884,30.9417077404699,-0.349483117726865
518.91,520,47537,47511,7700994,5178699,2025-10-21,2025-12-19,671.3,-26,-2522295,452890228,-117820487,1.14347775240582,85.1835540156543,-0.487051863798224
665.87,680,3390,3634,6668130,5134842,2025-10-21,2025-11-21,671.3,244,-1533288,432623087,-236699682,1.18690891778506,76.9620138187401,-0.298604708771954
666.83,670,10028,15695,8052484,4975315,2025-10-21,2025-10-24,671.3,5667,-3077169,35747412,-54558423,13.9179725793856,13.9179725793856,-0.618487271660186
670.5,685,1928,3373,3929264,4890850,2025-10-21,2025-10-31,671.3,1445,961586,118384054,-132327608,4.1313418781891,35.073049618659,0.196609178363679
661.95,674,4002,4003,7679838,4823615,2025-10-21,2025-11-28,671.3,1,-2856223,134798008,-74418053,3.57840228618215,33.0058831433177,-0.59213328592767
607.71,610,21029,20989,7759701,4806481,2025-10-21,2025-11-28,671.3,-40,-2953220,134798008,-74418053,3.56569141585534,36.571574559173,-0.614424565498126
579.55,580,105828,105909,9842004,4765905,2025-10-21,2025-11-07,671.3,81,-5076099,75641782,-43457618,6.30062496412366,33.3652517599334,-1.06508606445156
587.05,590,15872,15824,6872576,4668080,2025-10-21,2025-12-19,671.3,-48,-2204496,452890228,-117820487,1.03073100530665,86.214285020961,-0.472248976024404
628.51,630,2388,30726,747444,4578174,2025-10-21,2025-11-07,671.3,28338,3830730,75641782,-43457618,6.05244070003533,39.4176924599688,0.836737528979895
664.35,685,2098,2133,5540818,4404645,2025-10-21,2025-12-19,671.3,35,-1136173,452890228,-117820487,0.972563488386859,87.1868485093478,-0.257948824479612
567.87,570,20154,20205,6227586,4303665,2025-10-21,2025-12-19,671.3,51,-1923921,452890228,-117820487,0.950266694648134,88.137115203996,-0.447042462645211
659.3,670,3577,3988,5544350,4267160,2025-10-21,2025-11-28,671.3,411,-1277190,134798008,-74418053,3.16559574085101,39.737170300024,-0.299306798901377
652.46,655,16636,16687,9316160,4238498,2025-10-21,2025-10-31,671.3,51,-5077662,118384054,-132327608,3.58029469070218,38.6533443093611,-1.19798617340388
630.61,634,12413,12451,6976106,4220889,2025-10-21,2025-11-21,671.3,38,-2755217,432623087,-236699682,0.975650428013335,77.9376642467534,-0.652757511510016
529.8,530,210671,210652,10744221,4213040,2025-10-21,2025-11-07,671.3,-19,-6531181,75641782,-43457618,5.56972600143133,44.9874184614001,-1.55023000018989
661.33,672,3343,3879,5271911,4138893,2025-10-21,2025-11-21,671.3,536,-1133018,432623087,-236699682,0.956697209273069,78.8943614560265,-0.27374904352444
538.61,540,29524,29635,6347660,4119265,2025-10-21,2025-12-19,671.3,111,-2228395,452890228,-117820487,0.909550426422537,89.0466656304185,-0.540969080649097
638.83,640,33474,33324,10142622,3898908,2025-10-21,2025-10-31,671.3,-150,-6243714,118384054,-132327608,3.29344017902952,41.9467844883906,-1.60140069988828
659.1,665,6512,6375,6564096,3761250,2025-10-21,2025-11-07,671.3,-137,-2802846,75641782,-43457618,4.97245027886836,49.9598687402685,-0.745190029910269
558.15,560,19751,19792,5530280,3661520,2025-10-21,2025-12-19,671.3,41,-1868760,452890228,-117820487,0.808478473066105,89.8551441034846,-0.510378203587581
662.58,674,3017,3166,5035373,3615572,2025-10-21,2025-11-21,671.3,149,-1419801,432623087,-236699682,0.835732559968535,79.730094015995,-0.392690561825349
603.37,605,21777,21967,6097560,3580621,2025-10-21,2025-11-21,671.3,190,-2516939,432623087,-236699682,0.827653703095138,80.5577477190902,-0.702933653128885
499.13,500,40776,41002,5219328,3567174,2025-10-21,2025-12-19,671.3,226,-1652154,452890228,-117820487,0.787646493445648,90.6427905969303,-0.463154867130115
643.5,645,22926,22393,8436768,3358950,2025-10-21,2025-10-31,671.3,-533,-5077818,118384054,-132327608,2.83733314285723,44.7841176312479,-1.51172777207163
637.9,640,15824,15893,6851792,3337530,2025-10-21,2025-11-07,671.3,69,-3514262,75641782,-43457618,4.41228367676478,54.3721524170332,-1.05295293225829
598.12,600,17631,17664,5430348,3320832,2025-10-21,2025-11-28,671.3,33,-2109516,134798008,-74418053,2.46356162770595,42.20073192773,-0.635237193570768
644.83,651,5376,5381,5236224,3320077,2025-10-21,2025-11-28,671.3,5,-1916147,134798008,-74418053,2.46300153040837,44.6637334581383,-0.577139325383116
657.37,666,3612,3810,4713660,3288030,2025-10-21,2025-11-21,671.3,198,-1425630,432623087,-236699682,0.760021852462996,81.3177695715532,-0.433581810384942
591.76,595,8960,10125,4363520,3280500,2025-10-21,2025-12-19,671.3,1165,-1083020,452890228,-117820487,0.724347711030762,91.367138307961,-0.330138698369151
655.79,664,4363,3927,5327223,3224067,2025-10-21,2025-11-21,671.3,-436,-2103156,432623087,-236699682,0.745236927219282,82.0630064987725,-0.652330115968434
655.9,661,1150,6298,1007400,3211980,2025-10-21,2025-11-07,671.3,5148,2204580,75641782,-43457618,4.24630398051701,58.6184563975502,0.686361683447593
630.8,635,7426,7559,4789770,3174780,2025-10-21,2025-11-28,671.3,133,-1614990,134798008,-74418053,2.35521284557855,47.0189463037169,-0.508693515771171
666.92,675,3458,3900,4581850,3151200,2025-10-21,2025-10-31,671.3,442,-1430650,118384054,-132327608,2.6618449812506,47.4459626124985,-0.454001650165017
658.85,675,1806,1909,3928050,3083035,2025-10-21,2025-12-19,671.3,103,-845015,452890228,-117820487,0.680746637792326,92.0478849457533,-0.274085438537026
658.68,669,2821,2911,4471285,3004152,2025-10-21,2025-11-28,671.3,90,-1467133,134798008,-74418053,2.22863234002686,49.2475786437438,-0.488368431424242
588.79,590,25276,24792,5232132,2999832,2025-10-21,2025-11-21,671.3,-484,-2232300,432623087,-236699682,0.693405435387687,82.7564119341601,-0.744141671933628
593.32,595,17885,17847,4918375,2998296,2025-10-21,2025-11-28,671.3,-38,-1920079,134798008,-74418053,2.22428806217967,51.4718667059234,-0.640390074895874
647.19,654,4383,4384,4803768,2985504,2025-10-21,2025-11-28,671.3,1,-1818264,134798008,-74418053,2.214798307702,53.6866650136254,-0.609030837004406
469.71,470,101981,101978,7240651,2957362,2025-10-21,2025-11-28,671.3,-3,-4283289,134798008,-74418053,2.19392114459139,55.8805861582168,-1.44834788571707
663.86,676,2398,2402,5208456,2916028,2025-10-21,2025-11-21,671.3,4,-2292428,432623087,-236699682,0.674034300901746,83.4304462350619,-0.786147458117686
601.14,605,7320,7472,4209000,2884192,2025-10-21,2025-12-19,671.3,152,-1324808,452890228,-117820487,0.636841296562486,92.6847262423158,-0.459334191343711
578.97,580,28177,27646,4818267,2847538,2025-10-21,2025-11-21,671.3,-531,-1970729,432623087,-236699682,0.658202968257216,84.0886492033191,-0.692081721121896
652.08,660,3223,3491,3799917,2764872,2025-10-21,2025-11-28,671.3,268,-1035045,134798008,-74418053,2.05112229848382,57.9317084567006,-0.374355485534231
655.05,663,3342,3414,3963612,2714130,2025-10-21,2025-11-21,671.3,72,-1249482,432623087,-236699682,0.627365963943575,84.7160151672627,-0.460361883918604
539.26,540,36625,36617,5567000,2709658,2025-10-21,2025-11-28,671.3,-8,-2857342,134798008,-74418053,2.01016175253866,59.9418702092393,-1.05450281917497
654.24,655,45861,35645,13620717,2709020,2025-10-21,2025-10-24,671.3,-10216,-10911697,35747412,-54558423,7.57822692171394,21.4961995010995,-4.02791304604617
582.31,585,9941,9960,3886931,2679240,2025-10-21,2025-12-19,671.3,19,-1207691,452890228,-117820487,0.59158706334463,93.2763133056605,-0.450758797270868
563.03,565,13538,13542,4088476,2667774,2025-10-21,2025-12-19,671.3,4,-1420702,452890228,-117820487,0.58905532401993,93.8653686296804,-0.532542111888039
654.42,662,3525,3495,4053750,2649210,2025-10-21,2025-11-21,671.3,-30,-1404540,432623087,-236699682,0.612359829978283,85.328374997241,-0.530173145956719
528.76,530,21181,21308,3876123,2642192,2025-10-21,2025-12-19,671.3,127,-1233931,452890228,-117820487,0.58340671461783,94.4487753442982,-0.467010345955177
658.83,660,21169,21564,8721628,2522988,2025-10-21,2025-10-24,671.3,395,-6198640,35747412,-54558423,7.05782001785192,28.5540195189515,-2.45686463827811
623.24,626,9256,9046,4202224,2496696,2025-10-21,2025-11-21,671.3,-210,-1705528,432623087,-236699682,0.57710651026814,85.9054815075091,-0.683114003466982
668.08,685,1392,1464,3236400,2477088,2025-10-21,2025-11-21,671.3,72,-759312,432623087,-236699682,0.572574158530749,86.4780556660399,-0.306534123939077
652.02,659,3380,3530,3599700,2463940,2025-10-21,2025-11-21,671.3,150,-1135760,432623087,-236699682,0.569535023451025,87.0475906894909,-0.460952782941143
646.31,652,3571,4307,3221042,2450683,2025-10-21,2025-11-21,671.3,736,-770359,432623087,-236699682,0.566470693229555,87.6140613827204,-0.314344613318002
624.37,625,39110,38707,6687810,2438541,2025-10-21,2025-10-31,671.3,-403,-4249269,118384054,-132327608,2.05985596675039,49.5058185792489,-1.74254564512141
663.1,665,6587,12675,3787525,2408250,2025-10-21,2025-10-24,671.3,6088,-1379275,35747412,-54558423,6.73685132786676,35.2908708468182,-0.572729160178553
657.94,667,2518,2601,3411890,2356506,2025-10-21,2025-11-21,671.3,83,-1055384,432623087,-236699682,0.544701859612037,88.1587632423325,-0.447859670206653
662.73,668,3819,4443,3830457,2341461,2025-10-21,2025-10-31,671.3,624,-1488996,118384054,-132327608,1.97785167924727,51.4836702584961,-0.63592603079872
593.67,595,17324,17308,3949872,2301964,2025-10-21,2025-11-21,671.3,-16,-1647908,432623087,-236699682,0.532094580518769,88.6908578228512,-0.715870448017432
662.52,675,1824,1809,4104000,2257632,2025-10-21,2025-11-28,671.3,-15,-1846368,134798008,-74418053,1.67482593659693,61.6166961458362,-0.817833907386146
653.71,661,3048,3086,3422904,2249694,2025-10-21,2025-11-21,671.3,38,-1173210,432623087,-236699682,0.520012469884669,89.2108702927359,-0.521497590338953
665.37,672,2548,3373,3103464,2236299,2025-10-21,2025-10-31,671.3,825,-867165,118384054,-132327608,1.88902045878578,53.3726907172819,-0.387767914755585
665.31,680,1496,1504,3015936,2209376,2025-10-21,2025-11-28,671.3,8,-806560,134798008,-74418053,1.63902718799821,63.2557233338344,-0.365062352447026
661.3,673,1857,1863,4129968,2179710,2025-10-21,2025-11-28,671.3,6,-1950258,134798008,-74418053,1.61701944438229,64.8727427782167,-0.894732785554042
464.79,465,102208,102002,3781696,2142042,2025-10-21,2025-11-21,671.3,-206,-1639654,432623087,-236699682,0.495128915762186,89.7059992084981,-0.765463048810434
666.82,692,831,831,2092458,2092458,2025-10-21,2025-11-21,671.3,0,0,432623087,-236699682,0.483667668896274,90.1896668773944,0
662.75,676,1564,1569,2913732,2078925,2025-10-21,2025-11-28,671.3,5,-834807,134798008,-74418053,1.54225201903577,66.4149947972525,-0.401557054727804
642.41,645,8371,7922,4285952,2051798,2025-10-21,2025-11-07,671.3,-449,-2234154,75641782,-43457618,2.71251938511972,61.33097578267,-1.08887619541495
653.3,656,7073,7202,4314530,1944540,2025-10-21,2025-10-31,671.3,129,-2369990,118384054,-132327608,1.64256919263806,55.01525990992,-1.21879210507369
639.58,644,3633,4313,2673888,1906346,2025-10-21,2025-11-21,671.3,680,-767542,432623087,-236699682,0.440648235677723,90.6303151130721,-0.402624707162289
666.5,690,742,807,2223032,1896450,2025-10-21,2025-12-19,671.3,65,-326582,452890228,-117820487,0.418743855078277,94.8675191993765,-0.17220701837644
629.25,630,25572,25043,5191116,1878225,2025-10-21,2025-10-31,671.3,-529,-3312891,118384054,-132327608,1.58655235780319,56.6018122677232,-1.76384139280438
636.93,638,17690,17512,4900130,1873784,2025-10-21,2025-10-31,671.3,-178,-3026346,118384054,-132327608,1.58280100798035,58.1846132757035,-1.6150986453081
634.05,635,20103,19663,4985544,1867985,2025-10-21,2025-10-31,671.3,-440,-3117559,118384054,-132327608,1.57790254420583,59.7625158199093,-1.66894220242668
479.82,480,101111,101112,3538885,1820016,2025-10-21,2025-11-14,671.3,1,-1718869,44392815,-28335435,4.09979858227058,36.3067807256647,-0.944425213844274
661.15,666,2696,3735,2399440,1811475,2025-10-21,2025-10-31,671.3,1039,-587965,118384054,-132327608,1.53016807483211,61.2926838947414,-0.32457803723485
663.35,669,1775,3166,1801625,1788790,2025-10-21,2025-10-31,671.3,1391,-12834.9999999998,118384054,-132327608,1.51100586570553,62.803689760447,-0.00717524136427404
648.02,654,3292,2988,3153736,1786824,2025-10-21,2025-11-21,671.3,-304,-1366912,432623087,-236699682,0.413020953733798,91.0433360668059,-0.764995321307526
669.7,675,2464,3371,2747360,1786630,2025-10-21,2025-10-24,671.3,907,-960730,35747412,-54558423,4.99792824163047,40.2887990884487,-0.537733050491708
449.83,450,104515,104507,3344480,1776619,2025-10-21,2025-11-21,671.3,-8,-1567861,432623087,-236699682,0.410662087481245,91.4539981542871,-0.88249703509869
642.99,648,3237,3512,2667288,1759512,2025-10-21,2025-11-21,671.3,275,-907776,432623087,-236699682,0.406707837115498,91.8607059914026,-0.515924870077613
651.31,658,2588,2587,2714812,1730703,2025-10-21,2025-11-21,671.3,-1,-984109,432623087,-236699682,0.400048691807333,92.26075468321,-0.568618070229265
559.85,560,115099,114993,5179455,1724895,2025-10-21,2025-10-31,671.3,-106,-3454560,118384054,-132327608,1.45703322509973,64.2607229855467,-2.00276538571913
661.28,670,1663,1964,2228420,1712608,2025-10-21,2025-11-14,671.3,301,-515812,44392815,-28335435,3.857849519117,40.1646302447817,-0.301185093144491
646.87,650,6124,5404,3692772,1691452,2025-10-21,2025-11-07,671.3,-720,-2001320,75641782,-43457618,2.23613452152674,63.5671103041967,-1.18319644896811
653.36,662,1939,1957,2460591,1690848,2025-10-21,2025-11-28,671.3,18,-769743,134798008,-74418053,1.25435681512445,67.6693516123769,-0.455240802248339
619.47,620,29440,31851,4239360,1688103,2025-10-21,2025-10-31,671.3,2411,-2551257,118384054,-132327608,1.42595471515108,65.6866777006978,-1.51131595643157
659.34,669,1445,1733,2106810,1674078,2025-10-21,2025-11-21,671.3,288,-432732,432623087,-236699682,0.386959931243799,92.6477146144538,-0.25848974778953
633.27,635,4143,9612,1516338,1662876,2025-10-21,2025-11-07,671.3,5469,146538,75641782,-43457618,2.19835645860379,65.7654667628005,0.0881232274685543
621.74,625,5159,5094,2646567,1660644,2025-10-21,2025-11-28,671.3,-65,-985923,134798008,-74418053,1.23194995581834,68.9013015681953,-0.593699191398036
659.92,671,1028,1469,1668444,1627652,2025-10-21,2025-11-28,671.3,441,-40791.9999999998,134798008,-74418053,1.20747481669017,70.1087763848855,-0.0250618682617659
523.83,525,13436,13438,2230376,1572246,2025-10-21,2025-12-19,671.3,2,-658130,452890228,-117820487,0.347158296380818,95.2146774957573,-0.418592255919239
658.03,668,1436,1565,2352168,1560305,2025-10-21,2025-11-28,671.3,129,-791863,134798008,-74418053,1.15751339589529,71.2662897807807,-0.507505263394016
665.44,668,2751,6078,1983471,1555968,2025-10-21,2025-10-24,671.3,3327,-427503,35747412,-54558423,4.35267313896737,44.6414722274161,-0.274750509007897
665.45,675,613,1621,1040261,1548055,2025-10-21,2025-11-07,671.3,1008,507794,75641782,-43457618,2.04656072222095,67.8120274850215,0.328020645261312
662.6,670,2080,2077,2516800,1536980,2025-10-21,2025-11-07,671.3,-3,-979820,75641782,-43457618,2.03191934320109,69.8439468282225,-0.637496909523872
658.66,668,1601,1594,2172557,1488796,2025-10-21,2025-11-21,671.3,-7,-683761,432623087,-236699682,0.344132350939468,92.9918469653932,-0.459271115720354
549.16,550,17430,17558,2405340,1474872,2025-10-21,2025-11-28,671.3,128,-930468,134798008,-74418053,1.09413486288314,72.3604246436639,-0.630880510308691
667.49,671,2096,4201,1792080,1474551,2025-10-21,2025-10-24,671.3,2105,-317529.000000001,35747412,-54558423,4.12491679117918,48.7663890185953,-0.215339449093318
669.73,700,459,482,1675350,1459014,2025-10-21,2025-12-19,671.3,23,-216336,452890228,-117820487,0.322156211328101,95.5368337070854,-0.148275479193483
665.05,678,1095,1122,2052030,1452990,2025-10-21,2025-11-21,671.3,27,-599040,432623087,-236699682,0.335855862449615,93.3277028278428,-0.412280882869118
619.38,622,5343,5466,2350920,1432092,2025-10-21,2025-11-21,671.3,123,-918828,432623087,-236699682,0.33102532967687,93.6587281575197,-0.641598444792653
636.92,640,4431,4644,2375016,1430352,2025-10-21,2025-11-14,671.3,213,-944664,44392815,-28335435,3.22203491713693,43.3866651619187,-0.660441625557905
618.96,620,13591,13612,3180294,1415648,2025-10-21,2025-11-07,671.3,21,-1764646,75641782,-43457618,1.87151593017732,71.7154627583999,-1.24652879811931
509.93,510,201699,201691,4235679,1411837,2025-10-21,2025-10-31,671.3,-8,-2823842,118384054,-132327608,1.19259051561117,66.8792682163089,-2.00011899390652
659.06,663,3378,3572,2638218,1407368,2025-10-21,2025-10-31,671.3,194,-1230850,118384054,-132327608,1.18881551395427,68.0680837302632,-0.874575803911983
652.85,661,1731,1712,2125668,1395280,2025-10-21,2025-11-28,671.3,-19,-730388,134798008,-74418053,1.0350894799573,73.3955141236212,-0.523470557880856
661.95,667,2549,2755,2449589,1391275,2025-10-21,2025-10-31,671.3,206,-1058314,118384054,-132327608,1.17522162233099,69.2433053525942,-0.760679233077573
664.31,675,1197,1293,1925973,1382217,2025-10-21,2025-11-14,671.3,96,-543756,44392815,-28335435,3.11360520841042,46.5002703703291,-0.39339409079761
655.7,662,2162,2180,2229022,1373400,2025-10-21,2025-11-14,671.3,18,-855622,44392815,-28335435,3.09374388625727,49.5940142565863,-0.622995485656036
658.25,662,4720,3660,3521120,1372500,2025-10-21,2025-10-31,671.3,-1060,-2148620,118384054,-132327608,1.15936222288857,70.4026675754828,-1.56547905282331
649.65,656,2132,2159,2134132,1370965,2025-10-21,2025-11-21,671.3,27,-763167,432623087,-236699682,0.316895940414756,93.9756240979345,-0.556664101563497
655.82,665,1290,1492,1724730,1369656,2025-10-21,2025-11-28,671.3,202,-355074,134798008,-74418053,1.01608029697293,74.4115944205941,-0.259243196831905
662.29,664,2169,7987,1171260,1365777,2025-10-21,2025-10-24,671.3,5818,194517,35747412,-54558423,3.82063182643823,52.5870208450335,0.142422225590268
489.21,490,17213,17213,2306542,1359827,2025-10-21,2025-12-19,671.3,0,-946715,452890228,-117820487,0.300255319264694,95.8370890263501,-0.69620253164557
654.17,657,4721,4775,2856205,1351325,2025-10-21,2025-10-31,671.3,54,-1504880,118384054,-132327608,1.14147552338426,71.544143098867,-1.11363291584186
650.53,657,2126,2039,2211040,1319233,2025-10-21,2025-11-21,671.3,-87,-891807,432623087,-236699682,0.304938187452765,94.2805622853872,-0.676004163025031
670.13,695,498,529,1536330,1315623,2025-10-21,2025-11-21,671.3,31,-220707,432623087,-236699682,0.304103742849951,94.5846660282372,-0.167758544811089
657.93,659,9029,12236,3485194,1309252,2025-10-21,2025-10-24,671.3,3207,-2175942,35747412,-54558423,3.66250849152381,56.2495293365573,-1.66197340160641
642.16,647,2636,2681,2193152,1297604,2025-10-21,2025-11-21,671.3,45,-895548,432623087,-236699682,0.299938685426652,94.8846047136638,-0.690155085835124
574.04,575,13257,13287,2081349,1275552,2025-10-21,2025-11-21,671.3,30,-805797,432623087,-236699682,0.294841407758713,95.1794461214226,-0.63172414766313
647.3,653,2399,2237,2221474,1275090,2025-10-21,2025-11-21,671.3,-162,-946384,432623087,-236699682,0.2947346173414,95.474180738764,-0.742209569520583
645.63,651,2379,2355,2119689,1264635,2025-10-21,2025-11-21,671.3,-24,-855054,432623087,-236699682,0.29231796406649,95.7664987028304,-0.676127103867914
533.67,535,9360,9377,1928160,1247141,2025-10-21,2025-12-19,671.3,17,-681019,452890228,-117820487,0.27537379322744,96.1124628195775,-0.546064157942045
664.67,667,3826,5344,2528986,1245152,2025-10-21,2025-10-24,671.3,1518,-1283834,35747412,-54558423,3.4831948114174,59.7327241479747,-1.0310660867107
626.37,630,3427,3427,1977379,1244001,2025-10-21,2025-11-28,671.3,0,-733378,134798008,-74418053,0.922863044088901,75.334457464683,-0.589531680440771
617.13,620,4067,4296,1858619,1232952,2025-10-21,2025-11-28,671.3,229,-625667,134798008,-74418053,0.914666335425372,76.2491238001084,-0.507454467002771
660.42,672,913,1055,1472669,1221690,2025-10-21,2025-11-28,671.3,142,-250979,134798008,-74418053,0.906311612557361,77.1554354126657,-0.205435912547373
668.11,672,830,3139,761110,1221071,2025-10-21,2025-10-24,671.3,2309,459961,35747412,-54558423,3.41583049424669,63.1485546422214,0.376686531741398
639.67,645,2168,2283,1788600,1216839,2025-10-21,2025-11-28,671.3,115,-571761,134798008,-74418053,0.902712894689067,78.0581483073548,-0.469873993190554
657.78,665,917,1678,1034376,1211516,2025-10-21,2025-11-14,671.3,761,177140,44392815,-28335435,2.72908127137241,52.3230955279588,0.146213504402748
632.4,635,4605,4632,2201190,1204320,2025-10-21,2025-11-14,671.3,27,-996870,44392815,-28335435,2.71287144102035,55.0359669689791,-0.827745117576724
654.75,661,1923,1913,1971075,1195625,2025-10-21,2025-11-14,671.3,-10,-775450,44392815,-28335435,2.69328493811442,57.7292519070935,-0.648572922111866
670.49,705,324,344,1417500,1187144,2025-10-21,2025-12-19,671.3,20,-230356,452890228,-117820487,0.26212621218226,96.3745890317598,-0.194042171800557
479.89,480,105872,105926,2435056,1165186,2025-10-21,2025-11-07,671.3,54,-1269870,75641782,-43457618,1.54039998687498,73.2558627452748,-1.08984316667039
643.82,649,1988,2229,1616244,1154622,2025-10-21,2025-11-21,671.3,241,-461622,432623087,-236699682,0.266888669304882,96.0333873721353,-0.399803572078135
609.6,610,31423,28814,3362261,1152560,2025-10-21,2025-10-31,671.3,-2609,-2209701,118384054,-132327608,0.973577066384295,72.5177201652513,-1.91721125147498
668.68,673,2067,2657,2124876,1147824,2025-10-21,2025-10-24,671.3,590,-977052,35747412,-54558423,3.21092894780747,66.3594835900288,-0.85122109312926
543.51,545,7567,7686,1695008,1145214,2025-10-21,2025-12-19,671.3,119,-549794,452890228,-117820487,0.252867898046146,96.627456929806,-0.480079705627071
646.53,653,1515,1769,1492275,1144543,2025-10-21,2025-11-28,671.3,254,-347732,134798008,-74418053,0.849080054654814,78.9072283620096,-0.303817331458932
668.4,678,999,1185,1548450,1137600,2025-10-21,2025-10-31,671.3,186,-410850,118384054,-132327608,0.9609402293319,73.4786603945832,-0.361155063291139
399.7,400,37775,37729,1699875,1131870,2025-10-21,2025-12-19,671.3,-46,-568005,452890228,-117820487,0.249921488701231,96.8773784185072,-0.501828831932996
654.03,660,1760,1881,1705440,1122957,2025-10-21,2025-11-14,671.3,121,-582483,44392815,-28335435,2.52959178191336,60.2588436890069,-0.518704634282524
641.23,646,2283,2337,1776174,1114749,2025-10-21,2025-11-21,671.3,54,-661425,432623087,-236699682,0.257672101535349,96.2910594736707,-0.593339846010178
509.01,510,11164,11149,1562960,1103751,2025-10-21,2025-12-19,671.3,-15,-459209,452890228,-117820487,0.243712699404943,97.1210911179121,-0.416044017174163
583.87,585,9749,9747,1832812,1101411,2025-10-21,2025-11-21,671.3,-2,-731401,432623087,-236699682,0.254589048318635,96.5456485219893,-0.66405819444331
664.81,687,494,494,1096186,1096186,2025-10-21,2025-10-31,671.3,0,0,118384054,-132327608,0.925957477347414,74.4046178719306,0
661.84,671,947,1185,1557815,1085460,2025-10-21,2025-11-14,671.3,238,-472355,44392815,-28335435,2.44512541049717,62.7039690995041,-0.43516573618558
604.63,605,28691,28658,2668263,1060346,2025-10-21,2025-10-31,671.3,-33,-1607917,118384054,-132327608,0.895683129756648,75.3003010016873,-1.51640785177668
569.12,570,11945,12011,1732025,1056968,2025-10-21,2025-11-21,671.3,66,-675057,432623087,-236699682,0.244316133780443,96.7899646557698,-0.638673072410896
666.16,669,1096,3659,865840,1039156,2025-10-21,2025-10-24,671.3,2563,173316,35747412,-54558423,2.90694050802895,69.2664240980578,0.166785352728561
449.48,450,19952,19963,1656016,1038076,2025-10-21,2025-12-19,671.3,11,-617940,452890228,-117820487,0.229211392920582,97.3503025108327,-0.595274334441794
649.54,650,22264,22221,4719968,1022166,2025-10-21,2025-10-24,671.3,-43,-3697802,35747412,-54558423,2.85941259188218,72.12583668994,-3.61761396876828
661.79,669,1024,1411,1249280,1017331,2025-10-21,2025-11-07,671.3,387,-231949,75641782,-43457618,1.34493261938224,74.6007953646571,-0.227997574044239
665.86,673,691,1407,904519,1004598,2025-10-21,2025-10-31,671.3,716,100079,118384054,-132327608,0.848592328152574,76.1488933298399,0.099620942904525
663.24,671,1067,1284,1436182,996384,2025-10-21,2025-11-07,671.3,217,-439798,75641782,-43457618,1.31724025221934,75.9180356168764,-0.441394080996885
664.76,671,1072,1595,1226368,995280,2025-10-21,2025-10-31,671.3,523,-231088,118384054,-132327608,0.840721335662318,76.9896146655022,-0.232183908045977
649.62,657,1332,1339,1495836,988182,2025-10-21,2025-11-28,671.3,7,-507654,134798008,-74418053,0.733083533400583,79.6403118954102,-0.513725204466384
664.92,674,814,1081,1261700,981548,2025-10-21,2025-11-07,671.3,267,-280152,75641782,-43457618,1.29762675342577,77.2156623703022,-0.285418542954598
613.55,615,6596,6696,1813900,970920,2025-10-21,2025-11-14,671.3,100,-842980,44392815,-28335435,2.18711068446549,64.8910797839696,-0.868228072343757
654.94,664,1078,1065,1401400,964890,2025-10-21,2025-11-28,671.3,-13,-436510,134798008,-74418053,0.715804346307551,80.3561162417178,-0.452393537087129
661.96,673,799,869,1261621,959376,2025-10-21,2025-11-21,671.3,70,-302245,432623087,-236699682,0.221757929437548,97.0117225852073,-0.315043319824553
514.47,515,17918,17923,1523030,949919,2025-10-21,2025-11-28,671.3,5,-573111,134798008,-74418053,0.704698099099506,81.0608143408173,-0.603326178337311
651.54,654,3972,3852,2132964,947592,2025-10-21,2025-10-31,671.3,-120,-1185372,118384054,-132327608,0.80043888343273,77.7900535489349,-1.25093078033584
670.33,690,469,476,1231125,936292,2025-10-21,2025-11-14,671.3,7,-294833,44392815,-28335435,2.10910707059239,67.0001868545619,-0.314894285116182
529.91,530,102651,102839,2874228,925551,2025-10-21,2025-10-31,671.3,188,-1948677,118384054,-132327608,0.781820666489424,78.5718742154243,-2.10542368815981
661.43,663,5491,5826,2789428,914682,2025-10-21,2025-10-24,671.3,335,-1874746,35747412,-54558423,2.55873627998581,74.6845729699258,-2.04961505747353
655.02,658,2961,3067,1886157,913966,2025-10-21,2025-10-31,671.3,106,-972191,118384054,-132327608,0.77203472014905,79.3439089355734,-1.06370587089673
645.82,650,2066,2154,1479256,900372,2025-10-21,2025-11-14,671.3,88,-578884,44392815,-28335435,2.02819307583896,69.0283799304009,-0.642938696449912
638.74,643,1859,2108,1362647,898008,2025-10-21,2025-11-21,671.3,249,-464639,432623087,-236699682,0.207572833485884,97.2192954186932,-0.517410758033336
649.78,652,3811,4002,1886445,888444,2025-10-21,2025-10-31,671.3,191,-998001,118384054,-132327608,0.750476073407657,80.094385008981,-1.12331334332834
513.96,515,8208,8539,1255824,888056,2025-10-21,2025-12-19,671.3,331,-367768,452890228,-117820487,0.196086368196048,97.5463888790288,-0.414127037033701
659.81,664,1966,2119,1608188,887861,2025-10-21,2025-10-31,671.3,153,-720327,118384054,-132327608,0.749983608434291,80.8443686174153,-0.81130604903245
665.62,677,708,752,1203600,855776,2025-10-21,2025-11-14,671.3,44,-347824,44392815,-28335435,1.92773537789843,70.9561153082993,-0.406442807463635
648.12,655,1204,1230,1247344,846240,2025-10-21,2025-11-28,671.3,26,-401104,134798008,-74418053,0.627783757754046,81.6885980985713,-0.473983739837398
657.47,661,1538,2387,1111974,842611,2025-10-21,2025-10-31,671.3,849,-269363,118384054,-132327608,0.711760555184231,81.5561291725996,-0.319676576735884
479.96,480,208353,208450,3125295,833800,2025-10-21,2025-10-31,671.3,97,-2291495,118384054,-132327608,0.704317829832048,82.2604470024316,-2.74825497721276
669.32,680,559,768,921232,820224,2025-10-21,2025-10-31,671.3,209,-101008,118384054,-132327608,0.692850069148671,82.9532970715803,-0.123146847690387
573.8,575,6845,6825,1437450,819000,2025-10-21,2025-11-28,671.3,-20,-618450,134798008,-74418053,0.607575743997641,82.296173842569,-0.755128205128205
667.38,676,753,928,1057212,799936,2025-10-21,2025-10-31,671.3,175,-257276,118384054,-132327608,0.675712625958898,83.6290096975392,-0.321620729658373
636.95,641,1984,1935,1400704,783675,2025-10-21,2025-11-21,671.3,-49,-617029,432623087,-236699682,0.181144978977971,97.4004403976712,-0.787353175742495
655.79,659,2075,2354,1375725,755634,2025-10-21,2025-10-31,671.3,279,-620091,118384054,-132327608,0.638290356233281,84.2673000537724,-0.820623476444946
660.58,662,2129,5272,1004888,748624,2025-10-21,2025-10-24,671.3,3143,-256264,35747412,-54558423,2.09420474970328,76.7787777196291,-0.342313364252281
602.88,605,3589,3504,1195137,742848,2025-10-21,2025-11-28,671.3,-85,-452289,134798008,-74418053,0.55108232756674,82.8472561701357,-0.608858070560869
671.2,690,444,388,1116660,729440,2025-10-21,2025-11-07,671.3,-56,-387220,75641782,-43457618,0.964334764085806,78.179997134388,-0.53084558017109
657.25,667,674,732,982018,713700,2025-10-21,2025-11-28,671.3,58,-268318,134798008,-74418053,0.529458862626516,83.3767150327622,-0.375953481855121
588.46,590,4570,4613,1137930,710402,2025-10-21,2025-11-28,671.3,43,-427528,134798008,-74418053,0.527012238934569,83.9037272716968,-0.6018113687743
663.85,672,779,853,1017374,695195,2025-10-21,2025-11-07,671.3,74,-322179,75641782,-43457618,0.919062165933637,79.0990593003216,-0.463436877422881
649.98,655,882,1377,761166,691254,2025-10-21,2025-11-14,671.3,495,-69912.0000000002,44392815,-28335435,1.55713035994676,72.5132456682461,-0.101137931932401
668.12,695,247,255,835601,685440,2025-10-21,2025-12-19,671.3,8,-150161,452890228,-117820487,0.151347933256798,97.6977368122856,-0.219072420634921
656.47,666,681,717,955443,683301,2025-10-21,2025-11-28,671.3,36,-272142,134798008,-74418053,0.506907342428977,84.4106346141258,-0.398275430593545
646.26,648,3690,3880,1546110,675120,2025-10-21,2025-10-31,671.3,190,-870990,118384054,-132327608,0.570279507407307,84.8375795611798,-1.2901261997867
499.55,500,15102,14994,1042038,674730,2025-10-21,2025-11-28,671.3,-108,-367308,134798008,-74418053,0.500548939862672,84.9111835539884,-0.54437775110044
648.57,652,1526,1960,1046836,672280,2025-10-21,2025-11-07,671.3,434,-374556,75641782,-43457618,0.888768062074476,79.9878273623961,-0.557142857142857
653.5,658,1378,1482,1088620,666900,2025-10-21,2025-11-07,671.3,104,-421720,75641782,-43457618,0.881655590821485,80.8694829532176,-0.632358674463938
599.36,600,2081,10169,287178,650816,2025-10-21,2025-11-07,671.3,8088,363638,75641782,-43457618,0.860392210220537,81.7298751634381,0.558741641262661
419.62,420,17039,17062,1022340,648356,2025-10-21,2025-12-19,671.3,23,-373984,452890228,-117820487,0.143159635583923,97.8408964478695,-0.576818908130718
641.47,645,1526,1823,988848,643519,2025-10-21,2025-11-14,671.3,297,-345329,44392815,-28335435,1.44960169793242,73.9628473661785,-0.536625958207916
644.7,645,36344,21445,5487944,643350,2025-10-21,2025-10-24,671.3,-14899,-4844594,35747412,-54558423,1.79971070353289,78.5784884231619,-7.53026191031321
657.57,663,1183,1184,1115569,642912,2025-10-21,2025-11-07,671.3,1,-472657,75641782,-43457618,0.849942958773763,82.5798181222119,-0.735181486735354
637.73,642,1490,1494,1056410,637938,2025-10-21,2025-11-21,671.3,4,-418472,432623087,-236699682,0.147458149869843,97.547898547541,-0.655975972586678
664.34,673,613,729,1103400,631314,2025-10-21,2025-11-07,671.3,116,-472086,75641782,-43457618,0.834610162938784,83.4144282851507,-0.747783195050324
598.66,599,18471,18498,1662390,628932,2025-10-21,2025-10-31,671.3,27,-1033458,118384054,-132327608,0.531264117716395,85.3688436788961,-1.64319513079315
599.68,600,19989,19611,1679076,627552,2025-10-21,2025-10-31,671.3,-378,-1051524,118384054,-132327608,0.530098420180813,85.898942099077,-1.67559660394676
633.03,634,6544,6448,1636000,625456,2025-10-21,2025-10-31,671.3,-96,-1010544,118384054,-132327608,0.528327911460103,86.4272700105371,-1.6156915914149
648.9,656,831,879,915762,624090,2025-10-21,2025-11-28,671.3,48,-291672,134798008,-74418053,0.462981619134906,85.3741651731233,-0.467355669855309
624.17,627,2191,2189,1088927,619487,2025-10-21,2025-11-21,671.3,-2,-469440,432623087,-236699682,0.143193236471913,97.6910917840129,-0.757788299028066
666.75,677,715,602,1158300,617050,2025-10-21,2025-11-07,671.3,-113,-541250,75641782,-43457618,0.815752859973606,84.2301811451243,-0.877157442670772
671.04,700,193,213,696151,616848,2025-10-21,2025-10-31,671.3,20,-79303,118384054,-132327608,0.52105666190482,86.9483266724419,-0.128561655383498
645.63,652,970,961,955450,612157,2025-10-21,2025-11-28,671.3,-9,-343293,134798008,-74418053,0.454129114430237,85.8282942875536,-0.560792411097153
650.35,658,827,799,947742,611235,2025-10-21,2025-11-28,671.3,-28,-336507,134798008,-74418053,0.453445128061536,86.2817394156151,-0.550536209477533
484.25,485,8113,8112,1095255,608400,2025-10-21,2025-12-19,671.3,-1,-486855,452890228,-117820487,0.134337188657557,97.975233636527,-0.800221893491124
656.8,662,2182,1157,1976892,601640,2025-10-21,2025-11-07,671.3,-1025,-1375252,75641782,-43457618,0.795380521310299,85.0255616664346,-2.28583870753274
659.72,661,4418,4648,1957174,594944,2025-10-21,2025-10-24,671.3,230,-1362230,35747412,-54558423,1.66429950229684,80.2427879254588,-2.28967768395009
666.44,674,724,770,1233696,582120,2025-10-21,2025-10-31,671.3,46,-651576,118384054,-132327608,0.491721630009393,87.4400483024513,-1.11931560502989
660.51,667,734,883,796390,573067,2025-10-21,2025-11-07,671.3,149,-223323,75641782,-43457618,0.757606424449387,85.783168090884,-0.389697888728543
654.28,663,588,646,764400,563312,2025-10-21,2025-11-28,671.3,58,-201088,134798008,-74418053,0.417893415754334,86.6996328313694,-0.356974465305195
637.91,643,624,1094,501072,556846,2025-10-21,2025-11-28,671.3,470,55774.0000000001,134798008,-74418053,0.413096608964726,87.1127294403342,0.10016054708124
652.75,657,1294,1309,988616,556325,2025-10-21,2025-11-07,671.3,15,-432291,75641782,-43457618,0.73547315424166,86.5186412451256,-0.777047589089112
664.13,678,379,399,750799,553413,2025-10-21,2025-11-28,671.3,20,-197386,134798008,-74418053,0.410549835424868,87.523279275759,-0.356670334813241
559.23,560,7184,7159,883632,551243,2025-10-21,2025-11-21,671.3,-25,-332389,432623087,-236699682,0.127418766257382,97.8185105502703,-0.602980899530697
627.81,630,2560,2517,1034240,551223,2025-10-21,2025-11-14,671.3,-43,-483017,44392815,-28335435,1.24169417956487,75.2045415457434,-0.876264234257279
657.05,658,4851,5798,1751211,550810,2025-10-21,2025-10-24,671.3,947,-1200401,35747412,-54558423,1.54083881652747,81.7836267419862,-2.17933770265609
479.29,480,7673,7691,851703,546061,2025-10-21,2025-12-19,671.3,18,-305642,452890228,-117820487,0.120572484509425,98.0958061210365,-0.559721349812567
633.59,638,1162,1227,840126,541107,2025-10-21,2025-11-28,671.3,65,-299019,134798008,-74418053,0.401420620399672,87.9246998961587,-0.552606046493577
632.11,633,5999,6065,1367772,539785,2025-10-21,2025-10-31,671.3,66,-827987,118384054,-132327608,0.45596090162616,87.8960092040774,-1.53391998666136
662.62,672,354,575,505866,539350,2025-10-21,2025-11-14,671.3,221,33484,44392815,-28335435,1.2149488605307,76.4194904062741,0.0620821359043293
663.89,666,1414,2553,871024,538683,2025-10-21,2025-10-24,671.3,1139,-332341,35747412,-54558423,1.50691468238316,83.2905414243694,-0.61695097116486
666.8,682,299,352,635076,535040,2025-10-21,2025-11-21,671.3,53,-100036,432623087,-236699682,0.123673473764473,97.9421840240348,-0.186969198564593
444.5,445,10610,10611,1039780,530550,2025-10-21,2025-12-19,671.3,1,-509230,452890228,-117820487,0.117147592771642,98.2129537138081,-0.959815286023937
671.15,700,180,181,639540,522185,2025-10-21,2025-11-14,671.3,1,-117355,44392815,-28335435,1.17628269349443,77.5957730997685,-0.224738359010695
623.75,625,3806,4176,1027620,522000,2025-10-21,2025-11-07,671.3,370,-505620,75641782,-43457618,0.690094794435171,87.2087360395608,-0.968620689655173
647.13,649,2699,2787,1257734,521169,2025-10-21,2025-10-31,671.3,88,-736565,118384054,-132327608,0.440235810812831,88.3362450148903,-1.41329396030846
661.1,668,563,751,634501,518190,2025-10-21,2025-11-07,671.3,188,-116311,75641782,-43457618,0.685057895648201,87.893793935209,-0.224456280514869
645.12,648,1688,1739,979040,500832,2025-10-21,2025-11-07,671.3,51,-478208,75641782,-43457618,0.662110260702213,88.5559041959112,-0.954827167593125
671.32,700,172,174,602000,499032,2025-10-21,2025-11-21,671.3,2,-102968,432623087,-236699682,0.115350293360558,98.0575343173953,-0.206335465461133
594.08,595,5390,5395,937860,496340,2025-10-21,2025-11-14,671.3,5,-441520,44392815,-28335435,1.11806381280394,78.7138369125725,-0.88955151710521
554.28,555,6811,6892,878619,496224,2025-10-21,2025-11-21,671.3,81,-382395,432623087,-236699682,0.11470122952546,98.1722355469208,-0.770609644031728
669,690,232,236,722912,495600,2025-10-21,2025-11-28,671.3,4,-227312,134798008,-74418053,0.367661219444727,88.2923611156034,-0.458660209846651
659.98,668,300,614,372900,492428,2025-10-21,2025-11-14,671.3,314,119528,44392815,-28335435,1.10925157595886,79.8230884885313,0.242731932384024
654.45,659,1089,1072,927828,487760,2025-10-21,2025-11-07,671.3,-17,-440068,75641782,-43457618,0.644828806386396,89.2007330022976,-0.90222240446121
645.35,647,2800,2937,1128400,484605,2025-10-21,2025-10-31,671.3,137,-643795,118384054,-132327608,0.409349894370064,88.7455949092603,-1.32849434075175
670.1,693,210,210,837690,480900,2025-10-21,2025-11-28,671.3,0,-356790,134798008,-74418053,0.35675601378323,88.6491171293867,-0.741921397379913
494.16,495,5696,5720,899968,480480,2025-10-21,2025-12-19,671.3,24,-419488,452890228,-117820487,0.106091933606481,98.3190456474146,-0.873060273060273
640.59,646,866,888,762080,480408,2025-10-21,2025-11-28,671.3,22,-281672,134798008,-74418053,0.356391023226397,89.0055081526131,-0.586318296114969
591.71,592,16323,16324,1387455,473396,2025-10-21,2025-10-31,671.3,1,-914059,118384054,-132327608,0.399881558372718,89.1454764676331,-1.93085492906573
636.19,641,957,981,755073,471861,2025-10-21,2025-11-28,671.3,24,-283212,134798008,-74418053,0.350050425077498,89.3555585776906,-0.60020217818383
663.15,673,451,474,811800,466890,2025-10-21,2025-11-14,671.3,23,-344910,44392815,-28335435,1.05172424861996,80.8748127371513,-0.738739317612286
469.36,470,7006,7106,700600,454784,2025-10-21,2025-12-19,671.3,100,-245816,452890228,-117820487,0.100418152541812,98.4194637999564,-0.540511539544047
636.95,639,2197,2188,973271,448540,2025-10-21,2025-11-07,671.3,-9,-524731,75641782,-43457618,0.592979155356229,89.7937121576538,-1.16986444910153
618.35,620,2744,2690,850640,443850,2025-10-21,2025-11-14,671.3,-54,-406790,44392815,-28335435,0.999823957998609,81.8746366951499,-0.916503323194773
650.74,653,1891,1942,971974,438892,2025-10-21,2025-10-31,671.3,51,-533082,118384054,-132327608,0.370735741149733,89.5162122087828,-1.21460860530609
608.73,610,3267,3443,800415,437261,2025-10-21,2025-11-14,671.3,176,-363154,44392815,-28335435,0.984981466032285,82.8596181611822,-0.830519986918568
627.86,631,1368,1384,738720,434576,2025-10-21,2025-11-21,671.3,16,-304144,432623087,-236699682,0.100451412108758,98.2726869590295,-0.699863775266007
584.76,585,17863,17846,1339725,428304,2025-10-21,2025-10-31,671.3,-17,-911421,118384054,-132327608,0.361791969043398,89.8780041778262,-2.12797685755912
633.29,637,784,1151,478240,427021,2025-10-21,2025-11-21,671.3,367,-51219,432623087,-236699682,0.0987050882931729,98.3713920473227,-0.119944920741603
614.07,615,4095,4590,827190,426870,2025-10-21,2025-11-07,671.3,495,-400320,75641782,-43457618,0.564330967242416,90.3580431248962,-0.937803078220536
656.13,657,4337,4879,1500602,424473,2025-10-21,2025-10-24,671.3,542,-1076129,35747412,-54558423,1.1874230223995,84.4779644467689,-2.5352118980477
627.3,631,1141,1139,669767,421430,2025-10-21,2025-11-28,671.3,-2,-248337,134798008,-74418053,0.312638151151314,89.6681967288419,-0.58927223975512
623.08,625,2169,2176,765657,417792,2025-10-21,2025-11-14,671.3,7,-347865,44392815,-28335435,0.941125269933885,83.8007434311161,-0.832627240349265
643.18,649,699,717,643080,417294,2025-10-21,2025-11-28,671.3,18,-225786,134798008,-74418053,0.309569856551589,89.9777665853935,-0.541071762354599
344.83,345,24354,24354,706266,414018,2025-10-21,2025-12-19,671.3,0,-292248,452890228,-117820487,0.0914168543287713,98.5108806542852,-0.705882352941177
611.58,612,9761,9749,1093232,409458,2025-10-21,2025-10-31,671.3,-12,-683774,118384054,-132327608,0.345872595307473,90.2238767731337,-1.66994905460389
549.87,550,31118,31077,1244720,404001,2025-10-21,2025-10-31,671.3,-41,-840719,118384054,-132327608,0.341263021791769,90.5651397949254,-2.08098247281566
424.6,425,9924,9906,605364,396240,2025-10-21,2025-12-19,671.3,-18,-209124,452890228,-117820487,0.0874913997923576,98.5983720540775,-0.527771047849788
642.58,644,2490,2759,946200,391778,2025-10-21,2025-10-31,671.3,269,-554422,118384054,-132327608,0.330938151518278,90.8960779464437,-1.41514326991306
614.53,615,8503,8322,1045869,391134,2025-10-21,2025-10-31,671.3,-181,-654735,118384054,-132327608,0.330394159335006,91.2264721057787,-1.67394038871589
434.56,435,8711,8810,775279,387640,2025-10-21,2025-12-19,671.3,99,-387639,452890228,-117820487,0.0855924848968038,98.6839645389743,-0.999997420286864
653.35,654,5649,5949,1581720,386685,2025-10-21,2025-10-24,671.3,300,-1195035,35747412,-54558423,1.0817146707012,85.5596791174701,-3.09046122813143
648.96,651,1781,1880,845975,383520,2025-10-21,2025-10-31,671.3,99,-462455,118384054,-132327608,0.323962549888687,91.5504346556674,-1.20581716729245
474.33,475,5664,5715,730656,382905,2025-10-21,2025-12-19,671.3,51,-347751,452890228,-117820487,0.084546977683961,98.7685115166583,-0.908191326830415
664,672.5,385,445,685300,378250,2025-10-21,2025-11-07,671.3,60,-307050,75641782,-43457618,0.5000543218297,90.8580974467259,-0.811764705882353
670.04,682,29,314,52026,375544,2025-10-21,2025-10-31,671.3,285,323518,118384054,-132327608,0.317225156016367,91.8676598116838,0.861464968152866
659.93,666,604,610,657152,370270,2025-10-21,2025-11-07,671.3,6,-286882,75641782,-43457618,0.489504596811323,91.3476020435373,-0.774791368460853
660.44,669,415,425,568550,363800,2025-10-21,2025-11-14,671.3,10,-204750,44392815,-28335435,0.81950198472433,84.6202454158404,-0.56280923584387
652.37,653,4691,5746,1247806,361998,2025-10-21,2025-10-24,671.3,1055,-885808,35747412,-54558423,1.01265512591513,86.5723342433852,-2.4469969447345
598.97,600,3418,3499,659674,360397,2025-10-21,2025-11-14,671.3,81,-299277,44392815,-28335435,0.81183632982049,85.4320817456609,-0.830409243140204
616.67,619,1539,1539,592515,358587,2025-10-21,2025-11-21,671.3,0,-233928,432623087,-236699682,0.0828866999416515,98.4542787472644,-0.652360515021459
661.81,686,148,148,358012,358012,2025-10-21,2025-11-21,671.3,0,0,432623087,-236699682,0.0827537897902337,98.5370325370546,0
642.17,648,561,604,505461,352132,2025-10-21,2025-11-28,671.3,43,-153329,134798008,-74418053,0.261229379591425,90.2389959649849,-0.435430463576159
659.35,667,415,459,500075,351135,2025-10-21,2025-11-14,671.3,44,-148940,44392815,-28335435,0.790972593200048,86.2230543388609,-0.424167343044698
656.31,663,493,523,538356,349887,2025-10-21,2025-11-14,671.3,30,-188469,44392815,-28335435,0.788161327458058,87.011215666319,-0.538656766327414
578.7,580,2671,2690,667750,349700,2025-10-21,2025-11-28,671.3,19,-318050,134798008,-74418053,0.259425198627564,90.4984211636125,-0.909493851873034
589.73,590,12798,12747,921456,344169,2025-10-21,2025-10-31,671.3,-51,-577287,118384054,-132327608,0.29072243124906,92.1583822429328,-1.67733584372794
504.81,505,18066,18066,343254,343254,2025-10-21,2025-10-31,671.3,0,0,118384054,-132327608,0.289949523100468,92.4483317660333,0
658.27,664,648,599,632448,343227,2025-10-21,2025-11-07,671.3,-49,-289221,75641782,-43457618,0.453753191589273,91.8013552351265,-0.842652238897289
651.9,656,852,837,628776,343170,2025-10-21,2025-11-07,671.3,-15,-285606,75641782,-43457618,0.45367783641057,92.2550330715371,-0.832258064516129
669.89,676,415,561,511280,342771,2025-10-21,2025-10-24,671.3,146,-168509,35747412,-54558423,0.958869414099124,87.5312036574844,-0.491608099868425
634.42,639,739,748,547599,342584,2025-10-21,2025-11-28,671.3,9,-205015,134798008,-74418053,0.25414618886653,90.752567352479,-0.598437171613385
664.94,676,307,308,555363,340648,2025-10-21,2025-11-14,671.3,1,-214715,44392815,-28335435,0.767349401023567,87.7785650673425,-0.630313402691341
620.46,623,1308,1337,601680,339598,2025-10-21,2025-11-21,671.3,29,-262082,432623087,-236699682,0.0784974288716127,98.6155299659262,-0.771741883049959
374.77,375,14684,14686,587360,337778,2025-10-21,2025-12-19,671.3,2,-249582,452890228,-117820487,0.0745827529756283,98.8430942696339,-0.738893592833163
658.69,666,421,456,493833,333336,2025-10-21,2025-11-14,671.3,35,-160497,44392815,-28335435,0.750878267124984,88.5294433344675,-0.481487148102815
641.62,643,2286,2413,777240,332994,2025-10-21,2025-10-31,671.3,127,-444246,118384054,-132327608,0.281282815335924,92.7296145813692,-1.33409610983982
637.03,642,626,668,488280,331996,2025-10-21,2025-11-28,671.3,42,-156284,134798008,-74418053,0.246291473387352,90.9988588258663,-0.470740611332667
659.97,681,157,157,330171,330171,2025-10-21,2025-11-28,671.3,0,0,134798008,-74418053,0.24493759581373,91.2437964216801,0
614.26,617,1248,1192,580320,326608,2025-10-21,2025-11-28,671.3,-56,-253712,134798008,-74418053,0.242294381679587,91.4860908033596,-0.776808896291579
539.4,540,5351,5367,567206,322020,2025-10-21,2025-11-21,671.3,16,-245186,432623087,-236699682,0.0744343077557486,98.689964273682,-0.761399913048879
583.58,585,2213,2225,708160,315950,2025-10-21,2025-11-28,671.3,12,-392210,134798008,-74418053,0.23438773664964,91.7204785400093,-1.24136730495332
637.85,639,2454,2707,765648,311305,2025-10-21,2025-10-31,671.3,253,-454343,118384054,-132327608,0.262961935735027,92.9925765171043,-1.45947864634362
594.7,595,10383,10270,851406,308100,2025-10-21,2025-10-31,671.3,-113,-543306,118384054,-132327608,0.260254645444056,93.2528311625483,-1.76340798442064
459.97,460,100967,100969,1312571,302907,2025-10-21,2025-10-31,671.3,2,-1009664,118384054,-132327608,0.25586807493516,93.5086992374835,-3.3332474984071
612.38,615,1138,1146,469994,300252,2025-10-21,2025-11-28,671.3,8,-169742,134798008,-74418053,0.222742163964322,91.9432207039736,-0.565331787964776
671.26,680,262,343,399550,299782,2025-10-21,2025-10-24,671.3,81,-99768,35747412,-54558423,0.838611757404984,88.3698154148893,-0.332801836000827
669.12,674,497,612,516880,298656,2025-10-21,2025-10-24,671.3,115,-218224,35747412,-54558423,0.835461879030572,89.2052772939199,-0.730686810243223
640.73,642,2195,2347,715570,298069,2025-10-21,2025-10-31,671.3,152,-417501,118384054,-132327608,0.25178137589375,93.7604806133772,-1.40068574725986
649.19,654,539,602,450065,289562,2025-10-21,2025-11-14,671.3,63,-160503,44392815,-28335435,0.652272220177973,89.1817155546455,-0.554295798481845
639.79,640,11101,13754,1221110,288834,2025-10-21,2025-10-24,671.3,2653,-932276,35747412,-54558423,0.807985764116295,90.0132630580362,-3.22772249804386
628.2,632,745,757,471585,287660,2025-10-21,2025-11-28,671.3,12,-183925,134798008,-74418053,0.213400779631699,92.1566214836053,-0.639383299728847
651.19,659,358,368,419218,287408,2025-10-21,2025-11-28,671.3,10,-131810,134798008,-74418053,0.21321383324893,92.3698353168542,-0.458616322440572
429.58,430,6757,6758,574345,283836,2025-10-21,2025-12-19,671.3,1,-290509,452890228,-117820487,0.062672140499353,98.9057664101333,-1.02351005510224
464.36,465,4411,4414,396990,282496,2025-10-21,2025-12-19,671.3,3,-114494,452890228,-117820487,0.0623762630621388,98.9681426731954,-0.405294234254644
667.85,677,290,307,543750,280905,2025-10-21,2025-10-31,671.3,17,-262845,118384054,-132327608,0.23728280161786,93.9977634149951,-0.935707801569926
616.16,619,991,987,482617,280308,2025-10-21,2025-11-28,671.3,-4,-202309,134798008,-74418053,0.2079466930995,92.5777820099537,-0.721738230803259
641.49,644,521,1113,265710,279363,2025-10-21,2025-11-07,671.3,592,13652.9999999999,75641782,-43457618,0.369323662945963,92.6243567344831,0.0488718978533304
364.79,365,13263,13263,411153,278523,2025-10-21,2025-12-19,671.3,0,-132630,452890228,-117820487,0.0614990085412044,99.0296416817366,-0.476190476190476
657.22,664,253,408,277288,276624,2025-10-21,2025-11-14,671.3,155,-664,44392815,-28335435,0.623127864272631,89.8048434189181,-0.00240037017756955
667.03,680,188,209,360396,271073,2025-10-21,2025-11-14,671.3,21,-89323.0000000001,44392815,-28335435,0.610623588524404,90.4154670074425,-0.329516403330468
642.3,646,676,732,447512,270840,2025-10-21,2025-11-14,671.3,56,-176672,44392815,-28335435,0.610098728814562,91.0255657362571,-0.652311327721164
459.43,460,4756,4744,394748,270408,2025-10-21,2025-12-19,671.3,-12,-124340,452890228,-117820487,0.0597071836135974,99.0893488653502,-0.459823673855803
671,700,90,93,296100,269700,2025-10-21,2025-11-28,671.3,3,-26400,134798008,-74418053,0.200077140605817,92.7778591505596,-0.0978865406006674
644.43,646,1475,1705,569350,267685,2025-10-21,2025-10-31,671.3,230,-301665,118384054,-132327608,0.226115757110328,94.2238791721054,-1.12694024693203
623.45,627,736,745,420992,264475,2025-10-21,2025-11-28,671.3,9,-156517,134798008,-74418053,0.196200970566271,92.9740601211258,-0.591802627847623
655.19,656,2664,3199,852480,259119,2025-10-21,2025-10-24,671.3,535,-593361,35747412,-54558423,0.724860865452302,90.7381239234885,-2.28991698794762
653.2,659,481,444,470899,257520,2025-10-21,2025-11-14,671.3,-37,-213379,44392815,-28335435,0.580093873299091,91.6056596095562,-0.828591954022989
632.57,637,585,576,418275,255168,2025-10-21,2025-11-28,671.3,-9,-163107,134798008,-74418053,0.189296565866166,93.163356686992,-0.639214164785553
384.73,385,9417,9428,499101,254556,2025-10-21,2025-12-19,671.3,11,-244545,452890228,-117820487,0.0562069976921648,99.1455558630424,-0.960672700702399
641.48,647,434,458,380184,252816,2025-10-21,2025-11-28,671.3,24,-127368,134798008,-74418053,0.187551732960327,93.3509084199523,-0.503797228023543
663.65,677,174,187,425778,249645,2025-10-21,2025-11-28,671.3,13,-176133,134798008,-74418053,0.18519932431049,93.5361077442628,-0.705533858078472
636.04,639,823,843,459234,249528,2025-10-21,2025-11-14,671.3,20,-209706,44392815,-28335435,0.562090959989809,92.167750569546,-0.840410695392902
579.75,580,9946,9945,596760,248625,2025-10-21,2025-10-31,671.3,-1,-348135,118384054,-132327608,0.210015615785552,94.433894787891,-1.40024132730015
670.59,678,100,335,142300,248235,2025-10-21,2025-10-24,671.3,235,105935,35747412,-54558423,0.694413906103189,91.4325378295917,0.426752875299615
559.04,560,2310,2568,351120,246528,2025-10-21,2025-11-28,671.3,258,-104592,134798008,-74418053,0.182886975599817,93.7189947198626,-0.424260124610592
627.49,629,1259,1620,381477,244620,2025-10-21,2025-11-07,671.3,361,-136857,75641782,-43457618,0.323392698495654,92.9477494329787,-0.559467745891587
647.74,651,765,748,475065,243848,2025-10-21,2025-11-07,671.3,-17,-231217,75641782,-43457618,0.32237209853147,93.2701215315102,-0.948201338538762
657.06,662.5,376,448,364720,243712,2025-10-21,2025-11-07,671.3,72,-121008,75641782,-43457618,0.322192303719127,93.5923138352293,-0.496520483193277
629.03,633,615,611,402210,242567,2025-10-21,2025-11-28,671.3,-4,-159643,134798008,-74418053,0.179948504877016,93.8989432247396,-0.658139812917668
621.42,622,4195,4174,692175,242092,2025-10-21,2025-10-31,671.3,-21,-450083,118384054,-132327608,0.204497136075438,94.6383919239664,-1.8591403268179
646.02,649,789,811,461565,241678,2025-10-21,2025-11-07,671.3,22,-219887,75641782,-43457618,0.319503313658052,93.9118171488874,-0.909834573275184
639.78,641,1951,1976,641879,241072,2025-10-21,2025-10-31,671.3,25,-400807,118384054,-132327608,0.203635533549138,94.8420274575155,-1.66260287383023
651.45,652,2862,4372,692604,240460,2025-10-21,2025-10-24,671.3,1510,-452144,35747412,-54558423,0.672664079850032,92.1052019094417,-1.88032936870997
524.52,525,4801,4883,408085,234384,2025-10-21,2025-11-21,671.3,82,-173701,432623087,-236699682,0.0541774137911415,98.7441416874731,-0.741095808587617
626.33,627,3459,3481,643374,233227,2025-10-21,2025-10-31,671.3,22,-410147,118384054,-132327608,0.197008796471863,95.0390362539874,-1.75857426455771
587.01,589,1149,1148,303336,228452,2025-10-21,2025-11-28,671.3,-1,-74884,134798008,-74418053,0.169477281889804,94.0684205066294,-0.327788769632133
619.63,623,680,671,393040,226127,2025-10-21,2025-11-28,671.3,-9,-166913,134798008,-74418053,0.167752478953547,94.236172985583,-0.738138302812137
614.53,617,513,902,202635,222794,2025-10-21,2025-11-21,671.3,389,20159,432623087,-236699682,0.0514984074347378,98.7956400949079,0.0904826880436636
359.77,360,9615,9619,326910,221237,2025-10-21,2025-12-19,671.3,4,-105673,452890228,-117820487,0.0488500272962392,99.1944058903386,-0.477646144180223
618.89,622,707,708,339360,220188,2025-10-21,2025-11-28,671.3,1,-119172,134798008,-74418053,0.163346627496157,94.3995196130792,-0.541228404817701
671.39,720,30,45,167610,218745,2025-10-21,2025-11-28,671.3,15,51135,134798008,-74418053,0.16227613689959,94.5617957499787,0.233765343207845
589.19,591,1249,1198,518335,216838,2025-10-21,2025-11-28,671.3,-51,-301497,134798008,-74418053,0.160861427566496,94.7226571775452,-1.39042510998995
670.02,677,240,306,319200,213588,2025-10-21,2025-10-24,671.3,66,-105612,35747412,-54558423,0.597492204470634,92.7026941139124,-0.494465981234901
584.5,585,4293,4266,459351,213300,2025-10-21,2025-11-07,671.3,-27,-246051,75641782,-43457618,0.281987010829544,94.1938041597169,-1.15354430379747
627.3,628,1996,3036,391216,212520,2025-10-21,2025-10-31,671.3,1040,-178696,118384054,-132327608,0.17951742047962,95.218553674467,-0.840843214756258
635.08,637,1089,1101,456291,211392,2025-10-21,2025-11-07,671.3,12,-244899,75641782,-43457618,0.279464595374022,94.4732687550909,-1.15850647138965
668.6,686,120,121,306000,210540,2025-10-21,2025-11-14,671.3,1,-95460,44392815,-28335435,0.474265936953987,92.6420165065,-0.453405528640639
379.74,380,8025,7972,321000,207272,2025-10-21,2025-12-19,671.3,-53,-113728,452890228,-117820487,0.0457664986315404,99.2401723889702,-0.548689644525068
617.39,621,573,573,309993,206853,2025-10-21,2025-11-28,671.3,0,-103140,134798008,-74418053,0.153454048074657,94.8761112256199,-0.498614958448754
602.62,603,5354,5443,717436,206834,2025-10-21,2025-10-31,671.3,89,-510602,118384054,-132327608,0.174714408749678,95.3932680832167,-2.46865602367116
635.12,638,774,713,400932,205344,2025-10-21,2025-11-14,671.3,-61,-195588,44392815,-28335435,0.462561340162817,93.1045778466628,-0.952489481065919
630.88,631,17059,17072,1108835,204864,2025-10-21,2025-10-24,671.3,13,-903971,35747412,-54558423,0.573087640582205,93.2757817544946,-4.41254197906904
534.45,535,2873,3713,264316,204215,2025-10-21,2025-11-21,671.3,840,-60101.0000000001,432623087,-236699682,0.047203907081362,98.8428440019892,-0.294302573268369
651.65,657,358,380,321126,203300,2025-10-21,2025-11-14,671.3,22,-117826,44392815,-28335435,0.457956991463596,93.5625348381264,-0.579567142154452
631.68,636,993,470,684177,203040,2025-10-21,2025-11-28,671.3,-523,-481137,134798008,-74418053,0.150625371259195,95.0267365968791,-2.36966607565012
624.49,628,582,577,338142,202527,2025-10-21,2025-11-28,671.3,-5,-135615,134798008,-74418053,0.150244801837131,95.1769813987162,-0.669614421780799
605.28,607,1182,1169,381786,201068,2025-10-21,2025-11-21,671.3,-13,-180718,432623087,-236699682,0.0464764840439503,98.8893204860332,-0.898790458949211
519.54,520,4318,4326,345440,198996,2025-10-21,2025-11-21,671.3,8,-146444,432623087,-236699682,0.0459975452026674,98.9353180312358,-0.735914289734467
630.23,631,2554,2576,572096,198352,2025-10-21,2025-10-31,671.3,22,-373744,118384054,-132327608,0.167549592447645,95.5608176756643,-1.88424618859402
529.5,530,3849,3952,365655,197600,2025-10-21,2025-11-21,671.3,103,-168055,432623087,-236699682,0.0456748624698339,98.9809928937057,-0.850480769230769
554.86,555,14011,14032,546429,196448,2025-10-21,2025-10-31,671.3,21,-349981,118384054,-132327608,0.165941267731886,95.7267589433962,-1.781545243525
625.99,629,565,651,289845,195951,2025-10-21,2025-11-21,671.3,86,-93894,432623087,-236699682,0.0452936992703767,99.026286592976,-0.479170813111441
613.85,616,961,907,345960,195005,2025-10-21,2025-11-21,671.3,-54,-150955,432623087,-236699682,0.0450750331777832,99.0713616261538,-0.774108356195995
650.35,654,534,534,380208,194910,2025-10-21,2025-11-07,671.3,0,-185298,75641782,-43457618,0.257675050542834,94.7309438056338,-0.950684931506849
635.84,636,12093,12174,1039998,194784,2025-10-21,2025-10-24,671.3,81,-845214,35747412,-54558423,0.544889795099013,93.8206715495936,-4.33923730901922
389.72,390,6928,6942,387968,194376,2025-10-21,2025-12-19,671.3,14,-193592,452890228,-117820487,0.04291900950444,99.2830913984746,-0.995966580236243
600.03,602,978,982,437166,193454,2025-10-21,2025-11-28,671.3,4,-243712,134798008,-74418053,0.14351399020674,95.320495388923,-1.25979302573222
644.2,647,445,683,253650,191240,2025-10-21,2025-11-07,671.3,238,-62410,75641782,-43457618,0.252823234650923,94.9837670402847,-0.326343861116921
439.53,440,4038,4032,294774,189504,2025-10-21,2025-12-19,671.3,-6,-105270,452890228,-117820487,0.041843252135703,99.3249346506103,-0.555502786220871
643.35,646,703,714,385244,189210,2025-10-21,2025-11-07,671.3,11,-196034,75641782,-43457618,0.250139532672565,95.2339065729573,-1.03606574705354
658.35,684,71,71,182115,182115,2025-10-21,2025-11-21,671.3,0,0,432623087,-236699682,0.0420955343051306,99.1134571604589,0
606.16,608,971,988,293242,181792,2025-10-21,2025-11-21,671.3,17,-111450,432623087,-236699682,0.0420208734722472,99.1554780339312,-0.61306328111248
609.21,610,2097,2269,387945,179251,2025-10-21,2025-11-07,671.3,172,-208694,75641782,-43457618,0.236973528730457,95.4708801016877,-1.16425570847582
544.36,545,2899,2799,356577,179136,2025-10-21,2025-11-21,671.3,-100,-177441,432623087,-236699682,0.0414069441467418,99.1968849780779,-0.990537915326902
635.98,637,1744,1753,470880,178806,2025-10-21,2025-10-31,671.3,9,-292074,118384054,-132327608,0.151038922860337,95.8777978662565,-1.6334686755478
569.81,570,9274,9400,482248,178600,2025-10-21,2025-10-31,671.3,126,-303648,118384054,-132327608,0.150864912938359,96.0286627791949,-1.70015677491601
640.38,644,494,492,311714,178104,2025-10-21,2025-11-14,671.3,-2,-133610,44392815,-28335435,0.401200059063612,93.96373489719,-0.75017967030499
629.93,634,419,423,343161,172161,2025-10-21,2025-11-28,671.3,4,-171000,134798008,-74418053,0.127717762713526,95.4482131516365,-0.993256312405248
613.36,616,650,651,371800,171864,2025-10-21,2025-11-28,671.3,1,-199936,134798008,-74418053,0.12749743304812,95.5757105846846,-1.16333845366103
668.92,679,77,170,124355,171360,2025-10-21,2025-10-31,671.3,93,47005,118384054,-132327608,0.144749224418349,96.1734120036133,0.274305555555556
668.03,680,142,143,253754,171171,2025-10-21,2025-11-07,671.3,1,-82583,75641782,-43457618,0.226291601644181,95.6971717033319,-0.48245906140643
666.37,681,95,117,182495,171171,2025-10-21,2025-11-21,671.3,22,-11324,432623087,-236699682,0.0395658496144936,99.2364508276924,-0.0661560661560662
394.71,395,5732,5718,332456,165822,2025-10-21,2025-12-19,671.3,-14,-166634,452890228,-117820487,0.0366141704430858,99.3615488210534,-1.00489681706891
663.65,674,40,160,62160,165600,2025-10-21,2025-11-14,671.3,120,103440,44392815,-28335435,0.373033338840981,94.336768236031,0.62463768115942
607.06,609,814,851,271062,165094,2025-10-21,2025-11-21,671.3,37,-105968,432623087,-236699682,0.0381611626750747,99.2746119903675,-0.641864634692963
558.27,559,2243,2243,163739,163739,2025-10-21,2025-10-31,671.3,0,0,118384054,-132327608,0.138311702013516,96.3117237056268,0
644.62,647.5,545,568,314465,163584,2025-10-21,2025-11-07,671.3,23,-150881,75641782,-43457618,0.216261430752649,95.9134331340846,-0.922345706181533
414.8,415,8104,8104,162080,162080,2025-10-21,2025-11-21,671.3,0,0,432623087,-236699682,0.0374644823335561,99.3120764727011,0
644.07,648,381,406,267843,159558,2025-10-21,2025-11-14,671.3,25,-108285,44392815,-28335435,0.359423028253559,94.6961912642846,-0.678656037303049
629.69,633,470,480,264610,158880,2025-10-21,2025-11-21,671.3,10,-105730,432623087,-236699682,0.0367248084474049,99.3488012811485,-0.665470795568983
668.6,697,52,53,190892,150520,2025-10-21,2025-11-28,671.3,1,-40372,134798008,-74418053,0.111663371167918,95.6873739558525,-0.268216848259368
618.52,621,575,603,232300,149544,2025-10-21,2025-11-21,671.3,28,-82756,432623087,-236699682,0.0345668098845589,99.383368091033,-0.55338896913283
581.78,584,673,673,149406,149406,2025-10-21,2025-11-28,671.3,0,0,134798008,-74418053,0.110836949459965,95.7982109053125,0
600.65,601,4267,4267,409632,149345,2025-10-21,2025-10-31,671.3,0,-260287,118384054,-132327608,0.126152969892381,96.4378766755192,-1.74285714285714
574.8,575,7171,7386,451773,147720,2025-10-21,2025-10-31,671.3,215,-304053,118384054,-132327608,0.124780318808815,96.562656994328,-2.05830625507717
598.97,601,715,718,260260,145754,2025-10-21,2025-11-28,671.3,3,-114506,134798008,-74418053,0.108127710611273,95.9063386159238,-0.785611372586687
603.84,605,1238,1256,268646,145696,2025-10-21,2025-11-14,671.3,18,-122950,44392815,-28335435,0.328197254443089,95.0243885187276,-0.843880408521854
649.41,653,393,405,262131,145395,2025-10-21,2025-11-07,671.3,12,-116736,75641782,-43457618,0.192215196622417,96.105648330707,-0.802888682554421
660.26,681,70,70,145180,145180,2025-10-21,2025-11-07,671.3,0,0,75641782,-43457618,0.191930962176433,96.2975792928834,0
668.9,685,46,90,104650,144900,2025-10-21,2025-11-14,671.3,44,40250,44392815,-28335435,0.326404171485859,95.3507926902135,0.277777777777778
419.89,420,13060,13060,365680,143660,2025-10-21,2025-11-21,671.3,0,-222020,432623087,-236699682,0.0332067345263985,99.4165748255594,-1.54545454545455
349.83,350,8502,8443,238056,143531,2025-10-21,2025-12-19,671.3,-59,-94525,452890228,-117820487,0.0316922271946217,99.393241048248,-0.658568532233455
625.35,629,367,392,213227,143080,2025-10-21,2025-11-28,671.3,25,-70147,134798008,-74418053,0.106144001771896,96.0124826176957,-0.490264187866928
634.86,635,11072,10151,896832,142114,2025-10-21,2025-10-24,671.3,-921,-754718,35747412,-54558423,0.397550457638724,94.2182220072323,-5.3106520117652
334.83,335,8133,8333,211458,141661,2025-10-21,2025-12-19,671.3,200,-69797,452890228,-117820487,0.0312793236068675,99.4245203718549,-0.492704414058915
659.64,695,40,40,141440,141440,2025-10-21,2025-11-28,671.3,0,0,134798008,-74418053,0.10492736658245,96.1174099842781,0
623.4,624,2308,2333,380820,139980,2025-10-21,2025-10-31,671.3,25,-240840,118384054,-132327608,0.118242276109247,96.6808992704372,-1.72053150450064
650.88,656,190,273,162640,139776,2025-10-21,2025-11-14,671.3,83,-22864,44392815,-28335435,0.314861763102881,95.6656544533164,-0.163576007326007
622.4,623,2349,2317,387585,139020,2025-10-21,2025-10-31,671.3,-32,-248565,118384054,-132327608,0.117431356084494,96.7983306265217,-1.78798014674148
625.32,626,2042,2038,359392,138584,2025-10-21,2025-10-31,671.3,-4,-220808,118384054,-132327608,0.117063063239919,96.9153936897616,-1.5933152456272
638.78,644,262,265,214840,138330,2025-10-21,2025-11-28,671.3,3,-76510,134798008,-74418053,0.102620210826854,96.220030195105,-0.553097665003976
644.79,649,309,325,224025,136825,2025-10-21,2025-11-14,671.3,16,-87200,44392815,-28335435,0.3082142909838,95.9738687443002,-0.637310433034899
648.43,653,301,299,242305,136643,2025-10-21,2025-11-14,671.3,-2,-105662,44392815,-28335435,0.30780431472976,96.2816730590299,-0.773270493182966
624.91,625,14687,15146,690289,136314,2025-10-21,2025-10-24,671.3,459,-553975,35747412,-54558423,0.381325506864665,94.599547514097,-4.06396261572546
615.76,618,688,596,259376,133504,2025-10-21,2025-11-21,671.3,-92,-125872,432623087,-236699682,0.0308591945302263,99.4474340200897,-0.942833173537871
274.93,275,19068,19068,266952,133476,2025-10-21,2025-12-19,671.3,0,-133476,452890228,-117820487,0.029472042395227,99.4539924142501,-1
604.3,605,1072,1869,167232,130830,2025-10-21,2025-11-07,671.3,797,-36402,75641782,-43457618,0.172959965432861,96.4705392583163,-0.278238936023848
638.79,642,383,404,227885,129684,2025-10-21,2025-11-14,671.3,21,-98201,44392815,-28335435,0.292128354554673,96.5738014135846,-0.757232966287283
639.77,642,557,578,272930,128894,2025-10-21,2025-11-07,671.3,21,-144036,75641782,-43457618,0.170400533398327,96.6409397917146,-1.11747637593682
652.55,658,248,236,233120,128620,2025-10-21,2025-11-14,671.3,-12,-104500,44392815,-28335435,0.289731570300284,96.8635329838849,-0.812470844347691
669.5,681,22,110,45782,126500,2025-10-21,2025-10-31,671.3,88,80718,118384054,-132327608,0.106855607428345,97.02224929719,0.638086956521739
671.7,710,32,33,128416,126390,2025-10-21,2025-12-19,671.3,1,-2026.00000000003,452890228,-117820487,0.0279074248429136,99.481899839093,-0.0160297491890184
620.26,624,278,337,148730,126038,2025-10-21,2025-11-28,671.3,59,-22692,134798008,-74418053,0.0935013817118128,96.3135315768168,-0.180040940033958
615.2,618,455,447,204750,125160,2025-10-21,2025-11-28,671.3,-8,-79590,134798008,-74418053,0.0928500367750241,96.4063816135918,-0.635906040268457
594.26,596,714,719,215628,125106,2025-10-21,2025-11-28,671.3,5,-90522,134798008,-74418053,0.0928099768358595,96.4991915904277,-0.72356241906863
635.01,636,1126,1263,314154,125037,2025-10-21,2025-10-31,671.3,137,-189117,118384054,-132327608,0.105619799098956,97.1278690962889,-1.51248830346218
632.32,634,739,743,263823,124824,2025-10-21,2025-11-07,671.3,4,-138999,75641782,-43457618,0.165019909234819,96.8059597009494,-1.1135598923284
324.87,325,9579,9572,296949,124436,2025-10-21,2025-12-19,671.3,-7,-172513,452890228,-117820487,0.0274759737143191,99.5093758128073,-1.38635925294931
602.37,604,753,756,264303,123228,2025-10-21,2025-11-21,671.3,3,-141075,432623087,-236699682,0.0284839167633234,99.475917936853,-1.14482909728309
638.78,641,522,551,247950,122322,2025-10-21,2025-11-07,671.3,29,-125628,75641782,-43457618,0.161712213495975,96.9676719144454,-1.02702702702703
409.66,410,3581,3580,196955,121720,2025-10-21,2025-12-19,671.3,-1,-75235,452890228,-117820487,0.0268762698938163,99.5362520827012,-0.618098915543872
630.39,632,774,755,267030,121555,2025-10-21,2025-11-07,671.3,-19,-145475,75641782,-43457618,0.160698223635186,97.1283701380806,-1.19678334910123
605.61,606,3109,3101,345099,120939,2025-10-21,2025-10-31,671.3,-8,-224160,118384054,-132327608,0.102158184243293,97.2300272805322,-1.85349639074244
631.16,632,1367,1439,323979,120876,2025-10-21,2025-10-31,671.3,72,-203103,118384054,-132327608,0.102104967616669,97.3321322481489,-1.68025910850789
601.95,604,599,583,236605,119515,2025-10-21,2025-11-28,671.3,-16,-117090,134798008,-74418053,0.0886622894308646,96.5878538798585,-0.97970965987533
439.85,440,7934,7933,341162,118995,2025-10-21,2025-11-21,671.3,-1,-222167,432623087,-236699682,0.027505466900799,99.5034234037538,-1.86702802638766
299.91,300,12913,12910,219521,116190,2025-10-21,2025-12-19,671.3,-3,-103331,452890228,-117820487,0.0256552234551636,99.5619073061563,-0.889327825114038
668.39,688,53,59,136210,115699,2025-10-21,2025-11-21,671.3,6,-20511,432623087,-236699682,0.0267436027980633,99.5301670065518,-0.177278973889143
509.61,510,2970,2953,207900,115167,2025-10-21,2025-11-21,671.3,-17,-92733,432623087,-236699682,0.0266206320144907,99.5567876385663,-0.805204615905598
574.3,575,1635,1639,225630,114730,2025-10-21,2025-11-14,671.3,4,-110900,44392815,-28335435,0.258442723219963,97.1219757071049,-0.966617275342107
249.95,250,22932,22942,183456,114710,2025-10-21,2025-12-19,671.3,10,-68746,452890228,-117820487,0.0253284334498823,99.5872357396062,-0.599302589137826
653.23,657.5,268,265,209844,113155,2025-10-21,2025-11-07,671.3,-3,-96689,75641782,-43457618,0.149593249931632,97.2779633880122,-0.854482789094605
259.96,260,28192,28200,281920,112800,2025-10-21,2025-12-19,671.3,8,-169120,452890228,-117820487,0.0249066976998232,99.612142437306,-1.49929078014184
581.5,583,734,736,227540,110400,2025-10-21,2025-11-28,671.3,2,-117140,134798008,-74418053,0.0819003200700117,96.6697541999285,-1.06105072463768
670.64,687,63,67,146034,109612,2025-10-21,2025-11-07,671.3,4,-36422,75641782,-43457618,0.144909330665954,97.4228727186782,-0.332281137101777
600.99,603,543,545,231861,109545,2025-10-21,2025-11-28,671.3,2,-122316,134798008,-74418053,0.0812660376999043,96.7510202376284,-1.11658222648227
640.64,643,502,459,239454,108324,2025-10-21,2025-11-07,671.3,-43,-131130,75641782,-43457618,0.143206568031409,97.5660792867096,-1.21053506148222
671.35,681,81,111,130815,107115,2025-10-21,2025-10-24,671.3,30,-23700,35747412,-54558423,0.299644069338502,94.8991915834355,-0.221257526957009
670.28,699,27,37,84024,106264,2025-10-21,2025-11-28,671.3,10,22240,134798008,-74418053,0.0788320254702874,96.8298522630987,0.209290070014304
666.47,683,54,64,118260,105792,2025-10-21,2025-11-21,671.3,10,-12468,432623087,-236699682,0.0244536186761572,99.5812412572425,-0.11785390199637
650.51,651,1736,2155,394072,105595,2025-10-21,2025-10-24,671.3,419,-288477,35747412,-54558423,0.295392013273576,95.194583596709,-2.73191912495857
609.33,612,426,395,170400,105465,2025-10-21,2025-11-28,671.3,-31,-64935,134798008,-74418053,0.0782392867407952,96.9080915498395,-0.615701891622814
647.47,652,240,230,190800,104190,2025-10-21,2025-11-14,671.3,-10,-86610,44392815,-28335435,0.234700142354117,97.356675849459,-0.831269795565793
610.59,611,2439,2532,268290,103812,2025-10-21,2025-10-31,671.3,93,-164478,118384054,-132327608,0.0876908641766906,97.4198231123256,-1.58438330828806
414.65,415,2963,2963,213336,103705,2025-10-21,2025-12-19,671.3,0,-109631,452890228,-117820487,0.0228984847957461,99.6350409221018,-1.05714285714286
666.32,676,100,107,149800,103576,2025-10-21,2025-11-07,671.3,7,-46224,75641782,-43457618,0.136929613847543,97.7030089005571,-0.446280991735537
239.96,240,25860,25872,258600,103488,2025-10-21,2025-12-19,671.3,12,-155112,452890228,-117820487,0.022850570315242,99.657891492417,-1.49884044526902
603.89,606,447,488,163602,102968,2025-10-21,2025-11-28,671.3,41,-60634,134798008,-74418053,0.0763868854797914,96.9844784353193,-0.588862559241706
429.99,430,102270,102264,1329510,102264,2025-10-21,2025-10-31,671.3,-6,-1227246,118384054,-132327608,0.0863832556367769,97.5062063679624,-12.0007627317531
628.26,629,1354,1353,274862,100122,2025-10-21,2025-10-31,671.3,-1,-174740,118384054,-132327608,0.0845738903315475,97.5907802582939,-1.74527076966101
631.36,633,589,604,219108,99056,2025-10-21,2025-11-07,671.3,15,-120052,75641782,-43457618,0.130954080378487,97.8339629809356,-1.21196091099984
571.81,572,5215,5208,427630,98952,2025-10-21,2025-10-31,671.3,-7,-328678,118384054,-132327608,0.0835855815513802,97.6743658398453,-3.32159026598755
584.36,586,601,603,192320,98892,2025-10-21,2025-11-28,671.3,2,-93428,134798008,-74418053,0.0733631019235833,97.0578415372429,-0.944747805687012
591,593,489,488,141321,97600,2025-10-21,2025-11-28,671.3,-1,-43721,134798008,-74418053,0.0724046307865321,97.1302461680294,-0.447961065573771
671.29,679,74,126,109372,97146,2025-10-21,2025-10-24,671.3,52,-12226,35747412,-54558423,0.271756735844262,95.4663403325533,-0.125851810676713
647.61,648,2656,2488,494016,97032,2025-10-21,2025-10-24,671.3,-168,-396984,35747412,-54558423,0.271437831639393,95.7377781641927,-4.09126885975761
672,695,20,42,60000,96600,2025-10-21,2025-11-07,671.3,22,36600,75641782,-43457618,0.127707197590876,97.9616701785265,0.37888198757764
589.47,590,1884,1798,214776,95294,2025-10-21,2025-11-07,671.3,-86,-119482,75641782,-43457618,0.125980638584109,98.0876508171106,-1.25382500472223
643.13,647,249,245,169071,94815,2025-10-21,2025-11-14,671.3,-4,-74256,44392815,-28335435,0.213581860037486,97.5702577094965,-0.783167220376523
670.41,683,75,75,185100,94425,2025-10-21,2025-10-31,671.3,0,-90675,118384054,-132327608,0.079761586809656,97.7541274266549,-0.960285941223193
590.61,591,2283,2401,191772,93639,2025-10-21,2025-10-31,671.3,118,-98133,118384054,-132327608,0.0790976460393897,97.8332250726943,-1.04799282350303
531.5,533,618,618,92700,92700,2025-10-21,2025-11-28,671.3,0,0,134798008,-74418053,0.0687695622327001,97.1990157302621,0
665.43,679,64,68,121984,92276,2025-10-21,2025-11-21,671.3,4,-29708,432623087,-236699682,0.0213294210995263,99.602570678342,-0.321947201872643
494.57,495,2107,2102,151704,90386,2025-10-21,2025-11-28,671.3,-5,-61318,134798008,-74418053,0.067052919654421,97.2660686499166,-0.678401522359657
629.89,630,7398,8204,458676,90244,2025-10-21,2025-10-24,671.3,806,-368432,35747412,-54558423,0.252449044423132,95.9902272086158,-4.08262045122113
646.64,647,2199,2499,384825,89964,2025-10-21,2025-10-24,671.3,300,-294861,35747412,-54558423,0.251665770937488,96.2418929795533,-3.27754435107376
634.16,636,393,488,249555,89792,2025-10-21,2025-11-07,671.3,95,-159763,75641782,-43457618,0.118706880808281,98.2063576979189,-1.77925650392017
289.92,290,11215,11215,201870,89720,2025-10-21,2025-12-19,671.3,0,-112150,452890228,-117820487,0.0198105400498948,99.6777020324669,-1.25
631.87,632,6947,6823,472396,88699,2025-10-21,2025-10-24,671.3,-124,-383697,35747412,-54558423,0.248127053225559,96.4900200327789,-4.32583230927068
429.86,430,6206,6214,148944,86996,2025-10-21,2025-11-21,671.3,8,-61948,432623087,-236699682,0.0201089591873769,99.6226796375294,-0.712078716262817
669.03,682,25,67,46150,86899,2025-10-21,2025-11-07,671.3,42,40749,75641782,-43457618,0.11488227498395,98.3212399729028,0.468923693022935
665.68,682,52,53,117000,86496,2025-10-21,2025-11-14,671.3,1,-30504,44392815,-28335435,0.194842341041,97.7651000505375,-0.352663706992231
666.02,678,56,72,108472,86256,2025-10-21,2025-11-14,671.3,16,-22216,44392815,-28335435,0.194301713013694,97.9594017635512,-0.257558894453719
657.15,684,32,32,85920,85920,2025-10-21,2025-11-28,671.3,0,0,134798008,-74418053,0.0637398143153569,97.3298084642319,0
618.48,619,1433,1641,216383,85332,2025-10-21,2025-10-31,671.3,208,-131051,118384054,-132327608,0.0720806537002019,97.9053057263945,-1.53577790277973
660.91,667.5,105,129,115500,85011,2025-10-21,2025-11-07,671.3,24,-30489,75641782,-43457618,0.112386299942008,98.4336262728448,-0.358647704414723
610.07,612,373,439,128312,84727,2025-10-21,2025-11-21,671.3,66,-43585,432623087,-236699682,0.0195844841724778,99.6422641217019,-0.514416891899867
643.72,644,3065,3004,447490,84112,2025-10-21,2025-10-24,671.3,-61,-363378,35747412,-54558423,0.235295355087524,96.7253153878664,-4.32016834696595
621.41,624,280,324,146160,83916,2025-10-21,2025-11-21,671.3,44,-62244,432623087,-236699682,0.0193970230719564,99.6616611447738,-0.741741741741742
591.96,594,411,410,119190,83640,2025-10-21,2025-11-28,671.3,-1,-35550,134798008,-74418053,0.0620483946617372,97.3918568588937,-0.425035868005739
664.6,686,39,39,83460,83460,2025-10-21,2025-11-28,671.3,0,0,134798008,-74418053,0.0619148615311882,97.4537717204248,0
479.75,480,3293,3300,151478,82500,2025-10-21,2025-11-21,671.3,7,-68978,432623087,-236699682,0.0190697173773345,99.6807308621512,-0.83609696969697
593.18,594,1004,1004,82328,82328,2025-10-21,2025-10-31,671.3,0,0,118384054,-132327608,0.0695431497894134,97.974848876184,0
605.73,608,370,362,137270,82174,2025-10-21,2025-11-28,671.3,-8,-55096,134798008,-74418053,0.0609608414984886,97.5147325619233,-0.670479713778081
610.95,613,201,399,76983,81795,2025-10-21,2025-11-21,671.3,198,4812,432623087,-236699682,0.0189067579742918,99.6996376201255,0.0588300018338529
611.91,614,289,389,107797,81301,2025-10-21,2025-11-21,671.3,100,-26496,432623087,-236699682,0.0187925708181173,99.7184301909436,-0.325900050429884
667.06,679,66,68,122892,81192,2025-10-21,2025-11-07,671.3,2,-41700,75641782,-43457618,0.107337502968928,98.5409637758138,-0.513597398758498
612.55,613,1917,1804,226206,81180,2025-10-21,2025-10-31,671.3,-113,-145026,118384054,-132327608,0.0685734245931466,98.0434223007771,-1.78647450110865
622.64,626,236,234,154580,78624,2025-10-21,2025-11-28,671.3,-2,-75956,134798008,-74418053,0.0583272714237736,97.5730598333471,-0.966066341066341
636.02,638,364,394,146692,78012,2025-10-21,2025-11-07,671.3,30,-68680,75641782,-43457618,0.103133477209725,98.6440972530235,-0.880377377839307
404.66,405,2293,2293,130701,77962,2025-10-21,2025-12-19,671.3,0,-52739,452890228,-117820487,0.0172143259403689,99.6949163584073,-0.676470588235294
597.1,599,405,404,184275,76760,2025-10-21,2025-11-28,671.3,-1,-107515,134798008,-74418053,0.0569444616718668,97.630004295019,-1.40066440854612
589.16,590,912,912,162336,76608,2025-10-21,2025-11-14,671.3,0,-85728,44392815,-28335435,0.172568466316002,98.1319702298672,-1.11904761904762
637.83,641,239,240,140771,76080,2025-10-21,2025-11-14,671.3,1,-64691,44392815,-28335435,0.171379084655929,98.3033493145231,-0.850302313354364
304.91,305,8411,8401,201864,75609,2025-10-21,2025-12-19,671.3,-10,-126255,452890228,-117820487,0.0166947739927831,99.7116111324001,-1.66984089195731
590.35,592,445,454,115255,74910,2025-10-21,2025-11-28,671.3,9,-40345,134798008,-74418053,0.0555720378301139,97.6855763328491,-0.538579628887999
604.09,606,390,391,122850,74681,2025-10-21,2025-11-21,671.3,1,-48169,432623087,-236699682,0.017262370466142,99.7356925614097,-0.644996719379762
667.33,692,2,30,6858,74010,2025-10-21,2025-12-19,671.3,28,67152,452890228,-117820487,0.0163417083046446,99.7279528407047,0.907336846372112
648.58,649,951,1757,188298,73794,2025-10-21,2025-10-24,671.3,806,-114504,35747412,-54558423,0.206431727141534,96.931747115008,-1.55167086755021
608.99,611,281,365,96664,73365,2025-10-21,2025-11-21,671.3,84,-23299,432623087,-236699682,0.0169581795804624,99.7526507409902,-0.317576501056362
608.58,609,1741,1746,252445,73332,2025-10-21,2025-10-31,671.3,5,-179113,118384054,-132327608,0.0619441533907937,98.1053664541679,-2.44249440898925
354.81,355,3741,3746,127194,71174,2025-10-21,2025-12-19,671.3,5,-56020,452890228,-117820487,0.0157155079972271,99.7436683487019,-0.787085171551409
539.31,541,417,417,70473,70473,2025-10-21,2025-11-28,671.3,0,0,134798008,-74418053,0.0522804461620827,97.7378567790112,0
369.77,370,3029,3047,139334,70081,2025-10-21,2025-12-19,671.3,18,-69253,452890228,-117820487,0.0154741691622456,99.7591425178642,-0.988185100098458
571.65,573,516,516,154284,69660,2025-10-21,2025-11-28,671.3,0,-84624,134798008,-74418053,0.0516773215224367,97.7895341005336,-1.21481481481481
626.9,627,6828,6949,368712,69490,2025-10-21,2025-10-24,671.3,121,-299222,35747412,-54558423,0.19439169470506,97.126138809713,-4.305972082314
529.53,531,468,468,68796,68796,2025-10-21,2025-11-28,671.3,0,0,134798008,-74418053,0.0510363624958019,97.8405704630294,0
646.74,651,165,161,124080,68586,2025-10-21,2025-11-14,671.3,-4,-55494,44392815,-28335435,0.154497974503306,98.4578472890264,-0.809115562942875
639.59,643,214,201,124976,68541,2025-10-21,2025-11-14,671.3,-13,-56435,44392815,-28335435,0.154396606748187,98.6122438957746,-0.823375789673334
617.49,618,1324,1340,180064,68340,2025-10-21,2025-10-31,671.3,16,-111724,118384054,-132327608,0.0577273692620798,98.16309382343,-1.63482587064677
671.51,691,0,35,0,68215,2025-10-21,2025-11-07,671.3,35,68215,75641782,-43457618,0.0901816406176153,98.7342788936411,1
663.14,699,19,19,68134,68134,2025-10-21,2025-11-21,671.3,0,0,432623087,-236699682,0.0157490439246947,99.7683997849149,0
546.55,548,465,465,67425,67425,2025-10-21,2025-11-28,671.3,0,0,134798008,-74418053,0.0500192851514542,97.8905897481808,0
615.52,616,1433,1397,194888,67056,2025-10-21,2025-10-31,671.3,-36,-127832,118384054,-132327608,0.0566427637289732,98.219736587159,-1.90634693390599
638.8,639,3367,3348,360269,66960,2025-10-21,2025-10-24,671.3,-19,-293309,35747412,-54558423,0.187314259281203,97.3134530689942,-4.38036140979689
149.99,150,66388,66599,132776,66599,2025-10-21,2025-12-19,671.3,211,-66177,452890228,-117820487,0.0147053294336039,99.7738478472978,-0.99366356852205
574.55,576,455,456,102375,66120,2025-10-21,2025-11-28,671.3,1,-36255,134798008,-74418053,0.0490511699549744,97.9396409181358,-0.548321234119782
524.4,525,1063,1094,102048,65640,2025-10-21,2025-11-28,671.3,31,-36408,134798008,-74418053,0.0486950816068439,97.9883359997427,-0.554661791590494
219.97,220,21730,21780,108650,65340,2025-10-21,2025-12-19,671.3,50,-43310,452890228,-117820487,0.0144273371250572,99.7882751844228,-0.66284052647689
479.64,480,1682,1782,134560,64152,2025-10-21,2025-11-28,671.3,100,-70408,134798008,-74418053,0.0475912077276394,98.0359272074703,-1.09751839381469
540.44,542,403,403,62868,62868,2025-10-21,2025-11-28,671.3,0,0,134798008,-74418053,0.0466386713963904,98.0825658788667,0
666.91,691,0,26,0,62634,2025-10-21,2025-12-19,671.3,26,62634,452890228,-117820487,0.0138298413451305,99.802105025768,1
214.95,215,12482,12482,62410,62410,2025-10-21,2025-12-19,671.3,0,0,452890228,-117820487,0.0137803812362231,99.8158854070042,0
269.85,270,4149,4149,62235,62235,2025-10-21,2025-12-19,671.3,0,0,452890228,-117820487,0.0137417405261392,99.8296271475303,0
534.31,535,895,897,157520,61893,2025-10-21,2025-11-28,671.3,2,-95627,134798008,-74418053,0.0459153669392503,98.128481245806,-1.54503740326047
586.19,588,341,341,86955,61721,2025-10-21,2025-11-28,671.3,0,-25234,134798008,-74418053,0.0457877686145036,98.1742690144205,-0.408839779005525
549.52,550,781,1275,64823,61200,2025-10-21,2025-11-14,671.3,494,-3623,44392815,-28335435,0.137860146962971,98.7501040427376,-0.0591993464052288
620.45,621,1056,1102,157344,60610,2025-10-21,2025-10-31,671.3,46,-96734,118384054,-132327608,0.0511977736461027,98.270934360805,-1.59600725952813
607.59,608,1648,1476,201056,60516,2025-10-21,2025-10-31,671.3,-172,-140540,118384054,-132327608,0.0511183710603457,98.3220527318654,-2.32236102848833
279.92,280,7428,7508,118848,60064,2025-10-21,2025-12-19,671.3,80,-58784,452890228,-117820487,0.0132623749170406,99.8428895224474,-0.978689397975493
429.68,430,1871,1871,59872,59872,2025-10-21,2025-11-28,671.3,0,0,134798008,-74418053,0.0444160866234759,98.2186851010439,0
595.03,597,291,300,89628,59100,2025-10-21,2025-11-28,671.3,9,-30528,134798008,-74418053,0.0438433778635661,98.2625284789075,-0.516548223350254
564.76,566,491,475,116367,58900,2025-10-21,2025-11-28,671.3,-16,-57467,134798008,-74418053,0.0436950077185117,98.306223486626,-0.975670628183362
613.53,614,1112,1251,134552,58797,2025-10-21,2025-10-31,671.3,139,-75755,118384054,-132327608,0.0496663173910229,98.3717190492564,-1.28841607565012
566.83,569,270,270,58590,58590,2025-10-21,2025-11-28,671.3,0,0,134798008,-74418053,0.0434650339936774,98.3496885206197,0
494.68,495,1865,1828,111900,58496,2025-10-21,2025-11-21,671.3,-37,-53404,432623087,-236699682,0.0135212386388431,99.7819210235537,-0.912951312910284
671.28,690,9,31,22464,58032,2025-10-21,2025-10-31,671.3,22,35568,118384054,-132327608,0.0490201154962982,98.4207391647527,0.612903225806452
369.94,370,8758,9647,96338,57882,2025-10-21,2025-11-21,671.3,889,-38456,432623087,-236699682,0.0133793137119379,99.7953003372656,-0.664386164956291
489.6,490,1396,1444,93532,57760,2025-10-21,2025-11-28,671.3,48,-35772,134798008,-74418053,0.0428492978917018,98.3925378185114,-0.619321329639889
539.88,540,4649,4696,185960,56352,2025-10-21,2025-10-31,671.3,47,-129608,118384054,-132327608,0.047601005452981,98.4683401702057,-2.29997160704145
664.56,679,38,39,75962,56316,2025-10-21,2025-11-28,671.3,1,-19646,134798008,-74418053,0.0417780654444092,98.4343158839558,-0.34885290148448
544.21,545,705,705,95880,55695,2025-10-21,2025-11-28,671.3,0,-40185,134798008,-74418053,0.0413173761440154,98.4756332600998,-0.721518987341772
535.33,537,333,333,55611,55611,2025-10-21,2025-11-28,671.3,0,0,134798008,-74418053,0.0412550606830926,98.5168883207829,0
329.88,330,4612,4608,119912,55296,2025-10-21,2025-12-19,671.3,-4,-64616,452890228,-117820487,0.0122095811702963,99.8550991036177,-1.1685474537037
504.62,505,1447,1455,89714,55290,2025-10-21,2025-11-21,671.3,8,-34424,432623087,-236699682,0.0127801778641555,99.8080805151298,-0.622608066558148
669.53,683,39,41,96525,55227,2025-10-21,2025-11-07,671.3,2,-41298,75641782,-43457618,0.0730112360388337,98.8072901296799,-0.747786408821772
611.39,614,212,211,110240,55071,2025-10-21,2025-11-28,671.3,-1,-55169,134798008,-74418053,0.0408544612914458,98.5577427820743,-1.00177952098201
562.8,563,2738,2738,249158,54760,2025-10-21,2025-10-31,671.3,0,-194398,118384054,-132327608,0.0462562297452662,98.514596399951,-3.55
633.87,634,3055,4168,241345,54184,2025-10-21,2025-10-24,671.3,1113,-187161,35747412,-54558423,0.15157460909338,97.4650276780876,-3.45417466410749
601.38,603,332,334,95948,54108,2025-10-21,2025-11-21,671.3,2,-41840,432623087,-236699682,0.0125069608224584,99.8205874759523,-0.773268278258298
642.72,643,1841,1923,246694,53844,2025-10-21,2025-10-24,671.3,82,-192850,35747412,-54558423,0.150623491289383,97.615651169377,-3.58164326573063
614.93,615,7665,7547,245280,52829,2025-10-21,2025-10-24,671.3,-118,-192451,35747412,-54558423,0.147784124903923,97.7634352942809,-3.64290446535047
564.64,565,1456,1467,122304,52812,2025-10-21,2025-11-07,671.3,11,-69492,75641782,-43457618,0.0698185560990618,98.877108685779,-1.31583730970234
527.92,529,489,489,52812,52812,2025-10-21,2025-11-28,671.3,0,0,134798008,-74418053,0.0391786205030567,98.5969214025774,0
670.47,686,20,34,51600,52802,2025-10-21,2025-11-07,671.3,14,1202,75641782,-43457618,0.0698053358922718,98.9469140216713,0.0227642892314685
667.77,694,20,20,52460,52460,2025-10-21,2025-11-21,671.3,0,0,432623087,-236699682,0.0121260287710905,99.8327135047234,0
608.66,611,223,223,88531,52182,2025-10-21,2025-11-28,671.3,0,-36349,134798008,-74418053,0.0387112545461354,98.6356326571235,-0.696581196581197
524.88,525,4341,4341,112866,52092,2025-10-21,2025-10-31,671.3,0,-60774,118384054,-132327608,0.0440025478431411,98.5585989477941,-1.16666666666667
384.92,385,6381,6381,121239,51048,2025-10-21,2025-11-21,671.3,0,-70191,432623087,-236699682,0.0117996476688263,99.8445131523922,-1.375
610.5,613,214,204,119626,51000,2025-10-21,2025-11-28,671.3,-10,-68626,134798008,-74418053,0.0378343869888641,98.6734670441124,-1.34560784313726
474.76,475,2017,2105,100850,50520,2025-10-21,2025-11-21,671.3,88,-50330,432623087,-236699682,0.0116776014776114,99.8561907538698,-0.996239113222486
664,692,18,18,50400,50400,2025-10-21,2025-11-28,671.3,0,0,134798008,-74418053,0.037389276553701,98.7108563206661,0
564.82,565,2212,2737,123872,49266,2025-10-21,2025-10-31,671.3,525,-74606,118384054,-132327608,0.0416154020202755,98.6002143498144,-1.51435066780335
616.52,617,1047,1017,149721,48816,2025-10-21,2025-10-31,671.3,-30,-100905,118384054,-132327608,0.0412352832586727,98.6414496330731,-2.0670476892822
599.29,601,286,284,81510,48564,2025-10-21,2025-11-21,671.3,-2,-32946,432623087,-236699682,0.0112254758147015,99.8674162296845,-0.678403755868545
545.2,547,268,268,48240,48240,2025-10-21,2025-11-28,671.3,0,0,134798008,-74418053,0.0357868789871138,98.7466431996532,0
544.68,545,1504,1506,93248,48192,2025-10-21,2025-11-07,671.3,2,-45056,75641782,-43457618,0.0637108205621068,99.0106248422334,-0.934926958831341
671,686,33,32,75702,48000,2025-10-21,2025-10-31,671.3,-1,-27702,118384054,-132327608,0.0405460012376329,98.6819956343107,-0.577125
666.91,678,35,43,72030,47687,2025-10-21,2025-11-07,671.3,8,-24343,75641782,-43457618,0.0630432001192145,99.0736680423526,-0.510474552813136
424.86,425,3405,3404,125985,47656,2025-10-21,2025-11-21,671.3,-1,-78329,432623087,-236699682,0.0110155933495061,99.878431823034,-1.64363354037267
209.94,210,7859,7859,47154,47154,2025-10-21,2025-12-19,671.3,0,0,452890228,-117820487,0.0104117945331335,99.8655108981508,0
539.46,540,869,869,46926,46926,2025-10-21,2025-11-07,671.3,0,0,75641782,-43457618,0.0620371423824997,99.1357051847351,0
671.63,685,0,35,0,46795,2025-10-21,2025-10-24,671.3,35,46795,35747412,-54558423,0.13090458128829,97.8943398755692,1
534.9,535,4672,4675,233600,46750,2025-10-21,2025-10-31,671.3,3,-186850,118384054,-132327608,0.0394901157887362,98.7214857500994,-3.99679144385027
576.66,578,348,347,92568,46498,2025-10-21,2025-11-28,671.3,-1,-46070,134798008,-74418053,0.0344945750236903,98.7811377746769,-0.990795303023786
669.27,685,30,29,70860,45617,2025-10-21,2025-11-07,671.3,-1,-25243,75641782,-43457618,0.0603066173136958,99.1960118020488,-0.553368261832212
649,652.5,133,130,91770,45500,2025-10-21,2025-11-07,671.3,-3,-46270,75641782,-43457618,0.0601519408942534,99.256163742943,-1.01692307692308
557.81,558,2381,2381,104764,45239,2025-10-21,2025-10-31,671.3,0,-59525,118384054,-132327608,0.0382137614581099,98.7596995115575,-1.31578947368421
669.25,688,24,24,45000,45000,2025-10-21,2025-11-28,671.3,0,0,134798008,-74418053,0.033383282637233,98.8145210573141,0
309.9,310,4489,4479,112225,44790,2025-10-21,2025-12-19,671.3,-10,-67435,452890228,-117820487,0.00988981374091384,99.8754007118917,-1.50558160303639
606.62,607,1176,1174,125832,44612,2025-10-21,2025-10-31,671.3,-2,-81220,118384054,-132327608,0.0376841293169433,98.7973836408745,-1.82058638931229
592.17,593,532,532,44156,44156,2025-10-21,2025-10-31,671.3,0,0,118384054,-132327608,0.0372989423051858,98.8346825831797,0
580.67,582,328,328,102992,43624,2025-10-21,2025-11-28,671.3,0,-59368,134798008,-74418053,0.032362496039259,98.8468835533534,-1.3609022556391
585.5,587,289,290,98838,43500,2025-10-21,2025-11-28,671.3,1,-55338,134798008,-74418053,0.0322705065493253,98.8791540599027,-1.27213793103448
234.91,235,4786,4786,43074,43074,2025-10-21,2025-12-19,671.3,0,0,452890228,-117820487,0.00951091397803355,99.8849116258697,0
560.01,561,219,435,34164,43065,2025-10-21,2025-11-28,671.3,216,8901,134798008,-74418053,0.031947801483832,98.9111018613866,0.206687565308255
596,598,214,215,78110,43000,2025-10-21,2025-11-28,671.3,1,-35110,134798008,-74418053,0.0318995811866894,98.9430014425733,-0.816511627906977
671.38,700,15,15,53295,42930,2025-10-21,2025-11-07,671.3,0,-10365,75641782,-43457618,0.0567543477492373,99.3129180906923,-0.241439552760308
671.65,700,0,15,0,42525,2025-10-21,2025-10-24,671.3,15,42525,35747412,-54558423,0.118959660632216,98.0132995362014,1
189.95,190,8390,8390,41950,41950,2025-10-21,2025-12-19,671.3,0,0,452890228,-117820487,0.0092627302172658,99.894174356087,0
449.76,450,1657,1737,81193,41688,2025-10-21,2025-11-28,671.3,80,-39505,134798008,-74418053,0.0309262730351327,98.9739277156084,-0.94763481097678
670.7,688,57,24,137313,41520,2025-10-21,2025-11-07,671.3,-33,-95793,75641782,-43457618,0.054890298591855,99.3678083892841,-2.30715317919075
563,564,413,413,90034,41300,2025-10-21,2025-11-28,671.3,0,-48734,134798008,-74418053,0.0306384349537272,99.0045661505621,-1.18
520.4,521,641,686,64100,41160,2025-10-21,2025-11-28,671.3,45,-22940,134798008,-74418053,0.0305345758521892,99.0351007264143,-0.557337220602527
671.39,730,7,7,45864,41027,2025-10-21,2025-11-21,671.3,0,-4837,432623087,-236699682,0.0094833126647261,99.8879151356987,-0.117897969629756
594.43,595,765,715,98685,40755,2025-10-21,2025-11-07,671.3,-50,-57930,75641782,-43457618,0.0538789527724241,99.4216873420566,-1.42142068457858
617.9,618,4079,4074,150923,40740,2025-10-21,2025-10-24,671.3,-5,-110183,35747412,-54558423,0.113966292161234,98.1272658283626,-2.70454099165439
509.49,510,816,797,78336,40647,2025-10-21,2025-11-28,671.3,-19,-37689,134798008,-74418053,0.0301540064301247,99.0652547328444,-0.927227101631117
568.41,569,684,684,40356,40356,2025-10-21,2025-10-31,671.3,0,0,118384054,-132327608,0.0340890505405399,98.8687716337202,0
489.7,490,1294,1342,67288,40260,2025-10-21,2025-11-21,671.3,48,-27028,432623087,-236699682,0.00930602208013924,99.8972211577789,-0.671336313959265
666.94,683,24,25,55200,40150,2025-10-21,2025-11-14,671.3,1,-15050,44392815,-28335435,0.0904425637346944,98.8405466064722,-0.374844333748444
224.93,225,5708,5708,39956,39956,2025-10-21,2025-12-19,671.3,0,0,452890228,-117820487,0.00882244692636645,99.9029968030134,0
563.93,565,373,373,73108,39911,2025-10-21,2025-11-28,671.3,0,-33197,134798008,-74418053,0.0296080042963246,99.0948627371407,-0.831775700934579
339.85,340,2628,2629,84096,39435,2025-10-21,2025-12-19,671.3,1,-44661,452890228,-117820487,0.0087074080123451,99.9117042110257,-1.13252187143401
548.16,549,446,468,88754,39312,2025-10-21,2025-11-28,671.3,22,-49442,134798008,-74418053,0.0291636357118868,99.1240263728526,-1.25768213268213
519.32,520,575,575,39100,39100,2025-10-21,2025-11-14,671.3,0,0,44392815,-28335435,0.0880773161152317,98.9286239225875,0
667.47,685,20,22,46600,38566,2025-10-21,2025-11-28,671.3,2,-8034,134798008,-74418053,0.028610215070834,99.1526365879235,-0.208318207747757
629.44,631,233,247,79453,38532,2025-10-21,2025-11-07,671.3,14,-40921,75641782,-43457618,0.0509401008030192,99.4726274428596,-1.06200041523928
504.49,505,769,755,56137,38505,2025-10-21,2025-11-28,671.3,-14,-17632,134798008,-74418053,0.0285649621765924,99.1812015501001,-0.457914556551097
584.2,585,499,481,77844,38480,2025-10-21,2025-11-14,671.3,-18,-39364,44392815,-28335435,0.0866806937113585,99.0153046162988,-1.02297297297297
559.69,560,1231,1228,86170,38068,2025-10-21,2025-11-07,671.3,-3,-48102,75641782,-43457618,0.0503266832079657,99.5229541260675,-1.26358096038668
444.84,445,2354,2349,94160,37584,2025-10-21,2025-11-21,671.3,-5,-56576,432623087,-236699682,0.00868746979284534,99.9059086275717,-1.50532141336739
666.97,689,17,17,44795,37451,2025-10-21,2025-11-21,671.3,0,-7344.00000000001,432623087,-236699682,0.00865672709695218,99.9145653546687,-0.19609623241035
566.77,567,1625,1626,123500,37398,2025-10-21,2025-10-31,671.3,1,-86102,118384054,-132327608,0.0315904032142707,98.9003620369345,-2.30231563185197
554.1,555,412,413,81164,37170,2025-10-21,2025-11-28,671.3,1,-43994,134798008,-74418053,0.0275745914583545,99.2087761415584,-1.18358891579231
554.68,555,1140,1153,83220,36896,2025-10-21,2025-11-07,671.3,13,-46324,75641782,-43457618,0.048777274972184,99.5717314010397,-1.25552905464007
550.16,551,444,439,59940,36876,2025-10-21,2025-11-28,671.3,-5,-23064,134798008,-74418053,0.0273564873451246,99.2361326289035,-0.625447445493004
559.4,560,650,613,65650,36780,2025-10-21,2025-11-14,671.3,-37,-28870,44392815,-28335435,0.0828512451846093,99.0981558614834,-0.784937466014138
499.95,500,7212,7273,158664,36365,2025-10-21,2025-10-31,671.3,61,-122299,118384054,-132327608,0.0307178194793025,98.9310798564138,-3.3630963838856
628.89,629,3312,3298,195408,36278,2025-10-21,2025-10-24,671.3,-14,-159130,35747412,-54558423,0.101484269686432,98.2287500980491,-4.3864049837367
570.79,571,1721,1719,151448,36099,2025-10-21,2025-10-31,671.3,-2,-115349,118384054,-132327608,0.0304931270557773,98.9615729834696,-3.19535167179146
561.01,562,359,361,94417,35739,2025-10-21,2025-11-28,671.3,2,-58678,134798008,-74418053,0.0265130030704905,99.262645631974,-1.64184784129382
524.67,525,1061,1071,97612,35343,2025-10-21,2025-11-14,671.3,10,-62269,44392815,-28335435,0.079614234871116,99.1777700963546,-1.76184817361288
549.72,550,1236,1259,87756,35252,2025-10-21,2025-11-07,671.3,23,-52504,75641782,-43457618,0.0466038729759169,99.6183352740156,-1.48939067286962
464.71,465,1198,1189,61098,34481,2025-10-21,2025-11-28,671.3,-9,-26617,134798008,-74418053,0.0255797548580985,99.2882253868321,-0.771932368550796
449.9,450,3445,3445,34450,34450,2025-10-21,2025-10-31,671.3,0,0,118384054,-132327608,0.0291002029715928,98.9906731864411,0
546.89,547,3130,3123,190930,34353,2025-10-21,2025-10-31,671.3,-7,-156577,118384054,-132327608,0.0290182662607584,99.0196914527019,-4.55788431869124
541.3,543,202,202,34340,34340,2025-10-21,2025-11-28,671.3,0,0,134798008,-74418053,0.0254751539058352,99.313700540738,0
637.82,638,1894,1906,185612,34308,2025-10-21,2025-10-24,671.3,12,-151304,35747412,-54558423,0.0959733812338639,98.3247234792829,-4.41016672496211
601.66,602,985,1003,94560,34102,2025-10-21,2025-10-31,671.3,18,-60458,118384054,-132327608,0.0288062444626199,99.0484976971645,-1.77285789689754
569.64,570,959,947,81515,34092,2025-10-21,2025-11-07,671.3,-12,-47423,75641782,-43457618,0.0450703289882832,99.6634056030039,-1.39103015370175
619.93,620,4710,4863,174270,34041,2025-10-21,2025-10-24,671.3,153,-140229,35747412,-54558423,0.095226474017196,98.4199499533001,-4.11941482330131
578.7,579,1122,1121,84150,33630,2025-10-21,2025-10-31,671.3,-1,-50520,118384054,-132327608,0.0284075421171166,99.0769052392816,-1.50223015165031
399.91,400,3717,3728,63189,33552,2025-10-21,2025-11-21,671.3,11,-29637,432623087,-236699682,0.00775548069629488,99.9223208353649,-0.883315450643777
524.77,525,1447,1458,59327,33534,2025-10-21,2025-11-07,671.3,11,-25793,75641782,-43457618,0.0443326414494043,99.7077382444533,-0.769159658853701
474.68,475,811,1023,52715,32736,2025-10-21,2025-11-28,671.3,212,-19979,134798008,-74418053,0.0242852253424991,99.3379857660805,-0.61030669599218
600.34,602,174,197,52722,32702,2025-10-21,2025-11-21,671.3,23,-20020,432623087,-236699682,0.00755900482028598,99.9298798401852,-0.612194972784539
645.66,646,893,930,144666,31620,2025-10-21,2025-10-24,671.3,37,-113046,35747412,-54558423,0.0884539557716794,98.5084039090718,-3.57514231499051
159.99,160,31260,31428,62520,31428,2025-10-21,2025-12-19,671.3,168,-31092,452890228,-117820487,0.00693942992296138,99.9186436409487,-0.989308896525391
636.83,637,2001,1839,190095,31263,2025-10-21,2025-10-24,671.3,-162,-158832,35747412,-54558423,0.087455282077483,98.5958591911493,-5.08051050762883
538.28,539,432,434,54432,31248,2025-10-21,2025-11-28,671.3,2,-23184,134798008,-74418053,0.0231813514632946,99.3611671175438,-0.741935483870968
572.69,574,194,238,54126,31178,2025-10-21,2025-11-28,671.3,44,-22948,134798008,-74418053,0.0231294219125256,99.3842965394563,-0.736031817307075
640.77,641,1081,1346,128639,30958,2025-10-21,2025-10-24,671.3,265,-97681,35747412,-54558423,0.086602073459192,98.6824612646085,-3.15527488855869
490.75,491,1229,1229,30725,30725,2025-10-21,2025-10-31,671.3,0,0,118384054,-132327608,0.0259536643338806,99.1028589036155,0
389.89,390,2676,2782,58872,30602,2025-10-21,2025-11-28,671.3,106,-28270,134798008,-74418053,0.022702115894769,99.4069986553511,-0.923795830337886
671.69,686,14,21,31584,30051,2025-10-21,2025-10-24,671.3,7,-1533,35747412,-54558423,0.0840648268467659,98.7665260914552,-0.0510132774283717
469.78,470,1343,1362,52377,29964,2025-10-21,2025-11-21,671.3,19,-22413,432623087,-236699682,0.00692612135144789,99.9368059615367,-0.74799759711654
671.7,683,18,26,32580,29380,2025-10-21,2025-10-24,671.3,8,-3200,35747412,-54558423,0.0821877678865256,98.8487138593418,-0.108917631041525
484.62,485,766,768,63578,29184,2025-10-21,2025-11-28,671.3,2,-34394,134798008,-74418053,0.0216501715663335,99.4286488269174,-1.17852247807018
529.36,530,405,452,58320,28928,2025-10-21,2025-11-28,671.3,47,-29392,134798008,-74418053,0.0214602577806639,99.450109084698,-1.01603982300885
641.75,642,1264,1154,160528,28850,2025-10-21,2025-10-24,671.3,-110,-131678,35747412,-54558423,0.0807051430744133,98.9294190024162,-4.5642287694974
670,688,1,16,2897,28800,2025-10-21,2025-11-14,671.3,15,25903,44392815,-28335435,0.0648753632766924,99.2426454596313,0.899409722222222
525.49,527,188,188,28388,28388,2025-10-21,2025-11-28,671.3,0,0,134798008,-74418053,0.0210596583890171,99.4711687430871,0
664.53,688,0,12,0,28164,2025-10-21,2025-12-19,671.3,12,28164,452890228,-117820487,0.00621872547888139,99.9248623664276,1
459.79,460,1311,1293,64239,27153,2025-10-21,2025-11-21,671.3,-18,-37086,432623087,-236699682,0.00627636407208199,99.9430823256088,-1.36581593194122
536.43,537,473,473,26961,26961,2025-10-21,2025-10-31,671.3,0,0,118384054,-132327608,0.0227741820701629,99.1256330856857,0
154.98,155,13332,13332,26664,26664,2025-10-21,2025-12-19,671.3,0,0,452890228,-117820487,0.00588751939244757,99.93074988582,0
484.73,485,737,986,50853,26622,2025-10-21,2025-11-21,671.3,249,-24231,432623087,-236699682,0.00615362443659878,99.9492359500454,-0.910187063331079
504.18,505,320,320,26240,26240,2025-10-21,2025-11-14,671.3,0,0,44392815,-28335435,0.0591086643187642,99.30175412395,0
557,558,258,258,35088,25800,2025-10-21,2025-11-28,671.3,0,-9288.00000000001,134798008,-74418053,0.0191397487120136,99.4903084917991,-0.36
511.74,512,987,987,25662,25662,2025-10-21,2025-10-31,671.3,0,0,118384054,-132327608,0.0216769059116695,99.1473099915974,0
551,552,253,255,48829,25500,2025-10-21,2025-11-28,671.3,2,-23329,134798008,-74418053,0.0189171934944321,99.5092256852935,-0.914862745098039
538.58,539,598,598,25116,25116,2025-10-21,2025-10-31,671.3,0,0,118384054,-132327608,0.0212156951475914,99.1685256867449,0
537.49,538,491,491,25041,25041,2025-10-21,2025-10-31,671.3,0,0,118384054,-132327608,0.0211523420206576,99.1896780287656,0
551.76,554,111,111,24864,24864,2025-10-21,2025-11-28,671.3,0,0,134798008,-74418053,0.0184453764331592,99.5276710617267,0
660.28,691,8,8,24576,24576,2025-10-21,2025-11-21,671.3,0,0,432623087,-236699682,0.00568069544564089,99.954916645491,0
194.98,195,12257,12257,49028,24514,2025-10-21,2025-12-19,671.3,0,-24514,452890228,-117820487,0.00541279066855909,99.9361626764886,-1
434.85,435,1567,1610,54845,24150,2025-10-21,2025-11-21,671.3,43,-30695,432623087,-236699682,0.00558222635954701,99.9604988718506,-1.27101449275362
314.87,315,1858,1857,40876,24141,2025-10-21,2025-12-19,671.3,-1,-16735,452890228,-117820487,0.00533043075506588,99.9414931072436,-0.69321900501222
409.97,410,8034,8033,112476,24099,2025-10-21,2025-11-07,671.3,-1,-88377,75641782,-43457618,0.0318593763430904,99.7395976207964,-3.66724760363501
577.76,578,1000,1004,63000,24096,2025-10-21,2025-10-31,671.3,4,-38904,118384054,-132327608,0.0203540926212917,99.2100321213869,-1.61454183266932
514.42,515,411,411,23838,23838,2025-10-21,2025-11-14,671.3,0,0,44392815,-28335435,0.0536978788121456,99.3554520027622,0
671.67,682,7,23,15750,23759,2025-10-21,2025-10-24,671.3,16,8009,35747412,-54558423,0.0664635526622179,98.9958825550784,0.337093312008081
603.63,604,987,641,94752,23717,2025-10-21,2025-10-31,671.3,-346,-71035,118384054,-132327608,0.0200339481531862,99.2300660695401,-2.99510899354893
319.89,320,2174,2156,47828,23716,2025-10-21,2025-12-19,671.3,-18,-24112,452890228,-117820487,0.0052365890305763,99.9467296962742,-1.01669758812616
569.81,571,194,198,47724,23562,2025-10-21,2025-11-28,671.3,4,-24162,134798008,-74418053,0.0174794867888552,99.5451505485155,-1.02546473134708
669.59,689,4,12,9956,23292,2025-10-21,2025-11-14,671.3,8,13336,44392815,-28335435,0.052467950050025,99.4079199528122,0.57255710115061
522.39,523,374,379,41888,23119,2025-10-21,2025-11-28,671.3,5,-18769,134798008,-74418053,0.0171508469175598,99.5623013954331,-0.811843072797267
536.32,538,137,137,23016,23016,2025-10-21,2025-11-28,671.3,0,0,134798008,-74418053,0.0170744362928568,99.5793758317259,0
654.02,677,10,10,22980,22980,2025-10-21,2025-11-21,671.3,0,0,432623087,-236699682,0.005311783094923,99.9658106549455,0
534.74,535,738,883,54612,22958,2025-10-21,2025-11-07,671.3,145,-31654,75641782,-43457618,0.0303509507483576,99.7699485715448,-1.37877863925429
566.92,568,222,212,44178,22896,2025-10-21,2025-11-28,671.3,-10,-21282,134798008,-74418053,0.0169854142058242,99.5963612459318,-0.929507337526205
544.88,545,1883,1903,62139,22836,2025-10-21,2025-10-31,671.3,20,-39303,118384054,-132327608,0.0192897600888039,99.2493558296289,-1.72109826589595
526.6,528,163,163,22820,22820,2025-10-21,2025-11-28,671.3,0,0,134798008,-74418053,0.0169290335507035,99.6132902794825,0
565.92,567,175,211,44975,22788,2025-10-21,2025-11-28,671.3,36,-22187,134798008,-74418053,0.0169052943274948,99.63019557381,-0.973626470071967
574.16,577,80,80,22720,22720,2025-10-21,2025-11-28,671.3,0,0,134798008,-74418053,0.0168548484781763,99.6470504222881,0
668.64,706,0,6,0,22416,2025-10-21,2025-11-21,671.3,6,22416,432623087,-236699682,0.00518141557248885,99.970992070518,1
569.35,570,337,339,37407,22035,2025-10-21,2025-11-14,671.3,2,-15372,44392815,-28335435,0.049636410757011,99.4575563635692,-0.697617426820967
595.66,596,572,646,52052,21964,2025-10-21,2025-10-31,671.3,74,-30088,118384054,-132327608,0.0185531743996535,99.2679090040285,-1.36987798215261
169.99,170,21703,21703,65109,21703,2025-10-21,2025-12-19,671.3,0,-43406,452890228,-117820487,0.00479211046258212,99.9515218067368,-2
574.58,575,492,515,49200,21630,2025-10-21,2025-11-07,671.3,23,-27570,75641782,-43457618,0.0285953072866528,99.7985438788314,-1.2746185852982
534.63,535,584,584,59568,21608,2025-10-21,2025-11-14,671.3,0,-37960,44392815,-28335435,0.0486745433917628,99.506230906961,-1.75675675675676
582.69,583,690,692,50370,21452,2025-10-21,2025-10-31,671.3,2,-28918,118384054,-132327608,0.0181206837197854,99.2860296877483,-1.34803281745292
454.81,455,1121,1122,36993,21318,2025-10-21,2025-11-21,671.3,1,-15675,432623087,-236699682,0.00492761497030324,99.9759196854883,-0.735294117647059
579.58,581,146,148,43216,21016,2025-10-21,2025-11-28,671.3,2,-22200,134798008,-74418053,0.0155907348423131,99.6626411571305,-1.05633802816901
664.67,682,11,12,27566,20796,2025-10-21,2025-11-28,671.3,1,-6770,134798008,-74418053,0.0154275276827533,99.6780686848132,-0.325543373725717
526.69,527,668,668,20708,20708,2025-10-21,2025-10-31,671.3,0,0,118384054,-132327608,0.0174922207006021,99.3035219084489,0
585.75,586,829,827,63833,20675,2025-10-21,2025-10-31,671.3,-2,-43158,118384054,-132327608,0.0174643453247513,99.3209862537737,-2.08744860943168
670.69,705,0,6,0,20586,2025-10-21,2025-11-28,671.3,6,20586,134798008,-74418053,0.0152717390304462,99.6933404238437,1
671.43,690,11,11,27522,20427,2025-10-21,2025-10-24,671.3,0,-7095,35747412,-54558423,0.0571425981830517,99.0530251532615,-0.347334410339257
409.89,410,1846,1846,51688,20306,2025-10-21,2025-11-21,671.3,0,-31382,432623087,-236699682,0.00469369310380793,99.9806133785921,-1.54545454545455
596.65,597,587,571,55765,19985,2025-10-21,2025-10-31,671.3,-16,-35780,118384054,-132327608,0.0168814965569603,99.3378677503306,-1.7903427570678
587.68,588,628,616,43332,19712,2025-10-21,2025-10-31,671.3,-12,-23620,118384054,-132327608,0.0166508911749212,99.3545186415056,-1.19825487012987
552.07,553,207,211,29187,19623,2025-10-21,2025-11-28,671.3,4,-9564,134798008,-74418053,0.0145573367820094,99.7078977606257,-0.487387249656016
522.68,524,148,148,19536,19536,2025-10-21,2025-11-28,671.3,0,0,134798008,-74418053,0.0144927957689108,99.7223905563946,0
609.95,610,3938,3907,106326,19535,2025-10-21,2025-10-24,671.3,-31,-86791,35747412,-54558423,0.0546473126502137,99.1076724659117,-4.44284617353468
424.83,425,1191,1147,32157,19499,2025-10-21,2025-11-28,671.3,-44,-12658,134798008,-74418053,0.0144653472920757,99.7368559036867,-0.649161495461306
497.7,498,649,649,19470,19470,2025-10-21,2025-10-31,671.3,0,0,118384054,-132327608,0.0164464717520148,99.3709651132576,0
671.38,710,5,5,25515,19310,2025-10-21,2025-11-07,671.3,0,-6205,75641782,-43457618,0.0255282193113853,99.8240720981428,-0.321336095287416
459.73,460,717,713,32265,19251,2025-10-21,2025-11-28,671.3,-4,-13014,134798008,-74418053,0.0142813683122083,99.7511372719989,-0.67601683029453
588.63,589,485,515,38800,19055,2025-10-21,2025-10-31,671.3,30,-19745,118384054,-132327608,0.0160959177829811,99.3870610310405,-1.0362109682498
496.67,497,577,577,19041,19041,2025-10-21,2025-10-31,671.3,0,0,118384054,-132327608,0.0160840918659535,99.4031451229065,0
570.84,572,131,163,38645,18908,2025-10-21,2025-11-28,671.3,32,-19737,134798008,-74418053,0.0140269135134401,99.7651641855123,-1.04384387560821
561.49,563,124,124,18724,18724,2025-10-21,2025-11-28,671.3,0,0,134798008,-74418053,0.01389041297999,99.7790545984923,0
561.77,562,814,814,49654,18722,2025-10-21,2025-10-31,671.3,0,-30932,118384054,-132327608,0.0158146298993951,99.4189597528059,-1.65217391304348
586.74,587,719,719,76214,18694,2025-10-21,2025-10-31,671.3,0,-57520,118384054,-132327608,0.0157909780653398,99.4347507308713,-3.07692307692308
662.4,681,0,10,0,18600,2025-10-21,2025-12-19,671.3,10,18600,452890228,-117820487,0.00410695547177936,99.9556287622086,1
599.96,600,4631,4616,97251,18464,2025-10-21,2025-10-24,671.3,-15,-78787,35747412,-54558423,0.0516512915676245,99.1593237574793,-4.26706022530329
671.42,688,10,11,28420,18238,2025-10-21,2025-10-31,671.3,1,-10182,118384054,-132327608,0.0154057910535823,99.4501565219248,-0.558284899660051
558.06,559,162,193,29160,18142,2025-10-21,2025-11-28,671.3,31,-11018,134798008,-74418053,0.0134586558578818,99.7925132543502,-0.6073200308676
419.84,420,1125,1125,33750,18000,2025-10-21,2025-11-28,671.3,0,-15750,134798008,-74418053,0.0133533130548932,99.8058665674051,-0.875
560.78,561,805,813,61180,17886,2025-10-21,2025-10-31,671.3,8,-43294,118384054,-132327608,0.015108453711173,99.465264975636,-2.42055238734205
199.99,200,17830,17830,89150,17830,2025-10-21,2025-12-19,671.3,0,-71320,452890228,-117820487,0.00393693634741,99.959565698556,-4
513.61,514,457,457,17823,17823,2025-10-21,2025-10-31,671.3,0,0,118384054,-132327608,0.0150552370845486,99.4803202127206,0
665.37,695,6,6,17778,17778,2025-10-21,2025-11-14,671.3,0,0,44392815,-28335435,0.0400470211226749,99.5462779280836,0
539.58,540,398,419,30646,17598,2025-10-21,2025-11-14,671.3,21,-13048,44392815,-28335435,0.0396415501021956,99.5859194781858,-0.741447891805887
671.57,706,0,5,0,17215,2025-10-21,2025-10-24,671.3,5,17215,35747412,-54558423,0.0481573323405902,99.2074810898199,1
284.93,285,2393,2433,40681,17031,2025-10-21,2025-12-19,671.3,40,-23650,452890228,-117820487,0.00376051390536958,99.9633262124614,-1.38864423697963
454.75,455,648,678,36288,16950,2025-10-21,2025-11-28,671.3,30,-19338,134798008,-74418053,0.0125743697933578,99.8184409371984,-1.14088495575221
670.3,694,1,7,3308,16590,2025-10-21,2025-11-28,671.3,6,13282,134798008,-74418053,0.0123073035322599,99.8307482407307,0.800602772754672
671.25,684,5,13,9565,16575,2025-10-21,2025-10-24,671.3,8,7010,35747412,-54558423,0.0463669929448319,99.2538480827647,0.422926093514329
439.78,440,753,753,39156,16566,2025-10-21,2025-11-28,671.3,0,-22590,134798008,-74418053,0.0122894991148534,99.8430377398455,-1.36363636363636
666.51,683,11,10,26301,16490,2025-10-21,2025-11-28,671.3,-1,-9811,134798008,-74418053,0.0122331184597327,99.8552708583053,-0.594966646452396
494.67,495,499,499,16467,16467,2025-10-21,2025-11-07,671.3,0,0,75641782,-43457618,0.0217697145210038,99.8458418126638,0
632.88,633,1525,1347,108275,16164,2025-10-21,2025-10-24,671.3,-178,-92111,35747412,-54558423,0.0452172593641184,99.2990653421288,-5.69852759218015
670.49,750,2,2,17816,15902,2025-10-21,2025-12-19,671.3,0,-1914,452890228,-117820487,0.00351122612431373,99.9668374385857,-0.120362218588857
577.72,579,123,122,36285,15616,2025-10-21,2025-11-28,671.3,-1,-20669,134798008,-74418053,0.0115847409258451,99.8668555992311,-1.32357838114754
601.94,602,2597,2601,77910,15606,2025-10-21,2025-10-24,671.3,4,-62304,35747412,-54558423,0.0436563072034418,99.3427216493323,-3.9923106497501
664.91,696,5,5,15545,15545,2025-10-21,2025-11-21,671.3,0,0,432623087,-236699682,0.00359319705006867,99.9842065756421,0
580.7,581,514,515,35980,15450,2025-10-21,2025-10-31,671.3,1,-20530,118384054,-132327608,0.0130507441483631,99.4933709568689,-1.32880258899676
627.91,628,987,1711,54285,15399,2025-10-21,2025-10-24,671.3,724,-38886,35747412,-54558423,0.0430772443051262,99.3857988936374,-2.52522891096825
444.76,445,642,638,35952,15312,2025-10-21,2025-11-28,671.3,-4,-20640,134798008,-74418053,0.0113592183053625,99.8782148175365,-1.34796238244514
668.75,684,6,10,14136,15250,2025-10-21,2025-11-14,671.3,4,1114,44392815,-28335435,0.0343524059017208,99.6202718840875,0.073049180327869
512.59,513,366,366,15006,15006,2025-10-21,2025-10-31,671.3,0,0,118384054,-132327608,0.012675693636915,99.5060466505058,0
666.55,679,11,12,21571,14940,2025-10-21,2025-11-14,671.3,1,-6631,44392815,-28335435,0.0336540946997842,99.6539259787873,-0.44384203480589
543.1,544,164,165,31980,14850,2025-10-21,2025-11-28,671.3,1,-17130,134798008,-74418053,0.0110164832702869,99.8892313008068,-1.15353535353535
503.66,504,429,429,14586,14586,2025-10-21,2025-10-31,671.3,0,0,118384054,-132327608,0.0123209161260857,99.5183675666319,0
531.24,532,181,191,22444,14516,2025-10-21,2025-11-28,671.3,10,-7928,134798008,-74418053,0.0107687051280461,99.9000000059348,-0.546155965830807
597.67,598,408,435,35904,14355,2025-10-21,2025-10-31,671.3,27,-21549,118384054,-132327608,0.0121257884951296,99.530493355127,-1.50114942528736
174.99,175,14250,14246,42750,14246,2025-10-21,2025-12-19,671.3,-4,-28504,452890228,-117820487,0.00314557460489079,99.9699830131906,-2.00084234170995
523.58,524,334,334,14028,14028,2025-10-21,2025-10-31,671.3,0,0,118384054,-132327608,0.0118495688616982,99.5423429239887,0
374.94,375,2336,2337,30368,14022,2025-10-21,2025-11-21,671.3,1,-16346,432623087,-236699682,0.0032411585098786,99.987447734152,-1.16573955213236
552.81,553,712,737,33464,14003,2025-10-21,2025-10-31,671.3,25,-19461,118384054,-132327608,0.0118284511527203,99.5541713751415,-1.38977361993858
544.52,545,114,290,9462,13920,2025-10-21,2025-11-14,671.3,176,4458,44392815,-28335435,0.0313564255837347,99.6852824043711,0.320258620689655
164.99,165,14996,13750,29992,13750,2025-10-21,2025-12-19,671.3,-1246,-16242,452890228,-117820487,0.00303605579231001,99.9730190689829,-1.18123636363636
556.81,557,668,710,36740,13490,2025-10-21,2025-10-31,671.3,42,-23250,118384054,-132327608,0.0113951157644931,99.565566490906,-1.72349888806523
484.59,485,326,326,13366,13366,2025-10-21,2025-11-07,671.3,0,0,75641782,-43457618,0.0176701283954416,99.8635119410593,0
564.39,565,209,219,21318,13359,2025-10-21,2025-11-14,671.3,10,-7959,44392815,-28335435,0.0300927075699074,99.715375111941,-0.595778127105322
294.92,295,1785,1660,39270,13280,2025-10-21,2025-12-19,671.3,-125,-25990,452890228,-117820487,0.00293227788522741,99.9759513468681,-1.95707831325301
544.89,546,119,119,13209,13209,2025-10-21,2025-11-28,671.3,0,0,134798008,-74418053,0.0097991062301158,99.9097991121649,0
554.52,555,238,274,24038,13152,2025-10-21,2025-11-14,671.3,36,-10886,44392815,-28335435,0.0296264158963562,99.7450015278373,-0.827706812652068
547.86,548,973,936,55461,13104,2025-10-21,2025-10-31,671.3,-37,-42357,118384054,-132327608,0.0110690583378738,99.5766355492438,-3.23237179487179
669.47,691,5,6,15000,12918,2025-10-21,2025-11-28,671.3,1,-2082,134798008,-74418053,0.0095832276690617,99.919382339834,-0.161170459823502
665.59,687,6,6,12846,12846,2025-10-21,2025-11-14,671.3,0,0,44392815,-28335435,0.0289371151615413,99.7739386429989,0
179.99,180,12795,12795,38385,12795,2025-10-21,2025-12-19,671.3,0,-25590,452890228,-117820487,0.00282518791728048,99.9787765347854,-2
531.59,532,312,312,12792,12792,2025-10-21,2025-10-31,671.3,0,0,118384054,-132327608,0.0108055093298292,99.5874410585736,0
553.83,554,640,737,43520,12529,2025-10-21,2025-10-31,671.3,97,-30991,118384054,-132327608,0.0105833510313813,99.598024409605,-2.47354138398915
518.88,519,1018,1043,45810,12516,2025-10-21,2025-10-31,671.3,25,-33294,118384054,-132327608,0.0105723698227128,99.6085967794277,-2.6601150527325
625.89,626,1091,1122,52368,12342,2025-10-21,2025-10-24,671.3,31,-40026,35747412,-54558423,0.0345255762850749,99.4203244699225,-3.2430724355858
434.86,435,872,872,12208,12208,2025-10-21,2025-10-31,671.3,0,0,118384054,-132327608,0.0103121996481046,99.6189089790759,0
565.82,566,711,672,57591,12096,2025-10-21,2025-10-31,671.3,-39,-45495,118384054,-132327608,0.0102175923118835,99.6291265713877,-3.76116071428572
534.98,535,5124,6009,40992,12018,2025-10-21,2025-10-24,671.3,885,-28974,35747412,-54558423,0.0336192169659722,99.4539436868885,-2.41088367448827
444.84,445,746,746,11936,11936,2025-10-21,2025-10-31,671.3,0,0,118384054,-132327608,0.0100824389744247,99.6392090103622,0
204.98,205,5878,5898,35268,11796,2025-10-21,2025-12-19,671.3,20,-23472,452890228,-117820487,0.00260460466371555,99.9813811394491,-1.98982706002035
575.79,576,546,561,42588,11781,2025-10-21,2025-10-31,671.3,15,-30807,118384054,-132327608,0.00995150917876153,99.6491605195409,-2.61497326203209
668.5,692,0,5,0,11750,2025-10-21,2025-10-31,671.3,5,11750,118384054,-132327608,0.00992532321962889,99.6590858427606,1
525.38,526,110,186,11550,11532,2025-10-21,2025-11-28,671.3,76,-18,134798008,-74418053,0.00855502256383492,99.9279373623978,-0.00156087408949011
672.8,730,0,2,0,11440,2025-10-21,2025-10-24,671.3,2,11440,35747412,-54558423,0.0320023166991781,99.4859460035876,1
414.62,415,301,301,11438,11438,2025-10-21,2025-11-28,671.3,0,0,134798008,-74418053,0.00848528859565937,99.9364226509935,0
563.8,564,558,571,30690,11420,2025-10-21,2025-10-31,671.3,13,-19270,118384054,-132327608,0.00964656946112016,99.6687324122217,-1.68739054290718
589.97,590,3558,3799,60486,11397,2025-10-21,2025-10-24,671.3,241,-49089,35747412,-54558423,0.0318820282710256,99.5178280318586,-4.30718610160569
414.81,415,597,597,11343,11343,2025-10-21,2025-11-07,671.3,0,0,75641782,-43457618,0.0149956805618355,99.8785076216211,0
542.89,543,1027,1027,48269,11297,2025-10-21,2025-10-31,671.3,0,-36972,118384054,-132327608,0.00954267033294873,99.6782750825546,-3.27272727272727
509.22,510,143,143,11154,11154,2025-10-21,2025-11-14,671.3,0,0,44392815,-28335435,0.0251256875690357,99.7990643305679,0
535.29,536,156,156,23556,11076,2025-10-21,2025-11-28,671.3,0,-12480,134798008,-74418053,0.00821673863311096,99.9446393896266,-1.12676056338028
494.76,495,460,460,11040,11040,2025-10-21,2025-10-31,671.3,0,0,118384054,-132327608,0.00932558028465557,99.6876006628393,0
394.92,395,1357,1358,21712,10864,2025-10-21,2025-11-21,671.3,1,-10848,432623087,-236699682,0.00251119284348318,99.9899589269955,-0.998527245949926
543.86,544,767,767,39884,10738,2025-10-21,2025-10-31,671.3,0,-29146,118384054,-132327608,0.00907047836020213,99.6966711411995,-2.71428571428571
434.79,435,645,508,23220,10668,2025-10-21,2025-11-28,671.3,-137,-12552,134798008,-74418053,0.00791406353720004,99.9525534531638,-1.17660292463442
615.92,616,1330,1332,46550,10656,2025-10-21,2025-10-24,671.3,2,-35894,35747412,-54558423,0.0298091509393743,99.547637182798,-3.36843093093093
184.99,185,10528,10527,52640,10527,2025-10-21,2025-12-19,671.3,-1,-42113,452890228,-117820487,0.00232440431459254,99.9837055437637,-4.00047496912701
527.91,528,1179,1167,53055,10503,2025-10-21,2025-10-31,671.3,-12,-42552,118384054,-132327608,0.00887197189580955,99.7055431130953,-4.05141388174807
658.08,684,4,4,10368,10368,2025-10-21,2025-11-07,671.3,0,0,75641782,-43457618,0.0137067103998158,99.8922143320209,0
264.94,265,1691,1692,13528,10152,2025-10-21,2025-12-19,671.3,1,-3376,452890228,-117820487,0.00224160279298409,99.9859471465567,-0.332545311268716
548.88,549,829,843,35647,10116,2025-10-21,2025-10-31,671.3,14,-25531,118384054,-132327608,0.00854506976083113,99.7140881828561,-2.52382364570977
399.88,400,795,821,23850,9852,2025-10-21,2025-11-28,671.3,26,-13998,134798008,-74418053,0.00730871334537822,99.9598621665092,-1.42082825822168
508.61,509,251,251,9789,9789,2025-10-21,2025-10-31,671.3,0,0,118384054,-132327608,0.00826885012739976,99.7223570329835,0
540.87,541,747,749,37350,9737,2025-10-21,2025-10-31,671.3,2,-27613,118384054,-132327608,0.00822492529272566,99.7305819582762,-2.8358837424258
491.77,492,422,422,9706,9706,2025-10-21,2025-10-31,671.3,0,0,118384054,-132327608,0.00819873933359302,99.7387806976098,0
509.83,510,589,569,38285,9673,2025-10-21,2025-11-07,671.3,-20,-28612,75641782,-43457618,0.0127879060279146,99.9050022380488,-2.95792411868086
581.75,582,374,383,26928,9575,2025-10-21,2025-10-31,671.3,9,-17353,118384054,-132327608,0.00808808253854865,99.7468687801484,-1.81232375979112
394.69,395,308,308,9548,9548,2025-10-21,2025-11-28,671.3,0,0,134798008,-74418053,0.00708319072489558,99.9669453572341,0
499.87,500,675,722,21600,9386,2025-10-21,2025-11-07,671.3,47,-12214,75641782,-43457618,0.0124084860930431,99.9174107241419,-1.30129980822502
668.36,687,4,5,11652,9320,2025-10-21,2025-11-21,671.3,1,-2332,432623087,-236699682,0.00215430019341524,99.9921132271889,-0.250214592274678
541.89,542,841,841,28594,9251,2025-10-21,2025-10-31,671.3,0,-19343,118384054,-132327608,0.00781439703019462,99.7546831771786,-2.09090909090909
532.87,533,709,710,38286,9230,2025-10-21,2025-10-31,671.3,1,-29056,118384054,-132327608,0.00779665815465316,99.7624798353332,-3.14799566630553
510.9,511,920,920,27600,9200,2025-10-21,2025-10-31,671.3,0,-18400,118384054,-132327608,0.00777131690387964,99.7702511522371,-2
505.63,506,245,245,9065,9065,2025-10-21,2025-10-31,671.3,0,0,118384054,-132327608,0.0076572812753988,99.7779084335125,0
551.85,552,604,604,38656,9060,2025-10-21,2025-10-31,671.3,0,-29596,118384054,-132327608,0.00765305773360321,99.7855614912461,-3.26666666666667
670,715,0,2,0,9000,2025-10-21,2025-12-19,671.3,2,9000,452890228,-117820487,0.00198723651860291,99.9879343830753,1
244.96,245,2209,2209,24299,8836,2025-10-21,2025-12-19,671.3,0,-15463,452890228,-117820487,0.00195102465315282,99.9898854077284,-1.75
521.42,522,144,151,12960,8758,2025-10-21,2025-11-28,671.3,7,-4202,134798008,-74418053,0.00649712865193082,99.973442485886,-0.479789906371318
604.96,605,2151,2180,53775,8720,2025-10-21,2025-10-24,671.3,29,-45055,35747412,-54558423,0.0243933742672057,99.5720305570652,-5.16685779816514
525.9,526,870,869,42630,8690,2025-10-21,2025-10-31,671.3,-1,-33940,118384054,-132327608,0.00734051564072979,99.7929020068868,-3.90563866513234
572.8,573,433,432,38970,8640,2025-10-21,2025-10-31,671.3,-1,-30330,118384054,-132327608,0.00729828022277392,99.8002002871096,-3.51041666666667
621.92,622,806,1058,37882,8464,2025-10-21,2025-10-24,671.3,252,-29418,35747412,-54558423,0.0236772385089024,99.5957077955741,-3.47566162570889
528.91,529,915,918,40260,8262,2025-10-21,2025-10-31,671.3,3,-31998,118384054,-132327608,0.00697898046302756,99.8071792675726,-3.87291212781409
504.99,505,5487,8161,16461,8161,2025-10-21,2025-10-24,671.3,2674,-8300,35747412,-54558423,0.0228296247012231,99.6185374202754,-1.01703222644284
657.31,698,2,2,8138,8138,2025-10-21,2025-11-21,671.3,0,0,432623087,-236699682,0.00188108315171816,99.9939943103406,0
670.5,684,4,6,6420,8100,2025-10-21,2025-10-31,671.3,2,1680,118384054,-132327608,0.00684213770885055,99.8140214052815,0.207407407407407
556,557,80,81,17600,8100,2025-10-21,2025-11-28,671.3,1,-9500,134798008,-74418053,0.00600899087470195,99.9794514767607,-1.17283950617284
567.82,568,447,447,37995,8046,2025-10-21,2025-10-31,671.3,0,-29949,118384054,-132327608,0.00679652345745821,99.820817928739,-3.72222222222222
665.16,681,2,5,4100,7920,2025-10-21,2025-11-14,671.3,3,3820,44392815,-28335435,0.0178407249010904,99.816905055469,0.482323232323232
229.97,230,2616,2626,20928,7878,2025-10-21,2025-12-19,671.3,10,-13050,452890228,-117820487,0.00173949436595042,99.9916249020944,-1.65651180502666
573.79,574,372,365,23064,7665,2025-10-21,2025-10-31,671.3,-7,-15399,118384054,-132327608,0.0064746895726345,99.8272926183116,-2.00900195694716
504.6,505,191,191,7640,7640,2025-10-21,2025-11-07,671.3,0,0,75641782,-43457618,0.0101002379875186,99.9275109621294,0
498.92,499,949,949,24674,7592,2025-10-21,2025-10-31,671.3,0,-17082,118384054,-132327608,0.00641302586241894,99.833705644174,-2.25
514.94,515,1164,1263,43068,7578,2025-10-21,2025-10-31,671.3,99,-35490,118384054,-132327608,0.00640119994539129,99.8401068441194,-4.68329374505147
502.73,503,270,270,7290,7290,2025-10-21,2025-10-31,671.3,0,0,118384054,-132327608,0.0061579239379655,99.8462647680574,0
369.99,370,7271,7265,21813,7265,2025-10-21,2025-10-31,671.3,-6,-14548,118384054,-132327608,0.00613680622898756,99.8524015742863,-2.00247763248451
594.96,595,1803,1791,36060,7164,2025-10-21,2025-10-24,671.3,-12,-28896,35747412,-54558423,0.0200406116112685,99.6385780318866,-4.03350083752094
576.8,577,360,358,36360,7160,2025-10-21,2025-10-31,671.3,-2,-29200,118384054,-132327608,0.00604811185128024,99.8584496861376,-4.07821229050279
519.81,520,408,375,26520,7125,2025-10-21,2025-11-07,671.3,-33,-19395,75641782,-43457618,0.00941939733783638,99.9369303594672,-2.72210526315789
474.74,475,274,274,7124,7124,2025-10-21,2025-11-07,671.3,0,0,75641782,-43457618,0.00941807531715739,99.9463484347844,0
522.9,523,713,711,25668,7110,2025-10-21,2025-10-31,671.3,-2,-18558,118384054,-132327608,0.00600587643332437,99.864455562571,-2.61012658227848
519.93,520,1011,1011,28308,7077,2025-10-21,2025-10-31,671.3,0,-21231,118384054,-132327608,0.0059780010574735,99.8704335636284,-3
495.81,496,372,372,7068,7068,2025-10-21,2025-10-31,671.3,0,0,118384054,-132327608,0.00597039868224145,99.8764039623107,0
662.8,686,2,3,6056,6960,2025-10-21,2025-12-19,671.3,1,903.999999999999,452890228,-117820487,0.00153679624105292,99.9931616983354,0.129885057471264
669.98,693,1,3,3038,6906,2025-10-21,2025-10-24,671.3,2,3868,35747412,-54558423,0.0193188810423535,99.657896912929,0.560092673037938
545.86,546,487,488,19967,6832,2025-10-21,2025-10-31,671.3,1,-13135,118384054,-132327608,0.00577104750948975,99.8821750098202,-1.92257025761124
583.73,584,249,250,23904,6750,2025-10-21,2025-10-31,671.3,1,-17154,118384054,-132327608,0.00570178142404213,99.8878767912442,-2.54133333333333
419.91,420,750,750,18750,6750,2025-10-21,2025-11-14,671.3,0,-12000,44392815,-28335435,0.0152051632679748,99.832110218737,-1.77777777777778
535.88,536,533,560,22919,6720,2025-10-21,2025-10-31,671.3,27,-16199,118384054,-132327608,0.00567644017326861,99.8935532314175,-2.41056547619048
389.91,390,765,744,11475,6696,2025-10-21,2025-11-21,671.3,-21,-4779,432623087,-236699682,0.0015477676067713,99.9955420779474,-0.713709677419355
574.98,575,3362,3333,43706,6666,2025-10-21,2025-10-24,671.3,-29,-37040,35747412,-54558423,0.0186475037689442,99.6765444166979,-5.55655565556556
613.94,614,1089,1109,32670,6654,2025-10-21,2025-10-24,671.3,20,-26016,35747412,-54558423,0.0186139349052737,99.6951583516032,-3.90982867448152
484.81,485,345,345,18975,6555,2025-10-21,2025-11-14,671.3,0,-12420,44392815,-28335435,0.0147659029957888,99.8468761217328,-1.89473684210526
584.95,585,1222,1297,18330,6485,2025-10-21,2025-10-24,671.3,75,-11845,35747412,-54558423,0.0181411734085813,99.7132995250118,-1.82652274479568
555.85,556,430,431,24080,6465,2025-10-21,2025-10-31,671.3,1,-17615,118384054,-132327608,0.00546103954169368,99.8990142709592,-2.7246713070379
656.77,689,2,2,6446,6446,2025-10-21,2025-12-19,671.3,0,0,452890228,-117820487,0.00142330295543493,99.9945850012909,0
379.94,380,1071,1071,12852,6426,2025-10-21,2025-11-21,671.3,0,-6426,432623087,-236699682,0.00148535762262729,99.99702743557,-1
659,691,2,2,6400,6400,2025-10-21,2025-10-24,671.3,0,0,35747412,-54558423,0.0179033939575822,99.7312029189693,0
663,684,0,3,0,6300,2025-10-21,2025-12-19,671.3,3,6300,452890228,-117820487,0.00139106556302204,99.9959760668539,1
444.88,445,523,523,15167,6276,2025-10-21,2025-11-14,671.3,0,-8891,44392815,-28335435,0.0141374229140459,99.8610135446468,-1.41666666666667
254.95,255,1216,1216,14592,6080,2025-10-21,2025-12-19,671.3,0,-8512,452890228,-117820487,0.00134248867034508,99.9973185555242,-1.4
620.9,621,643,571,28935,5710,2025-10-21,2025-10-24,671.3,-72,-23225,35747412,-54558423,0.0159731842965303,99.7471761032659,-4.06742556917688
654.56,683,2,2,5688,5688,2025-10-21,2025-12-19,671.3,0,0,452890228,-117820487,0.00125593347975704,99.998574489004,0
469.96,470,1418,1411,24106,5644,2025-10-21,2025-10-31,671.3,-7,-18462,118384054,-132327608,0.00476753397885834,99.903781804938,-3.2710843373494
499.99,500,3710,5518,11130,5518,2025-10-21,2025-10-24,671.3,1808,-5612,35747412,-54558423,0.0154360824778029,99.7626121857437,-1.01703515766582
616.89,617,468,476,18252,5236,2025-10-21,2025-10-24,671.3,8,-13016,35747412,-54558423,0.0146472141815469,99.7772593999252,-2.48586707410237
507.89,508,465,466,13485,5126,2025-10-21,2025-10-31,671.3,1,-8359,118384054,-132327608,0.00432997504883555,99.9081117799869,-1.63070620366758
520.91,521,462,562,18942,5058,2025-10-21,2025-10-31,671.3,100,-13884,118384054,-132327608,0.00427253488041557,99.9123843148673,-2.74495848161329
469.84,470,313,315,15024,5040,2025-10-21,2025-11-14,671.3,2,-9984,44392815,-28335435,0.0113531885734212,99.8723667332202,-1.98095238095238
623.92,624,788,627,35460,5016,2025-10-21,2025-10-24,671.3,-161,-30444,35747412,-54558423,0.014031785014255,99.7912911849395,-6.06937799043062
530.91,531,303,552,8181,4968,2025-10-21,2025-10-31,671.3,249,-3213,118384054,-132327608,0.00419651112809501,99.9165808259954,-0.646739130434783
454.88,455,413,413,12390,4956,2025-10-21,2025-11-14,671.3,0,-7434,44392815,-28335435,0.0111639687638642,99.8835307019841,-1.5
671,720,2,1,12146,4900,2025-10-21,2025-11-21,671.3,-1,-7246,432623087,-236699682,0.00113262563816896,99.9981600612082,-1.47877551020408
404.9,405,487,486,10714,4860,2025-10-21,2025-11-21,671.3,-1,-5854,432623087,-236699682,0.00112337971459207,99.9992834409228,-1.20452674897119
668.75,693,0,2,0,4850,2025-10-21,2025-10-31,671.3,2,4850,118384054,-132327608,0.00409683554171916,99.9206776615371,1
459.87,460,375,373,11625,4849,2025-10-21,2025-11-14,671.3,-2,-6776,44392815,-28335435,0.010922938768357,99.8944536407524,-1.39740152608785
409.99,410,4682,4712,42138,4712,2025-10-21,2025-10-31,671.3,30,-37426,118384054,-132327608,0.00398026578816096,99.9246579273252,-7.94269949066214
394.95,395,929,929,4645,4645,2025-10-21,2025-10-31,671.3,0,0,118384054,-132327608,0.0039236703281001,99.9285815976534,0
404.86,405,327,327,4578,4578,2025-10-21,2025-11-07,671.3,0,0,75641782,-43457618,0.00605221066843719,99.9524006454528,0
449.88,450,382,381,16044,4572,2025-10-21,2025-11-14,671.3,-1,-11472,44392815,-28335435,0.0102989639201749,99.9047526046726,-2.50918635170604
489.96,490,1037,1140,26962,4560,2025-10-21,2025-10-31,671.3,103,-22402,118384054,-132327608,0.00385187011757513,99.9324334677709,-4.91271929824561
521.52,522,95,95,4560,4560,2025-10-21,2025-10-31,671.3,0,0,118384054,-132327608,0.00385187011757513,99.9362853378885,0
499.76,500,176,190,7744,4560,2025-10-21,2025-11-14,671.3,14,-3184,44392815,-28335435,0.0102719325188096,99.9150245371914,-0.698245614035088
664.3,687,0,2,0,4540,2025-10-21,2025-12-19,671.3,2,4540,452890228,-117820487,0.00100245042160636,99.9995769394256,1
494.78,495,201,202,9045,4444,2025-10-21,2025-11-14,671.3,1,-4601,44392815,-28335435,0.0100106289722785,99.9250351661637,-1.03532853285329
603.92,604,540,555,19440,4440,2025-10-21,2025-10-24,671.3,15,-15000,35747412,-54558423,0.0124204795580726,99.8037116644976,-3.37837837837838
409.74,410,154,154,4004,4004,2025-10-21,2025-11-28,671.3,0,0,134798008,-74418053,0.00297037030398847,99.9824218470647,0
517.94,518,664,664,23904,3984,2025-10-21,2025-10-31,671.3,0,-19920,118384054,-132327608,0.00336531810272353,99.9396506559912,-5
501.95,502,744,795,24552,3975,2025-10-21,2025-10-31,671.3,51,-20577,118384054,-132327608,0.00335771572749147,99.9430083717187,-5.17660377358491
489.8,490,198,198,7524,3960,2025-10-21,2025-11-14,671.3,0,-3564,44392815,-28335435,0.00892036245054521,99.9339555286143,-0.9
550.84,551,246,246,14760,3936,2025-10-21,2025-10-31,671.3,0,-10824,118384054,-132327608,0.0033247721014859,99.9463331438202,-2.75
454.96,455,984,981,18696,3924,2025-10-21,2025-10-31,671.3,-3,-14772,118384054,-132327608,0.00331463560117649,99.9496477794214,-3.76452599388379
514.84,515,245,245,14700,3920,2025-10-21,2025-11-07,671.3,0,-10780,75641782,-43457618,0.00518232106165875,99.9575829665145,-2.75
533.9,534,388,388,16296,3880,2025-10-21,2025-10-31,671.3,0,-12416,118384054,-132327608,0.00327746843337533,99.9529252478548,-3.2
671.64,691,0,2,0,3872,2025-10-21,2025-10-31,671.3,2,3872,118384054,-132327608,0.00327071076650239,99.9561959586213,1
607.94,608,646,642,21318,3852,2025-10-21,2025-10-24,671.3,-4,-17466,35747412,-54558423,0.0107756052382198,99.8144872697358,-4.53426791277259
389.97,390,1264,1264,3792,3792,2025-10-21,2025-10-31,671.3,0,0,118384054,-132327608,0.003203134097773,99.959399092719,0
399.99,400,4074,3690,20370,3690,2025-10-21,2025-10-31,671.3,-384,-16680,118384054,-132327608,0.00311697384514303,99.9625160665642,-4.52032520325203
670.1,707,0,1,0,3690,2025-10-21,2025-11-28,671.3,1,3690,134798008,-74418053,0.00273742917625311,99.9851592762409,1
660.13,697,1,1,3687,3687,2025-10-21,2025-10-31,671.3,0,0,118384054,-132327608,0.00311443972006568,99.9656305062842,0
559.97,560,1249,1214,12490,3642,2025-10-21,2025-10-24,671.3,-35,-8848,35747412,-54558423,0.0101881501239866,99.8246754198598,-2.42943437671609
658.62,695,1,1,3638,3638,2025-10-21,2025-10-24,671.3,0,0,35747412,-54558423,0.0101769605027631,99.8348523803625,0
389.92,390,446,446,3568,3568,2025-10-21,2025-11-07,671.3,0,0,75641782,-43457618,0.00471696978265266,99.9622999362971,0
434.86,435,253,253,3542,3542,2025-10-21,2025-11-07,671.3,0,0,75641782,-43457618,0.0046825972449988,99.9669825335421,0
533.32,534,53,52,8003,3536,2025-10-21,2025-11-28,671.3,-1,-4467,134798008,-74418053,0.00262318416456125,99.9877824604055,-1.26329185520362
394.97,395,1131,1147,10179,3441,2025-10-21,2025-11-07,671.3,16,-6738,75641782,-43457618,0.00454907315642035,99.9715316066985,-1.95815170008718
671.26,688,0,2,0,3348,2025-10-21,2025-10-24,671.3,2,3348,35747412,-54558423,0.00936571296406017,99.8442180933266,1
493.94,494,510,558,8670,3348,2025-10-21,2025-10-31,671.3,48,-5322,118384054,-132327608,0.00282808358632489,99.9684585898706,-1.58960573476703
409.8,410,166,166,3320,3320,2025-10-21,2025-11-14,671.3,0,0,44392815,-28335435,0.00747868771106315,99.9414342163253,0
444.8,445,164,164,3280,3280,2025-10-21,2025-11-07,671.3,0,0,75641782,-43457618,0.00433622782710222,99.9758678345256,0
469.91,470,363,363,9075,3267,2025-10-21,2025-11-07,671.3,0,-5808,75641782,-43457618,0.00431904155827529,99.9801868760839,-1.77777777777778
439.9,440,305,325,7320,3250,2025-10-21,2025-11-14,671.3,20,-4070,44392815,-28335435,0.0073210045364323,99.9487552208618,-1.25230769230769
500.93,501,478,458,12428,3206,2025-10-21,2025-10-31,671.3,-20,-9222,118384054,-132327608,0.00270813499933023,99.9711667248699,-2.87648159700561
424.98,425,1585,1585,7925,3170,2025-10-21,2025-10-31,671.3,0,-4755,118384054,-132327608,0.00267772549840201,99.9738444503683,-1.5
671.33,703,0,1,0,3167,2025-10-21,2025-11-28,671.3,1,3167,134798008,-74418053,0.00234944124693593,99.9901319016524,1
671.25,687,2,2,5640,3150,2025-10-21,2025-10-24,671.3,0,-2490,35747412,-54558423,0.00881182671349747,99.8530299200401,-0.79047619047619
506.91,507,318,347,12084,3123,2025-10-21,2025-10-31,671.3,29,-8961,118384054,-132327608,0.00263802420552349,99.9764824745738,-2.86935638808838
662,693,1,1,3100,3100,2025-10-21,2025-11-21,671.3,0,0,432623087,-236699682,0.000716559077208933,100,0
622.9,623,320,309,15360,3090,2025-10-21,2025-10-24,671.3,-11,-12270,35747412,-54558423,0.00864398239514514,99.8616739024352,-3.97087378640777
569.99,570,3012,3080,39156,3080,2025-10-21,2025-10-24,671.3,68,-36076,35747412,-54558423,0.00861600834208642,99.8702899107773,-11.712987012987
600.94,601,487,497,11201,2982,2025-10-21,2025-10-24,671.3,10,-8219,35747412,-54558423,0.00834186262211094,99.8786317733994,-2.75620389000671
564.98,565,1488,1484,20832,2968,2025-10-21,2025-10-24,671.3,-4,-17864,35747412,-54558423,0.00830269894782873,99.8869344723473,-6.0188679245283
668.85,698,1,1,2915,2915,2025-10-21,2025-11-28,671.3,0,0,134798008,-74418053,0.00216249486416743,99.9922943965166,0
671.94,701,1,1,2906,2906,2025-10-21,2025-11-28,671.3,0,0,134798008,-74418053,0.00215581820763998,99.9944502147243,0
579.98,580,1486,1447,19318,2894,2025-10-21,2025-10-24,671.3,-39,-16424,35747412,-54558423,0.00809569095519418,99.8950301633025,-5.67519004837595
597.96,598,665,722,13965,2888,2025-10-21,2025-10-24,671.3,57,-11077,35747412,-54558423,0.00807890652335895,99.9031090698258,-3.83552631578947
492.94,493,463,466,13890,2796,2025-10-21,2025-10-31,671.3,3,-11094,118384054,-132327608,0.00236180457209212,99.9788442791459,-3.96781115879828
612.94,613,469,463,16884,2778,2025-10-21,2025-10-24,671.3,-6,-14106,35747412,-54558423,0.007771191939713,99.9108802617655,-5.07775377969763
668.96,696,1,1,2704,2704,2025-10-21,2025-10-31,671.3,0,0,118384054,-132327608,0.00228409140305332,99.981128370549,0
429.95,430,500,539,6500,2695,2025-10-21,2025-11-07,671.3,39,-3805,75641782,-43457618,0.00356284572989039,99.9837497218138,-1.41187384044527
484.96,485,667,667,16008,2668,2025-10-21,2025-10-31,671.3,0,-13340,118384054,-132327608,0.0022536819021251,99.9833820524511,-5
474.96,475,642,661,7062,2644,2025-10-21,2025-10-31,671.3,19,-4418,118384054,-132327608,0.00223340890150628,99.9856154613526,-1.67095310136157
514.99,515,1301,2573,9107,2573,2025-10-21,2025-10-24,671.3,1272,-6534,35747412,-54558423,0.0071977238520092,99.9180779856175,-2.53944811504081
611.91,612,271,272,8672,2448,2025-10-21,2025-10-24,671.3,1,-6224,35747412,-54558423,0.00684804818877518,99.9249260338063,-2.54248366013072
379.99,380,1699,2392,6796,2392,2025-10-21,2025-10-31,671.3,693,-4404,118384054,-132327608,0.00202054239500871,99.9876360037476,-1.84113712374582
618.93,619,137,333,7809,2331,2025-10-21,2025-10-24,671.3,196,-5478,35747412,-54558423,0.00652075176798813,99.9314467855743,-2.35006435006435
419.99,420,2307,2308,16149,2308,2025-10-21,2025-10-31,671.3,1,-13841,118384054,-132327608,0.00194958689284285,99.9895855906404,-5.99696707105719
595.95,596,437,458,8740,2290,2025-10-21,2025-10-24,671.3,21,-6450,35747412,-54558423,0.00640605815044737,99.9378528437247,-2.81659388646288
439.99,440,2276,2270,34140,2270,2025-10-21,2025-10-31,671.3,-6,-31870,118384054,-132327608,0.00191748797519639,99.9915030786156,-14.0396475770925
668.46,691,0,1,0,2254,2025-10-21,2025-11-14,671.3,1,2254,44392815,-28335435,0.00507739822311336,99.9538326190849,1
429.9,430,220,220,3960,2200,2025-10-21,2025-11-14,671.3,0,-1760,44392815,-28335435,0.00495575691696956,99.9587883760018,-0.8
606.93,607,271,313,16260,2191,2025-10-21,2025-10-24,671.3,42,-14069,35747412,-54558423,0.00612911502516602,99.9439819587499,-6.42126882701963
555,556,16,21,2560,2100,2025-10-21,2025-11-28,671.3,5,-460,134798008,-74418053,0.00155788652307088,99.9960081012473,-0.219047619047619
668.21,689,1,1,2079,2079,2025-10-21,2025-11-28,671.3,0,0,134798008,-74418053,0.00154230765784017,99.9975504089052,0
516.94,517,346,343,8996,2058,2025-10-21,2025-10-31,671.3,-3,-6938,118384054,-132327608,0.00173840980306351,99.9932414884187,-3.3712342079689
554.98,555,903,1018,17157,2036,2025-10-21,2025-10-24,671.3,115,-15121,35747412,-54558423,0.00569551720275583,99.9496774759527,-7.42681728880157
668.68,689,0,1,0,2032,2025-10-21,2025-11-07,671.3,1,2032,75641782,-43457618,0.00268634601971699,99.9864360678335,1
489.88,490,169,168,7267,2016,2025-10-21,2025-11-07,671.3,-1,-5251,75641782,-43457618,0.00266519368885307,99.9891012615224,-2.6046626984127
374.9,375,201,201,2010,2010,2025-10-21,2025-11-14,671.3,0,0,44392815,-28335435,0.00452775972868583,99.9633161357305,0
667,687,1,1,2480,2000,2025-10-21,2025-11-28,671.3,0,-480,134798008,-74418053,0.00148370145054369,99.9990341103557,-0.24
593.95,594,389,395,9336,1975,2025-10-21,2025-10-24,671.3,6,-7361,35747412,-54558423,0.00552487547909762,99.9552023514318,-3.72708860759494
591.97,592,301,657,5418,1971,2025-10-21,2025-10-24,671.3,356,-3447,35747412,-54558423,0.00551368585787413,99.9607160372896,-1.74885844748858
474.79,475,92,93,3864,1953,2025-10-21,2025-11-14,671.3,1,-1911,44392815,-28335435,0.0043993605722007,99.9677154963027,-0.978494623655914
662.84,682,2,1,5208,1916,2025-10-21,2025-12-19,671.3,-1,-3292,452890228,-117820487,0.000423060574404798,100,-1.71816283924843
399.93,400,269,265,5111,1855,2025-10-21,2025-11-14,671.3,-4,-3256,44392815,-28335435,0.00417860412771752,99.9718941004305,-1.75525606469003
464.67,465,54,54,1782,1782,2025-10-21,2025-11-07,671.3,0,0,75641782,-43457618,0.00235584084996834,99.9914571023723,0
374.99,375,1757,1756,5271,1756,2025-10-21,2025-10-31,671.3,-1,-3515,118384054,-132327608,0.00148330787861007,99.9947247962973,-2.00170842824601
608.95,609,466,348,17708,1740,2025-10-21,2025-10-24,671.3,-118,-15968,35747412,-54558423,0.00486748523221765,99.9655835225219,-9.17701149425287
394.9,395,166,166,1660,1660,2025-10-21,2025-11-14,671.3,0,0,44392815,-28335435,0.00373934385553158,99.975633444286,0
605.95,606,328,324,7872,1620,2025-10-21,2025-10-24,671.3,-4,-6252,35747412,-54558423,0.00453179659551298,99.9701153191174,-3.85925925925926
539.99,540,1281,1616,8967,1616,2025-10-21,2025-10-24,671.3,335,-7351,35747412,-54558423,0.0045206069742895,99.9746359260917,-4.54888613861386
419.96,420,359,381,2872,1524,2025-10-21,2025-11-07,671.3,22,-1348,75641782,-43457618,0.00201475951478774,99.9934718618871,-0.884514435695538
519.99,520,1496,1496,11968,1496,2025-10-21,2025-10-24,671.3,0,-10472,35747412,-54558423,0.00418491833758483,99.9788208444292,-7
414.98,415,717,735,5019,1470,2025-10-21,2025-10-31,671.3,18,-3549,118384054,-132327608,0.00124172128790251,99.9959665175852,-2.41428571428572
549.99,550,1438,1459,11504,1459,2025-10-21,2025-10-24,671.3,21,-10045,35747412,-54558423,0.00408141434126756,99.9829022587705,-6.88485263879369
384.99,385,1483,1457,4449,1457,2025-10-21,2025-10-31,671.3,-26,-2992,118384054,-132327608,0.00123074007923398,99.9971972576645,-2.05353466026081
602.96,603,351,362,10881,1448,2025-10-21,2025-10-24,671.3,11,-9433,35747412,-54558423,0.00405064288290297,99.9869529016534,-6.51450276243094
414.8,415,71,71,1420,1420,2025-10-21,2025-11-14,671.3,0,0,44392815,-28335435,0.00319871582822581,99.9788321601142,0
369.93,370,200,200,1400,1400,2025-10-21,2025-11-14,671.3,0,0,44392815,-28335435,0.00315366349261699,99.9819858236068,0
434.9,435,129,140,3612,1400,2025-10-21,2025-11-14,671.3,11,-2212,44392815,-28335435,0.00315366349261699,99.9851394870994,-1.58
379.96,380,324,349,4536,1396,2025-10-21,2025-11-14,671.3,25,-3140,44392815,-28335435,0.00314465302549523,99.9882841401249,-2.24928366762178
509.99,510,790,1385,6320,1385,2025-10-21,2025-10-24,671.3,595,-4935,35747412,-54558423,0.00387440634863302,99.990827308002,-3.56317689530686
404.86,405,89,93,2848,1302,2025-10-21,2025-11-28,671.3,4,-1546,134798008,-74418053,0.000965889644303943,100,-1.18740399385561
515.93,516,180,180,9180,1260,2025-10-21,2025-10-31,671.3,0,-7920,118384054,-132327608,0.00106433253248786,99.9982615901969,-6.28571428571429
399.96,400,277,280,2770,1120,2025-10-21,2025-11-07,671.3,3,-1650,75641782,-43457618,0.00148066316047393,99.9949525250476,-1.47321428571429
464.85,465,74,74,3182,1110,2025-10-21,2025-11-14,671.3,0,-2072,44392815,-28335435,0.00250040462628919,99.9907845447512,-1.86666666666667
464.98,465,541,540,11361,1080,2025-10-21,2025-10-31,671.3,-1,-10281,118384054,-132327608,0.00091228502784674,99.9991738752248,-9.51944444444444
404.94,405,17,169,136,1014,2025-10-21,2025-11-14,671.3,152,878,44392815,-28335435,0.00228415341536688,99.9930686981666,0.865877712031558
404.99,405,1282,978,10256,978,2025-10-21,2025-10-31,671.3,-304,-9278,118384054,-132327608,0.00082612477521677,100,-9.48670756646217
379.99,380,894,895,8940,895,2025-10-21,2025-11-07,671.3,1,-8045,75641782,-43457618,0.00118320850770015,99.9961357335553,-8.98882681564246
524.99,525,1090,866,5450,866,2025-10-21,2025-10-24,671.3,-224,-4584,35747412,-54558423,0.00242255299488534,99.9932498609969,-5.29330254041571
529.99,530,860,836,8600,836,2025-10-21,2025-10-24,671.3,-24,-7764,35747412,-54558423,0.00233863083570917,99.9955884918326,-9.28708133971292
459.93,460,116,119,2088,833,2025-10-21,2025-11-07,671.3,3,-1255,75641782,-43457618,0.00110124322560249,99.9972369767809,-1.50660264105642
544.99,545,849,829,8490,829,2025-10-21,2025-10-24,671.3,-20,-7661,35747412,-54558423,0.00231904899856806,99.9979075408312,-9.24125452352231
610.96,611,128,187,4736,748,2025-10-21,2025-10-24,671.3,59,-3988,35747412,-54558423,0.00209245916879242,100,-5.33155080213904
389.88,390,61,61,732,732,2025-10-21,2025-11-14,671.3,0,0,44392815,-28335435,0.0016489154832826,99.9947176136499,0
359.9,360,58,58,580,580,2025-10-21,2025-11-14,671.3,0,0,44392815,-28335435,0.00130651773265561,99.9960241313825,0
349.96,350,137,138,1507,552,2025-10-21,2025-11-14,671.3,1,-955,44392815,-28335435,0.00124344446280327,99.9972675758453,-1.73007246376812
439.95,440,102,107,2040,535,2025-10-21,2025-11-07,671.3,5,-1505,75641782,-43457618,0.0007072810632621,99.9979442578442,-2.81308411214953
424.92,425,60,60,1500,480,2025-10-21,2025-11-14,671.3,0,-1020,44392815,-28335435,0.00108125605461154,99.9983488318999,-2.125
449.94,450,76,78,1520,468,2025-10-21,2025-11-07,671.3,2,-1052,75641782,-43457618,0.000618705677769464,99.9985629635219,-2.24786324786325
354.91,355,48,48,432,432,2025-10-21,2025-11-14,671.3,0,0,44392815,-28335435,0.000973130449150386,99.9993219623491,0
384.96,385,106,106,1060,424,2025-10-21,2025-11-07,671.3,0,-636,75641782,-43457618,0.000560536767893702,99.9991235002898,-1.5
454.93,455,24,48,576,336,2025-10-21,2025-11-07,671.3,24,-240,75641782,-43457618,0.000444198948142179,99.999567699238,-0.714285714285714
384.95,385,53,53,901,265,2025-10-21,2025-11-14,671.3,0,-636,44392815,-28335435,0.000596943446816788,99.9999189057959,-2.4
424.95,425,34,34,578,170,2025-10-21,2025-11-07,671.3,0,-408,75641782,-43457618,0.000224743515429079,99.9997924427534,-2.4
369.99,370,103,98,721,98,2025-10-21,2025-11-07,671.3,-5,-623,75641782,-43457618,0.000129558026541469,99.99992200078,-6.35714285714286
374.99,375,56,59,616,59,2025-10-21,2025-11-07,671.3,3,-557,75641782,-43457618,7.79992200606802e-05,100,-9.4406779661017
364.96,365,8,9,56,36,2025-10-21,2025-11-14,671.3,1,-20,44392815,-28335435,8.10942040958655e-05,100,-0.555555555555556
672.35,689,0,0,0,0,2025-10-21,2025-10-24,671.3,0,0,35747412,-54558423,0,100,
663.2,692,0,0,0,0,2025-10-21,2025-10-24,671.3,0,0,35747412,-54558423,0,100,
659.47,694,0,0,0,0,2025-10-21,2025-10-24,671.3,0,0,35747412,-54558423,0,100,
659.79,696,0,0,0,0,2025-10-21,2025-10-24,671.3,0,0,35747412,-54558423,0,100,
661.43,697,0,0,0,0,2025-10-21,2025-10-24,671.3,0,0,35747412,-54558423,0,100,
663.97,698,0,0,0,0,2025-10-21,2025-10-24,671.3,0,0,35747412,-54558423,0,100,
699,699,0,0,0,0,2025-10-21,2025-10-24,671.3,0,0,35747412,-54558423,0,100,
672.85,701,0,0,0,0,2025-10-21,2025-10-24,671.3,0,0,35747412,-54558423,0,100,
702,702,0,0,0,0,2025-10-21,2025-10-24,671.3,0,0,35747412,-54558423,0,100,
669.99,703,0,0,0,0,2025-10-21,2025-10-24,671.3,0,0,35747412,-54558423,0,100,
669.79,704,0,0,0,0,2025-10-21,2025-10-24,671.3,0,0,35747412,-54558423,0,100,
705,705,0,0,0,0,2025-10-21,2025-10-24,671.3,0,0,35747412,-54558423,0,100,
707,707,0,0,0,0,2025-10-21,2025-10-24,671.3,0,0,35747412,-54558423,0,100,
708,708,0,0,0,0,2025-10-21,2025-10-24,671.3,0,0,35747412,-54558423,0,100,
669.35,709,0,0,0,0,2025-10-21,2025-10-24,671.3,0,0,35747412,-54558423,0,100,
658.38,710,0,0,0,0,2025-10-21,2025-10-24,671.3,0,0,35747412,-54558423,0,100,
711,711,0,0,0,0,2025-10-21,2025-10-24,671.3,0,0,35747412,-54558423,0,100,
670.46,712,0,0,0,0,2025-10-21,2025-10-24,671.3,0,0,35747412,-54558423,0,100,
713,713,0,0,0,0,2025-10-21,2025-10-24,671.3,0,0,35747412,-54558423,0,100,
714,714,0,0,0,0,2025-10-21,2025-10-24,671.3,0,0,35747412,-54558423,0,100,
715,715,0,0,0,0,2025-10-21,2025-10-24,671.3,0,0,35747412,-54558423,0,100,
656.42,716,0,0,0,0,2025-10-21,2025-10-24,671.3,0,0,35747412,-54558423,0,100,
718,718,0,0,0,0,2025-10-21,2025-10-24,671.3,0,0,35747412,-54558423,0,100,
720,720,0,0,0,0,2025-10-21,2025-10-24,671.3,0,0,35747412,-54558423,0,100,
725,725,0,0,0,0,2025-10-21,2025-10-24,671.3,0,0,35747412,-54558423,0,100,
735,735,0,0,0,0,2025-10-21,2025-10-24,671.3,0,0,35747412,-54558423,0,100,
740,740,0,0,0,0,2025-10-21,2025-10-24,671.3,0,0,35747412,-54558423,0,100,
745,745,0,0,0,0,2025-10-21,2025-10-24,671.3,0,0,35747412,-54558423,0,100,
750,750,0,0,0,0,2025-10-21,2025-10-24,671.3,0,0,35747412,-54558423,0,100,
755,755,0,0,0,0,2025-10-21,2025-10-24,671.3,0,0,35747412,-54558423,0,100,
760,760,0,0,0,0,2025-10-21,2025-10-24,671.3,0,0,35747412,-54558423,0,100,
765,765,0,0,0,0,2025-10-21,2025-10-24,671.3,0,0,35747412,-54558423,0,100,
770,770,0,0,0,0,2025-10-21,2025-10-24,671.3,0,0,35747412,-54558423,0,100,
780,780,0,0,0,0,2025-10-21,2025-10-24,671.3,0,0,35747412,-54558423,0,100,
667.65,689,0,0,0,0,2025-10-21,2025-10-31,671.3,0,0,118384054,-132327608,0,100,
659.01,694,0,0,0,0,2025-10-21,2025-10-31,671.3,0,0,118384054,-132327608,0,100,
666.26,695,0,0,0,0,2025-10-21,2025-10-31,671.3,0,0,118384054,-132327608,0,100,
698,698,0,0,0,0,2025-10-21,2025-10-31,671.3,0,0,118384054,-132327608,0,100,
665.53,699,0,0,0,0,2025-10-21,2025-10-31,671.3,0,0,118384054,-132327608,0,100,
668.84,701,0,0,0,0,2025-10-21,2025-10-31,671.3,0,0,118384054,-132327608,0,100,
702,702,0,0,0,0,2025-10-21,2025-10-31,671.3,0,0,118384054,-132327608,0,100,
703,703,0,0,0,0,2025-10-21,2025-10-31,671.3,0,0,118384054,-132327608,0,100,
666.74,704,0,0,0,0,2025-10-21,2025-10-31,671.3,0,0,118384054,-132327608,0,100,
672.5,705,0,0,0,0,2025-10-21,2025-10-31,671.3,0,0,118384054,-132327608,0,100,
662.94,706,0,0,0,0,2025-10-21,2025-10-31,671.3,0,0,118384054,-132327608,0,100,
670.37,707,0,0,0,0,2025-10-21,2025-10-31,671.3,0,0,118384054,-132327608,0,100,
671.05,708,0,0,0,0,2025-10-21,2025-10-31,671.3,0,0,118384054,-132327608,0,100,
709,709,0,0,0,0,2025-10-21,2025-10-31,671.3,0,0,118384054,-132327608,0,100,
665.37,710,0,0,0,0,2025-10-21,2025-10-31,671.3,0,0,118384054,-132327608,0,100,
669.75,711,0,0,0,0,2025-10-21,2025-10-31,671.3,0,0,118384054,-132327608,0,100,
712,712,0,0,0,0,2025-10-21,2025-10-31,671.3,0,0,118384054,-132327608,0,100,
713,713,0,0,0,0,2025-10-21,2025-10-31,671.3,0,0,118384054,-132327608,0,100,
714,714,0,0,0,0,2025-10-21,2025-10-31,671.3,0,0,118384054,-132327608,0,100,
662.81,715,0,0,0,0,2025-10-21,2025-10-31,671.3,0,0,118384054,-132327608,0,100,
658.4,716,0,0,0,0,2025-10-21,2025-10-31,671.3,0,0,118384054,-132327608,0,100,
718,718,0,0,0,0,2025-10-21,2025-10-31,671.3,0,0,118384054,-132327608,0,100,
669.87,720,0,0,0,0,2025-10-21,2025-10-31,671.3,0,0,118384054,-132327608,0,100,
643.98,725,0,0,0,0,2025-10-21,2025-10-31,671.3,0,0,118384054,-132327608,0,100,
643.96,730,0,0,0,0,2025-10-21,2025-10-31,671.3,0,0,118384054,-132327608,0,100,
735,735,0,0,0,0,2025-10-21,2025-10-31,671.3,0,0,118384054,-132327608,0,100,
740,740,0,0,0,0,2025-10-21,2025-10-31,671.3,0,0,118384054,-132327608,0,100,
745,745,0,0,0,0,2025-10-21,2025-10-31,671.3,0,0,118384054,-132327608,0,100,
750,750,0,0,0,0,2025-10-21,2025-10-31,671.3,0,0,118384054,-132327608,0,100,
755,755,0,0,0,0,2025-10-21,2025-10-31,671.3,0,0,118384054,-132327608,0,100,
760,760,0,0,0,0,2025-10-21,2025-10-31,671.3,0,0,118384054,-132327608,0,100,
765,765,0,0,0,0,2025-10-21,2025-10-31,671.3,0,0,118384054,-132327608,0,100,
770,770,0,0,0,0,2025-10-21,2025-10-31,671.3,0,0,118384054,-132327608,0,100,
780,780,0,0,0,0,2025-10-21,2025-10-31,671.3,0,0,118384054,-132327608,0,100,
705,705,0,0,0,0,2025-10-21,2025-11-07,671.3,0,0,75641782,-43457618,0,100,
715,715,0,0,0,0,2025-10-21,2025-11-07,671.3,0,0,75641782,-43457618,0,100,
720,720,0,0,0,0,2025-10-21,2025-11-07,671.3,0,0,75641782,-43457618,0,100,
725,725,0,0,0,0,2025-10-21,2025-11-07,671.3,0,0,75641782,-43457618,0,100,
671.49,730,0,0,0,0,2025-10-21,2025-11-07,671.3,0,0,75641782,-43457618,0,100,
735,735,0,0,0,0,2025-10-21,2025-11-07,671.3,0,0,75641782,-43457618,0,100,
740,740,0,0,0,0,2025-10-21,2025-11-07,671.3,0,0,75641782,-43457618,0,100,
745,745,0,0,0,0,2025-10-21,2025-11-07,671.3,0,0,75641782,-43457618,0,100,
750,750,0,0,0,0,2025-10-21,2025-11-07,671.3,0,0,75641782,-43457618,0,100,
755,755,0,0,0,0,2025-10-21,2025-11-07,671.3,0,0,75641782,-43457618,0,100,
760,760,0,0,0,0,2025-10-21,2025-11-07,671.3,0,0,75641782,-43457618,0,100,
765,765,0,0,0,0,2025-10-21,2025-11-07,671.3,0,0,75641782,-43457618,0,100,
770,770,0,0,0,0,2025-10-21,2025-11-07,671.3,0,0,75641782,-43457618,0,100,
780,780,0,0,0,0,2025-10-21,2025-11-07,671.3,0,0,75641782,-43457618,0,100,
692,692,0,0,0,0,2025-10-21,2025-11-14,671.3,0,0,44392815,-28335435,0,100,
693,693,0,0,0,0,2025-10-21,2025-11-14,671.3,0,0,44392815,-28335435,0,100,
694,694,0,0,0,0,2025-10-21,2025-11-14,671.3,0,0,44392815,-28335435,0,100,
696,696,0,0,0,0,2025-10-21,2025-11-14,671.3,0,0,44392815,-28335435,0,100,
697,697,0,0,0,0,2025-10-21,2025-11-14,671.3,0,0,44392815,-28335435,0,100,
698,698,0,0,0,0,2025-10-21,2025-11-14,671.3,0,0,44392815,-28335435,0,100,
699,699,0,0,0,0,2025-10-21,2025-11-14,671.3,0,0,44392815,-28335435,0,100,
655.58,705,0,0,0,0,2025-10-21,2025-11-14,671.3,0,0,44392815,-28335435,0,100,
710,710,0,0,0,0,2025-10-21,2025-11-14,671.3,0,0,44392815,-28335435,0,100,
715,715,0,0,0,0,2025-10-21,2025-11-14,671.3,0,0,44392815,-28335435,0,100,
670.77,720,0,0,0,0,2025-10-21,2025-11-14,671.3,0,0,44392815,-28335435,0,100,
725,725,0,0,0,0,2025-10-21,2025-11-14,671.3,0,0,44392815,-28335435,0,100,
730,730,0,0,0,0,2025-10-21,2025-11-14,671.3,0,0,44392815,-28335435,0,100,
735,735,0,0,0,0,2025-10-21,2025-11-14,671.3,0,0,44392815,-28335435,0,100,
740,740,0,0,0,0,2025-10-21,2025-11-14,671.3,0,0,44392815,-28335435,0,100,
659.28,745,0,0,0,0,2025-10-21,2025-11-14,671.3,0,0,44392815,-28335435,0,100,
666.36,750,0,0,0,0,2025-10-21,2025-11-14,671.3,0,0,44392815,-28335435,0,100,
755,755,0,0,0,0,2025-10-21,2025-11-14,671.3,0,0,44392815,-28335435,0,100,
760,760,0,0,0,0,2025-10-21,2025-11-14,671.3,0,0,44392815,-28335435,0,100,
765,765,0,0,0,0,2025-10-21,2025-11-14,671.3,0,0,44392815,-28335435,0,100,
770,770,0,0,0,0,2025-10-21,2025-11-14,671.3,0,0,44392815,-28335435,0,100,
780,780,0,0,0,0,2025-10-21,2025-11-14,671.3,0,0,44392815,-28335435,0,100,
697,697,0,0,0,0,2025-10-21,2025-11-21,671.3,0,0,432623087,-236699682,0,100,
662.82,702,0,0,0,0,2025-10-21,2025-11-21,671.3,0,0,432623087,-236699682,0,100,
672.66,704,0,0,0,0,2025-10-21,2025-11-21,671.3,0,0,432623087,-236699682,0,100,
660.25,705,0,0,0,0,2025-10-21,2025-11-21,671.3,0,0,432623087,-236699682,0,100,
659,708,0,0,0,0,2025-10-21,2025-11-21,671.3,0,0,432623087,-236699682,0,100,
662,710,0,0,0,0,2025-10-21,2025-11-21,671.3,0,0,432623087,-236699682,0,100,
712,712,0,0,0,0,2025-10-21,2025-11-21,671.3,0,0,432623087,-236699682,0,100,
714,714,0,0,0,0,2025-10-21,2025-11-21,671.3,0,0,432623087,-236699682,0,100,
654.93,715,0,0,0,0,2025-10-21,2025-11-21,671.3,0,0,432623087,-236699682,0,100,
716,716,0,0,0,0,2025-10-21,2025-11-21,671.3,0,0,432623087,-236699682,0,100,
657.09,725,0,0,0,0,2025-10-21,2025-11-21,671.3,0,0,432623087,-236699682,0,100,
662.92,735,0,0,0,0,2025-10-21,2025-11-21,671.3,0,0,432623087,-236699682,0,100,
740,740,0,0,0,0,2025-10-21,2025-11-21,671.3,0,0,432623087,-236699682,0,100,
745,745,0,0,0,0,2025-10-21,2025-11-21,671.3,0,0,432623087,-236699682,0,100,
664.74,750,0,0,0,0,2025-10-21,2025-11-21,671.3,0,0,432623087,-236699682,0,100,
664.72,755,0,0,0,0,2025-10-21,2025-11-21,671.3,0,0,432623087,-236699682,0,100,
760,760,0,0,0,0,2025-10-21,2025-11-21,671.3,0,0,432623087,-236699682,0,100,
765,765,0,0,0,0,2025-10-21,2025-11-21,671.3,0,0,432623087,-236699682,0,100,
770,770,0,0,0,0,2025-10-21,2025-11-21,671.3,0,0,432623087,-236699682,0,100,
775,775,0,0,0,0,2025-10-21,2025-11-21,671.3,0,0,432623087,-236699682,0,100,
780,780,0,0,0,0,2025-10-21,2025-11-21,671.3,0,0,432623087,-236699682,0,100,
785,785,0,0,0,0,2025-10-21,2025-11-21,671.3,0,0,432623087,-236699682,0,100,
790,790,0,0,0,0,2025-10-21,2025-11-21,671.3,0,0,432623087,-236699682,0,100,
795,795,0,0,0,0,2025-10-21,2025-11-21,671.3,0,0,432623087,-236699682,0,100,
800,800,0,0,0,0,2025-10-21,2025-11-21,671.3,0,0,432623087,-236699682,0,100,
663.21,696,0,0,0,0,2025-10-21,2025-11-28,671.3,0,0,134798008,-74418053,0,100,
702,702,0,0,0,0,2025-10-21,2025-11-28,671.3,0,0,134798008,-74418053,0,100,
704,704,0,0,0,0,2025-10-21,2025-11-28,671.3,0,0,134798008,-74418053,0,100,
706,706,0,0,0,0,2025-10-21,2025-11-28,671.3,0,0,134798008,-74418053,0,100,
708,708,0,0,0,0,2025-10-21,2025-11-28,671.3,0,0,134798008,-74418053,0,100,
709,709,0,0,0,0,2025-10-21,2025-11-28,671.3,0,0,134798008,-74418053,0,100,
665,710,0,0,0,0,2025-10-21,2025-11-28,671.3,0,0,134798008,-74418053,0,100,
672.85,711,0,0,0,0,2025-10-21,2025-11-28,671.3,0,0,134798008,-74418053,0,100,
712,712,0,0,0,0,2025-10-21,2025-11-28,671.3,0,0,134798008,-74418053,0,100,
713,713,0,0,0,0,2025-10-21,2025-11-28,671.3,0,0,134798008,-74418053,0,100,
714,714,0,0,0,0,2025-10-21,2025-11-28,671.3,0,0,134798008,-74418053,0,100,
715,715,0,0,0,0,2025-10-21,2025-11-28,671.3,0,0,134798008,-74418053,0,100,
716,716,0,0,0,0,2025-10-21,2025-11-28,671.3,0,0,134798008,-74418053,0,100,
717,717,0,0,0,0,2025-10-21,2025-11-28,671.3,0,0,134798008,-74418053,0,100,
718,718,0,0,0,0,2025-10-21,2025-11-28,671.3,0,0,134798008,-74418053,0,100,
719,719,0,0,0,0,2025-10-21,2025-11-28,671.3,0,0,134798008,-74418053,0,100,
722,722,0,0,0,0,2025-10-21,2025-11-28,671.3,0,0,134798008,-74418053,0,100,
672.18,725,0,0,0,0,2025-10-21,2025-11-28,671.3,0,0,134798008,-74418053,0,100,
668.64,730,0,0,0,0,2025-10-21,2025-11-28,671.3,0,0,134798008,-74418053,0,100,
735,735,0,0,0,0,2025-10-21,2025-11-28,671.3,0,0,134798008,-74418053,0,100,
740,740,0,0,0,0,2025-10-21,2025-11-28,671.3,0,0,134798008,-74418053,0,100,
745,745,0,0,0,0,2025-10-21,2025-11-28,671.3,0,0,134798008,-74418053,0,100,
657.63,750,0,0,0,0,2025-10-21,2025-11-28,671.3,0,0,134798008,-74418053,0,100,
755,755,0,0,0,0,2025-10-21,2025-11-28,671.3,0,0,134798008,-74418053,0,100,
760,760,0,0,0,0,2025-10-21,2025-11-28,671.3,0,0,134798008,-74418053,0,100,
765,765,0,0,0,0,2025-10-21,2025-11-28,671.3,0,0,134798008,-74418053,0,100,
770,770,0,0,0,0,2025-10-21,2025-11-28,671.3,0,0,134798008,-74418053,0,100,
658.89,780,0,0,0,0,2025-10-21,2025-11-28,671.3,0,0,134798008,-74418053,0,100,
693,693,0,0,0,0,2025-10-21,2025-12-19,671.3,0,0,452890228,-117820487,0,100,
694,694,0,0,0,0,2025-10-21,2025-12-19,671.3,0,0,452890228,-117820487,0,100,
696,696,0,0,0,0,2025-10-21,2025-12-19,671.3,0,0,452890228,-117820487,0,100,
697,697,0,0,0,0,2025-10-21,2025-12-19,671.3,0,0,452890228,-117820487,0,100,
698,698,0,0,0,0,2025-10-21,2025-12-19,671.3,0,0,452890228,-117820487,0,100,
699,699,0,0,0,0,2025-10-21,2025-12-19,671.3,0,0,452890228,-117820487,0,100,
665.54,720,0,0,0,0,2025-10-21,2025-12-19,671.3,0,0,452890228,-117820487,0,100,
626.5,725,0,0,0,0,2025-10-21,2025-12-19,671.3,0,0,452890228,-117820487,0,100,
663.08,730,0,0,0,0,2025-10-21,2025-12-19,671.3,0,0,452890228,-117820487,0,100,
735,735,0,0,0,0,2025-10-21,2025-12-19,671.3,0,0,452890228,-117820487,0,100,
557.52,740,0,0,0,0,2025-10-21,2025-12-19,671.3,0,0,452890228,-117820487,0,100,
657.64,745,0,0,0,0,2025-10-21,2025-12-19,671.3,0,0,452890228,-117820487,0,100,
670.47,755,0,0,0,0,2025-10-21,2025-12-19,671.3,0,0,452890228,-117820487,0,100,
760,760,0,0,0,0,2025-10-21,2025-12-19,671.3,0,0,452890228,-117820487,0,100,
556.84,765,0,0,0,0,2025-10-21,2025-12-19,671.3,0,0,452890228,-117820487,0,100,
770,770,0,0,0,0,2025-10-21,2025-12-19,671.3,0,0,452890228,-117820487,0,100,
775,775,0,0,0,0,2025-10-21,2025-12-19,671.3,0,0,452890228,-117820487,0,100,
602,780,0,0,0,0,2025-10-21,2025-12-19,671.3,0,0,452890228,-117820487,0,100,
785,785,0,0,0,0,2025-10-21,2025-12-19,671.3,0,0,452890228,-117820487,0,100,
644.13,790,0,0,0,0,2025-10-21,2025-12-19,671.3,0,0,452890228,-117820487,0,100,
795,795,0,0,0,0,2025-10-21,2025-12-19,671.3,0,0,452890228,-117820487,0,100,
659.04,800,0,0,0,0,2025-10-21,2025-12-19,671.3,0,0,452890228,-117820487,0,100,
666.36,805,0,0,0,0,2025-10-21,2025-12-19,671.3,0,0,452890228,-117820487,0,100,
810,810,0,0,0,0,2025-10-21,2025-12-19,671.3,0,0,452890228,-117820487,0,100,
815,815,0,0,0,0,2025-10-21,2025-12-19,671.3,0,0,452890228,-117820487,0,100,
820,820,0,0,0,0,2025-10-21,2025-12-19,671.3,0,0,452890228,-117820487,0,100,
516.96,825,0,0,0,0,2025-10-21,2025-12-19,671.3,0,0,452890228,-117820487,0,100,
830,830,0,0,0,0,2025-10-21,2025-12-19,671.3,0,0,452890228,-117820487,0,100,
835,835,0,0,0,0,2025-10-21,2025-12-19,671.3,0,0,452890228,-117820487,0,100,
663.65,840,0,0,0,0,2025-10-21,2025-12-19,671.3,0,0,452890228,-117820487,0,100,
