Watch,strike,open_interest.yt,open_interest.td,OI_Dollar.yt,OI_Dollar.td,Date.td,expiry,stkClose,diff_oi,diff_oi_d,totalOI,totalOIdiff,OI_pct,cum_sep_OI,pct
438.52,450,18893,18951,33024964,21755748,2023-11-13,2023-12-15,440.61,58,-11269216,302704033,-178564111,7.18713516446608,7.18713516446608,-0.517987981842776
426.79,430,56161,62879,31000872,20184159,2023-11-13,2023-12-15,440.61,6718,-10816713,302704033,-178564111,6.66795179435221,13.8550869588183,-0.535901099471125
418.23,420,109360,109712,33573520,19419024,2023-11-13,2023-12-15,440.61,352,-14154496,302704033,-178564111,6.41518509269416,20.2702720515124,-0.728898424555219
430.57,435,39913,40081,29535620,17755883,2023-11-13,2023-12-15,440.61,168,-11779737,302704033,-178564111,5.86575699835489,26.1360290498673,-0.663427270837502
433.88,440,28864,27168,28459904,16626816,2023-11-13,2023-12-15,440.61,-1696,-11833088,302704033,-178564111,5.49276328934805,31.6287923392154,-0.711686951969637
432.8,440,21971,22159,24717375,15954480,2023-11-13,2023-12-29,440.61,188,-8762895,120671117,-59187285,13.2214571279721,13.2214571279721,-0.549243535358094
422.65,425,53662,59077,22162406,13883095,2023-11-13,2023-12-15,440.61,5415,-8279311,302704033,-178564111,4.58635944239303,36.2151517816084,-0.59635916919102
408.96,410,105697,114438,18602672,11901552,2023-11-13,2023-12-15,440.61,8741,-6701120,302704033,-178564111,3.93174543531767,40.1468972169261,-0.563045895190812
399.33,400,159589,159534,16916434,10688778,2023-11-13,2023-12-15,440.61,-55,-6227656,302704033,-178564111,3.53109864248158,43.6779958594077,-0.582634984092662
421.7,425,26521,26980,13897004,8903400,2023-11-13,2023-12-29,440.61,459,-4993604,120671117,-59187285,7.37823616897489,20.5996932969469,-0.560864838151717
412.97,415,34654,39491,11435820,8016673,2023-11-13,2023-12-29,440.61,4837,-3419147,120671117,-59187285,6.6434066405468,27.2430999374937,-0.426504486337412
425.74,430,17837,17693,12057812,7537218,2023-11-13,2023-12-29,440.61,-144,-4520594,120671117,-59187285,6.24608289653936,33.4891828340331,-0.599769570151746
429.48,435,12951,13261,11111958,7320072,2023-11-13,2023-12-29,440.61,310,-3791886,120671117,-59187285,6.06613428464411,39.5553171186772,-0.518012117913594
436.51,445,8239,8601,10685983,7302249,2023-11-13,2023-12-15,440.61,362,-3383734,302704033,-178564111,2.41233951448543,46.0903353738931,-0.463382445599979
413.66,415,46252,47780,10730464,6402520,2023-11-13,2023-12-15,440.61,1528,-4327944,302704033,-178564111,2.11510891894856,48.2054442928417,-0.675975084810356
435.42,445,6546,6528,9517884,6253824,2023-11-13,2023-12-29,440.61,-18,-3264060,120671117,-59187285,5.18253593359876,44.737853052276,-0.521930262188383
435.03,442,7440,8628,8332800,6013716,2023-11-13,2023-12-15,440.61,1188,-2319084,302704033,-178564111,1.98666530485241,50.1921095976941,-0.385632444232485
440.51,460,51,3061,133467,5965889,2023-11-13,2023-11-17,440.61,3010,5832422,63077977,-98136508,9.45795867866847,9.45795867866847,0.97762831323211
425.15,428,27394,20751,13423060,5914035,2023-11-13,2023-12-15,440.61,-6643,-7509025,302704033,-178564111,1.95373511921462,52.1458447169087,-1.26969573227078
420.85,423,24806,24957,9252638,5365755,2023-11-13,2023-12-15,440.61,151,-3886883,302704033,-178564111,1.77260770093539,53.9184524178441,-0.724386968842223
417.4,420,18772,20359,7959328,5293340,2023-11-13,2023-12-29,440.61,1587,-2665988,120671117,-59187285,4.38658407380119,49.1244371260772,-0.503649491625326
433.27,440,7365,7802,7608045,5250746,2023-11-13,2023-12-22,440.61,437,-2357299,22794974,-7809504,23.0346654486204,23.0346654486204,-0.448945540309891
403.69,405,38274,37946,8228910,4970926,2023-11-13,2023-12-29,440.61,-328,-3257984,120671117,-59187285,4.11940000522246,53.2438371312996,-0.655407865657223
379.66,380,142279,141971,6687113,4827014,2023-11-13,2023-12-15,440.61,-308,-1860099,302704033,-178564111,1.59463154559292,55.513083963437,-0.385351896638377
412.72,414,36506,36659,8031320,4692352,2023-11-13,2023-12-15,440.61,153,-3338968,302704033,-178564111,1.55014518752712,57.0632291509641,-0.711576625112524
404.18,405,53628,56828,7293408,4659896,2023-11-13,2023-12-15,440.61,3200,-2633512,302704033,-178564111,1.53942316321897,58.6026523141831,-0.565143943126628
429.63,430,113287,122821,20165086,4544377,2023-11-13,2023-11-17,440.61,9534,-15620709,63077977,-98136508,7.20437974730864,16.6623384259771,-3.43737084313207
432.63,438,7760,8431,6984000,4527447,2023-11-13,2023-12-15,440.61,671,-2456553,302704033,-178564111,1.49566788229743,60.0983201964805,-0.542591221940312
429.08,433,10574,11441,6968266,4484872,2023-11-13,2023-12-15,440.61,867,-2483394,302704033,-178564111,1.48160298875172,61.5799231852322,-0.553726839918731
440.67,450,4506,4605,7164540,4296465,2023-11-13,2023-11-17,440.61,99,-2868075,63077977,-98136508,6.81135509466323,23.4736935206403,-0.667542968463609
398.92,400,39101,38812,6451665,4191696,2023-11-13,2023-12-29,440.61,-289,-2259969,120671117,-59187285,3.47365310292106,56.7174902342207,-0.539153841309102
431.95,437,7511,8103,6241641,4092015,2023-11-13,2023-12-15,440.61,592,-2149626,302704033,-178564111,1.35182044303982,62.9317436282721,-0.525322121253221
433.23,439,6301,6919,6055261,3992263,2023-11-13,2023-12-15,440.61,618,-2062998,302704033,-178564111,1.31886680214796,64.25061043042,-0.516749021795408
434.08,435,40375,42635,14535000,3922420,2023-11-13,2023-11-17,440.61,2260,-10612580,63077977,-98136508,6.21836683189761,29.6920603525379,-2.70562050978733
389.54,390,73620,80461,5079780,3701206,2023-11-13,2023-12-15,440.61,6841,-1378574,302704033,-178564111,1.22271446578315,65.4733248962032,-0.372466163731497
406.1,407,40561,40872,6327516,3678480,2023-11-13,2023-12-15,440.61,311,-2649036,302704033,-178564111,1.21520680234875,66.6885316985519,-0.720144189991518
431.25,436,7016,7284,5542640,3459900,2023-11-13,2023-12-15,440.61,268,-2082740,302704033,-178564111,1.14299765540289,67.8315293539548,-0.601965374721813
429.87,434,7450,8114,5215000,3351082,2023-11-13,2023-12-15,440.61,664,-1863918,302704033,-178564111,1.10704900981613,68.9385783637709,-0.55621378408526
428.44,430,19469,21419,6775212,3341364,2023-11-13,2023-12-01,440.61,1950,-3433848,30624514,-25040527,10.9107494734447,10.9107494734447,-1.02767851691704
401.28,402,45307,45264,5527454,3259008,2023-11-13,2023-12-15,440.61,-43,-2268446,302704033,-178564111,1.07663183992002,70.0152102036909,-0.696054136718903
437.68,440,8566,14017,5824880,3251944,2023-11-13,2023-11-17,440.61,5451,-2572936,63077977,-98136508,5.15543483583819,34.8474951883761,-0.791199356446482
426.03,429,11067,10895,5920845,3235815,2023-11-13,2023-12-15,440.61,-172,-2685030,302704033,-178564111,1.0689699003779,71.0841801040689,-0.829784768288669
427.57,431,8555,9214,5175775,3160402,2023-11-13,2023-12-15,440.61,659,-2015373,302704033,-178564111,1.04405678665008,72.1282368907189,-0.637695141314301
424.34,427,11887,11824,5551229,3145184,2023-11-13,2023-12-15,440.61,-63,-2406045,302704033,-178564111,1.03902943374395,73.1672663244629,-0.764993399432275
394.46,395,57182,58219,5032016,3143826,2023-11-13,2023-12-15,440.61,1037,-1888190,302704033,-178564111,1.03858081071553,74.2058471351784,-0.600602577878038
427.21,432,6238,6377,4616120,3054583,2023-11-13,2023-12-29,440.61,139,-1561537,120671117,-59187285,2.5313290171997,59.2488192514204,-0.511211186600593
428.36,432,8310,8208,5152200,2987712,2023-11-13,2023-12-15,440.61,-102,-2164488,302704033,-178564111,0.987007662365701,75.1928547975441,-0.724463402094981
429.96,435,5227,5837,4218189,2941848,2023-11-13,2023-12-22,440.61,610,-1276341,22794974,-7809504,12.9056870167959,35.9403524654163,-0.433856881796748
435.54,443,4018,3844,4849726,2867624,2023-11-13,2023-12-15,440.61,-174,-1982102,302704033,-178564111,0.947335908141006,76.1401907056851,-0.691200101547483
434.56,439,5890,6337,4888700,2813628,2023-11-13,2023-12-08,440.61,447,-2075072,28464419,-15251963,9.8847195862315,9.8847195862315,-0.73750758806779
431.5,438,3805,4218,3774560,2741700,2023-11-13,2023-12-29,440.61,413,-1032860,120671117,-59187285,2.27204327610558,61.520862527526,-0.376722471459314
410.82,412,22047,23141,4343259,2730638,2023-11-13,2023-12-15,440.61,1094,-1612621,302704033,-178564111,0.902081803449246,77.0422725091344,-0.590565648028044
432.17,439,3943,3891,4199295,2657553,2023-11-13,2023-12-29,440.61,-52,-1541742,120671117,-59187285,2.20231076505242,63.7231732925784,-0.58013593708197
402.25,403,34835,34823,4528550,2611725,2023-11-13,2023-12-15,440.61,-12,-1916825,302704033,-178564111,0.862798217161514,77.9050707262959,-0.733930639711302
421.76,424,11572,11596,4536224,2597504,2023-11-13,2023-12-15,440.61,24,-1938720,302704033,-178564111,0.858100228879343,78.7631709551752,-0.746378061400483
396.41,397,43620,43612,4187520,2573108,2023-11-13,2023-12-15,440.61,-8,-1614412,302704033,-178564111,0.850040871440917,79.6132118266161,-0.627417115799259
435.97,440,4987,6287,3979626,2533661,2023-11-13,2023-12-01,440.61,1300,-1445965,30624514,-25040527,8.27331006787569,19.1840595413204,-0.570701842117
379.44,380,45030,45049,3512340,2522744,2023-11-13,2023-12-29,440.61,19,-989596,120671117,-59187285,2.09059471953011,65.8137680121085,-0.392269687292884
420.01,422,12452,12649,4308392,2517151,2023-11-13,2023-12-15,440.61,197,-1791241,302704033,-178564111,0.831555158037818,80.444766984654,-0.711614440293808
364.76,365,104209,103907,3230479,2493768,2023-11-13,2023-12-15,440.61,-302,-736711,302704033,-178564111,0.823830450914409,81.2685974355684,-0.295420825032641
430.87,437,3994,4029,3838234,2469777,2023-11-13,2023-12-29,440.61,35,-1368457,120671117,-59187285,2.04670103451516,67.8604690466237,-0.554081198423987
417.32,419,13549,14218,3929210,2388624,2023-11-13,2023-12-15,440.61,669,-1540586,302704033,-178564111,0.789095532136501,82.0576929677049,-0.644967981565956
369.66,370,70127,70190,3295969,2386460,2023-11-13,2023-12-22,440.61,63,-909509,22794974,-7809504,10.469237648615,46.4095901140313,-0.381112191279133
434.46,441,2625,3621,2798250,2368134,2023-11-13,2023-12-15,440.61,996,-430116,302704033,-178564111,0.782326544027248,82.8400195117321,-0.181626546470766
432.51,435,7499,9441,3951973,2350809,2023-11-13,2023-12-01,440.61,1942,-1601164,30624514,-25040527,7.67623283752356,26.860292378844,-0.681111906581946
433.25,434,28481,31131,8999996,2334825,2023-11-13,2023-11-17,440.61,2650,-6665171,63077977,-98136508,3.70148998278749,38.5489851711636,-2.85467690297988
418.89,420,14965,19757,3232440,2193027,2023-11-13,2023-12-08,440.61,4792,-1039413,28464419,-15251963,7.70445024716647,17.589169833398,-0.47396270086962
439.82,455,1365,1424,2895165,2161632,2023-11-13,2023-12-15,440.61,59,-733533,302704033,-178564111,0.714107433117682,83.5541269448498,-0.339342219212151
440.65,448,2839,2847,3988795,2092545,2023-11-13,2023-11-17,440.61,8,-1896250,63077977,-98136508,3.31739396144553,41.8663791326092,-0.906193176251885
431.48,432,39243,40005,9339834,2080260,2023-11-13,2023-11-17,440.61,762,-7259574,63077977,-98136508,3.29791806734702,45.1642971999562,-3.48974358974359
435.25,440,3697,4343,3190511,2062925,2023-11-13,2023-12-08,440.61,646,-1127586,28464419,-15251963,7.24738137110756,24.8365512045055,-0.546595731788601
428.76,434,3856,3815,3123360,1999060,2023-11-13,2023-12-29,440.61,-41,-1124300,120671117,-59187285,1.65661845990868,69.5170875065323,-0.562414334737326
374.71,375,66113,66115,2842859,1917335,2023-11-13,2023-12-15,440.61,2,-925524,302704033,-178564111,0.633402528865547,84.1875294737154,-0.482713766764807
384.61,385,49543,49014,2873494,1911546,2023-11-13,2023-12-15,440.61,-529,-961948,302704033,-178564111,0.631490099770161,84.8190195734855,-0.503230369554277
384.49,385,35751,35759,2681325,1823709,2023-11-13,2023-12-22,440.61,8,-857616,22794974,-7809504,8.00048730040227,54.4100774144336,-0.470259235437233
424.81,425,99270,95966,8338680,1823354,2023-11-13,2023-11-17,440.61,-3304,-6515326,63077977,-98136508,2.89063487245319,48.0549320724094,-3.57326443466272
437,446,2010,2017,2775810,1815300,2023-11-13,2023-12-15,440.61,7,-960510,302704033,-178564111,0.599694685931059,85.4187142594166,-0.529119153858866
407.05,408,18465,18986,2991330,1803670,2023-11-13,2023-12-15,440.61,521,-1187660,302704033,-178564111,0.595852649244353,86.0145669086609,-0.658468566866445
435.67,437,8720,13435,4080960,1786855,2023-11-13,2023-11-17,440.61,4715,-2294105,63077977,-98136508,2.83277157097159,50.887703643381,-1.28387865831307
426.49,431,3921,3956,2744700,1784156,2023-11-13,2023-12-29,440.61,35,-960544,120671117,-59187285,1.47852779053997,70.9956152970723,-0.538374447077498
408.36,410,10144,10704,2657728,1755456,2023-11-13,2023-12-29,440.61,560,-902272.000000001,120671117,-59187285,1.45474413732327,72.4503594343956,-0.513981552371578
433.92,438,3805,4233,2907020,1727064,2023-11-13,2023-12-08,440.61,428,-1179956,28464419,-15251963,6.06744862770605,30.9039998322116,-0.683214982189426
437.14,447,1741,1748,2524450,1723528,2023-11-13,2023-12-15,440.61,7,-800922,302704033,-178564111,0.569377283453637,86.5839441921145,-0.464699151972002
349.83,350,92822,101306,2042084,1722202,2023-11-13,2023-12-15,440.61,8484,-319882,302704033,-178564111,0.568939231807328,87.1528834239219,-0.185740116432335
411.78,413,13818,14010,2874144,1709220,2023-11-13,2023-12-15,440.61,192,-1164924,302704033,-178564111,0.564650554226346,87.7175339781482,-0.68155298908274
423.4,427,4673,4688,2738378,1687680,2023-11-13,2023-12-29,440.61,15,-1050698,120671117,-59187285,1.39857825298824,73.8489376873838,-0.622569444444445
392.49,393,32622,32690,2577138,1667190,2023-11-13,2023-12-15,440.61,68,-909948,302704033,-178564111,0.550765704532255,88.2682996826805,-0.545797419610242
435.06,444,1859,1862,2303301,1664628,2023-11-13,2023-12-29,440.61,3,-638673,120671117,-59187285,1.37947509013279,75.2284127775166,-0.383673108946864
409.91,411,15585,15234,2898810,1660506,2023-11-13,2023-12-15,440.61,-351,-1238304,302704033,-178564111,0.548557607093395,88.8168572897739,-0.745738949452757
432.38,433,19809,26242,5447475,1627004,2023-11-13,2023-11-17,440.61,6433,-3820471,63077977,-98136508,2.57935348814373,53.4670571315247,-2.34816324975231
419.12,421,8013,8619,2628264,1620372,2023-11-13,2023-12-15,440.61,606,-1007892,302704033,-178564111,0.535299111789502,89.3521564015634,-0.622012723004347
419.31,420,18052,22593,2743904,1558917,2023-11-13,2023-12-01,440.61,4541,-1184987,30624514,-25040527,5.09042200637045,31.9507143852144,-0.760134760221359
439.92,445,2694,3049,2958012,1548892,2023-11-13,2023-11-17,440.61,355,-1409120,63077977,-98136508,2.45551945966815,55.9225765911928,-0.90976000909037
389.24,390,19750,19906,2251500,1512856,2023-11-13,2023-12-29,440.61,156,-738644,120671117,-59187285,1.25370182825108,76.4821146057677,-0.488244750326534
436.4,438,5354,9386,2837620,1501760,2023-11-13,2023-11-17,440.61,4032,-1335860,63077977,-98136508,2.38079924471896,58.3033758359118,-0.889529618580865
406.5,408,10103,9991,2455029,1498650,2023-11-13,2023-12-29,440.61,-112,-956379,120671117,-59187285,1.24192933425817,77.7240439400259,-0.638160344309879
359.79,360,70767,70867,1981476,1488207,2023-11-13,2023-12-15,440.61,100,-493269,302704033,-178564111,0.491637651884209,89.8437940534476,-0.331451874638407
423.48,426,6804,5903,2986956,1487556,2023-11-13,2023-12-15,440.61,-901,-1499400,302704033,-178564111,0.491422590329347,90.3352166437769,-1.00796205319329
397.38,398,24175,23855,2417500,1479010,2023-11-13,2023-12-15,440.61,-320,-938490,302704033,-178564111,0.488599370593784,90.8238160143707,-0.634539320220959
436.88,440,1511,4706,1095475,1468272,2023-11-13,2023-11-24,440.61,3195,372797,21544370,-14129174,6.81510761280093,6.81510761280093,0.253901865594386
405.12,406,16588,16502,2355496,1452176,2023-11-13,2023-12-15,440.61,-86,-903320,302704033,-178564111,0.479734605980621,91.3035506203513,-0.622045812628772
434.89,436,11433,12919,4721829,1434009,2023-11-13,2023-11-17,440.61,1486,-3287820,63077977,-98136508,2.27339091740371,60.5767667533155,-2.2927471166499
339.87,340,107141,107050,1928538,1391650,2023-11-13,2023-12-15,440.61,-91,-536888,302704033,-178564111,0.459739497425196,91.7632901177765,-0.385792404699457
433.36,435,5842,8455,2570480,1386620,2023-11-13,2023-11-24,440.61,2613,-1183860,21544370,-14129174,6.43611300771385,13.2512206205148,-0.853773925084018
440.51,455,944,952,2024880,1379448,2023-11-13,2023-11-17,440.61,8,-645432,63077977,-98136508,2.18689321631225,62.7636599696278,-0.467891504427858
419.88,420,118328,114462,4969776,1373544,2023-11-13,2023-11-17,440.61,-3866,-3596232,63077977,-98136508,2.17753337270154,64.9411933423293,-2.61821390505146
437.06,439,3306,7064,2066250,1370416,2023-11-13,2023-11-17,440.61,3758,-695834,63077977,-98136508,2.17257443116795,67.1137677734973,-0.507753849925862
416.41,418,6685,8568,1838375,1362312,2023-11-13,2023-12-15,440.61,1883,-476063,302704033,-178564111,0.450047522161689,92.2133376399382,-0.349452254696428
369.73,370,49935,49850,1747725,1345950,2023-11-13,2023-12-15,440.61,-85,-401775,302704033,-178564111,0.444642242345017,92.6579798822832,-0.298506631004124
430.92,433,6871,6449,3098821,1341392,2023-11-13,2023-12-01,440.61,-422,-1757429,30624514,-25040527,4.38012502010644,36.3308394053209,-1.31015318415497
437.4,450,1057,1055,1548505,1329300,2023-11-13,2023-12-29,440.61,-2,-219205,120671117,-59187285,1.10158920630527,78.8256331463311,-0.164902580305424
436.01,444,1617,1630,2021250,1302370,2023-11-13,2023-12-15,440.61,13,-718880,302704033,-178564111,0.430245341329826,93.0882252236131,-0.55197831645385
433.22,437,2398,3396,1666610,1283688,2023-11-13,2023-12-08,440.61,998,-382922,28464419,-15251963,4.50979870694006,35.4137985391516,-0.298298340406703
359.56,360,29021,29021,1276924,1276924,2023-11-13,2023-12-29,440.61,0,0,120671117,-59187285,1.05818528223286,79.883818428564,0
384.35,385,18917,18981,1797115,1233765,2023-11-13,2023-12-29,440.61,64,-563350,120671117,-59187285,1.02241947424751,80.9062379028115,-0.456610456610456
437.43,441,151,3439,122008,1227723,2023-11-13,2023-11-24,440.61,3288,1105715,21544370,-14129174,5.69857925759723,18.949799878112,0.900622534561949
432.82,441,1419,1497,1667325,1224546,2023-11-13,2023-12-29,440.61,78,-442779,120671117,-59187285,1.01477970076303,81.9210176035745,-0.361586253190979
434.88,437,3210,5745,1800810,1217940,2023-11-13,2023-11-24,440.61,2535,-582870,21544370,-14129174,5.65317064272476,24.6029705208368,-0.478570372924775
414.89,415,112690,110302,2929940,1213322,2023-11-13,2023-11-17,440.61,-2388,-1716618,63077977,-98136508,1.92352712896928,69.0372949024665,-1.41480827018714
436.25,439,2165,4358,1476530,1198450,2023-11-13,2023-11-24,440.61,2193,-278080,21544370,-14129174,5.56270617335295,30.1656766941897,-0.232033042680129
403.19,404,14399,14433,1915067,1169073,2023-11-13,2023-12-15,440.61,34,-745994,302704033,-178564111,0.386209918782285,93.4744351423953,-0.63810728671349
399.94,400,193945,193812,2521285,1162872,2023-11-13,2023-11-17,440.61,-133,-1358413,63077977,-98136508,1.84354675800716,70.8808416604737,-1.16815350270709
354.81,355,60529,60426,1513225,1148094,2023-11-13,2023-12-15,440.61,-103,-365131,302704033,-178564111,0.379279386740117,93.8537145291355,-0.318032321395286
432.56,434,5322,7958,2112834,1145952,2023-11-13,2023-11-24,440.61,2636,-966882,21544370,-14129174,5.31903230403117,35.4847089982209,-0.843736910446511
375.63,376,30942,30932,1361448,1144484,2023-11-13,2023-12-15,440.61,-10,-216964,302704033,-178564111,0.37808680269549,94.231801331831,-0.189573641920726
426.19,430,2546,2999,1598888,1142619,2023-11-13,2023-12-22,440.61,453,-456269,22794974,-7809504,5.01259181080882,59.4226692252424,-0.399318583009735
434.68,438,2773,3440,1946646,1142080,2023-11-13,2023-12-01,440.61,667,-804566,30624514,-25040527,3.72929999803425,40.0601394033551,-0.704474292518913
429.14,430,10460,12669,2698680,1089534,2023-11-13,2023-11-24,440.61,2209,-1609146,21544370,-14129174,5.05716342599018,40.5418724242111,-1.47691214776225
431.73,434,4438,4784,2152430,1085968,2023-11-13,2023-12-01,440.61,346,-1066462,30624514,-25040527,3.54607423321069,43.6062136365658,-0.98203814477038
430.16,436,1644,1854,1509192,1082736,2023-11-13,2023-12-29,440.61,210,-426456,120671117,-59187285,0.897261935513533,82.8182795390881,-0.39386886554063
435.83,441,1609,2091,1235712,1081047,2023-11-13,2023-12-08,440.61,482,-154665,28464419,-15251963,3.7978888660963,39.2116874052479,-0.143069635270252
438.25,441,2676,3884,2108688,1068100,2023-11-13,2023-11-17,440.61,1208,-1040588,63077977,-98136508,1.69330097571138,72.5741426361851,-0.974242112161783
407.41,409,6144,6315,1511424,1004085,2023-11-13,2023-12-29,440.61,171,-507339,120671117,-59187285,0.832083952616433,83.6503634917045,-0.505274951821808
435.35,439,2649,2744,1986750,1001560,2023-11-13,2023-12-01,440.61,95,-985190,30624514,-25040527,3.27045190006934,46.8766655366351,-0.983655497424018
426.76,427,40637,41195,4632618,988680,2023-11-13,2023-11-17,440.61,558,-3643938,63077977,-98136508,1.56739332334644,74.1415359595315,-3.68565966743537
354.72,355,35173,35209,1125536,985852,2023-11-13,2023-12-22,440.61,36,-139684,22794974,-7809504,4.32486564801522,63.7475348732576,-0.141688610460799
432.51,436,2335,2816,1524755,982784,2023-11-13,2023-12-08,440.61,481,-541971,28464419,-15251963,3.45267542611708,42.664362831365,-0.551465021815577
409.91,410,104510,108058,1985690,972522,2023-11-13,2023-11-17,440.61,3548,-1013168,63077977,-98136508,1.54177740988745,75.6833133694189,-1.0417944272726
409.39,410,9409,15722,1082035,959042,2023-11-13,2023-12-08,440.61,6313,-122993,28464419,-15251963,3.36926602998642,46.0336288613514,-0.128245686841661
439.8,456,558,591,1036764,957420,2023-11-13,2023-12-15,440.61,33,-79344.0000000001,302704033,-178564111,0.316289145708211,94.5480904775392,-0.0828727204361723
423.97,425,9964,9151,2311648,942553,2023-11-13,2023-12-01,440.61,-813,-1369095,30624514,-25040527,3.07777292400461,49.9544384606397,-1.4525390084165
430.55,431,21548,20865,4460436,938925,2023-11-13,2023-11-17,440.61,-683,-3521511,63077977,-98136508,1.48851476324296,77.1718281326619,-3.75057752216631
431.01,434,2826,3139,1599516,938561,2023-11-13,2023-12-08,440.61,313,-660955,28464419,-15251963,3.29731304194194,49.3309419032934,-0.704221675522422
440.06,446,1559,1569,1875477,931986,2023-11-13,2023-11-17,440.61,10,-943491,63077977,-98136508,1.47751409338952,78.6493422260514,-1.01234460603485
433.27,436,2421,3393,1389654,926289,2023-11-13,2023-12-01,440.61,972,-463365,30624514,-25040527,3.02466514244112,52.9791036030809,-0.500238046657145
354.87,355,71171,71158,1138736,925054,2023-11-13,2023-12-08,440.61,-13,-213682,28464419,-15251963,3.24986081746478,52.5808027207582,-0.230994082507616
431.77,435,2146,2859,1298330,923457,2023-11-13,2023-12-08,440.61,713,-374873,28464419,-15251963,3.24425030421313,55.8250530249713,-0.405945268702278
435.58,438,2844,3810,1709244,922020,2023-11-13,2023-11-24,440.61,966,-787224,21544370,-14129174,4.27963314777828,44.8215055719893,-0.853803605127871
423.45,425,5136,5911,1622976,916205,2023-11-13,2023-12-08,440.61,775,-706771,28464419,-15251963,3.21877288273476,59.0438259077061,-0.771411419933312
433.97,437,2382,3001,1495896,909303,2023-11-13,2023-12-01,440.61,619,-586593,30624514,-25040527,2.96919977244374,55.9483033755246,-0.645101797750585
428.02,433,1761,1806,1387668,899388,2023-11-13,2023-12-29,440.61,45,-488280,120671117,-59187285,0.745321682901137,84.3956851746056,-0.542902507038119
414.58,416,5601,6332,1411452,899144,2023-11-13,2023-12-15,440.61,731,-512308,302704033,-178564111,0.297037337457608,94.8451278149968,-0.569773028569395
427.78,430,3890,3962,1680480,879564,2023-11-13,2023-12-08,440.61,72,-800916,28464419,-15251963,3.09004726216263,62.1338731698687,-0.910582970653642
430.9,432,3663,7774,1186812,855140,2023-11-13,2023-11-24,440.61,4111,-331672,21544370,-14129174,3.96920401942596,48.7907095914153,-0.387856959094417
433.82,442,662,979,707678,800822,2023-11-13,2023-12-29,440.61,317,93143.9999999999,120671117,-59187285,0.663640165028057,85.0593253396337,0.116310490970528
437.8,452,556,561,995240,796620,2023-11-13,2023-12-15,440.61,5,-198620,302704033,-178564111,0.263167950590206,95.108295765587,-0.249328412542994
434.49,443,824,930,1017640,791430,2023-11-13,2023-12-29,440.61,106,-226210,120671117,-59187285,0.655857026665296,85.715182366299,-0.285824393818784
385.6,386,19448,19455,1186328,778200,2023-11-13,2023-12-15,440.61,7,-408128,302704033,-178564111,0.257082798761389,95.3653785643484,-0.524451297866872
344.89,345,70664,70677,918632,777447,2023-11-13,2023-12-08,440.61,13,-141185,28464419,-15251963,2.73129411143084,64.8651672812995,-0.181600803656069
430.21,433,2459,2756,1295893,768924,2023-11-13,2023-12-08,440.61,297,-526969,28464419,-15251963,2.70135146619364,67.5665187474932,-0.685333010804709
399.85,401,6438,6462,1107336,743130,2023-11-13,2023-12-29,440.61,24,-364206,120671117,-59187285,0.615830878568896,86.3310132448679,-0.490097291187276
434.15,436,3476,3979,1738000,736115,2023-11-13,2023-11-24,440.61,503,-1001885,21544370,-14129174,3.41673950085336,52.2074490922687,-1.3610441303329
359.9,360,73576,73578,956488,735780,2023-11-13,2023-12-01,440.61,2,-220708,30624514,-25040527,2.40258506632954,58.3508884418541,-0.299964663350458
415.5,417,5124,4833,1337364,724950,2023-11-13,2023-12-15,440.61,-291,-612414,302704033,-178564111,0.239491358213916,95.6048699225623,-0.844767225325885
432.6,439,1008,1123,988848,718720,2023-11-13,2023-12-22,440.61,115,-270128,22794974,-7809504,3.15297573930113,66.9005106125587,-0.375845948352627
400.31,401,10154,10137,1167710,699453,2023-11-13,2023-12-15,440.61,-17,-468257,302704033,-178564111,0.231068279159664,95.835938201722,-0.669461707934629
425.79,426,30102,33061,2919894,694281,2023-11-13,2023-11-17,440.61,2959,-2225613,63077977,-98136508,1.10067099964224,79.7500132256937,-3.2056371987711
414.51,415,13463,13607,1400152,666743,2023-11-13,2023-12-01,440.61,144,-733409,30624514,-25040527,2.17715455010976,60.5280429919639,-1.09998755142536
428.68,429,19860,20676,3038580,661632,2023-11-13,2023-11-17,440.61,816,-2376948,63077977,-98136508,1.04891125471573,80.7989244804094,-3.59255295995357
437.99,442,136,1648,122400,660848,2023-11-13,2023-11-24,440.61,1512,538448,21544370,-14129174,3.06738140869285,55.2748305009615,0.814783429775077
431.32,437,1019,1140,915062,647520,2023-11-13,2023-12-22,440.61,121,-267542,22794974,-7809504,2.84062618364908,69.7411367962078,-0.413179515690635
398.36,399,10068,10050,1016868,643200,2023-11-13,2023-12-15,440.61,-18,-373668,302704033,-178564111,0.21248478047202,96.048422982194,-0.580951492537314
438.75,442,1071,1973,895356,641225,2023-11-13,2023-11-17,440.61,902,-254131,63077977,-98136508,1.01655923429504,81.8154837147044,-0.396321104136614
437.82,448,566,628,826926,639304,2023-11-13,2023-12-15,440.61,62,-187622,302704033,-178564111,0.211197714699758,96.2596206968937,-0.293478532904534
430.53,436,933,1165,818241,637255,2023-11-13,2023-12-22,440.61,232,-180986,22794974,-7809504,2.79559432706526,72.5367311232731,-0.284008756306345
421.64,423,4821,4581,1267923,623016,2023-11-13,2023-12-08,440.61,-240,-644907,28464419,-15251963,2.18875361552259,69.7552723630157,-1.03513713933511
430.51,432.5,3035,3116,1332365,620084,2023-11-13,2023-12-01,440.61,81,-712281,30624514,-25040527,2.0247962139089,62.5528392058728,-1.14868469433174
369.83,370,36179,36184,904475,615128,2023-11-13,2023-12-08,440.61,5,-289347,28464419,-15251963,2.16104182558583,71.9163141886016,-0.470385025555656
424.95,429,1621,1517,1030956,614385,2023-11-13,2023-12-29,440.61,-104,-416571,120671117,-59187285,0.509140062074672,86.8401533069426,-0.678029248760956
408.01,409,6144,6177,1069056,611523,2023-11-13,2023-12-15,440.61,33,-457533,302704033,-178564111,0.202020103247187,96.4616408001409,-0.748186086214255
369.58,370,14427,14416,836766,605472,2023-11-13,2023-12-29,440.61,-11,-231294,120671117,-59187285,0.501753870398001,87.3419071773406,-0.382006104328524
419.13,422,2091,2096,968133,601552,2023-11-13,2023-12-29,440.61,5,-366581,120671117,-59187285,0.498505371422061,87.8404125487626,-0.609392039258451
434.33,437.5,1742,1892,1174108,599764,2023-11-13,2023-12-01,440.61,150,-574344,30624514,-25040527,1.95844414053395,64.5112833464068,-0.957616662553938
424.14,428,1606,1540,976448,594440,2023-11-13,2023-12-29,440.61,-66,-382008,120671117,-59187285,0.492611666137142,88.3330242148998,-0.642635085122132
324.9,325,58930,58925,766090,589250,2023-11-13,2023-12-15,440.61,-5,-176840,302704033,-178564111,0.194662090940823,96.6563028910817,-0.30011030971574
349.72,350,20646,20999,722610,587972,2023-11-13,2023-12-29,440.61,353,-134638,120671117,-59187285,0.487251642826842,88.8202758577266,-0.228987094623554
421.86,422,41499,41356,2323944,578984,2023-11-13,2023-11-17,440.61,-143,-1744960,63077977,-98136508,0.917886126880702,82.7333698415851,-3.01383112486701
364.92,365,71599,71599,644391,572792,2023-11-13,2023-11-24,440.61,0,-71599,21544370,-14129174,2.65866210058591,57.9334926015474,-0.125
349.92,350,71651,71470,788161,571760,2023-11-13,2023-12-01,440.61,-181,-216401,30624514,-25040527,1.86700105673514,66.3782844031419,-0.378482230306422
419.67,420,15792,16975,1405488,560175,2023-11-13,2023-11-24,440.61,1183,-845313,21544370,-14129174,2.60009923706286,60.5335918386103,-1.50901593252109
431.74,433,3295,4430,1176315,558180,2023-11-13,2023-11-24,440.61,1135,-618135,21544370,-14129174,2.59083927726826,63.1244311158785,-1.10741158765989
374.86,375,38790,38833,698220,543662,2023-11-13,2023-12-01,440.61,43,-154558,30624514,-25040527,1.7752510292898,68.1535354324317,-0.284290607031575
410.21,412,2993,3019,864977,540401,2023-11-13,2023-12-29,440.61,26,-324576,120671117,-59187285,0.44782961609612,89.2681054738227,-0.600620650220855
407.91,408,59152,59278,1005584,533502,2023-11-13,2023-11-17,440.61,126,-472082,63077977,-98136508,0.845781721883693,83.5791515634688,-0.884873908626397
429.28,431,2860,3048,1115400,524256,2023-11-13,2023-12-01,440.61,188,-591144,30624514,-25040527,1.71188349307356,69.8654189255052,-1.12758652261491
393.42,394,8922,8913,767292,516954,2023-11-13,2023-12-15,440.61,-9,-250338,302704033,-178564111,0.170778695901947,96.8270815869837,-0.484255852551678
439.25,460,242,244,553938,506300,2023-11-13,2023-12-15,440.61,2,-47638,302704033,-178564111,0.167259086369688,96.9943406733534,-0.0940904602014616
359.86,360,35398,35634,637164,498876,2023-11-13,2023-12-08,440.61,236,-138288,28464419,-15251963,1.75263018718211,73.6689443757837,-0.277199143674981
394.1,395,5313,5529,738507,497610,2023-11-13,2023-12-29,440.61,216,-240897,120671117,-59187285,0.412368769239121,89.6804742430618,-0.484108036414059
439.22,443,975,1291,945750,487998,2023-11-13,2023-11-17,440.61,316,-457752,63077977,-98136508,0.773642439420655,84.3527940028895,-0.93802023778786
423.83,424,26495,28095,1934135,477615,2023-11-13,2023-11-17,440.61,1600,-1456520,63077977,-98136508,0.757181860794299,85.1099758636838,-3.04956921369722
422.1,425,1169,1640,552937,475600,2023-11-13,2023-12-22,440.61,471,-77337.0000000001,22794974,-7809504,2.0864248408443,74.6231559641174,-0.162609335576115
401.7,403,3608,3611,703560,469430,2023-11-13,2023-12-29,440.61,3,-234130,120671117,-59187285,0.389016039355963,90.0694902824178,-0.498753807809471
422.58,423,12928,11148,1551360,468216,2023-11-13,2023-11-24,440.61,-1780,-1083144,21544370,-14129174,2.17326382716227,65.2976949430408,-2.31334255984417
424.51,425,5464,9485,814136,464765,2023-11-13,2023-11-24,440.61,4021,-349371,21544370,-14129174,2.15724572127196,67.4549406643128,-0.751715383043044
425.2,427,2267,2575,788916,463500,2023-11-13,2023-12-08,440.61,308,-325416,28464419,-15251963,1.62834871142109,75.2972930872048,-0.702084142394822
427.73,428,16258,17151,2162314,463077,2023-11-13,2023-11-17,440.61,893,-1699237,63077977,-98136508,0.734134197106543,85.8441100607903,-3.66944806155348
404.92,405,57312,57424,859680,459392,2023-11-13,2023-11-17,440.61,112,-400288,63077977,-98136508,0.728292221546674,86.572402282337,-0.871342992477013
416.89,417,41453,41705,1285043,458755,2023-11-13,2023-11-17,440.61,252,-826288,63077977,-98136508,0.727282360371196,87.2996846427082,-1.80115312094691
377.67,378,13533,13533,622518,446589,2023-11-13,2023-12-15,440.61,0,-175929,302704033,-178564111,0.147533217702455,97.1418738910558,-0.393939393939394
430.13,432,2451,2370,1017165,443190,2023-11-13,2023-12-01,440.61,-81,-573975,30624514,-25040527,1.4471739861733,71.3125929116785,-1.29509916739999
384.95,385,87536,87447,787824,437235,2023-11-13,2023-11-17,440.61,-89,-350589,63077977,-98136508,0.693165857237305,87.9928504999455,-0.801831966791314
414.16,415,5132,5205,795460,437220,2023-11-13,2023-12-08,440.61,73,-358240,28464419,-15251963,1.53602292040459,76.8333160076094,-0.819358675266456
428.46,433,856,961,639432,436294,2023-11-13,2023-12-22,440.61,105,-203138,22794974,-7809504,1.91399209316931,76.5371480572867,-0.465598885155423
422.46,426,951,1223,529707,432942,2023-11-13,2023-12-29,440.61,272,-96765.0000000001,120671117,-59187285,0.358778480520736,90.4282687629385,-0.223505688983744
403.92,404,54022,54029,810330,432232,2023-11-13,2023-11-17,440.61,7,-378098,63077977,-98136508,0.685234404394421,88.6780849043399,-0.874757074904218
411.9,412,42331,42364,888951,423640,2023-11-13,2023-11-17,440.61,33,-465311,63077977,-98136508,0.671613168570704,89.3496980729106,-1.09836417713153
364.62,365,11116,11015,566916,418570,2023-11-13,2023-12-29,440.61,-101,-148346,120671117,-59187285,0.346868422540582,90.7751371854791,-0.354411448503237
429.23,434,760,865,583680,412605,2023-11-13,2023-12-22,440.61,105,-171075,22794974,-7809504,1.81007006193558,78.3472181192223,-0.414621732649871
439.52,444,726,903,729630,404544,2023-11-13,2023-11-17,440.61,177,-325086,63077977,-98136508,0.641339528057471,89.9910376009681,-0.803586260085429
427.67,432,706,931,498436,403123,2023-11-13,2023-12-22,440.61,225,-95312.9999999999,22794974,-7809504,1.76847317307754,80.1156912922998,-0.236436521855612
344.95,345,79356,79354,396780,396770,2023-11-13,2023-11-24,440.61,-2,-10,21544370,-14129174,1.84164122691914,69.2965818912319,-2.52035184111702e-05
431.29,432.5,2861,3246,981323,392766,2023-11-13,2023-11-24,440.61,385,-588557,21544370,-14129174,1.82305632515595,71.1196382163879,-1.49849274122506
429.44,432,1466,1520,721272,389120,2023-11-13,2023-12-08,440.61,54,-332152,28464419,-15251963,1.36704002284396,78.2003560304533,-0.853597861842105
426.98,431,497,962,328517,386724,2023-11-13,2023-12-22,440.61,465,58207,22794974,-7809504,1.69653187584246,81.8122231681423,0.150513027378699
418.27,421,1395,1414,619380,386022,2023-11-13,2023-12-29,440.61,19,-233358,120671117,-59187285,0.319895936655662,91.0950331221348,-0.604519949640176
409.62,410,11846,10128,864758,384864,2023-11-13,2023-12-01,440.61,-1718,-479894,30624514,-25040527,1.25671871886685,72.5693116305454,-1.24691839195144
329.77,330,16705,16705,384215,384215,2023-11-13,2023-12-29,440.61,0,0,120671117,-59187285,0.3183984780716,91.4134316002064,0
364.9,365,37826,37875,529564,378750,2023-11-13,2023-12-01,440.61,49,-150814,30624514,-25040527,1.23675432041142,73.8060659509568,-0.398188778877888
430.01,431,4158,3744,1209978,370656,2023-11-13,2023-11-24,440.61,-414,-839322,21544370,-14129174,1.72043090607894,72.8400691224668,-2.26442307692308
434.43,442,47,488,53110,369416,2023-11-13,2023-12-22,440.61,441,316306,22794974,-7809504,1.62060285745445,83.4328260255967,0.856232540009095
426.69,428,3041,2812,894054,368372,2023-11-13,2023-12-01,440.61,-229,-525682,30624514,-25040527,1.20286643569266,75.0089323866495,-1.42704114319221
354.7,355,12225,12226,501225,366780,2023-11-13,2023-12-29,440.61,1,-134445,120671117,-59187285,0.303950115917134,91.7173817161235,-0.366554883036152
394.94,395,60943,60867,670373,365202,2023-11-13,2023-11-17,440.61,-76,-305171,63077977,-98136508,0.578969106761303,90.5700067077294,-0.835622477423453
399.75,400,14318,14553,587038,363825,2023-11-13,2023-12-01,440.61,235,-223213,30624514,-25040527,1.18801885313184,76.1969512397813,-0.613517487803202
413.87,416,1575,1699,508725,361887,2023-11-13,2023-12-29,440.61,124,-146838,120671117,-59187285,0.299895293088238,92.0172770092117,-0.405756493048935
420.8,424,1238,1124,619000,359680,2023-11-13,2023-12-29,440.61,-114,-259320,120671117,-59187285,0.298066355016835,92.3153433642286,-0.720974199288256
391.5,392,7168,7159,559104,357950,2023-11-13,2023-12-15,440.61,-9,-201154,302704033,-178564111,0.118250819605036,97.2601247106609,-0.561961167760861
425.8,427,2836,2961,813932,355320,2023-11-13,2023-12-01,440.61,125,-458612,30624514,-25040527,1.16024698383785,77.3571982236192,-1.29070133963751
414.71,417,1538,1545,549066,353805,2023-11-13,2023-12-29,440.61,7,-195261,120671117,-59187285,0.293197750046517,92.6085411142751,-0.551888752278798
436.08,446,337,356,468430,353152,2023-11-13,2023-12-29,440.61,19,-115278,120671117,-59187285,0.292656609783433,92.9011977240585,-0.326426014860457
436.44,442,61,633,62403,351948,2023-11-13,2023-12-08,440.61,572,289545,28464419,-15251963,1.23644891539855,79.4368049458519,0.82269255685499
420.64,421,9469,9567,918493,344412,2023-11-13,2023-11-24,440.61,98,-574081,21544370,-14129174,1.59861717933734,74.4386863018042,-1.66684378012381
379.91,380,38197,37784,496561,340056,2023-11-13,2023-11-24,440.61,-413,-156505,21544370,-14129174,1.5783984400565,76.0170847418606,-0.460233020443692
412.55,413,7571,7553,704103,339885,2023-11-13,2023-12-01,440.61,-18,-364218,30624514,-25040527,1.10984618400801,78.4670444076272,-1.07159186195331
401.93,402,47909,47881,622817,335167,2023-11-13,2023-11-17,440.61,-28,-287650,63077977,-98136508,0.531353438934797,91.1013601466642,-0.858228882915084
396.01,397,3371,3368,509021,333432,2023-11-13,2023-12-29,440.61,-3,-175589,120671117,-59187285,0.276314671057532,93.1775123951161,-0.52661112310756
411.97,414,1641,1637,528402,332311,2023-11-13,2023-12-29,440.61,-4,-196091,120671117,-59187285,0.27538569979426,93.4528980949103,-0.590082783898216
394.79,395,14631,15472,482823,324912,2023-11-13,2023-12-01,440.61,841,-157911,30624514,-25040527,1.06095397954723,79.5279983871744,-0.486011596986261
410.8,411,16087,16123,675654,322460,2023-11-13,2023-11-24,440.61,36,-353194,21544370,-14129174,1.49672513050973,77.5138098723704,-1.09531104633133
339.91,340,35389,35608,460057,320472,2023-11-13,2023-12-08,440.61,219,-139585,28464419,-15251963,1.12586875565596,80.5626737015079,-0.435560673007314
299.94,300,53499,52818,374493,316908,2023-11-13,2023-12-15,440.61,-681,-57585,302704033,-178564111,0.104692361333686,97.3648170719946,-0.181708887121815
355.66,356,9282,9282,315588,315588,2023-11-13,2023-12-29,440.61,0,0,120671117,-59187285,0.26152737112726,93.7144254660376,0
431.98,438,320,522,298880,314244,2023-11-13,2023-12-22,440.61,202,15363.9999999999,22794974,-7809504,1.37856704727981,84.8113930728765,0.0488919438398186
410.97,413,1532,1541,462664,312823,2023-11-13,2023-12-29,440.61,9,-149841,120671117,-59187285,0.259236019171017,93.9736614852086,-0.478996109621096
374.96,375,77546,77500,465276,310000,2023-11-13,2023-11-17,440.61,-46,-155276,63077977,-98136508,0.491455203136905,91.5928153498011,-0.500890322580645
319.9,320,29673,30382,326403,303820,2023-11-13,2023-12-15,440.61,709,-22583,302704033,-178564111,0.100368666049454,97.465185738044,-0.0743301955104997
374.51,375,6123,6195,416364,303555,2023-11-13,2023-12-29,440.61,72,-112809,120671117,-59187285,0.251555639449331,94.2252171246579,-0.371626229184168
415.61,418,1005,1269,373860,303291,2023-11-13,2023-12-29,440.61,264,-70569,120671117,-59187285,0.251336862987686,94.4765539876456,-0.232677527523072
420.01,423,1106,1010,539728,301990,2023-11-13,2023-12-29,440.61,-96,-237738,120671117,-59187285,0.25025872595511,94.7268127136007,-0.787237988012848
344.85,345,20016,20023,400320,300345,2023-11-13,2023-12-15,440.61,7,-99975,302704033,-178564111,0.0992206800231168,97.5644064180671,-0.332867202716876
426.89,429,1466,1416,583468,298776,2023-11-13,2023-12-08,440.61,-50,-284692,28464419,-15251963,1.04964728069805,81.6123209822059,-0.952861006238787
372.71,373,10241,10241,327712,296989,2023-11-13,2023-12-15,440.61,0,-30723,302704033,-178564111,0.0981120063240122,97.6625184243911,-0.103448275862069
420.86,421,20870,21034,1022630,294476,2023-11-13,2023-11-17,440.61,164,-728154,63077977,-98136508,0.4668443948353,92.0596597446364,-2.47271084910145
415.1,416,2889,3269,482463,294210,2023-11-13,2023-12-08,440.61,380,-188253,28464419,-15251963,1.03360620148263,82.6459271836885,-0.639859284184766
434.85,443,1,359,1259,292585,2023-11-13,2023-12-22,440.61,358,291326,22794974,-7809504,1.28355048792773,86.0949435608042,0.99569697694687
424.32,426,1712,1737,571808,291816,2023-11-13,2023-12-08,440.61,25,-279992,28464419,-15251963,1.02519570134209,83.6711228850306,-0.95948131699427
344.92,345,36465,36470,364650,291760,2023-11-13,2023-12-01,440.61,5,-72890,30624514,-25040527,0.952700833064649,80.4806992202391,-0.249828626268166
414.76,415,11788,11948,671916,286752,2023-11-13,2023-11-24,440.61,160,-385164,21544370,-14129174,1.33098345414603,78.8447933265164,-1.34319551389354
329.92,330,35694,35778,285552,286224,2023-11-13,2023-12-08,440.61,84,672,28464419,-15251963,1.00555012206643,84.6766730070971,0.00234781150427637
381.65,382,8116,8118,413916,284130,2023-11-13,2023-12-15,440.61,2,-129786,302704033,-178564111,0.093863962493027,97.7563823868842,-0.456783866539964
390.51,391,5749,5755,431175,281995,2023-11-13,2023-12-15,440.61,6,-149180,302704033,-178564111,0.0931586530926729,97.8495410399768,-0.529016471923261
415.47,416,5498,5257,670756,278621,2023-11-13,2023-12-01,440.61,-241,-392135,30624514,-25040527,0.909797295068911,81.390496515308,-1.40741365510855
436.99,443,13,460,14170,276460,2023-11-13,2023-12-08,440.61,447,262290,28464419,-15251963,0.971247647809007,85.6479206549061,0.948744845547276
405.92,406,32652,34126,489780,273008,2023-11-13,2023-11-17,440.61,1474,-216772,63077977,-98136508,0.432810329348387,92.4924700739848,-0.794013362245795
388.56,389,6264,6185,432216,272140,2023-11-13,2023-12-15,440.61,-79,-160076,302704033,-178564111,0.0899029977575489,97.9394440377344,-0.588211949731756
382.64,383,7671,7558,429576,272088,2023-11-13,2023-12-15,440.61,-113,-157488,302704033,-178564111,0.0898858192616152,98.029329856996,-0.578812737055659
369.97,370,90924,90638,545544,271914,2023-11-13,2023-11-17,440.61,-286,-273630,63077977,-98136508,0.431075968083124,92.9235460420679,-1.00631081886185
405.54,407,1827,1828,422037,266888,2023-11-13,2023-12-29,440.61,1,-155149,120671117,-59187285,0.221169743543519,94.9479824571442,-0.581326249213153
418.36,419,3232,4141,478336,265024,2023-11-13,2023-12-01,440.61,909,-213312,30624514,-25040527,0.865398223135884,82.2558947384439,-0.804878048780488
378.66,379,7788,7782,373824,264588,2023-11-13,2023-12-15,440.61,-6,-109236,302704033,-178564111,0.0874081515788724,98.1167380085749,-0.41285319062089
419.8,421,2202,2191,532884,262920,2023-11-13,2023-12-08,440.61,-11,-269964,28464419,-15251963,0.923679489119381,86.5716001440254,-1.02679141944318
426.08,428,1505,1365,556850,262080,2023-11-13,2023-12-08,440.61,-140,-294770,28464419,-15251963,0.920728436438488,87.4923285804639,-1.12473290598291
397.76,398,10816,10816,432640,259584,2023-11-13,2023-12-01,440.61,0,-173056,30624514,-25040527,0.847634675933143,83.103529414377,-0.666666666666667
380.65,381,7177,7176,366027,251160,2023-11-13,2023-12-15,440.61,-1,-114867,302704033,-178564111,0.0829721353596898,98.1997101439346,-0.457345914954611
344.76,345,10466,10462,293048,251088,2023-11-13,2023-12-29,440.61,-4,-41960.0000000001,120671117,-59187285,0.208076303793558,95.1560587609378,-0.167112725418977
411.58,412,5875,5963,511125,250446,2023-11-13,2023-12-01,440.61,88,-260679,30624514,-25040527,0.817795835062068,83.9213252494391,-1.04085910735248
420.26,421,2440,3373,409920,249602,2023-11-13,2023-12-01,440.61,933,-160318,30624514,-25040527,0.81503987295929,84.7363651223984,-0.642294532896371
425.43,426,4212,4367,728676,248919,2023-11-13,2023-11-24,440.61,155,-479757,21544370,-14129174,1.15537841208631,80.0001717386027,-1.92736191291143
422.14,423,2948,2891,589600,248626,2023-11-13,2023-12-01,440.61,-57,-340974,30624514,-25040527,0.81185288360821,85.5482180060066,-1.37143339795516
416.43,417,4310,4254,543060,242478,2023-11-13,2023-12-01,440.61,-56,-300582,30624514,-25040527,0.791777462982759,86.3399954689893,-1.23962586296489
417.71,418,1900,8345,140600,242005,2023-11-13,2023-11-24,440.61,6445,101405,21544370,-14129174,1.12328650129941,81.1234582399021,0.419020268176277
379.96,380,56395,58274,394765,233096,2023-11-13,2023-11-17,440.61,1879,-161669,63077977,-98136508,0.369536264614193,93.2930823066821,-0.693572605278512
436.55,441,361,522,299630,232290,2023-11-13,2023-12-01,440.61,161,-67340,30624514,-25040527,0.75850999627292,87.0985054652623,-0.289896250376684
391.12,392,2647,2622,314993,230736,2023-11-13,2023-12-29,440.61,-25,-84257,120671117,-59187285,0.191210627477659,95.3472693884155,-0.365166250606754
420.72,422,1793,1797,459008,230016,2023-11-13,2023-12-08,440.61,4,-228992,28464419,-15251963,0.808082539819274,88.3004111202832,-0.995548135781859
395.44,396,4399,4099,400309,229544,2023-11-13,2023-12-15,440.61,-300,-170765,302704033,-178564111,0.0758311667423341,98.2755413106769,-0.743931446694316
425.33,429,614,620,361646,227540,2023-11-13,2023-12-22,440.61,6,-134106,22794974,-7809504,0.998202498498134,87.0931460593024,-0.589373297002725
412.22,413,2901,2884,420645,224952,2023-11-13,2023-12-08,440.61,-17,-195693,28464419,-15251963,0.790291907943036,89.0907030282262,-0.869932252213806
440.15,450,83,227,136535,223595,2023-11-13,2023-12-01,440.61,144,87060,30624514,-25040527,0.73011770897001,87.8286231742323,0.389364699568416
359.94,360,36975,36974,258825,221844,2023-11-13,2023-11-24,440.61,-1,-36981.0000000001,21544370,-14129174,1.02970752915959,82.1531657690617,-0.166698220371072
389.95,390,44339,44273,399051,221365,2023-11-13,2023-11-17,440.61,-66,-177686,63077977,-98136508,0.350938648523874,93.644020955206,-0.802683351026585
421.21,422,2633,2801,500270,221279,2023-11-13,2023-12-01,440.61,168,-278991,30624514,-25040527,0.722555139977079,88.5511783142093,-1.26081101234189
417.8,420,898,998,328668,219560,2023-11-13,2023-12-22,440.61,100,-109108,22794974,-7809504,0.963194781446121,88.0563408407485,-0.496939333211878
406.92,407,27416,27428,438656,219424,2023-11-13,2023-11-17,440.61,12,-219232,63077977,-98136508,0.347861504816491,93.9918824600224,-0.999124981770454
349.94,350,36439,36435,255073,218610,2023-11-13,2023-11-24,440.61,-4,-36463,21544370,-14129174,1.01469664696624,83.167862416028,-0.166794748639129
358.79,359,10403,10403,239269,218463,2023-11-13,2023-12-15,440.61,0,-20806,302704033,-178564111,0.0721704953300044,98.3477118060069,-0.0952380952380952
319.85,320,14554,14552,247418,218280,2023-11-13,2023-12-29,440.61,-2,-29138.0000000001,120671117,-59187285,0.180888356241867,95.5281577446573,-0.133489096573209
334.94,335,35496,35958,248472,215748,2023-11-13,2023-12-01,440.61,462,-32724,30624514,-25040527,0.704494445201645,89.255672759411,-0.151676956449191
410.91,411,20759,23521,415180,211689,2023-11-13,2023-11-17,440.61,2762,-203491,63077977,-98136508,0.335598904828543,94.327481364851,-0.961273377454662
438.59,445,130,330,153660,211530,2023-11-13,2023-12-01,440.61,200,57870,30624514,-25040527,0.690721165403637,89.9463939248146,0.273578215855907
427.58,429,1297,1480,420228,210160,2023-11-13,2023-12-01,440.61,183,-210068,30624514,-25040527,0.686247625023535,90.6326415498382,-0.999562238294633
428.21,429,2469,2637,567870,208323,2023-11-13,2023-11-24,440.61,168,-359547,21544370,-14129174,0.966948673829868,84.1348110898578,-1.72591120519578
416.52,419,904,834,364312,206832,2023-11-13,2023-12-29,440.61,-70,-157480,120671117,-59187285,0.171401413314174,95.6995591579715,-0.761390887290168
427.31,428,2399,2987,498992,206103,2023-11-13,2023-11-24,440.61,588,-292889,21544370,-14129174,0.956644357667455,85.0914554475253,-1.42108072177504
416.83,419,447,931,157344,202027,2023-11-13,2023-12-22,440.61,484,44683,22794974,-7809504,0.886278703366804,88.9426195441153,0.221173407514837
417.88,418,16620,16749,581700,200988,2023-11-13,2023-11-17,440.61,129,-380712,63077977,-98136508,0.31863418828413,94.6461155531351,-1.89420263896352
422.57,424,929,1372,272197,196196,2023-11-13,2023-12-08,440.61,443,-76001,28464419,-15251963,0.689267537833813,89.7799705660601,-0.387372831250382
423.78,427,599,602,324658,193844,2023-11-13,2023-12-22,440.61,3,-130814,22794974,-7809504,0.850380439126625,89.7929999832419,-0.674841625224407
412.78,413,8989,8792,449450,193424,2023-11-13,2023-11-24,440.61,-197,-256026,21544370,-14129174,0.89779371594528,85.9892491634706,-1.32365166680453
417.39,418,3249,3169,438615,193309,2023-11-13,2023-12-01,440.61,-80,-245306,30624514,-25040527,0.63122307834828,91.2638646281864,-1.26898385486449
441.2,470,73,67,261194,192960,2023-11-13,2023-12-15,440.61,-6,-68234,302704033,-178564111,0.0637454341416059,98.4114572401485,-0.353617330016584
415.9,416,19286,19291,520722,192910,2023-11-13,2023-11-17,440.61,5,-327812,63077977,-98136508,0.305827816894001,94.9519433700291,-1.69930019179928
404.83,405,11186,11185,335580,190145,2023-11-13,2023-11-24,440.61,-1,-145435,21544370,-14129174,0.882573962478364,86.8718231259489,-0.764863656683058
412.9,413,18544,19001,407968,190010,2023-11-13,2023-11-17,440.61,457,-217958,63077977,-98136508,0.301230332735623,95.2531737027648,-1.14708699542129
421.18,422.5,1548,1435,404028,189420,2023-11-13,2023-12-08,440.61,-113,-214608,28464419,-15251963,0.665462379541279,90.4454329456013,-1.13297434273044
396.95,398,1798,1801,282286,189105,2023-11-13,2023-12-29,440.61,3,-93181,120671117,-59187285,0.156711071133948,95.8562702291055,-0.492747415457021
423.05,424,1433,1970,300930,187150,2023-11-13,2023-12-01,440.61,537,-113780,30624514,-25040527,0.611111738785471,91.8749763669719,-0.607961528185947
408.92,409,24038,23383,432684,187064,2023-11-13,2023-11-17,440.61,-655,-245620,63077977,-98136508,0.296559922966458,95.5497336257312,-1.31302655775563
359.98,360,91990,92380,367960,184760,2023-11-13,2023-11-17,440.61,390,-183200,63077977,-98136508,0.292907301069595,95.8426409268008,-0.991556613985711
371.72,372,6605,6591,224570,184548,2023-11-13,2023-12-15,440.61,-14,-40022,302704033,-178564111,0.0609664820686416,98.4724237222171,-0.216864989054338
368.49,369,3611,3611,169717,184161,2023-11-13,2023-12-29,440.61,0,14444,120671117,-59187285,0.152613984670416,96.0088842137759,0.0784313725490198
408.65,410,1097,1347,241340,181845,2023-11-13,2023-12-22,440.61,250,-59495,22794974,-7809504,0.797741642521724,90.5907416257637,-0.327174241799335
402.73,404,1416,1424,281784,180848,2023-11-13,2023-12-29,440.61,8,-100936,120671117,-59187285,0.149868505816516,96.1587527195924,-0.558126161196143
413.23,414,2324,2329,348600,179333,2023-11-13,2023-12-08,440.61,5,-169267,28464419,-15251963,0.630025155264894,91.0754581008662,-0.94386978414458
386.59,387,4378,4371,280192,179211,2023-11-13,2023-12-15,440.61,-7,-100981,302704033,-178564111,0.0592033737456019,98.5316270959628,-0.563475456305696
389.8,390,8930,8921,258970,178420,2023-11-13,2023-12-01,440.61,-9,-80550,30624514,-25040527,0.582605163954602,92.4575815309265,-0.451462840488734
409.27,411,1032,1027,277608,177671,2023-11-13,2023-12-29,440.61,-5,-99937,120671117,-59187285,0.147235729988312,96.3059884495807,-0.562483466632146
334.87,335,13404,13403,214464,174239,2023-11-13,2023-12-15,440.61,-1,-40225,302704033,-178564111,0.0575608452497889,98.5891879412125,-0.230861058660805
387.57,388,4009,4006,272612,172258,2023-11-13,2023-12-15,440.61,-3,-100354,302704033,-178564111,0.0569064106258538,98.6460943518384,-0.582579618943678
379.79,380,8074,8136,242220,170856,2023-11-13,2023-12-08,440.61,62,-71364,28464419,-15251963,0.600244115293553,91.6757022161598,-0.417685068127546
426.25,427.5,1319,1364,389105,170500,2023-11-13,2023-12-01,440.61,45,-218605,30624514,-25040527,0.556743529056494,93.014325059983,-1.28214076246334
399.86,400,12215,12154,280945,170156,2023-11-13,2023-11-24,440.61,-61,-110789,21544370,-14129174,0.789793342761938,87.6616164687109,-0.651102517689649
400.94,401,29027,28329,406378,169974,2023-11-13,2023-11-17,440.61,-698,-236404,63077977,-98136508,0.26946647321933,96.1121074000202,-1.39082447903797
413.9,414,18820,16994,432860,169940,2023-11-13,2023-11-17,440.61,-1826,-262920,63077977,-98136508,0.269412571680921,96.3815199717011,-1.54713428268801
397.93,398,24025,24034,288300,168238,2023-11-13,2023-11-17,440.61,9,-120062,63077977,-98136508,0.266714324081763,96.6482342957828,-0.71364376656879
426.37,427,2613,2640,488631,166320,2023-11-13,2023-11-24,440.61,27,-322311,21544370,-14129174,0.771988227086705,88.4336046957976,-1.93789682539683
383.61,384,4156,4154,241048,162006,2023-11-13,2023-12-15,440.61,-2,-79042,302704033,-178564111,0.05351960408139,98.6996139559198,-0.487895510042838
416.72,417,5724,5744,372060,160832,2023-11-13,2023-11-24,440.61,20,-211228,21544370,-14129174,0.746515214879804,89.1801199106774,-1.3133456028651
424.89,426,1426,1446,355074,160506,2023-11-13,2023-12-01,440.61,20,-194568,30624514,-25040527,0.524109541787341,93.5384346017703,-1.21221636574334
357.8,358,7992,8020,183816,160400,2023-11-13,2023-12-15,440.61,28,-23416,302704033,-178564111,0.052989052841592,98.7526030087614,-0.145985037406484
404.62,406,973,1154,217952,159252,2023-11-13,2023-12-29,440.61,181,-58700,120671117,-59187285,0.131971928294987,96.4379603778757,-0.36859819656896
433.74,441,152,216,171760,156816,2023-11-13,2023-12-22,440.61,64,-14944,22794974,-7809504,0.687941122459714,91.2786827482234,-0.0952963983267014
428.62,431,511,644,238126,153272,2023-11-13,2023-12-08,440.61,133,-84854,28464419,-15251963,0.538468745840202,92.214170962,-0.553617099013519
294.95,295,30449,30499,213143,152495,2023-11-13,2023-12-15,440.61,50,-60648,302704033,-178564111,0.0503775911039811,98.8029805998654,-0.397704842781731
426.85,427.5,1560,2335,310440,151775,2023-11-13,2023-11-24,440.61,775,-158665,21544370,-14129174,0.704476389887474,89.8845963005648,-1.04539614561028
425.66,427.5,722,823,260642,151432,2023-11-13,2023-12-08,440.61,101,-109210,28464419,-15251963,0.532004535205865,92.7461754972058,-0.721181784563368
403.93,405,1560,1415,266760,151405,2023-11-13,2023-12-22,440.61,-145,-115355,22794974,-7809504,0.664203433616551,91.9428861818399,-0.761896899045606
424.61,428,437,443,246468,150177,2023-11-13,2023-12-22,440.61,6,-96291,22794974,-7809504,0.658816281167945,92.6017024630079,-0.641183403583771
390.93,391,21452,21398,193068,149786,2023-11-13,2023-11-17,440.61,-54,-43282,63077977,-98136508,0.237461642119563,96.8856959379024,-0.288958914718331
421.21,424,509,536,235667,149544,2023-11-13,2023-12-22,440.61,27,-86123,22794974,-7809504,0.656039353236376,93.2577418162442,-0.575904081741829
416.08,417,1334,1625,241454,149500,2023-11-13,2023-12-08,440.61,291,-91954,28464419,-15251963,0.525217114039812,93.2713926112456,-0.615076923076923
373.7,374,4938,4938,207396,148140,2023-11-13,2023-12-15,440.61,0,-59256,302704033,-178564111,0.0489388920695351,98.8519194919349,-0.4
422.85,423,9020,9805,568260,147075,2023-11-13,2023-11-17,440.61,785,-421185,63077977,-98136508,0.233163787101162,97.1188597250035,-2.86374298827129
397.89,399,887,1322,144581,146742,2023-11-13,2023-12-29,440.61,435,2161,120671117,-59187285,0.121604907328404,96.5595652852041,0.0147265268294013
413.29,415,798,846,225834,144666,2023-11-13,2023-12-22,440.61,48,-81168,22794974,-7809504,0.634639899128641,93.8923817153729,-0.56107171000788
409.82,410,8005,7986,320200,143748,2023-11-13,2023-11-24,440.61,-19,-176452,21544370,-14129174,0.667218396267795,90.5518146968326,-1.22750925230264
399.11,400,1392,1611,192096,143379,2023-11-13,2023-12-22,440.61,219,-48717,22794974,-7809504,0.628993917694313,94.5213756330672,-0.339777791726822
376.69,377,4630,4621,208350,143251,2023-11-13,2023-12-15,440.61,-9,-65099,302704033,-178564111,0.0473237830960779,98.899243275031,-0.454440108620533
418.88,419,11751,11887,446538,142644,2023-11-13,2023-11-17,440.61,136,-303894,63077977,-98136508,0.226139148375034,97.3449988733786,-2.13043661142425
410.61,411,3578,3560,304130,138840,2023-11-13,2023-12-01,440.61,-18,-165290,30624514,-25040527,0.453362296622895,93.9917968983932,-1.19050705848459
400.81,402,1156,1165,206924,138635,2023-11-13,2023-12-29,440.61,9,-68289,120671117,-59187285,0.114886646818725,96.6744519320228,-0.492581238503986
382.38,383,2249,2232,202410,138384,2023-11-13,2023-12-29,440.61,-17,-64026,120671117,-59187285,0.114678643440418,96.7891305754632,-0.462669094693028
395.05,396,1459,1456,210096,138320,2023-11-13,2023-12-29,440.61,-3,-71776,120671117,-59187285,0.114625606722444,96.9037561821857,-0.518912666281087
417.91,419,834,1264,174306,137776,2023-11-13,2023-12-08,440.61,430,-36530,28464419,-15251963,0.48402885019364,93.7554214614393,-0.265140517942167
376.26,377,1728,1728,127872,127872,2023-11-13,2023-12-29,440.61,0,0,120671117,-59187285,0.105967362513102,97.0097235446988,0
381.96,382,30793,31936,184758,127744,2023-11-13,2023-11-17,440.61,1143,-57014,63077977,-98136508,0.202517591837164,97.5475164652158,-0.446314504008016
402.92,403,15591,15752,233865,126016,2023-11-13,2023-11-17,440.61,161,-107849,63077977,-98136508,0.199778125414517,97.7472945906303,-0.855835766886744
356.68,357,3922,3922,133348,125504,2023-11-13,2023-12-29,440.61,0,-7844,120671117,-59187285,0.104005003948045,97.1137285486468,-0.0625
304.93,305,17939,17909,161451,125363,2023-11-13,2023-12-15,440.61,-30,-36088,302704033,-178564111,0.0414143804948909,98.9406576555259,-0.287868031237287
370.73,371,4625,4624,166500,124848,2023-11-13,2023-12-15,440.61,-1,-41652,302704033,-178564111,0.0412442473140092,98.9819019028399,-0.333621683967705
398.94,399,20808,20764,249696,124584,2023-11-13,2023-11-17,440.61,-44,-125112,63077977,-98136508,0.197507919443897,97.9448025100742,-1.00423810441148
410.27,412,704,710,176000,122830,2023-11-13,2023-12-22,440.61,6,-53170,22794974,-7809504,0.538846852819398,95.0602224858866,-0.432874704876659
284.96,285,30487,30487,121948,121948,2023-11-13,2023-12-15,440.61,0,0,302704033,-178564111,0.0402862158100153,99.0221881186499,0
368.74,369,4488,4676,161568,121576,2023-11-13,2023-12-15,440.61,188,-39992,302704033,-178564111,0.0401633234929513,99.0623514421428,-0.328946502599197
333.76,334,5044,5044,121056,121056,2023-11-13,2023-12-29,440.61,0,0,120671117,-59187285,0.100318952048815,97.2140475006956,0
329.89,330,10954,10955,153356,120505,2023-11-13,2023-12-15,440.61,1,-32851,302704033,-178564111,0.0398095125478556,99.1021609546907,-0.272611094975313
354.98,355,60221,60229,180663,120458,2023-11-13,2023-11-17,440.61,8,-60205,63077977,-98136508,0.190966809224082,98.1357693192982,-0.499800760431022
377.47,378,2270,2269,172520,120257,2023-11-13,2023-12-29,440.61,-1,-52263,120671117,-59187285,0.0996568217728522,97.3137043224685,-0.434594243994112
415.06,417,526,618,166742,119892,2023-11-13,2023-12-22,440.61,92,-46850,22794974,-7809504,0.52595804671679,95.5861805326034,-0.390768358189037
439.27,445,75,206,82425,118038,2023-11-13,2023-11-24,440.61,131,35613,21544370,-14129174,0.547883275305799,91.0996979721384,0.301707924566665
314.92,315,14579,14579,145790,116632,2023-11-13,2023-12-15,440.61,0,-29158,302704033,-178564111,0.0385300449564873,99.1406909996472,-0.25
399.6,400,2772,2899,191268,115960,2023-11-13,2023-12-08,440.61,127,-75308,28464419,-15251963,0.407385796281315,94.1628072577206,-0.649430838220075
411.7,412.5,1443,1448,191919,115840,2023-11-13,2023-12-08,440.61,5,-76079,28464419,-15251963,0.406964217326902,94.5697714750475,-0.65675932320442
332.81,333,6196,6059,161096,115121,2023-11-13,2023-12-29,440.61,-137,-45975,120671117,-59187285,0.0954006251553965,97.4091049476239,-0.399362409986015
309.92,310,14413,14336,129717,114688,2023-11-13,2023-12-15,440.61,-77,-15029,302704033,-178564111,0.0378878334931203,99.1785788331403,-0.13104248046875
396.94,397,18822,18807,207042,112842,2023-11-13,2023-11-17,440.61,-15,-94200,63077977,-98136508,0.178892864620563,98.3146621839188,-0.8347955548466
365.75,366,4507,4507,153238,112675,2023-11-13,2023-12-15,440.61,0,-40563,302704033,-178564111,0.0372228274870722,99.2158016606274,-0.36
353.82,354,6236,6232,155900,112176,2023-11-13,2023-12-15,440.61,-4,-43724,302704033,-178564111,0.037057979997247,99.2528596406246,-0.389780345171873
379.85,380,7936,7440,166656,111600,2023-11-13,2023-12-01,440.61,-496,-55056,30624514,-25040527,0.364413946291523,94.3562108446848,-0.493333333333333
439.89,447,64,151,85120,107361,2023-11-13,2023-11-24,440.61,87,22241,21544370,-14129174,0.498325084465222,91.5980230566037,0.20716088710053
394.27,395,1378,1466,147446,107018,2023-11-13,2023-12-22,440.61,88,-40428,22794974,-7809504,0.469480684645659,96.0556612172491,-0.377768225905922
391.8,392,5345,5346,165695,106920,2023-11-13,2023-12-01,440.61,1,-58775,30624514,-25040527,0.349132071124459,94.7053429158092,-0.549710063598953
329.97,330,35442,35444,141768,106332,2023-11-13,2023-11-24,440.61,2,-35436,21544370,-14129174,0.493548894676428,92.0915719512801,-0.333258097280217
349.88,350,8781,8784,122934,105408,2023-11-13,2023-12-08,440.61,3,-17526,28464419,-15251963,0.370314953556579,94.9400864286041,-0.166268214936248
393.05,394,1120,1108,123200,105260,2023-11-13,2023-12-29,440.61,-12,-17940,120671117,-59187285,0.0872288270937278,97.4963337747176,-0.170435113053392
404.71,405,3460,3467,200680,100543,2023-11-13,2023-12-01,440.61,7,-100137,30624514,-25040527,0.328308883530364,95.0336517993396,-0.995961926737814
404.51,405,2021,2038,171785,99862,2023-11-13,2023-12-08,440.61,17,-71923,28464419,-15251963,0.350830979546781,95.2909174081509,-0.720223908994412
361.77,362,4271,4270,128130,98210,2023-11-13,2023-12-15,440.61,-1,-29920,302704033,-178564111,0.032444232416289,99.2853038730409,-0.304653293961918
422.92,426,303,316,157560,97328,2023-11-13,2023-12-22,440.61,13,-60232,22794974,-7809504,0.426971313939643,96.4826325311887,-0.618855827716587
387.74,388,3735,3717,160605,96642,2023-11-13,2023-12-08,440.61,-18,-63963,28464419,-15251963,0.339518610936693,95.6304360190876,-0.661855094058484
401.56,402,2197,2193,175760,96492,2023-11-13,2023-12-08,440.61,-4,-79268,28464419,-15251963,0.338991637243676,95.9694276563312,-0.821498155287485
440.12,500,16,16,104976,95808,2023-11-13,2023-12-15,440.61,0,-9168,302704033,-178564111,0.0316507180464292,99.3169545910873,-0.0956913827655311
410.34,411,1413,1433,179451,94578,2023-11-13,2023-12-08,440.61,20,-84873,28464419,-15251963,0.332267452920785,96.301695109252,-0.897386284336738
395.93,396,13526,13460,148786,94220,2023-11-13,2023-11-17,440.61,-66,-54566,63077977,-98136508,0.14937067496632,98.4640328588851,-0.579133941838251
411.3,412,1183,1340,154973,93800,2023-11-13,2023-12-08,440.61,157,-61173,28464419,-15251963,0.329534216033006,96.631229325285,-0.652164179104478
436.99,442,26,187,21164,93687,2023-11-13,2023-12-01,440.61,161,72523,30624514,-25040527,0.305921589482204,95.3395733888218,0.774098861101327
433.19,454,45,45,93645,93645,2023-11-13,2023-12-15,440.61,0,0,302704033,-178564111,0.0309361586867262,99.3478907497741,0
417.02,418,934,947,174658,92806,2023-11-13,2023-12-08,440.61,13,-81852,28464419,-15251963,0.326042137027283,96.9572714623123,-0.881968838221667
437.67,443,28,174,28448,92742,2023-11-13,2023-12-01,440.61,146,64294,30624514,-25040527,0.302835826227316,95.6424092150491,0.693256561212827
353.7,354,3086,3086,104924,92580,2023-11-13,2023-12-29,440.61,0,-12344,120671117,-59187285,0.0767209273450249,97.5730547020626,-0.133333333333333
366.75,367,3670,3646,117440,91150,2023-11-13,2023-12-15,440.61,-24,-26290,302704033,-178564111,0.0301119212376004,99.3780026710117,-0.288425671969282
363.61,364,2323,2323,111504,90597,2023-11-13,2023-12-29,440.61,0,-20907,120671117,-59187285,0.075077617786533,97.6481323198492,-0.230769230769231
383.34,384,1343,1364,111469,90024,2023-11-13,2023-12-29,440.61,21,-21445,120671117,-59187285,0.0746027734209173,97.7227350932701,-0.238214253976717
362.73,363,3275,3273,85150,88371,2023-11-13,2023-12-15,440.61,-2,3221,302704033,-178564111,0.0291938627722215,99.4071965337839,0.0364486087064761
342.59,343,2147,2147,88027,88027,2023-11-13,2023-12-29,440.61,0,0,120671117,-59187285,0.0729478620803684,97.7956829553505,0
435.05,470,25,25,87375,87375,2023-11-13,2023-12-29,440.61,0,0,120671117,-59187285,0.0724075505160029,97.8680905058665,0
394.86,395,6210,6179,117990,86506,2023-11-13,2023-11-24,440.61,-31,-31484,21544370,-14129174,0.401524853128683,92.4930968044088,-0.363951633412711
440.4,450,74,90,120102,86400,2023-11-13,2023-11-24,440.61,16,-33702,21544370,-14129174,0.401032845239847,92.8941296496486,-0.390069444444444
440.75,480,22,22,100694,86350,2023-11-13,2023-12-15,440.61,0,-14344,302704033,-178564111,0.0285262139206451,99.4357227477045,-0.166114649681529
367.75,368,3391,3388,115294,84700,2023-11-13,2023-12-15,440.61,-3,-30594,302704033,-178564111,0.0279811270304417,99.463703874735,-0.361204250295159
407.44,408,1381,1506,138100,84336,2023-11-13,2023-12-08,440.61,125,-53764,28464419,-15251963,0.296285689161616,97.2535571514739,-0.637497628533485
437.27,442.5,101,161,105343,84203,2023-11-13,2023-12-01,440.61,60,-21140,30624514,-25040527,0.274952934763308,95.9173621498124,-0.251059938482002
344.98,345,40870,41039,81740,82078,2023-11-13,2023-11-17,440.61,169,338,63077977,-98136508,0.130121484397003,98.5941543432821,0.00411803406515753
415.74,416,2721,3140,171423,81640,2023-11-13,2023-11-24,440.61,419,-89783,21544370,-14129174,0.3789389060808,93.2730685557294,-1.09974277315042
350.83,351,4713,4802,89547,81634,2023-11-13,2023-12-15,440.61,89,-7913,302704033,-178564111,0.0269682564817364,99.4906721312167,-0.0969326506112649
406.72,408,617,635,125868,81280,2023-11-13,2023-12-22,440.61,18,-44588,22794974,-7809504,0.356569829823013,96.8392023610117,-0.548572834645669
423.51,424,1661,1652,222574,80948,2023-11-13,2023-11-24,440.61,-9,-141626,21544370,-14129174,0.375726930051795,93.6487954857812,-1.74959233087908
299.9,300,8092,8084,105196,80840,2023-11-13,2023-12-29,440.61,-8,-24356,120671117,-59187285,0.0669920043915729,97.935082510258,-0.301286491835725
439.8,465,32,32,96256,80640,2023-11-13,2023-12-15,440.61,0,-15616,302704033,-178564111,0.0266398829248502,99.5173120141416,-0.193650793650794
433.64,447,60,60,80160,80160,2023-11-13,2023-12-29,440.61,0,0,120671117,-59187285,0.0664284892630935,98.0015109995211,0
413.77,414,3444,3453,182532,79419,2023-11-13,2023-11-24,440.61,9,-103113,21544370,-14129174,0.36862994833453,94.0174254341157,-1.29834170664451
421.61,422,1219,2035,140185,79365,2023-11-13,2023-11-24,440.61,816,-60820,21544370,-14129174,0.368379302806255,94.385804736922,-0.766332766332766
439.4,446,41,120,51537,79200,2023-11-13,2023-11-24,440.61,79,27663,21544370,-14129174,0.36761344146986,94.7534181783919,0.349280303030303
439.9,449,6,87,7554,79170,2023-11-13,2023-11-24,440.61,81,71616,21544370,-14129174,0.367474193954151,95.120892372346,0.904585070102311
418.65,421,319,333,126962,78255,2023-11-13,2023-12-22,440.61,14,-48707,22794974,-7809504,0.343299360639762,97.1825017216515,-0.622413903264967
387.95,388,15632,15623,125056,78115,2023-11-13,2023-11-17,440.61,-9,-46941,63077977,-98136508,0.123838784493675,98.7179931277758,-0.600921717979901
388.26,389,1056,1051,119328,77774,2023-11-13,2023-12-29,440.61,-5,-41554,120671117,-59187285,0.0644512141211057,98.0659622136422,-0.534291665595186
440.01,448,95,97,134330,77503,2023-11-13,2023-11-24,440.61,2,-56827,21544370,-14129174,0.359736673664628,95.4806290460106,-0.733223230068514
403.7,404,2486,2559,139216,76770,2023-11-13,2023-12-01,440.61,73,-62446,30624514,-25040527,0.250681529182798,96.1680436789952,-0.813416699231471
341.61,342,1959,1959,76401,76401,2023-11-13,2023-12-29,440.61,0,0,120671117,-59187285,0.0633134107808085,98.129275624423,0
385.29,386,1072,1071,106128,76041,2023-11-13,2023-12-29,440.61,-1,-30087,120671117,-59187285,0.0630150792422018,98.1922907036653,-0.395668126405492
371.55,372,1679,1681,83950,75645,2023-11-13,2023-12-29,440.61,2,-8305,120671117,-59187285,0.0626869145497344,98.254977618215,-0.109789146671955
437.43,455,42,42,79422,73794,2023-11-13,2023-12-29,440.61,0,-5628,120671117,-59187285,0.0611529932220649,98.316130611437,-0.0762663631189528
407.65,408,2008,2087,128512,73045,2023-11-13,2023-12-01,440.61,79,-55467,30624514,-25040527,0.238518070850039,96.4065617498452,-0.759353822985831
402.71,403,2472,2475,128544,71775,2023-11-13,2023-12-01,440.61,3,-56769,30624514,-25040527,0.234371066264105,96.6409328161093,-0.790929989550679
346.84,347,4337,4337,91077,69392,2023-11-13,2023-12-15,440.61,0,-21685,302704033,-178564111,0.0229240421121181,99.5402360562537,-0.3125
274.97,275,22650,22630,90600,67890,2023-11-13,2023-12-15,440.61,-20,-22710,302704033,-178564111,0.0224278478641875,99.5626639041179,-0.334511710119311
389.9,390,6696,6747,113832,67470,2023-11-13,2023-11-24,440.61,51,-46362,21544370,-14129174,0.313167662827922,95.7937967088386,-0.687149844375278
413.53,414,1461,1435,146100,67445,2023-11-13,2023-12-01,440.61,-26,-78655,30624514,-25040527,0.220232066376629,96.861164882486,-1.16620950404033
403.83,404,3868,3946,104436,67082,2023-11-13,2023-11-24,440.61,78,-37354,21544370,-14129174,0.311366728291428,96.10516343713,-0.556840881309442
417.23,417.5,2476,2471,188176,66717,2023-11-13,2023-11-24,440.61,-5,-121459,21544370,-14129174,0.309672550183644,96.4148359873136,-1.82051051456151
356.77,357,2796,2846,58716,65458,2023-11-13,2023-12-15,440.61,50,6742.00000000001,302704033,-178564111,0.0216244228235968,99.5842883269415,0.10299734180696
360.77,361,2843,2843,65389,65389,2023-11-13,2023-12-15,440.61,0,0,302704033,-178564111,0.0216016282809156,99.6058899552224,0
334.79,335,3106,3111,83862,65331,2023-11-13,2023-12-29,440.61,5,-18531,120671117,-59187285,0.0541397159686522,98.3702703274057,-0.283647885383662
401.72,402,2181,2318,100326,64904,2023-11-13,2023-12-01,440.61,137,-35422,30624514,-25040527,0.211934791846819,97.0730996743328,-0.545759891532109
438,444,106,108,84058,64800,2023-11-13,2023-12-01,440.61,2,-19258,30624514,-25040527,0.211595194620884,97.2846948689537,-0.297191358024691
416.44,417.5,604,603,112344,63918,2023-11-13,2023-12-08,440.61,-1,-48426,28464419,-15251963,0.224554030068206,97.4781111815421,-0.757626959541913
436.5,449,50,51,76250,63750,2023-11-13,2023-12-01,440.61,1,-12500,30624514,-25040527,0.20816656878212,97.4928614377358,-0.196078431372549
438.43,443,67,138,65258,63066,2023-11-13,2023-11-24,440.61,71,-2192,21544370,-14129174,0.292726127521947,96.7075621148356,-0.0347572384486094
440.25,449,1,72,1174,63000,2023-11-13,2023-11-17,440.61,71,61826,63077977,-98136508,0.0998763799923387,98.8178695077681,0.981365079365079
309.87,310,4791,4846,81447,62998,2023-11-13,2023-12-29,440.61,55,-18449,120671117,-59187285,0.0522063618587371,98.4224766892644,-0.292850566684657
402.53,403,1737,1334,100746,62698,2023-11-13,2023-12-08,440.61,-403,-38048,28464419,-15251963,0.220267977365004,97.6983791589071,-0.606845513413506
385.95,386,12455,12453,99640,62265,2023-11-13,2023-11-17,440.61,-2,-37375,63077977,-98136508,0.0987111555590947,98.9165806633272,-0.600256966192885
415.96,418,260,305,87620,62220,2023-11-13,2023-12-22,440.61,45,-25400,22794974,-7809504,0.27295490663863,97.4554566282901,-0.408228865316618
349.98,350,30640,31102,91920,62204,2023-11-13,2023-11-17,440.61,462,-29716,63077977,-98136508,0.0986144498578323,99.0151951131851,-0.477718474696161
437.94,445,34,88,41684,62128,2023-11-13,2023-12-08,440.61,54,20444,28464419,-15251963,0.218265477331542,97.9166446362387,0.329062580479011
392.15,393,725,726,89900,61710,2023-11-13,2023-12-29,440.61,1,-28190,120671117,-59187285,0.0511389979094998,98.4736156871739,-0.456814130610922
385.81,386,3197,3236,79925,61484,2023-11-13,2023-12-01,440.61,39,-18441,30624514,-25040527,0.200767267686273,97.6936287054221,-0.299931689545248
363.77,364,2667,2667,66675,61341,2023-11-13,2023-12-15,440.61,0,-5333.99999999999,302704033,-178564111,0.0202643484436165,99.626154303666,-0.0869565217391303
340.75,341,2432,2432,65664,60800,2023-11-13,2023-12-29,440.61,0,-4864.00000000002,120671117,-59187285,0.0503848820757995,98.5240005692497,-0.0800000000000002
348.84,349,3763,3765,82786,60240,2023-11-13,2023-12-15,440.61,2,-22546,302704033,-178564111,0.0199006268277899,99.6460549304938,-0.374269588313413
407.67,409,454,450,99880,59850,2023-11-13,2023-12-22,440.61,-4,-40030,22794974,-7809504,0.2625578778901,97.7180145061802,-0.668838763575606
381.4,382,992,996,86304,59760,2023-11-13,2023-12-29,440.61,4,-26544,120671117,-59187285,0.0495230354087134,98.5735236046584,-0.444176706827309
405.67,406,1683,1802,100980,59466,2023-11-13,2023-12-01,440.61,119,-41514,30624514,-25040527,0.194177775359962,97.887806480782,-0.69811320754717
389.95,391,553,553,58065,58065,2023-11-13,2023-12-29,440.61,0,0,120671117,-59187285,0.0481183910811068,98.6216419957396,0
403.51,404,1049,1176,84969,57624,2023-11-13,2023-12-08,440.61,127,-27345,28464419,-15251963,0.202442213909232,98.1190868501479,-0.47454185755935
408.64,409,1557,1594,112104,57384,2023-11-13,2023-12-01,440.61,37,-54720,30624514,-25040527,0.187379300125383,98.0751857809074,-0.95357590966123
352.82,353,3192,3180,63840,57240,2023-11-13,2023-12-15,440.61,-12,-6600.00000000001,302704033,-178564111,0.0189095597546928,99.6649644902485,-0.115303983228512
358.61,359,1454,1454,56706,56706,2023-11-13,2023-12-29,440.61,0,0,120671117,-59187285,0.0469921895228665,98.6686341852624,0
365.6,366,1416,1411,66552,56440,2023-11-13,2023-12-29,440.61,-5,-10112,120671117,-59187285,0.0467717556637849,98.7154059409262,-0.179163713678242
339.78,340,2775,2556,72150,56232,2023-11-13,2023-12-29,440.61,-219,-15918,120671117,-59187285,0.0465993863303677,98.7620053272566,-0.28307725138711
335.75,336,2219,2219,55475,55475,2023-11-13,2023-12-29,440.61,0,0,120671117,-59187285,0.0459720614005753,98.8079773886571,0
406.66,407,1625,1628,102375,55352,2023-11-13,2023-12-01,440.61,3,-47023,30624514,-25040527,0.180744092787889,98.2559298736953,-0.849526665703136
385.76,386,2263,2304,88257,55296,2023-11-13,2023-12-08,440.61,41,-32961,28464419,-15251963,0.194263582193615,98.3133504323415,-0.596082899305556
439.8,460,24,27,62760,54540,2023-11-13,2023-12-29,440.61,3,-8219.99999999999,120671117,-59187285,0.0451972280989162,98.853174616756,-0.150715071507151
407.83,408,3166,3181,113976,54077,2023-11-13,2023-11-24,440.61,15,-59899,21544370,-14129174,0.251002930231889,96.9585650450675,-1.10766129777909
387.24,388,710,709,76680,53884,2023-11-13,2023-12-29,440.61,-1,-22796,120671117,-59187285,0.0446536017396773,98.8978282184957,-0.423056937124193
386.32,387,782,782,69598,53176,2023-11-13,2023-12-29,440.61,0,-16422,120671117,-59187285,0.0440668830470841,98.9418951015428,-0.308823529411765
364.97,365,17583,17544,87915,52632,2023-11-13,2023-11-17,440.61,-39,-35283,63077977,-98136508,0.0834395814564567,99.0986346946415,-0.670371637026904
393.93,394,7341,7358,73410,51506,2023-11-13,2023-11-17,440.61,17,-21904,63077977,-98136508,0.0816544893315142,99.180289183973,-0.425270842231973
339.94,340,8548,8545,59836,51270,2023-11-13,2023-12-01,440.61,-3,-8566.00000000001,30624514,-25040527,0.16741490166995,98.4233447753653,-0.167076262921787
440.16,525,6,6,54534,50904,2023-11-13,2023-12-15,440.61,0,-3630,302704033,-178564111,0.0168164260963117,99.6817809163448,-0.0713107024988213
372.54,373,1111,1101,59994,50646,2023-11-13,2023-12-29,440.61,-10,-9348.00000000001,120671117,-59187285,0.0419702752896536,98.9838653768325,-0.184575287288236
411.79,412,2339,2406,102916,50526,2023-11-13,2023-11-24,440.61,67,-52390,21544370,-14129174,0.234520665955885,97.1930857110234,-1.03689189724102
324.83,325,2945,2952,55955,50184,2023-11-13,2023-12-29,440.61,7,-5770.99999999999,120671117,-59187285,0.041587416481775,99.0254527933143,-0.114996811732823
289.95,290,9482,9802,66374,49010,2023-11-13,2023-12-15,440.61,320,-17364,302704033,-178564111,0.0161907324174964,99.6979716487623,-0.354295041828198
422.09,422.5,1182,1185,140658,48585,2023-11-13,2023-11-24,440.61,3,-92073,21544370,-14129174,0.22551135168956,97.4185970627129,-1.89509107749305
391.94,392,8083,8076,80830,48456,2023-11-13,2023-11-17,440.61,-7,-32374,63077977,-98136508,0.0768192042683931,99.2571083882414,-0.668111276209345
418.69,419,1197,1545,102942,47895,2023-11-13,2023-11-24,440.61,348,-55047,21544370,-14129174,0.222308658828269,97.6409057215412,-1.14932665205136
384.84,385,3282,2986,78768,47776,2023-11-13,2023-12-01,440.61,-296,-30992,30624514,-25040527,0.156005741021719,98.579350516387,-0.648693904889484
419.5,422,60,191,24840,47750,2023-11-13,2023-12-22,440.61,131,22910,22794974,-7809504,0.209476001157097,97.9274905073373,0.479790575916231
395.78,396,2078,2161,76886,47542,2023-11-13,2023-12-01,440.61,83,-29344,30624514,-25040527,0.155241647263366,98.7345921636503,-0.617222666274031
374.8,375,2348,2373,61048,47460,2023-11-13,2023-12-08,440.61,25,-13588,28464419,-15251963,0.166734476470431,98.480084908812,-0.286304256215761
437.28,461,20,20,47440,47440,2023-11-13,2023-12-15,440.61,0,0,302704033,-178564111,0.0156720739825756,99.7136437227449,0
409.53,411,123,318,27429,46746,2023-11-13,2023-12-22,440.61,195,19317,22794974,-7809504,0.205071521467846,98.1325620288051,0.413233217815428
304.87,305,3589,3589,46657,46657,2023-11-13,2023-12-29,440.61,0,0,120671117,-59187285,0.0386645961021476,99.0641173894164,0
436.46,475,12,12,46248,46248,2023-11-13,2023-12-29,440.61,0,0,120671117,-59187285,0.0383256583263417,99.1024430477427,0
289.89,290,4184,4184,46024,46024,2023-11-13,2023-12-29,440.61,0,0,120671117,-59187285,0.0381400298134308,99.1405830775562,0
406.43,407,838,795,85476,45315,2023-11-13,2023-12-08,440.61,-43,-40161,28464419,-15251963,0.159198752660295,98.6392836614723,-0.886262826878517
438.88,444,33,84,34947,43008,2023-11-13,2023-11-24,440.61,51,8061,21544370,-14129174,0.19962523851939,97.8405309600606,0.187430245535714
345.73,346,1759,1589,52770,42903,2023-11-13,2023-12-29,440.61,-170,-9866.99999999999,120671117,-59187285,0.0355536611134543,99.1761367386696,-0.229983917208587
392.95,393,8548,8546,94028,42730,2023-11-13,2023-11-17,440.61,-2,-51298,63077977,-98136508,0.067741551064645,99.3248499393061,-1.20051486075357
407.15,407.5,1197,1205,76608,42175,2023-11-13,2023-12-01,440.61,8,-34433,30624514,-25040527,0.137716471190367,98.8723086348407,-0.81643153526971
327.82,328,2324,2324,48804,41832,2023-11-13,2023-12-29,440.61,0,-6972,120671117,-59187285,0.0346661247860994,99.2108028634557,-0.166666666666667
411.44,413,244,268,60268,41808,2023-11-13,2023-12-22,440.61,24,-18460,22794974,-7809504,0.183408851442428,98.3159708802476,-0.441542288557214
438.53,447,18,49,19152,41503,2023-11-13,2023-12-01,440.61,31,22351,30624514,-25040527,0.135522150653558,99.0078307854943,0.538539382695227
405.48,406,701,794,66595,41288,2023-11-13,2023-12-08,440.61,93,-25307,28464419,-15251963,0.145051265581778,98.784334927054,-0.612938384034102
395.88,396,3421,3404,68420,40848,2023-11-13,2023-11-24,440.61,-17,-27572,21544370,-14129174,0.189599417388394,98.030130377449,-0.674990207598904
420.37,423,90,155,40410,40765,2023-11-13,2023-12-22,440.61,65,355,22794974,-7809504,0.178833281406682,98.4948041616543,0.0087084508769778
351.82,352,2352,2238,54096,40284,2023-11-13,2023-12-15,440.61,-114,-13812,302704033,-178564111,0.013308048657548,99.7269517714024,-0.342865653857611
370.49,371,766,766,39066,39066,2023-11-13,2023-12-29,440.61,0,0,120671117,-59187285,0.0323739441311379,99.2431768075869,0
404.85,406,324,339,60912,38985,2023-11-13,2023-12-22,440.61,15,-21927,22794974,-7809504,0.171024542515381,98.6658287041696,-0.562447095036553
199.99,200,38926,38926,38926,38926,2023-11-13,2023-12-15,440.61,0,0,302704033,-178564111,0.012859425629126,99.7398111970315,0
384.9,385,3890,3861,58350,38610,2023-11-13,2023-11-24,440.61,-29,-19740,21544370,-14129174,0.179211552716557,98.2093419301655,-0.511266511266511
343.74,344,1470,1470,38220,38220,2023-11-13,2023-12-29,440.61,0,0,120671117,-59187285,0.0316728650154121,99.2748496726023,0
434.11,510,5,5,37945,37945,2023-11-13,2023-12-15,440.61,0,0,302704033,-178564111,0.0125353466962232,99.7523465437278,0
338.78,339,1717,1717,61812,37774,2023-11-13,2023-12-29,440.61,0,-24038,120671117,-59187285,0.0313032653870271,99.3061529379893,-0.636363636363636
433.4,471,10,10,37600,37600,2023-11-13,2023-12-15,440.61,0,0,302704033,-178564111,0.0124213739828171,99.7647679177106,0
249.98,250,18728,18731,37456,37462,2023-11-13,2023-12-15,440.61,3,6,302704033,-178564111,0.0123757848974546,99.777143702608,0.000160162297795099
414.15,416,242,202,75020,37370,2023-11-13,2023-12-22,440.61,-40,-37650,22794974,-7809504,0.163939647397711,98.8297683515673,-1.00749264115601
360.65,361,1064,1057,50008,36995,2023-11-13,2023-12-29,440.61,-7,-13013,120671117,-59187285,0.0306577090854309,99.3368106470747,-0.351750236518448
408.82,409,1849,1955,68413,35190,2023-11-13,2023-11-24,440.61,106,-33223,21544370,-14129174,0.163337335925813,98.3726792660913,-0.94410343847684
336.78,337,1599,1599,35178,35178,2023-11-13,2023-12-29,440.61,0,0,120671117,-59187285,0.0291519635141854,99.3659626105889,0
367.52,368,713,713,34224,34224,2023-11-13,2023-12-29,440.61,0,0,120671117,-59187285,0.0283613849368777,99.3943239955258,0
350.72,351,1205,1205,39765,33740,2023-11-13,2023-12-29,440.61,0,-6025,120671117,-59187285,0.0279602947571953,99.422284290283,-0.178571428571429
346.74,347,1944,1296,66096,33696,2023-11-13,2023-12-29,440.61,-648,-32400,120671117,-59187285,0.0279238320135878,99.4502081222966,-0.961538461538461
421.65,422.5,447,394,84483,33490,2023-11-13,2023-12-01,440.61,-53,-50993,30624514,-25040527,0.109356837466874,99.1171876229611,-1.52263362197671
149.99,150,32876,32876,32876,32876,2023-11-13,2023-12-15,440.61,0,0,302704033,-178564111,0.0108607736983802,99.7880044763064,0
345.85,346,2187,2187,34992,32805,2023-11-13,2023-12-15,440.61,0,-2187,302704033,-178564111,0.0108373184443169,99.7988417947507,-0.0666666666666667
355.8,356,1523,1615,35029,32300,2023-11-13,2023-12-15,440.61,92,-2729,302704033,-178564111,0.0106704888203455,99.8095122835711,-0.0844891640866873
440.48,452,10,28,14740,32256,2023-11-13,2023-11-17,440.61,18,17516,63077977,-98136508,0.0511367065560774,99.3759866458622,0.543030753968254
239.99,240,31852,31846,63704,31846,2023-11-13,2023-12-15,440.61,-6,-31858,302704033,-178564111,0.0105205073366168,99.8200327909077,-1.00037681341456
387.82,388,1767,1766,47709,31788,2023-11-13,2023-12-01,440.61,-1,-15921,30624514,-25040527,0.103799198250134,99.2209868212113,-0.500849377123443
434.26,466,10,10,31740,31740,2023-11-13,2023-12-15,440.61,0,0,302704033,-178564111,0.0104854896333674,99.830518280541,0
269.94,270,5305,5243,42440,31458,2023-11-13,2023-12-29,440.61,-62,-10982,120671117,-59187285,0.0260692042819161,99.4762773265785,-0.349100387818679
378.45,379,610,571,47580,31405,2023-11-13,2023-12-29,440.61,-39,-16175,120671117,-59187285,0.0260252832498435,99.5023026098283,-0.515045374940296
393.79,394,1455,1490,50925,31290,2023-11-13,2023-12-01,440.61,35,-19635,30624514,-25040527,0.102173049995177,99.3231598712065,-0.62751677852349
366.6,367,781,782,40612,31280,2023-11-13,2023-12-29,440.61,1,-9332,120671117,-59187285,0.0259216959100495,99.5282243057384,-0.298337595907928
274.93,275,4431,4426,31017,30982,2023-11-13,2023-12-29,440.61,-5,-34.9999999999964,120671117,-59187285,0.0256747436919806,99.5538990494304,-0.00112968820605501
339.95,340,6156,6156,30780,30780,2023-11-13,2023-11-24,440.61,0,0,21544370,-14129174,0.142867951116695,98.515547217208,0
279.96,280,7612,7642,38060,30568,2023-11-13,2023-12-15,440.61,30,-7492,302704033,-178564111,0.0100983127634775,99.8406165933045,-0.245092907615807
437,452,20,20,34200,30000,2023-11-13,2023-12-22,440.61,0,-4200,22794974,-7809504,0.131607958842155,98.9613763104095,-0.14
412.28,412.5,1259,1361,59173,29942,2023-11-13,2023-11-24,440.61,102,-29231,21544370,-14129174,0.138978303844578,98.6545255210526,-0.97625409124307
374.91,375,3418,3288,41016,29592,2023-11-13,2023-11-24,440.61,-130,-11424,21544370,-14129174,0.137353749494648,98.7918792705472,-0.386050283860503
440.16,447,13,43,15860,29412,2023-11-13,2023-11-17,440.61,30,13552,63077977,-98136508,0.0466280014021376,99.4226146472643,0.460764313885489
369.89,370,2688,2666,43008,29326,2023-11-13,2023-12-01,440.61,-22,-13682,30624514,-25040527,0.0957598869977169,99.4189197582042,-0.466548455295642
412.32,414,164,172,44280,28896,2023-11-13,2023-12-22,440.61,8,-15384,22794974,-7809504,0.126764785956764,99.0881410963662,-0.532392026578073
380.39,381,482,473,40970,28853,2023-11-13,2023-12-29,440.61,-9,-12117,120671117,-59187285,0.0239104441206092,99.577809493551,-0.41995633036426
347.84,348,1775,1774,37275,28384,2023-11-13,2023-12-15,440.61,-1,-8891,302704033,-178564111,0.00937681593426276,99.8499934092388,-0.313239853438557
406.8,407,1395,1405,44640,28100,2023-11-13,2023-11-24,440.61,10,-16540,21544370,-14129174,0.130428506380089,98.9223077769273,-0.588612099644128
438.75,447,8,34,10040,28050,2023-11-13,2023-12-08,440.61,26,18010,28464419,-15251963,0.0985440805940919,98.8828790076481,0.642067736185383
439.38,448,26,32,34684,27584,2023-11-13,2023-12-01,440.61,6,-7100,30624514,-25040527,0.0900716334633098,99.5089913916675,-0.257395591647332
389.39,390,340,449,30940,27389,2023-11-13,2023-12-22,440.61,109,-3551,22794974,-7809504,0.120153679490926,99.2082947758572,-0.12965058965278
437.55,457,14,14,27230,27230,2023-11-13,2023-12-15,440.61,0,0,302704033,-178564111,0.0089955854668114,99.8589889947056,0
437.46,444,12,41,11184,26814,2023-11-13,2023-12-08,440.61,29,15630,28464419,-15251963,0.0942018173636356,98.9770808250118,0.58290445289774
328.8,329,1339,1339,26780,26780,2023-11-13,2023-12-29,440.61,0,0,120671117,-59187285,0.0221925516774656,99.6000020452284,0
389.71,390,892,921,39248,26709,2023-11-13,2023-12-08,440.61,29,-12539,28464419,-15251963,0.093832935778524,99.0709137607903,-0.469467220787001
440.77,470,9,9,32490,26307,2023-11-13,2023-11-17,440.61,0,-6183,63077977,-98136508,0.0417055226739437,99.4643201699382,-0.235032500855286
437.5,475,7,7,26250,26250,2023-11-13,2023-12-15,440.61,0,0,302704033,-178564111,0.00867183688959968,99.8676608315952,0
421.45,465,6,6,26130,26130,2023-11-13,2023-12-29,440.61,0,0,120671117,-59187285,0.0216538975105368,99.621655942739,0
438.23,446,32,33,37440,25641,2023-11-13,2023-12-08,440.61,1,-11799,28464419,-15251963,0.0900808830842463,99.1609946438745,-0.46016146016146
439.36,450,13,24,16900,25536,2023-11-13,2023-12-08,440.61,11,8636,28464419,-15251963,0.0897120014991348,99.2507066453737,0.338189223057644
438.2,448,5,26,6560,25480,2023-11-13,2023-12-08,440.61,21,18920,28464419,-15251963,0.0895152646537419,99.3402219100274,0.7425431711146
331.51,332,520,520,25480,25480,2023-11-13,2023-12-29,440.61,0,0,120671117,-59187285,0.0211152433436081,99.6427711860826,0
352.55,353,565,565,25425,25425,2023-11-13,2023-12-29,440.61,0,0,120671117,-59187285,0.0210696649140987,99.6638408509967,0
348.73,349,543,936,17376,25272,2023-11-13,2023-12-29,440.61,393,7896,120671117,-59187285,0.0209428740101909,99.6847837250069,0.312440645773979
401.84,402,1493,1564,35832,25024,2023-11-13,2023-11-24,440.61,71,-10808,21544370,-14129174,0.116150994436133,99.0384587713635,-0.43190537084399
402.85,403,1625,1630,45500,24450,2023-11-13,2023-11-24,440.61,5,-21050,21544370,-14129174,0.113486725302248,99.1519454966657,-0.860940695296524
383.76,384,1018,1018,24432,24432,2023-11-13,2023-12-01,440.61,0,0,30624514,-25040527,0.0797792252311335,99.5887706168986,0
437.8,450,6,20,8910,24400,2023-11-13,2023-12-22,440.61,14,15490,22794974,-7809504,0.107041139858286,99.3153359157155,0.634836065573771
284.92,285,2987,2987,23896,23896,2023-11-13,2023-12-29,440.61,0,0,120671117,-59187285,0.0198025845737386,99.7045863095806,0
329.98,330,11906,11895,23812,23790,2023-11-13,2023-11-17,440.61,-11,-22,63077977,-98136508,0.037715223492345,99.5020353934306,-0.000924758301807482
362.59,363,579,579,25476,23739,2023-11-13,2023-12-29,440.61,0,-1737,120671117,-59187285,0.0196724788749573,99.7242587884556,-0.0731707317073171
269.97,270,7893,7898,23679,23694,2023-11-13,2023-12-15,440.61,5,15,302704033,-178564111,0.00782744774332095,99.8754882793385,0.000633071663712332
373.49,374,504,463,29232,23613,2023-11-13,2023-12-29,440.61,-41,-5619,120671117,-59187285,0.0195680628364449,99.743826851292,-0.237962139499428
375.51,376,474,474,32232,23226,2023-11-13,2023-12-29,440.61,0,-9006,120671117,-59187285,0.0192473564324427,99.7630742077245,-0.387755102040817
391.7,392,756,770,37800,23100,2023-11-13,2023-12-08,440.61,14,-14700,28464419,-15251963,0.0811539487245462,99.4213758587519,-0.636363636363636
337.78,338,1041,1045,26025,22990,2023-11-13,2023-12-29,440.61,4,-3035,120671117,-59187285,0.0190517835349117,99.7821259912594,-0.132013919095259
383.95,384,4597,4594,36776,22970,2023-11-13,2023-11-17,440.61,-3,-13806,63077977,-98136508,0.0364152452130797,99.5384506386437,-0.601044841097083
369.92,370,2857,2856,28570,22848,2023-11-13,2023-11-24,440.61,-1,-5722,21544370,-14129174,0.106050907963426,99.2579964046291,-0.250437675070028
349.78,350,1031,1036,29899,22792,2023-11-13,2023-12-22,440.61,5,-7107,22794974,-7809504,0.0999869532643468,99.4153228689798,-0.311819936819937
438.66,447.5,21,25,23562,22100,2023-11-13,2023-12-01,440.61,4,-1462,30624514,-25040527,0.072164410511135,99.6609350274097,-0.0661538461538462
438.12,449,19,20,30704,21760,2023-11-13,2023-12-15,440.61,1,-8944,302704033,-178564111,0.00718853983686435,99.8826768191754,-0.411029411764706
435.99,445,12,24,16380,21624,2023-11-13,2023-12-22,440.61,12,5244,22794974,-7809504,0.0948630167334255,99.5101858857132,0.242508324084351
438.52,455,0,13,0,21424,2023-11-13,2023-12-22,440.61,13,21424,22794974,-7809504,0.0939856303411445,99.6041715160544,1
434.13,540,2,2,21174,21174,2023-11-13,2023-12-15,440.61,0,0,302704033,-178564111,0.00699495140191938,99.8896717705773,0
219.99,220,20796,20796,20796,20796,2023-11-13,2023-12-15,440.61,0,0,302704033,-178564111,0.00687007695070914,99.896541847528,0
394.67,395,625,630,33125,20790,2023-11-13,2023-12-08,440.61,5,-12335,28464419,-15251963,0.0730385538520916,99.494414412604,-0.593314093314093
439.49,480,20,5,86340,20255,2023-11-13,2023-12-01,440.61,-15,-66085,30624514,-25040527,0.0661398251087348,99.7270748525185,-3.26265119723525
299.99,300,19526,19526,19526,19526,2023-11-13,2023-11-17,440.61,0,0,63077977,-98136508,0.0309553364401652,99.5694059750838,0
314.84,315,1220,1220,19520,19520,2023-11-13,2023-12-29,440.61,0,0,120671117,-59187285,0.0161761989822304,99.7983021902416,0
393.86,394,1079,1391,20501,19474,2023-11-13,2023-11-24,440.61,312,-1027,21544370,-14129174,0.0903902040301016,99.3483866086592,-0.0527369826435247
279.93,280,2807,2781,22456,19467,2023-11-13,2023-12-29,440.61,-26,-2989,120671117,-59187285,0.0161322779501577,99.8144344681918,-0.153541891405969
254.98,255,9650,9650,19300,19300,2023-11-13,2023-12-15,440.61,0,0,302704033,-178564111,0.00637586483692472,99.9029177123649,0
330.81,331,1009,1009,25225,19171,2023-11-13,2023-12-29,440.61,0,-6054,120671117,-59187285,0.0158869831295255,99.8303214513213,-0.315789473684211
294.91,295,2097,2097,25164,18873,2023-11-13,2023-12-29,440.61,0,-6291,120671117,-59187285,0.0156400309114566,99.8459614822328,-0.333333333333333
397.63,398,509,510,31558,18870,2023-11-13,2023-12-08,440.61,1,-12688,28464419,-15251963,0.06629329058148,99.5607077031855,-0.672390037095919
209.99,210,18786,18786,18786,18786,2023-11-13,2023-11-17,440.61,0,0,63077977,-98136508,0.0297821853100964,99.5991881603939,0
416.11,463,4,4,18756,18756,2023-11-13,2023-12-15,440.61,0,0,302704033,-178564111,0.00619615134100311,99.9091138637059,0
379.56,380,407,421,26862,18524,2023-11-13,2023-12-22,440.61,14,-8338,22794974,-7809504,0.0812635276530695,99.6854350437074,-0.450118764845606
438.74,451,14,15,21420,18390,2023-11-13,2023-12-15,440.61,1,-3030,302704033,-178564111,0.00607524115808526,99.915189104864,-0.164763458401305
405.7,407,133,141,25403,18330,2023-11-13,2023-12-22,440.61,8,-7073,22794974,-7809504,0.0804124628525569,99.76584750656,-0.385870158210584
357.63,358,487,487,18019,18019,2023-11-13,2023-12-29,440.61,0,0,120671117,-59187285,0.0149323222059841,99.8608938044387,0
384.75,385,722,716,26714,17900,2023-11-13,2023-12-08,440.61,-6,-8814,28464419,-15251963,0.0628855273666397,99.6235932305522,-0.492402234636872
437.33,473,5,5,17835,17835,2023-11-13,2023-12-15,440.61,0,0,302704033,-178564111,0.0058918937495623,99.9210809986136,0
408.4,409,244,294,28060,17640,2023-11-13,2023-12-08,440.61,50,-10420,28464419,-15251963,0.0619721062987444,99.6855653368509,-0.590702947845805
405.84,406,1064,1038,31920,16608,2023-11-13,2023-11-24,440.61,-26,-15312,21544370,-14129174,0.0770874246961039,99.4254740333553,-0.921965317919075
439.25,453,10,12,16440,16500,2023-11-13,2023-12-15,440.61,2,60,302704033,-178564111,0.00545086890203409,99.9265318675156,0.00363636363636364
406.95,407.5,294,292,31164,16060,2023-11-13,2023-12-08,440.61,-2,-15104,28464419,-15251963,0.0564213167323036,99.7419866535832,-0.940473225404732
159.98,160,7932,7932,15864,15864,2023-11-13,2023-12-15,440.61,0,0,302704033,-178564111,0.0052407626825375,99.9317726301982,0
440.7,455,1,11,1745,15730,2023-11-13,2023-12-01,440.61,10,13985,30624514,-25040527,0.0513640804226314,99.7784389329411,0.889065479974571
329.94,330,2592,2592,15552,15552,2023-11-13,2023-12-01,440.61,0,0,30624514,-25040527,0.0507828467090123,99.8292217796501,0
381.9,382,1553,1525,18636,15250,2023-11-13,2023-11-24,440.61,-28,-3386,21544370,-14129174,0.0707841538183758,99.4962581871737,-0.222032786885246
434.56,444,13,16,16965,15104,2023-11-13,2023-12-22,440.61,3,-1861,22794974,-7809504,0.0662602203450638,99.8321077269051,-0.123212394067797
381.83,382,898,886,17062,15062,2023-11-13,2023-12-01,440.61,-12,-2000,30624514,-25040527,0.0491828213175889,99.8784046009677,-0.132784490771478
439.69,590,1,1,15581,15031,2023-11-13,2023-12-15,440.61,0,-550,302704033,-178564111,0.00496557639190754,99.9367382065901,-0.0365910451733085
264.98,265,7514,7515,22542,15030,2023-11-13,2023-12-15,440.61,1,-7512,302704033,-178564111,0.00496524603621651,99.9417034526263,-0.499800399201597
309.99,310,14945,15009,14945,15009,2023-11-13,2023-11-17,440.61,64,63.9999999999982,63077977,-98136508,0.023794358528651,99.6229825189226,0.0042641082017455
189.99,190,14974,14974,14974,14974,2023-11-13,2023-12-15,440.61,0,0,302704033,-178564111,0.00494674611751869,99.9466501987438,0
434.63,453,8,8,14696,14696,2023-11-13,2023-11-17,440.61,0,0,63077977,-98136508,0.0232981473074192,99.64628066623,0
347.7,348,487,487,14610,14610,2023-11-13,2023-12-29,440.61,0,0,120671117,-59187285,0.0121072882751222,99.8730010927139,0
416.11,464,3,3,14367,14367,2023-11-13,2023-12-15,440.61,0,0,302704033,-178564111,0.00474622021306205,99.9513964189569,0
314.99,315,14254,14331,14254,14331,2023-11-13,2023-11-17,440.61,77,77,63077977,-98136508,0.0227194984392096,99.6690001646692,0.00537296769241504
351.71,352,294,484,9702,14036,2023-11-13,2023-12-29,440.61,190,4334,120671117,-59187285,0.0116316152107882,99.8846327079247,0.308777429467084
439.6,457,5,8,13880,13920,2023-11-13,2023-12-29,440.61,3,39.9999999999964,120671117,-59187285,0.0115354861594594,99.8961681940841,0.00287356321839054
209.99,210,13848,13850,13848,13850,2023-11-13,2023-12-15,440.61,2,2.00000000000182,302704033,-178564111,0.00457542632079831,99.9559718452777,0.000144404332130095
279.99,280,13485,13485,13485,13485,2023-11-13,2023-11-17,440.61,0,0,63077977,-98136508,0.0213783013364554,99.6903784660057,0
274.99,275,13482,13482,13482,13482,2023-11-13,2023-11-17,440.61,0,0,63077977,-98136508,0.0213735453183605,99.711752011324,0
214.99,215,13304,13304,13304,13304,2023-11-13,2023-11-17,440.61,0,0,63077977,-98136508,0.021091354911398,99.7328433662354,0
434.81,448,10,10,13190,13190,2023-11-13,2023-12-29,440.61,0,0,120671117,-59187285,0.0109305360950624,99.9070987301792,0
437.44,480,3,3,12768,12768,2023-11-13,2023-12-29,440.61,0,0,120671117,-59187285,0.0105808252359179,99.9176795554151,0
393.67,394,382,383,19864,12639,2023-11-13,2023-12-08,440.61,1,-7225,28464419,-15251963,0.0444028033735732,99.7863894569568,-0.571643326212517
184.99,185,12449,12449,12449,12449,2023-11-13,2023-12-15,440.61,0,0,302704033,-178564111,0.00411259799766196,99.9600844432753,0
179.99,180,11904,11904,11904,11904,2023-11-13,2023-12-15,440.61,0,0,302704033,-178564111,0.00393255414604932,99.9640169974214,0
440.66,464,0,5,0,11670,2023-11-13,2023-12-29,440.61,5,11670,120671117,-59187285,0.00967091404316743,99.9273504694582,1
154.99,155,11410,11410,11410,11410,2023-11-13,2023-12-15,440.61,0,0,302704033,-178564111,0.00376935843467933,99.9677863558561,0
304.99,305,11304,11304,11304,11304,2023-11-13,2023-11-17,440.61,0,0,63077977,-98136508,0.0179206761814825,99.7507640424169,0
334.9,335,1128,1128,11280,11280,2023-11-13,2023-12-08,440.61,0,0,28464419,-15251963,0.0396284217148434,99.8260178786716,0
391.87,392,836,836,15048,10868,2023-11-13,2023-11-24,440.61,0,-4180,21544370,-14129174,0.050444733357253,99.546702920531,-0.384615384615385
440.8,495,6,2,36600,10840,2023-11-13,2023-11-17,440.61,-4,-25760,63077977,-98136508,0.0171850787161421,99.7679491211331,-2.37638376383764
284.99,285,10510,10486,10510,10486,2023-11-13,2023-11-17,440.61,-24,-24,63077977,-98136508,0.016623868580947,99.784572989714,-0.00228876597367919
377.95,378,762,2079,5334,10395,2023-11-13,2023-11-17,440.61,1317,5061,63077977,-98136508,0.0164796026987359,99.8010525924127,0.486868686868687
334.99,335,10391,10390,10391,10390,2023-11-13,2023-11-17,440.61,-1,-1,63077977,-98136508,0.0164716760019111,99.8175242684146,-9.62463907603465e-05
259.98,260,5151,5150,10302,10300,2023-11-13,2023-12-15,440.61,-1,-2,302704033,-178564111,0.0034026636176334,99.9711890194737,-0.000194174757281553
397.86,398,796,730,15920,10220,2023-11-13,2023-11-24,440.61,-66,-5700,21544370,-14129174,0.0474369870179541,99.5941399075489,-0.557729941291585
417.61,468,2,2,10078,10078,2023-11-13,2023-12-15,440.61,0,0,302704033,-178564111,0.00332932465422421,99.9745183441279,0
440,460,0,5,0,10000,2023-11-13,2023-11-24,440.61,5,10000,21544370,-14129174,0.0464158385694267,99.6405557461184,1
289.99,290,9986,9986,9986,9986,2023-11-13,2023-11-17,440.61,0,0,63077977,-98136508,0.0158311988984682,99.8333554673131,0
164.99,165,9926,9926,9926,9926,2023-11-13,2023-12-15,440.61,0,0,302704033,-178564111,0.00327911058918729,99.9777974547171,0
339.99,340,9696,9673,19392,9673,2023-11-13,2023-11-17,440.61,-23,-9719,63077977,-98136508,0.0153349876772364,99.8486904549903,-1.00475550501396
387.89,388,709,869,11344,9559,2023-11-13,2023-11-24,440.61,160,-1785,21544370,-14129174,0.044368900088515,99.6849246462069,-0.186735014122816
436.08,452,6,6,9552,9552,2023-11-13,2023-12-08,440.61,0,0,28464419,-15251963,0.0335576847712929,99.8595755634429,0
294.99,295,9499,9509,9499,9509,2023-11-13,2023-11-17,440.61,10,10,63077977,-98136508,0.0150749920213833,99.8637654470117,0.00105163529288043
435.78,451,6,6,9132,9132,2023-11-13,2023-12-29,440.61,0,0,120671117,-59187285,0.00756767669599014,99.9349181461542,0
324.99,325,8923,8923,8923,8923,2023-11-13,2023-11-17,440.61,0,0,63077977,-98136508,0.0141459831535181,99.8779114301652,0
417.62,462,2,2,8876,8876,2023-11-13,2023-12-15,440.61,0,0,302704033,-178564111,0.00293223711360331,99.9807296918307,0
395.66,396,187,256,10659,8704,2023-11-13,2023-12-08,440.61,69,-1955,28464419,-15251963,0.0305785268267728,99.8901540902697,-0.224609375
364.84,365,540,540,11340,8640,2023-11-13,2023-12-08,440.61,0,-2700,28464419,-15251963,0.0303536847177524,99.9205077749875,-0.3125
244.99,245,7077,8506,14154,8506,2023-11-13,2023-12-15,440.61,1429,-5648,302704033,-178564111,0.00281000550792133,99.9835396973386,-0.664001881025159
385.89,386,728,758,10920,8338,2023-11-13,2023-11-24,440.61,30,-2582,21544370,-14129174,0.038701526199188,99.7236261724061,-0.309666586711442
354.94,355,1306,1356,9142,8136,2023-11-13,2023-11-24,440.61,50,-1006,21544370,-14129174,0.0377639262600856,99.7613900986662,-0.123647984267453
326.81,327,408,409,9384,7771,2023-11-13,2023-12-29,440.61,1,-1613,120671117,-59187285,0.00643981774031312,99.9413579638946,-0.207566593745978
319.99,320,7709,7710,7709,7710,2023-11-13,2023-11-17,440.61,1,1.00000000000091,63077977,-98136508,0.0122229665038243,99.8901343966691,0.000129701686122038
434.8,454,4,4,7680,7680,2023-11-13,2023-12-29,440.61,0,0,120671117,-59187285,0.00636440615694309,99.9477223700515,0
435.87,455,3,4,6303,7652,2023-11-13,2023-11-24,440.61,1,1349,21544370,-14129174,0.0355173996733253,99.7969074983395,0.176293779404077
437.94,453,3,5,5610,7530,2023-11-13,2023-12-29,440.61,2,1920,120671117,-59187285,0.0062401013491903,99.9539624714007,0.254980079681275
439.27,458,5,4,11080,7492,2023-11-13,2023-12-29,440.61,-1,-3588,120671117,-59187285,0.00620861079789292,99.9601710821986,-0.478910838227443
314.96,315,1813,1814,7252,7256,2023-11-13,2023-12-01,440.61,1,4,30624514,-25040527,0.0236934372248324,99.9020980381925,0.000551267916207277
234.99,235,7239,7239,7239,7239,2023-11-13,2023-11-17,440.61,0,0,63077977,-98136508,0.0114762716629292,99.901610668332,0
325.82,326,395,395,7110,7110,2023-11-13,2023-12-29,440.61,0,0,120671117,-59187285,0.00589204788748247,99.9660631300861,0
234.99,235,6682,6682,6682,6682,2023-11-13,2023-12-15,440.61,0,0,302704033,-178564111,0.00220743672747829,99.9857471340661,0
361.64,362,180,180,7560,6480,2023-11-13,2023-12-29,440.61,0,-1080,120671117,-59187285,0.00536996769492073,99.971433097781,-0.166666666666667
169.99,170,6353,6353,6353,6353,2023-11-13,2023-12-15,440.61,0,0,302704033,-178564111,0.00209874970512864,99.9878458837712,0
224.99,225,6327,6327,6327,6327,2023-11-13,2023-12-15,440.61,0,0,302704033,-178564111,0.0020901604571618,99.9899360442284,0
319.96,320,1573,1575,7865,6300,2023-11-13,2023-12-01,440.61,2,-1565,30624514,-25040527,0.020571755032586,99.9226697932251,-0.248412698412699
229.99,230,6257,6252,12514,6252,2023-11-13,2023-12-15,440.61,-5,-6262,302704033,-178564111,0.00206538378033437,99.9920014280087,-1.00159948816379
377.91,378,662,672,8606,6048,2023-11-13,2023-11-24,440.61,10,-2558,21544370,-14129174,0.0280722991667893,99.8249797975063,-0.422949735449735
433.91,464,2,2,6018,6018,2023-11-13,2023-11-17,440.61,0,0,63077977,-98136508,0.00954057229831578,99.9111512406303,0
440.13,500,0,1,0,5987,2023-11-13,2023-12-08,440.61,1,5987,28464419,-15251963,0.0210332766672666,99.9415410516547,1
249.99,250,5932,5932,5932,5932,2023-11-13,2023-11-17,440.61,0,0,63077977,-98136508,0.00940423311292941,99.9205554737432,0
412.73,472,1,1,5927,5927,2023-11-13,2023-12-15,440.61,0,0,302704033,-178564111,0.00195801818074885,99.9939594461895,0
436.89,495,1,1,5811,5811,2023-11-13,2023-12-29,440.61,0,0,120671117,-59187285,0.00481556825234327,99.9762486660333,0
174.99,175,5755,5755,5755,5755,2023-11-13,2023-12-15,440.61,0,0,302704033,-178564111,0.00190119700189128,99.9958606431914,0
204.99,205,5662,5662,5662,5662,2023-11-13,2023-12-15,440.61,0,0,302704033,-178564111,0.00187047392262527,99.997731117114,0
304.97,305,1879,1879,5637,5637,2023-11-13,2023-11-24,440.61,0,0,21544370,-14129174,0.0261646082015858,99.8511444057078,0
435.02,462,2,2,5396,5396,2023-11-13,2023-12-29,440.61,0,0,120671117,-59187285,0.0044716582842272,99.9807203243176,0
435,461,2,2,5200,5200,2023-11-13,2023-12-29,440.61,0,0,120671117,-59187285,0.00430923333543022,99.985029557653,0
434.55,447.5,4,4,5180,5180,2023-11-13,2023-11-24,440.61,0,0,21544370,-14129174,0.024043404378963,99.8751878100868,0
436.81,454,3,3,5157,5157,2023-11-13,2023-11-17,440.61,0,0,63077977,-98136508,0.00817559510508715,99.9287310688483,0
436.15,449,3,4,6294,5140,2023-11-13,2023-12-29,440.61,1,-1154,120671117,-59187285,0.0042595114123291,99.9892890690653,-0.224513618677043
435.19,485,0,1,0,4981,2023-11-13,2023-12-22,440.61,1,4981,22794974,-7809504,0.0218513080997592,99.8539590350048,1
324.95,325,938,948,4690,4740,2023-11-13,2023-12-01,440.61,10,50,30624514,-25040527,0.0154777966435647,99.9381475898687,0.0105485232067511
354.91,355,514,516,6168,4644,2023-11-13,2023-12-01,440.61,2,-1524,30624514,-25040527,0.0151643222811634,99.9533119121499,-0.328165374677003
383.89,384,422,422,5908,4642,2023-11-13,2023-11-24,440.61,0,-1266,21544370,-14129174,0.0215462322639279,99.8967340423508,-0.272727272727273
324.97,325,1535,1544,4605,4632,2023-11-13,2023-11-24,440.61,9,27,21544370,-14129174,0.0214998164253585,99.9182338587761,0.00582901554404145
376.95,377,2,913,14,4565,2023-11-13,2023-11-17,440.61,911,4551,63077977,-98136508,0.00723707420103216,99.9359681430494,0.996933187294633
319.98,320,1023,2273,2046,4546,2023-11-13,2023-11-24,440.61,1250,2500,21544370,-14129174,0.0211006402136614,99.9393344989898,0.54993400791905
435.85,447,2,4,2824,4460,2023-11-13,2023-12-22,440.61,2,1636,22794974,-7809504,0.0195657165478671,99.8735247515527,0.366816143497758
433.96,456,13,2,28652,4408,2023-11-13,2023-11-17,440.61,-11,-24244,63077977,-98136508,0.00698817592073379,99.9429563189701,-5.5
229.99,230,4321,4322,4321,4322,2023-11-13,2023-11-17,440.61,1,1,63077977,-98136508,0.00685183673534743,99.9498081557054,0.0002313743637205
435.22,478,1,1,4278,4278,2023-11-13,2023-12-22,440.61,0,0,22794974,-7809504,0.0187672949308913,99.8922920464836,0
436.87,478,1,1,4113,4113,2023-11-13,2023-12-01,440.61,0,0,30624514,-25040527,0.0134304172141311,99.966742329364,0
299.91,300,447,447,4470,4023,2023-11-13,2023-12-22,440.61,0,-447.000000000001,22794974,-7809504,0.017648627280733,99.9099406737643,-0.111111111111111
422.97,463,1,1,4003,4003,2023-11-13,2023-12-29,440.61,0,0,120671117,-59187285,0.00331728096956292,99.9926063500349,0
219.99,220,3881,3881,3881,3881,2023-11-13,2023-11-17,440.61,0,0,63077977,-98136508,0.00615270207540106,99.9559608577808,0
194.99,195,3768,3768,3768,3768,2023-11-13,2023-12-15,440.61,0,0,302704033,-178564111,0.00124478024380997,99.9989758973578,0
435.22,472,1,1,3678,3678,2023-11-13,2023-12-22,440.61,0,0,22794974,-7809504,0.0161351357540482,99.9260758095184,0
269.99,270,3661,3661,3661,3661,2023-11-13,2023-11-17,440.61,0,0,63077977,-98136508,0.00580392741511035,99.961764785196,0
374.61,375,92,87,4968,3393,2023-11-13,2023-12-22,440.61,-5,-1575,22794974,-7809504,0.0148848601450478,99.9409606696634,-0.464190981432361
436.94,470,1,1,3306,3306,2023-11-13,2023-11-24,440.61,0,0,21544370,-14129174,0.0153450762310525,99.9546795752208,0
254.99,255,3220,3220,3220,3220,2023-11-13,2023-11-17,440.61,0,0,63077977,-98136508,0.00510479275516398,99.9668695779511,0
214.99,215,2863,3100,2863,3100,2023-11-13,2023-12-15,440.61,237,237,302704033,-178564111,0.00102410264220034,100,0.0764516129032258
440.63,456,0,2,0,3074,2023-11-13,2023-12-08,440.61,2,3074,28464419,-15251963,0.0107994475488855,99.9523404992036,1
259.99,260,3046,3046,3046,3046,2023-11-13,2023-11-17,440.61,0,0,63077977,-98136508,0.00482894370566133,99.9716985216568,0
364.7,365,74,95,3034,2850,2023-11-13,2023-12-22,440.61,21,-184,22794974,-7809504,0.0125027560900048,99.9534634257534,-0.0645614035087719
224.99,225,2834,2834,2834,2834,2023-11-13,2023-11-17,440.61,0,0,63077977,-98136508,0.00449285176029028,99.9761913734171,0
324.93,325,173,402,1211,2814,2023-11-13,2023-12-08,440.61,229,1603,28464419,-15251963,0.00988602648099018,99.9622265256846,0.569651741293532
439.7,467,0,1,0,2730,2023-11-13,2023-12-29,440.61,1,2730,120671117,-59187285,0.00226234750110086,99.994868697536,1
334.95,335,529,529,2645,2645,2023-11-13,2023-11-24,440.61,0,0,21544370,-14129174,0.0122769893016134,99.9669565645224,0
436.02,462,2,1,5306,2598,2023-11-13,2023-11-17,440.61,-1,-2708,63077977,-98136508,0.00411871167016025,99.9803100850872,-1.0423402617398
304.9,305,246,248,2460,2480,2023-11-13,2023-12-22,440.61,2,20,22794974,-7809504,0.0108795912642848,99.9643430170177,0.00806451612903226
299.99,300,2457,2466,4914,2466,2023-11-13,2023-11-24,440.61,9,-2448,21544370,-14129174,0.0114461457912206,99.9784027103136,-0.992700729927007
319.87,320,23,185,299,2405,2023-11-13,2023-12-22,440.61,162,2106,22794974,-7809504,0.0105505713671794,99.9748935883849,0.875675675675676
435.01,459,1,1,3662,2399,2023-11-13,2023-12-29,440.61,0,-1263,120671117,-59187285,0.00198804822532636,99.9968567457613,-0.526469362234264
436.56,460,1,1,2344,2344,2023-11-13,2023-12-01,440.61,0,0,30624514,-25040527,0.00765399901529866,99.9743963283793,0
437.25,460,1,1,2275,2275,2023-11-13,2023-12-22,440.61,0,0,22794974,-7809504,0.00998027021219678,99.9848738585971,0
439.45,462,0,1,0,2255,2023-11-13,2023-11-24,440.61,1,2255,21544370,-14129174,0.0104667715974057,99.9888694819111,1
435.59,456,1,1,2041,2041,2023-11-13,2023-12-29,440.61,0,0,120671117,-59187285,0.00169137408415636,99.9985481198455,0
440.71,460,10,1,23080,1929,2023-11-13,2023-12-08,440.61,-9,-21151,28464419,-15251963,0.00677688169219263,99.9690034073768,-10.9647485743909
314.95,315,316,352,1896,1760,2023-11-13,2023-12-08,440.61,36,-136,28464419,-15251963,0.00618315799806067,99.9751865653748,-0.0772727272727271
434.48,452,1,1,1752,1752,2023-11-13,2023-12-29,440.61,0,0,120671117,-59187285,0.00145188015455264,100,0
264.99,265,1731,1733,1731,1733,2023-11-13,2023-11-17,440.61,2,2.00000000000045,63077977,-98136508,0.00274739311947179,99.9830574782067,0.00115406809001757
440.75,458,1,1,2106,1725,2023-11-13,2023-11-17,440.61,0,-381,63077977,-98136508,0.00273471040455213,99.9857921886112,-0.220869565217391
309.97,310,557,562,2228,1686,2023-11-13,2023-12-01,440.61,5,-542,30624514,-25040527,0.00550539348967301,99.979901721869,-0.3214709371293
299.96,300,377,421,2262,1684,2023-11-13,2023-12-08,440.61,44,-578,28464419,-15251963,0.00591615799359896,99.9811027233685,-0.343230403800475
284.98,285,396,800,1188,1600,2023-11-13,2023-12-01,440.61,404,412,30624514,-25040527,0.0052245727066885,99.9851262945757,0.2575
239.99,240,1578,1578,1578,1578,2023-11-13,2023-11-17,440.61,0,0,63077977,-98136508,0.00250166551790334,99.9882938541292,0
439.24,455,1,1,2120,1576,2023-11-13,2023-12-08,440.61,0,-544,28464419,-15251963,0.00553673693462705,99.9866394603031,-0.345177664974619
435.25,451,0,1,0,1575,2023-11-13,2023-12-08,440.61,1,1575,28464419,-15251963,0.00553322377667361,99.9921726840797,1
289.98,290,515,716,1545,1432,2023-11-13,2023-12-01,440.61,201,-113,30624514,-25040527,0.00467599257248621,99.9898022871481,-0.0789106145251397
436.96,451,1,1,1404,1404,2023-11-13,2023-11-17,440.61,0,0,63077977,-98136508,0.00222581646840069,99.9905196705976,0
359.73,360,46,49,1656,1323,2023-11-13,2023-12-22,440.61,3,-333,22794974,-7809504,0.00580391098493905,99.990677769582,-0.251700680272109
309.99,310,777,1224,1554,1224,2023-11-13,2023-11-24,440.61,447,-330,21544370,-14129174,0.00568129864089783,99.994550780552,-0.269607843137255
304.94,305,204,204,1224,1224,2023-11-13,2023-12-08,440.61,0,0,28464419,-15251963,0.00430010533501492,99.9964727894148,0
386.95,387,1,243,8,1215,2023-11-13,2023-11-17,440.61,242,1207,63077977,-98136508,0.00192618732842368,99.992445857926,0.993415637860082
314.98,315,512,587,1024,1174,2023-11-13,2023-11-24,440.61,75,150,21544370,-14129174,0.0054492194480507,100,0.127768313458262
309.9,310,1,112,15,1120,2023-11-13,2023-12-22,440.61,111,1105,22794974,-7809504,0.0049133637967738,99.9955911333788,0.986607142857143
244.99,245,1103,1103,1103,1103,2023-11-13,2023-11-17,440.61,0,0,63077977,-98136508,0.00174862931954841,99.9941944872455,0
435.01,446,1,1,1099,1099,2023-11-13,2023-12-01,440.61,0,0,30624514,-25040527,0.00358862837790667,99.993390915526,0
299.98,300,406,406,1624,812,2023-11-13,2023-12-01,440.61,0,-812,30624514,-25040527,0.00265147064864442,99.9960423861747,-1
294.97,295,263,263,789,789,2023-11-13,2023-12-01,440.61,0,0,30624514,-25040527,0.00257636741598577,99.9986187535907,0
319.94,320,120,124,840,744,2023-11-13,2023-12-08,440.61,4,-96,28464419,-15251963,0.00261378951736201,99.9990865789321,-0.129032258064516
373.95,374,101,144,505,720,2023-11-13,2023-11-17,440.61,43,215,63077977,-98136508,0.00114144434276959,99.9953359315883,0.298611111111111
375.95,376,1,122,5,610,2023-11-13,2023-11-17,440.61,121,605,63077977,-98136508,0.000967057012624232,99.9963029886009,0.991803278688525
382.94,383,17,99,136,594,2023-11-13,2023-11-17,440.61,82,458,63077977,-98136508,0.000941691582784908,99.9972446801837,0.771043771043771
378.95,379,62,94,434,470,2023-11-13,2023-11-17,440.61,32,35.9999999999999,63077977,-98136508,0.000745109501530146,99.9979897896852,0.0765957446808509
304.97,305,137,141,411,423,2023-11-13,2023-12-01,440.61,4,12,30624514,-25040527,0.00138124640933077,100,0.0283687943262411
388.95,389,68,83,612,415,2023-11-13,2023-11-17,440.61,15,-197,63077977,-98136508,0.000657915836457469,99.9986477055217,-0.474698795180723
334.82,335,19,19,342,342,2023-11-13,2023-12-22,440.61,0,0,22794974,-7809504,0.00150033073080057,99.9970914641096,0
380.95,381,22,61,132,305,2023-11-13,2023-11-17,440.61,39,173,63077977,-98136508,0.000483528506312116,99.999131234028,0.567213114754098
372.96,373,64,73,384,292,2023-11-13,2023-11-17,440.61,9,-92,63077977,-98136508,0.000462919094567665,99.9995941531226,-0.315068493150685
309.95,310,42,52,252,260,2023-11-13,2023-12-08,440.61,10,8,28464419,-15251963,0.000913421067895326,100,0.0307692307692308
339.81,340,13,13,247,247,2023-11-13,2023-12-22,440.61,0,0,22794974,-7809504,0.00108357219446708,99.9981750363041,0
370.96,371,0,46,0,184,2023-11-13,2023-11-17,440.61,46,184,63077977,-98136508,0.000291702443152227,99.9998858555657,1
344.8,345,7,9,161,180,2023-11-13,2023-12-22,440.61,2,19,22794974,-7809504,0.000789647753052932,99.9989646840571,0.105555555555556
324.86,325,2,10,34,140,2023-11-13,2023-12-22,440.61,8,106,22794974,-7809504,0.000614170474596725,99.9995788545317,0.757142857142857
371.96,372,0,18,0,72,2023-11-13,2023-11-17,440.61,18,72,63077977,-98136508,0.000114144434276959,100,1
329.81,330,3,3,57,57,2023-11-13,2023-12-22,440.61,0,0,22794974,-7809504,0.000250055121800095,99.9998289096535,0
314.87,315,2,3,24,39,2023-11-13,2023-12-22,440.61,1,15,22794974,-7809504,0.000171090346494802,100,0.384615384615385
436.92,457,0,0,0,0,2023-11-13,2023-11-17,440.61,0,0,63077977,-98136508,0,100,
440.55,459,0,0,0,0,2023-11-13,2023-11-17,440.61,0,0,63077977,-98136508,0,100,
461,461,0,0,0,0,2023-11-13,2023-11-17,440.61,0,0,63077977,-98136508,0,100,
463,463,0,0,0,0,2023-11-13,2023-11-17,440.61,0,0,63077977,-98136508,0,100,
428.69,465,0,0,0,0,2023-11-13,2023-11-17,440.61,0,0,63077977,-98136508,0,100,
435.39,466,0,0,0,0,2023-11-13,2023-11-17,440.61,0,0,63077977,-98136508,0,100,
467,467,0,0,0,0,2023-11-13,2023-11-17,440.61,0,0,63077977,-98136508,0,100,
414.98,468,0,0,0,0,2023-11-13,2023-11-17,440.61,0,0,63077977,-98136508,0,100,
469,469,0,0,0,0,2023-11-13,2023-11-17,440.61,0,0,63077977,-98136508,0,100,
471,471,0,0,0,0,2023-11-13,2023-11-17,440.61,0,0,63077977,-98136508,0,100,
440.76,472,0,0,0,0,2023-11-13,2023-11-17,440.61,0,0,63077977,-98136508,0,100,
473,473,0,0,0,0,2023-11-13,2023-11-17,440.61,0,0,63077977,-98136508,0,100,
440.75,474,0,0,0,0,2023-11-13,2023-11-17,440.61,0,0,63077977,-98136508,0,100,
433.89,475,0,0,0,0,2023-11-13,2023-11-17,440.61,0,0,63077977,-98136508,0,100,
476,476,0,0,0,0,2023-11-13,2023-11-17,440.61,0,0,63077977,-98136508,0,100,
477,477,0,0,0,0,2023-11-13,2023-11-17,440.61,0,0,63077977,-98136508,0,100,
478,478,0,0,0,0,2023-11-13,2023-11-17,440.61,0,0,63077977,-98136508,0,100,
479,479,0,0,0,0,2023-11-13,2023-11-17,440.61,0,0,63077977,-98136508,0,100,
480,480,0,0,0,0,2023-11-13,2023-11-17,440.61,0,0,63077977,-98136508,0,100,
481,481,0,0,0,0,2023-11-13,2023-11-17,440.61,0,0,63077977,-98136508,0,100,
482,482,0,0,0,0,2023-11-13,2023-11-17,440.61,0,0,63077977,-98136508,0,100,
435.41,483,0,0,0,0,2023-11-13,2023-11-17,440.61,0,0,63077977,-98136508,0,100,
484,484,0,0,0,0,2023-11-13,2023-11-17,440.61,0,0,63077977,-98136508,0,100,
485,485,0,0,0,0,2023-11-13,2023-11-17,440.61,0,0,63077977,-98136508,0,100,
486,486,0,0,0,0,2023-11-13,2023-11-17,440.61,0,0,63077977,-98136508,0,100,
487,487,0,0,0,0,2023-11-13,2023-11-17,440.61,0,0,63077977,-98136508,0,100,
488,488,0,0,0,0,2023-11-13,2023-11-17,440.61,0,0,63077977,-98136508,0,100,
489,489,0,0,0,0,2023-11-13,2023-11-17,440.61,0,0,63077977,-98136508,0,100,
428.7,490,0,0,0,0,2023-11-13,2023-11-17,440.61,0,0,63077977,-98136508,0,100,
491,491,0,0,0,0,2023-11-13,2023-11-17,440.61,0,0,63077977,-98136508,0,100,
492,492,0,0,0,0,2023-11-13,2023-11-17,440.61,0,0,63077977,-98136508,0,100,
493,493,0,0,0,0,2023-11-13,2023-11-17,440.61,0,0,63077977,-98136508,0,100,
494,494,0,0,0,0,2023-11-13,2023-11-17,440.61,0,0,63077977,-98136508,0,100,
433.99,496,0,0,0,0,2023-11-13,2023-11-17,440.61,0,0,63077977,-98136508,0,100,
497,497,0,0,0,0,2023-11-13,2023-11-17,440.61,0,0,63077977,-98136508,0,100,
498,498,0,0,0,0,2023-11-13,2023-11-17,440.61,0,0,63077977,-98136508,0,100,
499,499,0,0,0,0,2023-11-13,2023-11-17,440.61,0,0,63077977,-98136508,0,100,
433.98,500,0,0,0,0,2023-11-13,2023-11-17,440.61,0,0,63077977,-98136508,0,100,
414.65,505,0,0,0,0,2023-11-13,2023-11-17,440.61,0,0,63077977,-98136508,0,100,
420.86,510,0,0,0,0,2023-11-13,2023-11-17,440.61,0,0,63077977,-98136508,0,100,
515,515,0,0,0,0,2023-11-13,2023-11-17,440.61,0,0,63077977,-98136508,0,100,
520,520,0,0,0,0,2023-11-13,2023-11-17,440.61,0,0,63077977,-98136508,0,100,
525,525,0,0,0,0,2023-11-13,2023-11-17,440.61,0,0,63077977,-98136508,0,100,
530,530,0,0,0,0,2023-11-13,2023-11-17,440.61,0,0,63077977,-98136508,0,100,
535,535,0,0,0,0,2023-11-13,2023-11-17,440.61,0,0,63077977,-98136508,0,100,
540,540,0,0,0,0,2023-11-13,2023-11-17,440.61,0,0,63077977,-98136508,0,100,
545,545,0,0,0,0,2023-11-13,2023-11-17,440.61,0,0,63077977,-98136508,0,100,
550,550,0,0,0,0,2023-11-13,2023-11-17,440.61,0,0,63077977,-98136508,0,100,
560,560,0,0,0,0,2023-11-13,2023-11-17,440.61,0,0,63077977,-98136508,0,100,
435.4,451,0,0,0,0,2023-11-13,2023-11-24,440.61,0,0,21544370,-14129174,0,100,
452,452,0,0,0,0,2023-11-13,2023-11-24,440.61,0,0,21544370,-14129174,0,100,
453,453,0,0,0,0,2023-11-13,2023-11-24,440.61,0,0,21544370,-14129174,0,100,
424.09,454,0,0,0,0,2023-11-13,2023-11-24,440.61,0,0,21544370,-14129174,0,100,
433.98,456,0,0,0,0,2023-11-13,2023-11-24,440.61,0,0,21544370,-14129174,0,100,
433.97,457,0,0,0,0,2023-11-13,2023-11-24,440.61,0,0,21544370,-14129174,0,100,
458,458,0,0,0,0,2023-11-13,2023-11-24,440.61,0,0,21544370,-14129174,0,100,
436.94,459,0,0,0,0,2023-11-13,2023-11-24,440.61,0,0,21544370,-14129174,0,100,
464,464,0,0,0,0,2023-11-13,2023-11-24,440.61,0,0,21544370,-14129174,0,100,
436.92,465,0,0,0,0,2023-11-13,2023-11-24,440.61,0,0,21544370,-14129174,0,100,
422.99,466,0,0,0,0,2023-11-13,2023-11-24,440.61,0,0,21544370,-14129174,0,100,
468,468,0,0,0,0,2023-11-13,2023-11-24,440.61,0,0,21544370,-14129174,0,100,
472,472,0,0,0,0,2023-11-13,2023-11-24,440.61,0,0,21544370,-14129174,0,100,
474,474,0,0,0,0,2023-11-13,2023-11-24,440.61,0,0,21544370,-14129174,0,100,
475,475,0,0,0,0,2023-11-13,2023-11-24,440.61,0,0,21544370,-14129174,0,100,
476,476,0,0,0,0,2023-11-13,2023-11-24,440.61,0,0,21544370,-14129174,0,100,
478,478,0,0,0,0,2023-11-13,2023-11-24,440.61,0,0,21544370,-14129174,0,100,
423.66,480,0,0,0,0,2023-11-13,2023-11-24,440.61,0,0,21544370,-14129174,0,100,
485,485,0,0,0,0,2023-11-13,2023-11-24,440.61,0,0,21544370,-14129174,0,100,
490,490,0,0,0,0,2023-11-13,2023-11-24,440.61,0,0,21544370,-14129174,0,100,
495,495,0,0,0,0,2023-11-13,2023-11-24,440.61,0,0,21544370,-14129174,0,100,
417.25,500,0,0,0,0,2023-11-13,2023-11-24,440.61,0,0,21544370,-14129174,0,100,
420.86,505,0,0,0,0,2023-11-13,2023-11-24,440.61,0,0,21544370,-14129174,0,100,
510,510,0,0,0,0,2023-11-13,2023-11-24,440.61,0,0,21544370,-14129174,0,100,
515,515,0,0,0,0,2023-11-13,2023-11-24,440.61,0,0,21544370,-14129174,0,100,
520,520,0,0,0,0,2023-11-13,2023-11-24,440.61,0,0,21544370,-14129174,0,100,
525,525,0,0,0,0,2023-11-13,2023-11-24,440.61,0,0,21544370,-14129174,0,100,
530,530,0,0,0,0,2023-11-13,2023-11-24,440.61,0,0,21544370,-14129174,0,100,
437.52,540,0,0,0,0,2023-11-13,2023-11-24,440.61,0,0,21544370,-14129174,0,100,
451,451,0,0,0,0,2023-11-13,2023-12-01,440.61,0,0,30624514,-25040527,0,100,
436.6,452,0,0,0,0,2023-11-13,2023-12-01,440.61,0,0,30624514,-25040527,0,100,
434.97,454,0,0,0,0,2023-11-13,2023-12-01,440.61,0,0,30624514,-25040527,0,100,
456,456,0,0,0,0,2023-11-13,2023-12-01,440.61,0,0,30624514,-25040527,0,100,
434.53,458,0,0,0,0,2023-11-13,2023-12-01,440.61,0,0,30624514,-25040527,0,100,
416.1,462,0,0,0,0,2023-11-13,2023-12-01,440.61,0,0,30624514,-25040527,0,100,
464,464,0,0,0,0,2023-11-13,2023-12-01,440.61,0,0,30624514,-25040527,0,100,
465,465,0,0,0,0,2023-11-13,2023-12-01,440.61,0,0,30624514,-25040527,0,100,
466,466,0,0,0,0,2023-11-13,2023-12-01,440.61,0,0,30624514,-25040527,0,100,
468,468,0,0,0,0,2023-11-13,2023-12-01,440.61,0,0,30624514,-25040527,0,100,
436.85,470,0,0,0,0,2023-11-13,2023-12-01,440.61,0,0,30624514,-25040527,0,100,
416.1,472,0,0,0,0,2023-11-13,2023-12-01,440.61,0,0,30624514,-25040527,0,100,
474,474,0,0,0,0,2023-11-13,2023-12-01,440.61,0,0,30624514,-25040527,0,100,
475,475,0,0,0,0,2023-11-13,2023-12-01,440.61,0,0,30624514,-25040527,0,100,
476,476,0,0,0,0,2023-11-13,2023-12-01,440.61,0,0,30624514,-25040527,0,100,
436.85,485,0,0,0,0,2023-11-13,2023-12-01,440.61,0,0,30624514,-25040527,0,100,
418.02,490,0,0,0,0,2023-11-13,2023-12-01,440.61,0,0,30624514,-25040527,0,100,
495,495,0,0,0,0,2023-11-13,2023-12-01,440.61,0,0,30624514,-25040527,0,100,
500,500,0,0,0,0,2023-11-13,2023-12-01,440.61,0,0,30624514,-25040527,0,100,
505,505,0,0,0,0,2023-11-13,2023-12-01,440.61,0,0,30624514,-25040527,0,100,
510,510,0,0,0,0,2023-11-13,2023-12-01,440.61,0,0,30624514,-25040527,0,100,
515,515,0,0,0,0,2023-11-13,2023-12-01,440.61,0,0,30624514,-25040527,0,100,
520,520,0,0,0,0,2023-11-13,2023-12-01,440.61,0,0,30624514,-25040527,0,100,
525,525,0,0,0,0,2023-11-13,2023-12-01,440.61,0,0,30624514,-25040527,0,100,
530,530,0,0,0,0,2023-11-13,2023-12-01,440.61,0,0,30624514,-25040527,0,100,
417.8,540,0,0,0,0,2023-11-13,2023-12-01,440.61,0,0,30624514,-25040527,0,100,
439,449,0,0,0,0,2023-11-13,2023-12-08,440.61,0,0,28464419,-15251963,0,100,
435.39,454,0,0,0,0,2023-11-13,2023-12-08,440.61,0,0,28464419,-15251963,0,100,
437.38,458,0,0,0,0,2023-11-13,2023-12-08,440.61,0,0,28464419,-15251963,0,100,
462,462,0,0,0,0,2023-11-13,2023-12-08,440.61,0,0,28464419,-15251963,0,100,
464,464,0,0,0,0,2023-11-13,2023-12-08,440.61,0,0,28464419,-15251963,0,100,
414.66,465,0,0,0,0,2023-11-13,2023-12-08,440.61,0,0,28464419,-15251963,0,100,
466,466,0,0,0,0,2023-11-13,2023-12-08,440.61,0,0,28464419,-15251963,0,100,
468,468,0,0,0,0,2023-11-13,2023-12-08,440.61,0,0,28464419,-15251963,0,100,
436.83,470,0,0,0,0,2023-11-13,2023-12-08,440.61,0,0,28464419,-15251963,0,100,
472,472,0,0,0,0,2023-11-13,2023-12-08,440.61,0,0,28464419,-15251963,0,100,
474,474,0,0,0,0,2023-11-13,2023-12-08,440.61,0,0,28464419,-15251963,0,100,
437.41,475,0,0,0,0,2023-11-13,2023-12-08,440.61,0,0,28464419,-15251963,0,100,
476,476,0,0,0,0,2023-11-13,2023-12-08,440.61,0,0,28464419,-15251963,0,100,
478,478,0,0,0,0,2023-11-13,2023-12-08,440.61,0,0,28464419,-15251963,0,100,
422.9,480,0,0,0,0,2023-11-13,2023-12-08,440.61,0,0,28464419,-15251963,0,100,
482,482,0,0,0,0,2023-11-13,2023-12-08,440.61,0,0,28464419,-15251963,0,100,
485,485,0,0,0,0,2023-11-13,2023-12-08,440.61,0,0,28464419,-15251963,0,100,
490,490,0,0,0,0,2023-11-13,2023-12-08,440.61,0,0,28464419,-15251963,0,100,
495,495,0,0,0,0,2023-11-13,2023-12-08,440.61,0,0,28464419,-15251963,0,100,
505,505,0,0,0,0,2023-11-13,2023-12-08,440.61,0,0,28464419,-15251963,0,100,
438.92,510,0,0,0,0,2023-11-13,2023-12-08,440.61,0,0,28464419,-15251963,0,100,
515,515,0,0,0,0,2023-11-13,2023-12-08,440.61,0,0,28464419,-15251963,0,100,
520,520,0,0,0,0,2023-11-13,2023-12-08,440.61,0,0,28464419,-15251963,0,100,
525,525,0,0,0,0,2023-11-13,2023-12-08,440.61,0,0,28464419,-15251963,0,100,
530,530,0,0,0,0,2023-11-13,2023-12-08,440.61,0,0,28464419,-15251963,0,100,
540,540,0,0,0,0,2023-11-13,2023-12-08,440.61,0,0,28464419,-15251963,0,100,
434.93,458,0,0,0,0,2023-11-13,2023-12-15,440.61,0,0,302704033,-178564111,0,100,
435.1,459,0,0,0,0,2023-11-13,2023-12-15,440.61,0,0,302704033,-178564111,0,100,
416.14,467,0,0,0,0,2023-11-13,2023-12-15,440.61,0,0,302704033,-178564111,0,100,
438.58,469,2,0,7014,0,2023-11-13,2023-12-15,440.61,-2,-7014,302704033,-178564111,0,100,-Inf
412.71,474,0,0,0,0,2023-11-13,2023-12-15,440.61,0,0,302704033,-178564111,0,100,
476,476,1,1,0,0,2023-11-13,2023-12-15,440.61,0,0,302704033,-178564111,0,100,
477,477,0,0,0,0,2023-11-13,2023-12-15,440.61,0,0,302704033,-178564111,0,100,
478,478,0,0,0,0,2023-11-13,2023-12-15,440.61,0,0,302704033,-178564111,0,100,
479,479,0,0,0,0,2023-11-13,2023-12-15,440.61,0,0,302704033,-178564111,0,100,
481,481,0,0,0,0,2023-11-13,2023-12-15,440.61,0,0,302704033,-178564111,0,100,
482,482,0,0,0,0,2023-11-13,2023-12-15,440.61,0,0,302704033,-178564111,0,100,
483,483,0,0,0,0,2023-11-13,2023-12-15,440.61,0,0,302704033,-178564111,0,100,
484,484,0,0,0,0,2023-11-13,2023-12-15,440.61,0,0,302704033,-178564111,0,100,
485,485,0,0,0,0,2023-11-13,2023-12-15,440.61,0,0,302704033,-178564111,0,100,
486,486,0,0,0,0,2023-11-13,2023-12-15,440.61,0,0,302704033,-178564111,0,100,
487,487,0,0,0,0,2023-11-13,2023-12-15,440.61,0,0,302704033,-178564111,0,100,
488,488,0,0,0,0,2023-11-13,2023-12-15,440.61,0,0,302704033,-178564111,0,100,
489,489,0,0,0,0,2023-11-13,2023-12-15,440.61,0,0,302704033,-178564111,0,100,
437,490,0,0,0,0,2023-11-13,2023-12-15,440.61,0,0,302704033,-178564111,0,100,
412.71,491,0,0,0,0,2023-11-13,2023-12-15,440.61,0,0,302704033,-178564111,0,100,
492,492,0,0,0,0,2023-11-13,2023-12-15,440.61,0,0,302704033,-178564111,0,100,
493,493,0,0,0,0,2023-11-13,2023-12-15,440.61,0,0,302704033,-178564111,0,100,
494,494,0,0,0,0,2023-11-13,2023-12-15,440.61,0,0,302704033,-178564111,0,100,
495,495,0,0,0,0,2023-11-13,2023-12-15,440.61,0,0,302704033,-178564111,0,100,
496,496,0,0,0,0,2023-11-13,2023-12-15,440.61,0,0,302704033,-178564111,0,100,
497,497,0,0,0,0,2023-11-13,2023-12-15,440.61,0,0,302704033,-178564111,0,100,
498,498,0,0,0,0,2023-11-13,2023-12-15,440.61,0,0,302704033,-178564111,0,100,
499,499,0,0,0,0,2023-11-13,2023-12-15,440.61,0,0,302704033,-178564111,0,100,
436.88,501,0,0,0,0,2023-11-13,2023-12-15,440.61,0,0,302704033,-178564111,0,100,
436.87,505,0,0,0,0,2023-11-13,2023-12-15,440.61,0,0,302704033,-178564111,0,100,
434.89,515,0,0,0,0,2023-11-13,2023-12-15,440.61,0,0,302704033,-178564111,0,100,
418.17,520,0,0,0,0,2023-11-13,2023-12-15,440.61,0,0,302704033,-178564111,0,100,
440.12,530,0,0,0,0,2023-11-13,2023-12-15,440.61,0,0,302704033,-178564111,0,100,
423.02,535,0,0,0,0,2023-11-13,2023-12-15,440.61,0,0,302704033,-178564111,0,100,
434.19,545,0,0,0,0,2023-11-13,2023-12-15,440.61,0,0,302704033,-178564111,0,100,
550,550,0,0,0,0,2023-11-13,2023-12-15,440.61,0,0,302704033,-178564111,0,100,
555,555,0,0,0,0,2023-11-13,2023-12-15,440.61,0,0,302704033,-178564111,0,100,
560,560,0,0,0,0,2023-11-13,2023-12-15,440.61,0,0,302704033,-178564111,0,100,
565,565,0,0,0,0,2023-11-13,2023-12-15,440.61,0,0,302704033,-178564111,0,100,
570,570,0,0,0,0,2023-11-13,2023-12-15,440.61,0,0,302704033,-178564111,0,100,
575,575,0,0,0,0,2023-11-13,2023-12-15,440.61,0,0,302704033,-178564111,0,100,
417.91,580,0,0,0,0,2023-11-13,2023-12-15,440.61,0,0,302704033,-178564111,0,100,
585,585,0,0,0,0,2023-11-13,2023-12-15,440.61,0,0,302704033,-178564111,0,100,
439.67,595,0,0,0,0,2023-11-13,2023-12-15,440.61,0,0,302704033,-178564111,0,100,
412.92,600,0,0,0,0,2023-11-13,2023-12-15,440.61,0,0,302704033,-178564111,0,100,
605,605,0,0,0,0,2023-11-13,2023-12-15,440.61,0,0,302704033,-178564111,0,100,
610,610,0,0,0,0,2023-11-13,2023-12-15,440.61,0,0,302704033,-178564111,0,100,
615,615,0,0,0,0,2023-11-13,2023-12-15,440.61,0,0,302704033,-178564111,0,100,
620,620,0,0,0,0,2023-11-13,2023-12-15,440.61,0,0,302704033,-178564111,0,100,
625,625,0,0,0,0,2023-11-13,2023-12-15,440.61,0,0,302704033,-178564111,0,100,
630,630,0,0,0,0,2023-11-13,2023-12-15,440.61,0,0,302704033,-178564111,0,100,
635,635,0,0,0,0,2023-11-13,2023-12-15,440.61,0,0,302704033,-178564111,0,100,
640,640,0,0,0,0,2023-11-13,2023-12-15,440.61,0,0,302704033,-178564111,0,100,
645,645,0,0,0,0,2023-11-13,2023-12-15,440.61,0,0,302704033,-178564111,0,100,
650,650,0,0,0,0,2023-11-13,2023-12-15,440.61,0,0,302704033,-178564111,0,100,
655,655,0,0,0,0,2023-11-13,2023-12-15,440.61,0,0,302704033,-178564111,0,100,
660,660,0,0,0,0,2023-11-13,2023-12-15,440.61,0,0,302704033,-178564111,0,100,
665,665,0,0,0,0,2023-11-13,2023-12-15,440.61,0,0,302704033,-178564111,0,100,
670,670,0,0,0,0,2023-11-13,2023-12-15,440.61,0,0,302704033,-178564111,0,100,
675,675,0,0,0,0,2023-11-13,2023-12-15,440.61,0,0,302704033,-178564111,0,100,
680,680,0,0,0,0,2023-11-13,2023-12-15,440.61,0,0,302704033,-178564111,0,100,
685,685,0,0,0,0,2023-11-13,2023-12-15,440.61,0,0,302704033,-178564111,0,100,
690,690,0,0,0,0,2023-11-13,2023-12-15,440.61,0,0,302704033,-178564111,0,100,
695,695,0,0,0,0,2023-11-13,2023-12-15,440.61,0,0,302704033,-178564111,0,100,
413.88,700,0,0,0,0,2023-11-13,2023-12-15,440.61,0,0,302704033,-178564111,0,100,
705,705,0,0,0,0,2023-11-13,2023-12-15,440.61,0,0,302704033,-178564111,0,100,
710,710,0,0,0,0,2023-11-13,2023-12-15,440.61,0,0,302704033,-178564111,0,100,
715,715,0,0,0,0,2023-11-13,2023-12-15,440.61,0,0,302704033,-178564111,0,100,
438.19,720,0,0,0,0,2023-11-13,2023-12-15,440.61,0,0,302704033,-178564111,0,100,
446,446,0,0,0,0,2023-11-13,2023-12-22,440.61,0,0,22794974,-7809504,0,100,
448,448,0,0,0,0,2023-11-13,2023-12-22,440.61,0,0,22794974,-7809504,0,100,
449,449,0,0,0,0,2023-11-13,2023-12-22,440.61,0,0,22794974,-7809504,0,100,
451,451,0,0,0,0,2023-11-13,2023-12-22,440.61,0,0,22794974,-7809504,0,100,
454,454,0,0,0,0,2023-11-13,2023-12-22,440.61,0,0,22794974,-7809504,0,100,
434.92,456,0,0,0,0,2023-11-13,2023-12-22,440.61,0,0,22794974,-7809504,0,100,
433.74,458,0,0,0,0,2023-11-13,2023-12-22,440.61,0,0,22794974,-7809504,0,100,
462,462,0,0,0,0,2023-11-13,2023-12-22,440.61,0,0,22794974,-7809504,0,100,
464,464,0,0,0,0,2023-11-13,2023-12-22,440.61,0,0,22794974,-7809504,0,100,
465,465,0,0,0,0,2023-11-13,2023-12-22,440.61,0,0,22794974,-7809504,0,100,
466,466,0,0,0,0,2023-11-13,2023-12-22,440.61,0,0,22794974,-7809504,0,100,
468,468,0,0,0,0,2023-11-13,2023-12-22,440.61,0,0,22794974,-7809504,0,100,
470,470,0,0,0,0,2023-11-13,2023-12-22,440.61,0,0,22794974,-7809504,0,100,
474,474,0,0,0,0,2023-11-13,2023-12-22,440.61,0,0,22794974,-7809504,0,100,
475,475,0,0,0,0,2023-11-13,2023-12-22,440.61,0,0,22794974,-7809504,0,100,
435.21,476,0,0,0,0,2023-11-13,2023-12-22,440.61,0,0,22794974,-7809504,0,100,
435.29,480,1,0,4265,0,2023-11-13,2023-12-22,440.61,-1,-4265,22794974,-7809504,0,100,-Inf
490,490,0,0,0,0,2023-11-13,2023-12-22,440.61,0,0,22794974,-7809504,0,100,
495,495,0,0,0,0,2023-11-13,2023-12-22,440.61,0,0,22794974,-7809504,0,100,
500,500,0,0,0,0,2023-11-13,2023-12-22,440.61,0,0,22794974,-7809504,0,100,
435.64,505,0,0,0,0,2023-11-13,2023-12-22,440.61,0,0,22794974,-7809504,0,100,
510,510,0,0,0,0,2023-11-13,2023-12-22,440.61,0,0,22794974,-7809504,0,100,
515,515,0,0,0,0,2023-11-13,2023-12-22,440.61,0,0,22794974,-7809504,0,100,
520,520,0,0,0,0,2023-11-13,2023-12-22,440.61,0,0,22794974,-7809504,0,100,
525,525,0,0,0,0,2023-11-13,2023-12-22,440.61,0,0,22794974,-7809504,0,100,
530,530,0,0,0,0,2023-11-13,2023-12-22,440.61,0,0,22794974,-7809504,0,100,
540,540,0,0,0,0,2023-11-13,2023-12-22,440.61,0,0,22794974,-7809504,0,100,
466,466,0,0,0,0,2023-11-13,2023-12-29,440.61,0,0,120671117,-59187285,0,100,
468,468,0,0,0,0,2023-11-13,2023-12-29,440.61,0,0,120671117,-59187285,0,100,
469,469,0,0,0,0,2023-11-13,2023-12-29,440.61,0,0,120671117,-59187285,0,100,
419.44,471,0,0,0,0,2023-11-13,2023-12-29,440.61,0,0,120671117,-59187285,0,100,
420.98,472,0,0,0,0,2023-11-13,2023-12-29,440.61,0,0,120671117,-59187285,0,100,
473,473,0,0,0,0,2023-11-13,2023-12-29,440.61,0,0,120671117,-59187285,0,100,
474,474,0,0,0,0,2023-11-13,2023-12-29,440.61,0,0,120671117,-59187285,0,100,
476,476,0,0,0,0,2023-11-13,2023-12-29,440.61,0,0,120671117,-59187285,0,100,
477,477,0,0,0,0,2023-11-13,2023-12-29,440.61,0,0,120671117,-59187285,0,100,
478,478,0,0,0,0,2023-11-13,2023-12-29,440.61,0,0,120671117,-59187285,0,100,
479,479,0,0,0,0,2023-11-13,2023-12-29,440.61,0,0,120671117,-59187285,0,100,
434.88,481,0,0,0,0,2023-11-13,2023-12-29,440.61,0,0,120671117,-59187285,0,100,
482,482,0,0,0,0,2023-11-13,2023-12-29,440.61,0,0,120671117,-59187285,0,100,
483,483,0,0,0,0,2023-11-13,2023-12-29,440.61,0,0,120671117,-59187285,0,100,
484,484,0,0,0,0,2023-11-13,2023-12-29,440.61,0,0,120671117,-59187285,0,100,
485,485,1,1,0,0,2023-11-13,2023-12-29,440.61,0,0,120671117,-59187285,0,100,
486,486,0,0,0,0,2023-11-13,2023-12-29,440.61,0,0,120671117,-59187285,0,100,
487,487,0,0,0,0,2023-11-13,2023-12-29,440.61,0,0,120671117,-59187285,0,100,
488,488,0,0,0,0,2023-11-13,2023-12-29,440.61,0,0,120671117,-59187285,0,100,
489,489,0,0,0,0,2023-11-13,2023-12-29,440.61,0,0,120671117,-59187285,0,100,
436.87,490,0,0,0,0,2023-11-13,2023-12-29,440.61,0,0,120671117,-59187285,0,100,
491,491,0,0,0,0,2023-11-13,2023-12-29,440.61,0,0,120671117,-59187285,0,100,
492,492,0,0,0,0,2023-11-13,2023-12-29,440.61,0,0,120671117,-59187285,0,100,
493,493,0,0,0,0,2023-11-13,2023-12-29,440.61,0,0,120671117,-59187285,0,100,
494,494,0,0,0,0,2023-11-13,2023-12-29,440.61,0,0,120671117,-59187285,0,100,
496,496,0,0,0,0,2023-11-13,2023-12-29,440.61,0,0,120671117,-59187285,0,100,
497,497,0,0,0,0,2023-11-13,2023-12-29,440.61,0,0,120671117,-59187285,0,100,
498,498,0,0,0,0,2023-11-13,2023-12-29,440.61,0,0,120671117,-59187285,0,100,
499,499,0,0,0,0,2023-11-13,2023-12-29,440.61,0,0,120671117,-59187285,0,100,
417.65,500,0,0,0,0,2023-11-13,2023-12-29,440.61,0,0,120671117,-59187285,0,100,
505,505,0,0,0,0,2023-11-13,2023-12-29,440.61,0,0,120671117,-59187285,0,100,
510,510,0,0,0,0,2023-11-13,2023-12-29,440.61,0,0,120671117,-59187285,0,100,
515,515,0,0,0,0,2023-11-13,2023-12-29,440.61,0,0,120671117,-59187285,0,100,
520,520,0,0,0,0,2023-11-13,2023-12-29,440.61,0,0,120671117,-59187285,0,100,
525,525,0,0,0,0,2023-11-13,2023-12-29,440.61,0,0,120671117,-59187285,0,100,
530,530,0,0,0,0,2023-11-13,2023-12-29,440.61,0,0,120671117,-59187285,0,100,
535,535,0,0,0,0,2023-11-13,2023-12-29,440.61,0,0,120671117,-59187285,0,100,
435.75,540,0,0,0,0,2023-11-13,2023-12-29,440.61,0,0,120671117,-59187285,0,100,
550,550,0,0,0,0,2023-11-13,2023-12-29,440.61,0,0,120671117,-59187285,0,100,
