Watch,strike,open_interest.yt,open_interest.td,OI_Dollar.yt,OI_Dollar.td,Date.td,expiry,stkClose,diff_oi,diff_oi_d,totalOI,totalOIdiff,OI_pct,cum_sep_OI,pct
549.45,560,156453,157331,150664239,165984205,2025-07-08,2025-12-19,620.68,878,15319966,522038386,40509509,31.7954023020828,31.7954023020828,0.0922977339922193
589.97,600,38375,38683,33232750,38799049,2025-07-08,2025-09-19,620.68,308,5566299,397445891,51899302,9.76209589244439,9.76209589244439,0.143464830800363
594.32,600,60674,63252,28395432,35927136,2025-07-08,2025-08-15,620.68,2578,7531704,296966434,50073190,12.0980460707556,12.0980460707556,0.209638307935261
596.7,620,17920,13657,38348800,31820810,2025-07-08,2025-12-19,620.68,-4263,-6527990,522038386,40509509,6.09549237247086,37.8908946745537,-0.205148454737639
585.86,590,60054,66759,21018900,27638226,2025-07-08,2025-08-15,620.68,6705,6619326,296966434,50073190,9.3068518309379,21.4048979016935,0.239498946133518
540.75,550,31412,28357,26386080,26230225,2025-07-08,2025-12-19,620.68,-3055,-155855,522038386,40509509,5.02457782865032,42.915472503204,-0.00594180949648735
573.34,580,37830,38058,21941400,25346628,2025-07-08,2025-09-19,620.68,228,3405228,397445891,51899302,6.37737829827004,16.1394741907144,0.134346391164931
527.49,530,94999,93238,21279776,23402738,2025-07-08,2025-09-19,620.68,-1761,2122962,397445891,51899302,5.88828279017231,22.0277569808867,0.0907142574514143
582.38,600,12400,12479,20050800,21987998,2025-07-08,2025-12-19,620.68,79,1937198,522038386,40509509,4.21195042159218,47.1274229247962,0.0881025184739418
604.52,620,13636,13649,18190424,21128652,2025-07-08,2025-09-19,620.68,13,2938228,397445891,51899302,5.31610779692273,27.3438647778095,0.139063675240616
581.98,590,26110,26305,18511990,21096610,2025-07-08,2025-09-19,620.68,195,2584620,397445891,51899302,5.30804581899678,32.6519105968062,0.122513522314722
590.15,595,58073,41822,23287273,20283670,2025-07-08,2025-08-15,620.68,-16251,-3003603,296966434,50073190,6.83029045632814,28.2351883580216,-0.1480798593154
513.76,520,32493,32023,18618489,19982352,2025-07-08,2025-12-19,620.68,-470,1363863,522038386,40509509,3.82775530227005,50.9551782270662,0.0682533767796704
546.29,550,52796,53107,17105904,19702697,2025-07-08,2025-09-19,620.68,311,2596793,397445891,51899302,4.95732814105254,37.6092387378588,0.131798859821069
602.11,610,17546,24755,11317170,19531695,2025-07-08,2025-08-15,620.68,7209,8214525,296966434,50073190,6.57707160264449,34.8122599606661,0.420574097639759
555.5,560,33560,38439,13121960,17297550,2025-07-08,2025-09-19,620.68,4879,4175590,397445891,51899302,4.3521773382732,41.961416076132,0.241397770204451
553.44,560,26143,26162,15162940,17162272,2025-07-08,2025-10-17,620.68,19,1999332,130178883,18894460,13.1836067451892,13.1836067451892,0.116495764663327
560.06,565,33780,33637,14559180,16616678,2025-07-08,2025-09-19,620.68,-143,2057498,397445891,51899302,4.18086546528166,46.1422815414136,0.123821259580284
609.03,620,13253,14753,11940953,16184041,2025-07-08,2025-08-15,620.68,1500,4243088,296966434,50073190,5.44978797166012,40.2620479323263,0.262177289343249
536.95,540,52765,52813,14246550,16107965,2025-07-08,2025-09-19,620.68,48,1861415,397445891,51899302,4.0528699289031,50.1951514703168,0.115558669267037
589.69,610,7854,7857,14490630,15957567,2025-07-08,2025-12-19,620.68,3,1466937,522038386,40509509,3.05678038779317,54.0119586148594,0.0919273596031275
576.95,580,44096,50464,11376768,15391520,2025-07-08,2025-08-15,620.68,6368,4014752,296966434,50073190,5.18291572306115,45.4449636553874,0.26084181419379
577.66,585,20317,20485,12840344,15035990,2025-07-08,2025-09-19,620.68,168,2195646,397445891,51899302,3.78315396900153,53.9783054393183,0.146026034867009
610.99,615,37451,37478,10973143,15028678,2025-07-08,2025-07-18,620.68,27,4055535,131764767,24110937,11.4056878345939,11.4056878345939,0.269853076897383
592.48,600,9861,19871,6271596,14942992,2025-07-08,2025-08-29,620.68,10010,8671396,90008549,22549292,16.6017474628993,16.6017474628993,0.580298510499102
550.98,555,37395,37028,13275225,14885256,2025-07-08,2025-09-19,620.68,-367,1610031,397445891,51899302,3.74522830329123,57.7235337426095,0.108162802171491
545.2,555,15086,15115,13562314,14812700,2025-07-08,2025-12-19,620.68,29,1250386,522038386,40509509,2.83747333476738,56.8494319496268,0.0844131049707344
574.5,590,9474,9479,13462554,14692450,2025-07-08,2025-12-19,620.68,5,1229896,522038386,40509509,2.81443863018916,59.663870579816,0.0837093881551409
566.23,580,10610,10506,13124570,14466762,2025-07-08,2025-12-19,620.68,-104,1342192,522038386,40509509,2.77120656027773,62.4350771400937,0.092777637456122
587.12,600,9202,11157,10462674,14370216,2025-07-08,2025-10-17,620.68,1955,3907542,130178883,18894460,11.0388226330072,24.2224293781965,0.271919503506419
531.95,540,17448,17555,12876624,14131775,2025-07-08,2025-12-19,620.68,107,1255151,522038386,40509509,2.70703752424827,65.142114664342,0.0888176467570422
581.42,585,38736,39172,11620800,14023576,2025-07-08,2025-08-15,620.68,436,2402776,296966434,50073190,4.72227645768208,50.1672401130695,0.171338323406241
495.15,500,28350,28532,12700800,13838020,2025-07-08,2025-12-19,620.68,182,1137220,522038386,40509509,2.6507667579832,67.7928814223251,0.082180832228888
597.65,610,10199,10809,10902731,13349115,2025-07-08,2025-09-19,620.68,610,2446384,397445891,51899302,3.35872512517685,61.0822588677864,0.183261886649415
564.51,570,22780,23384,10866060,12837816,2025-07-08,2025-09-19,620.68,604,1971756,397445891,51899302,3.23007893419132,64.3123378019777,0.153589676000965
607.6,625,7157,7299,10721186,12700260,2025-07-08,2025-09-19,620.68,142,1979074,397445891,51899302,3.19546893994685,67.5078067419245,0.15582940821684
598.3,605,17927,18907,9823996,12667690,2025-07-08,2025-08-15,620.68,980,2843694,296966434,50073190,4.26569758385555,54.432937696925,0.224484021948753
598.6,600,91855,89028,10747035,12463920,2025-07-08,2025-07-18,620.68,-2827,1716885,131764767,24110937,9.45922061244187,20.8649084470358,0.137748396973023
593.91,605,10378,11021,9942124,12222289,2025-07-08,2025-09-19,620.68,643,2280165,397445891,51899302,3.07520829294471,70.5830150348692,0.186557935260736
569.1,575,18486,19074,9668178,11253660,2025-07-08,2025-09-19,620.68,588,1585482,397445891,51899302,2.8314948663037,73.4145099011729,0.140885898454369
605.75,615,10592,11558,8007552,10691150,2025-07-08,2025-08-15,620.68,966,2683598,296966434,50073190,3.60012067895862,58.0330583758837,0.251011163438919
607.22,620,8214,8152,8854692,10418256,2025-07-08,2025-08-29,620.68,-62,1563564,90008549,22549292,11.574740528258,28.1764879911574,0.150079245509037
532.25,535,37787,37717,9257815,10372175,2025-07-08,2025-09-19,620.68,-70,1114360,397445891,51899302,2.60970744316992,76.0242173443429,0.10743744682287
557.91,570,8502,8484,9190662,10257156,2025-07-08,2025-12-19,620.68,-18,1066494,522038386,40509509,1.96482792742371,69.7577093497489,0.103975604933765
586,595,10793,11221,8472505,10098900,2025-07-08,2025-09-19,620.68,428,1626395,397445891,51899302,2.5409496559621,78.565167000305,0.161046747665587
567.72,570,43788,44249,8451084,10088772,2025-07-08,2025-08-15,620.68,461,1637688,296966434,50073190,3.39727687877344,61.4303352546571,0.162327783797671
607.19,610,26857,35719,5720541,10037039,2025-07-08,2025-07-18,620.68,8862,4316498,131764767,24110937,7.61739213639713,28.4823005834329,0.430056912202892
599.84,625,1028,3865,2343840,9724340,2025-07-08,2025-12-19,620.68,2837,7380500,522038386,40509509,1.86276340222997,71.6204727519788,0.758971817110467
575.06,585,9275,9275,8189825,9219350,2025-07-08,2025-10-17,620.68,0,1029525,130178883,18894460,7.08206261072312,31.3044919889196,0.111670020120724
570.54,585,6255,6247,8262855,9033162,2025-07-08,2025-12-19,620.68,-8,770307.000000002,522038386,40509509,1.73036355989347,73.3508363118723,0.0852754550399962
578.21,595,5371,5328,8104839,8945712,2025-07-08,2025-12-19,620.68,-43,840873,522038386,40509509,1.71361191818565,75.0644482300579,0.0939973251989333
498.46,500,57048,57093,8100816,8792322,2025-07-08,2025-09-19,620.68,45,691506.000000001,397445891,51899302,2.21220603838121,80.7773730386862,0.0786488483929502
562.32,575,6771,6790,7867902,8609720,2025-07-08,2025-12-19,620.68,19,741818.000000001,522038386,40509509,1.64925036757738,76.7136985976353,0.0861605255455463
614.29,620,13941,14708,5743692,8398268,2025-07-08,2025-07-18,620.68,767,2654576,131764767,24110937,6.37368257934991,34.8559831627828,0.316086126329858
548.69,550,57305,61181,6647380,8014711,2025-07-08,2025-08-15,620.68,3876,1367331,296966434,50073190,2.69886090897398,64.1291961636311,0.170602658037202
601.76,620,4344,4378,7054656,7985472,2025-07-08,2025-10-17,620.68,34,930815.999999999,130178883,18894460,6.13422992729166,37.4387219162113,0.11656367964223
541.7,545,24524,23701,7210056,7821330,2025-07-08,2025-09-19,620.68,-823,611274,397445891,51899302,1.9678980653998,82.745271104086,0.0781547383884838
558.31,560,45087,45723,6582702,7727187,2025-07-08,2025-08-15,620.68,636,1144485,296966434,50073190,2.60204053903277,66.7312367026638,0.148111466695448
496.25,500,293,20408,99913,7653000,2025-07-08,2025-11-21,620.68,20115,7553087,23945131,16405869,31.9605685180841,31.9605685180841,0.986944596890108
485.72,490,17520,17563,6920400,7516964,2025-07-08,2025-12-19,620.68,43,596564,522038386,40509509,1.43992553068693,78.1536241283222,0.0793623595909199
553.86,565,6695,6697,6835595,7460458,2025-07-08,2025-12-19,620.68,2,624862.999999999,522038386,40509509,1.42910142243831,79.5827255507606,0.0837566540820951
585.91,605,3849,3853,6597186,7355377,2025-07-08,2025-12-19,620.68,4,758191,522038386,40509509,1.40897244288086,80.9916979936414,0.10307982853904
601.16,615,5063,5178,6030033,7166352,2025-07-08,2025-09-19,620.68,115,1136319,397445891,51899302,1.80310129310156,84.5483723971875,0.158563101561296
519.3,520,100255,100823,6616830,7057610,2025-07-08,2025-08-15,620.68,568,440779.999999999,296966434,50073190,2.3765682555221,69.107804958186,0.0624545703148799
517.9,520,31656,31877,5951328,6694170,2025-07-08,2025-09-19,620.68,221,742842,397445891,51899302,1.68429719657109,86.2326695937586,0.110968499455496
522.89,530,9254,9250,5931814,6576750,2025-07-08,2025-12-19,620.68,-4,644936,522038386,40509509,1.25982115039334,82.2515191440347,0.0980630250503668
598.39,615,3387,3949,4941633,6559289,2025-07-08,2025-10-17,620.68,562,1617656,130178883,18894460,5.03867359193733,42.4773955081486,0.246620632205716
617.46,630,5128,5133,4845960,6436782,2025-07-08,2025-07-25,620.68,5,1590822,47357171,17128032,13.591990112754,13.591990112754,0.24714554570902
535.99,545,6813,6805,5361831,6131305,2025-07-08,2025-12-19,620.68,-8,769474,522038386,40509509,1.17449313392062,83.4260122779554,0.125499220802097
572.31,585,1534,4803,1721148,6095007,2025-07-08,2025-11-21,620.68,3269,4373859,23945131,16405869,25.4540557744286,57.4146242925128,0.717613449828688
562.38,570,7649,7929,5193671,6041898,2025-07-08,2025-10-17,620.68,280,848227,130178883,18894460,4.64122741013226,47.1186229182808,0.140390817587453
583.32,595,4939,5112,5146438,5970816,2025-07-08,2025-10-17,620.68,173,824378,130178883,18894460,4.58662408403059,51.7052470023114,0.138067895577422
591.16,605,4168,4295,5155816,5944280,2025-07-08,2025-10-17,620.68,127,788464,130178883,18894460,4.56623982554836,56.2714868278598,0.13264247310019
589.26,590,90779,80124,6445309,5929176,2025-07-08,2025-07-18,620.68,-10655,-516133,131764767,24110937,4.49981898423575,39.3558021470186,-0.0870497013412994
474.62,475,154922,154965,5577192,5888670,2025-07-08,2025-08-15,620.68,43,311478,296966434,50073190,1.98294127746437,71.0907462356503,0.0528944566430111
594.82,610,4204,3803,5637564,5772954,2025-07-08,2025-10-17,620.68,-401,135390,130178883,18894460,4.43463169060991,60.7061185184697,0.02345246471737
604.18,610,9041,9859,4068450,5737938,2025-07-08,2025-08-01,620.68,818,1669488,34440445,8262067,16.6604641722835,16.6604641722835,0.290956089103786
553.5,555,37792,37914,4988544,5687100,2025-07-08,2025-08-15,620.68,122,698556,296966434,50073190,1.91506491942453,73.0058111550749,0.122831671678008
518.32,525,8472,8489,5167920,5670652,2025-07-08,2025-12-19,620.68,17,502732,522038386,40509509,1.08625192171213,84.5122641996675,0.0886550611816772
499.85,505,10941,10987,5207916,5658305,2025-07-08,2025-12-19,620.68,46,450389,522038386,40509509,1.08388676996638,85.5961509696339,0.0795978654385015
442.51,445,22627,22628,5430480,5634372,2025-07-08,2025-12-19,620.68,1,203892.000000001,522038386,40509509,1.07930224119573,86.6754532108296,0.03618717400981
579.13,590,4858,5122,4610242,5567614,2025-07-08,2025-10-17,620.68,264,957372,130178883,18894460,4.27689489392838,64.9830134123981,0.171953730987816
499.48,500,107775,107027,5173200,5565404,2025-07-08,2025-08-15,620.68,-748,392204,296966434,50073190,1.87408520385169,74.8798963589266,0.0704717932426828
544.5,550,9934,9976,4897462,5486800,2025-07-08,2025-10-17,620.68,42,589338,130178883,18894460,4.2148157009459,69.197829113344,0.107410147991543
504.51,510,9941,9965,5020205,5470785,2025-07-08,2025-12-19,620.68,24,450580,522038386,40509509,1.04796603979999,87.7234192506296,0.0823611236778634
614.55,630,4729,3530,6053120,5453850,2025-07-08,2025-08-15,620.68,-1199,-599270,296966434,50073190,1.83652068906885,76.7164170479954,-0.109880176389156
572.36,575,20547,20487,4561434,5408568,2025-07-08,2025-08-15,620.68,-60,847134,296966434,50073190,1.82127250112045,78.5376895491158,0.156628150001997
603.14,610,7398,7880,4024512,5405680,2025-07-08,2025-08-08,620.68,482,1381168,23649737,8175363,22.8572520700759,22.8572520700759,0.255503100442497
610.52,630,2436,2755,4104660,5366740,2025-07-08,2025-09-19,620.68,319,1262080,397445891,51899302,1.3503070786559,87.5829766724145,0.235166972873663
584.31,590,9221,9177,4518290,5221713,2025-07-08,2025-08-29,620.68,-44,703423,90008549,22549292,5.80135226932722,33.9778402604846,0.134711157047505
555.28,558,19000,19026,4351000,5175072,2025-07-08,2025-08-29,620.68,26,824072,90008549,22549292,5.74953385816718,39.7273741186518,0.159238750687913
447.29,450,18930,18921,4770360,5127591,2025-07-08,2025-12-19,620.68,-9,357231,522038386,40509509,0.98222489715536,88.705644147785,0.0696683881378215
611.98,625,3512,3778,3761352,4918956,2025-07-08,2025-08-15,620.68,266,1157604,296966434,50073190,1.65640134265141,80.1940908917672,0.235335302856948
522.66,525,20654,19942,4234070,4666428,2025-07-08,2025-09-19,620.68,-712,432358,397445891,51899302,1.17410397381615,88.7570806462307,0.0926528813902197
454.7,455,151890,151975,4252920,4559250,2025-07-08,2025-08-15,620.68,85,306330,296966434,50073190,1.53527452196837,81.7293654137356,0.0671886823490706
549.03,555,7190,7206,3753180,4301982,2025-07-08,2025-10-17,620.68,16,548802.000000001,130178883,18894460,3.30466962141625,72.5024987347602,0.127569571420801
593.99,595,38169,42408,3435210,4283208,2025-07-08,2025-07-18,620.68,4239,847998,131764767,24110937,3.25064742079345,42.606449567812,0.197981979861823
619.35,640,19,2033,31027,4198145,2025-07-08,2025-07-25,620.68,2014,4167118,47357171,17128032,8.86485596869796,22.456846081452,0.992609354846009
570.86,580,4590,4566,3685770,4173324,2025-07-08,2025-10-17,620.68,-24,487554.000000001,130178883,18894460,3.2058379238052,75.7083366585654,0.116826299611533
595.27,600,7243,8770,2824770,4148210,2025-07-08,2025-08-08,620.68,1527,1323440,23649737,8175363,17.5401950558689,40.3974471259448,0.319038814331965
478.83,480,34927,35309,3807043,4131153,2025-07-08,2025-09-19,620.68,382,324110,397445891,51899302,1.03942526355116,89.7965059097818,0.0784550947398946
509.16,515,6989,6989,3760082,4081576,2025-07-08,2025-12-19,620.68,0,321494,522038386,40509509,0.781853616412031,89.487497764197,0.0787671232876712
398.28,400,23657,23659,3761463,4069348,2025-07-08,2025-12-19,620.68,2,307884.999999999,522038386,40509509,0.779511259924859,90.2670090241218,0.0756595405455614
616.33,620,10464,11044,2448576,4053148,2025-07-08,2025-07-11,620.68,580,1604572,35723216,11601493,11.3459773610528,11.3459773610528,0.395882903856459
600.25,610,3706,4153,3053744,4049175,2025-07-08,2025-08-29,620.68,447,995431,90008549,22549292,4.49865601099736,44.2260301296491,0.245835509702594
535.35,540,8770,8358,3586930,3886470,2025-07-08,2025-10-17,620.68,-412,299540.000000001,130178883,18894460,2.98548421252009,78.6938208710855,0.0770725105301214
596.34,605,4376,4395,3106960,3806070,2025-07-08,2025-08-29,620.68,19,699110,90008549,22549292,4.22856499997572,48.4545951296249,0.183682906515119
600.23,605,8026,7965,3009750,3799305,2025-07-08,2025-08-01,620.68,-61,789555,34440445,8262067,11.031521224537,27.6919853968205,0.20781563996573
417.9,420,18028,18031,3407292,3786510,2025-07-08,2025-12-19,620.68,3,379218,522038386,40509509,0.725331719188941,90.9923407433108,0.100149742110809
612.63,635,1631,1670,3108686,3735790,2025-07-08,2025-09-19,620.68,39,627104.000000001,397445891,51899302,0.939949332625004,90.7364552424068,0.167863825322087
508.21,510,20281,20318,3265241,3636922,2025-07-08,2025-09-19,620.68,37,371681,397445891,51899302,0.915073493614254,91.6515287360211,0.102196582714724
584.44,585,64996,63800,3639776,3572800,2025-07-08,2025-07-18,620.68,-1196,-66976,131764767,24110937,2.71149874230036,45.3179483101124,-0.0187460815047022
488.7,490,44294,27315,5359574,3550950,2025-07-08,2025-09-19,620.68,-16979,-1808624,397445891,51899302,0.893442373014746,92.5449711090358,-0.509335248313832
464.67,465,107067,107033,3212010,3532089,2025-07-08,2025-08-15,620.68,-34,320079,296966434,50073190,1.18938997664632,82.9187553903819,0.0906203099638769
538.97,540,33787,34078,3175978,3510034,2025-07-08,2025-08-15,620.68,291,334056.000000001,296966434,50073190,1.18196321137089,84.1007186017528,0.0951717276812704
527.42,535,4583,4596,3166853,3483768,2025-07-08,2025-12-19,620.68,13,316915,522038386,40509509,0.667339432008741,91.6596801753195,0.090969031232849
610.98,617,680,5687,312800,3423574,2025-07-08,2025-07-25,620.68,5007,3110774,47357171,17128032,7.22926206888498,29.6861081503369,0.908633492367917
605.55,608,4329,13894,813852,3404030,2025-07-08,2025-07-18,620.68,9565,2590178,131764767,24110937,2.5834144267109,47.9013627368233,0.760915150571529
603,605,15881,16900,2509198,3380000,2025-07-08,2025-07-18,620.68,1019,870802,131764767,24110937,2.56517738159853,50.4665401184218,0.257633727810651
504.39,505,55036,55301,2861872,3373361,2025-07-08,2025-08-15,620.68,265,511489,296966434,50073190,1.13594016487399,85.2366587666268,0.15162593034069
566.64,575,3855,3993,2856555,3338148,2025-07-08,2025-10-17,620.68,138,481593,130178883,18894460,2.56427764862601,81.2580985197115,0.144269517109487
579.88,585,5815,6498,2535340,3326976,2025-07-08,2025-08-29,620.68,683,791636,90008549,22549292,3.69628889362498,52.1508840232498,0.237944607956294
452.1,455,11281,11281,3147399,3271490,2025-07-08,2025-12-19,620.68,0,124091,522038386,40509509,0.626676138715976,92.2863563140355,0.0379310344827586
616.84,625,3588,3895,2081040,3178320,2025-07-08,2025-07-18,620.68,307,1097280,131764767,24110937,2.41211673830835,52.8786568567302,0.345238994185608
449.13,450,35363,35382,2758314,3078234,2025-07-08,2025-09-19,620.68,19,319920,397445891,51899302,0.774503918572403,93.3194750276082,0.103929720742478
476.18,480,8030,8001,2810500,3056382,2025-07-08,2025-12-19,620.68,-29,245882,522038386,40509509,0.585470739693843,92.8718270537293,0.0804487135443148
539.97,545,5919,5917,2687226,2976251,2025-07-08,2025-10-17,620.68,-2,289025,130178883,18894460,2.28627787503754,83.5443763947491,0.0971104251623939
605.74,610,4465,6908,1451125,2942808,2025-07-08,2025-07-25,620.68,2443,1491683,47357171,17128032,6.21407051531858,35.9001786656555,0.506891037403731
597.49,600,8585,11536,1708415,2895536,2025-07-08,2025-07-25,620.68,2951,1187121,47357171,17128032,6.11425036347716,42.0144290291327,0.409983160285349
612.98,615,7631,14092,1037816,2846584,2025-07-08,2025-07-11,620.68,6461,1808768,35723216,11601493,7.96844270683804,19.3144200678909,0.635417047239779
615.7,623,3627,3769,1853397,2751370,2025-07-08,2025-07-18,620.68,142,897973,131764767,24110937,2.08809233503217,54.9667491917623,0.326373043247546
497.52,500,10846,11008,2451196,2729984,2025-07-08,2025-10-17,620.68,162,278788,130178883,18894460,2.09710203151766,85.6414784262667,0.102120745030008
538.26,540,13568,15673,2130176,2727102,2025-07-08,2025-08-29,620.68,2105,596926,90008549,22549292,3.02982553357237,55.1807095568222,0.218886568965884
399.5,400,52989,53099,2543472,2654950,2025-07-08,2025-09-19,620.68,110,111478,397445891,51899302,0.668002880422281,93.9874779080305,0.0419887380176653
602.12,604,14284,14101,2099748,2650988,2025-07-08,2025-07-18,620.68,-183,551240,131764767,24110937,2.01190960251157,56.9786587942739,0.207937568936562
613,618,2934,5164,1050372,2582000,2025-07-08,2025-07-18,620.68,2230,1531628,131764767,24110937,1.95955266251106,58.938211456785,0.593194422927963
513.07,515,13312,13318,2356224,2570374,2025-07-08,2025-09-19,620.68,6,214150,397445891,51899302,0.646723002603642,94.6342009106342,0.0833147238495254
618.52,625,4536,3829,1800792,2481192,2025-07-08,2025-07-11,620.68,-707,680400,35723216,11601493,6.94560086639456,26.2600209342854,0.274223034734918
516.6,520,7084,7252,2139368,2465680,2025-07-08,2025-10-17,620.68,168,326312,130178883,18894460,1.89407063816948,87.5355490644362,0.132341585282762
579.56,580,53244,55231,2502468,2430164,2025-07-08,2025-07-18,620.68,1987,-72304,131764767,24110937,1.84432003738905,60.782531494174,-0.0297527245074818
596.82,598,19953,20353,2115018,2401654,2025-07-08,2025-07-18,620.68,400,286636,131764767,24110937,1.82268299385374,62.6052144880277,0.119349415028143
604.42,605,37927,40417,1858423,2344186,2025-07-08,2025-07-11,620.68,2490,485763,35723216,11601493,6.5620799650289,32.8221008993143,0.207220331492467
605.04,625,1050,1157,1876350,2309372,2025-07-08,2025-10-17,620.68,107,433022,130178883,18894460,1.7739989365249,89.3095480009611,0.187506387017769
557.94,565,2710,3098,1691040,2187188,2025-07-08,2025-10-17,620.68,388,496147.999999999,130178883,18894460,1.68014039573531,90.9896883966964,0.226842868559996
466.65,470,6479,6480,2002011,2170800,2025-07-08,2025-12-19,620.68,1,168789,522038386,40509509,0.415831490215358,93.2876585439447,0.0777542841348812
422.88,425,10034,10035,1966664,2127420,2025-07-08,2025-12-19,620.68,1,160756,522038386,40509509,0.407521756455664,93.6951803004004,0.0755638284870877
529.58,530,50618,50484,2075338,2120328,2025-07-08,2025-08-01,620.68,-134,44990.0000000002,34440445,8262067,6.15650581750613,33.8484912143266,0.0212184152640536
612.17,614,12035,11437,1468270,2092971,2025-07-08,2025-07-11,620.68,-598,624701,35723216,11601493,5.85885380532369,38.680954704638,0.298475707499053
563.09,565,11721,10876,1980849,2077316,2025-07-08,2025-08-15,620.68,-845,96467.0000000002,296966434,50073190,0.699512053271314,85.9361708198981,0.0464382886378386
468.91,470,18867,18810,1811232,2050290,2025-07-08,2025-09-19,620.68,-57,239058,397445891,51899302,0.515866447843085,95.1500673584772,0.116597164303586
582.16,585,7114,7195,1664676,2043380,2025-07-08,2025-08-08,620.68,81,378704,23649737,8175363,8.64018064978904,49.0376277757338,0.185332145758498
471.41,475,5631,5603,1863861,2011477,2025-07-08,2025-12-19,620.68,-28,147616,522038386,40509509,0.385312086992775,94.0804923873931,0.0733868694496631
489.8,490,100495,100503,2110395,2010060,2025-07-08,2025-08-01,620.68,8,-100335,34440445,8262067,5.83633573840292,39.6848269527296,-0.0499164204053609
569.71,570,68034,67951,2313156,1970579,2025-07-08,2025-07-18,620.68,-83,-342577,131764767,24110937,1.4955280116725,64.1007424997003,-0.173845859516416
615.39,640,721,798,1553034,1963878,2025-07-08,2025-09-19,620.68,77,410844,397445891,51899302,0.494124620349893,95.6441919788271,0.209200367843624
503.34,505,11658,11708,1748700,1943528,2025-07-08,2025-09-19,620.68,50,194828,397445891,51899302,0.489004426517017,96.1331964053441,0.100244503809567
564.91,567,8787,8812,1555299,1841708,2025-07-08,2025-08-15,620.68,25,286409,296966434,50073190,0.620173793783037,86.5563446136811,0.155512708855041
591.11,595,3486,4604,1139922,1790956,2025-07-08,2025-08-08,620.68,1118,651034,23649737,8175363,7.57283685649443,56.6104646322283,0.363512001411537
604.7,607,7545,7651,1327920,1759730,2025-07-08,2025-07-18,620.68,106,431810,131764767,24110937,1.33550875553857,65.4362512552388,0.245384235081518
429.78,430,79854,79842,1597080,1756524,2025-07-08,2025-08-15,620.68,-12,159444,296966434,50073190,0.591489070444911,87.1478336841261,0.0907724574215896
612.65,620,2110,2363,1152060,1736805,2025-07-08,2025-07-25,620.68,253,584745,47357171,17128032,3.66745935900605,45.6818883881387,0.336678556314612
566.52,570,5015,4937,1499485,1718076,2025-07-08,2025-08-29,620.68,-78,218591,90008549,22549292,1.9087920193003,57.0895015761225,0.127230110891485
480.97,485,4173,4172,1569048,1681316,2025-07-08,2025-12-19,620.68,-1,112268,522038386,40509509,0.322067504055152,94.4025598914483,0.0667738842668481
456.97,460,5545,5548,1547055,1681044,2025-07-08,2025-12-19,620.68,3,133989,522038386,40509509,0.322015400606958,94.7245752920553,0.0797058256654792
543.83,545,12948,14337,1320696,1677429,2025-07-08,2025-08-15,620.68,1389,356733,296966434,50073190,0.56485474718668,87.7126884313127,0.212666527167469
576.02,579,5531,5490,1382750,1636020,2025-07-08,2025-08-15,620.68,-41,253270,296966434,50073190,0.550910747037492,88.2635991783502,0.154808620921505
510.33,515,7,3500,2926,1634500,2025-07-08,2025-11-21,620.68,3493,1631574,23945131,16405869,6.82602237590598,64.2406466684187,0.998209850107066
564.75,565,65645,65055,1969350,1626375,2025-07-08,2025-07-18,620.68,-590,-342975,131764767,24110937,1.23430188283944,66.6705531380783,-0.210883098916302
432.67,435,6954,6954,1578558,1620282,2025-07-08,2025-12-19,620.68,0,41724,522038386,40509509,0.310376026639543,95.0349513186948,0.0257510729613734
518.78,520,13144,13195,1406408,1609790,2025-07-08,2025-08-29,620.68,51,203382,90008549,22549292,1.78848566928904,58.8779872454115,0.126340702824592
611.64,616,3591,3674,1113210,1601864,2025-07-08,2025-07-18,620.68,83,488654,131764767,24110937,1.21569979325353,67.8862529313318,0.3050533628323
570.95,575,3530,3953,1207260,1600965,2025-07-08,2025-08-29,620.68,423,393705,90008549,22549292,1.77868104506384,60.6566682904754,0.245917306124744
609.51,613,3940,4584,996820,1599816,2025-07-08,2025-07-18,620.68,644,602996,131764767,24110937,1.21414550826019,69.100398439592,0.376915845322212
526.04,530,3668,4016,1294804,1590336,2025-07-08,2025-10-17,620.68,348,295532,130178883,18894460,1.22165436002397,92.2113427567204,0.185829912672542
609.49,615,2105,2867,884100,1579717,2025-07-08,2025-07-25,620.68,762,695617,47357171,17128032,3.33575035552694,49.0176387436657,0.440342795576676
586.39,587,28660,25885,1776920,1578985,2025-07-08,2025-07-18,620.68,-2775,-197935,131764767,24110937,1.1983362745217,70.2987347141137,-0.125355845685678
578.2,580,8691,8695,1260195,1565100,2025-07-08,2025-08-01,620.68,4,304905,34440445,8262067,4.54436636924988,44.2291933219794,0.194815027793751
612.65,650,432,419,1430784,1564965,2025-07-08,2025-12-19,620.68,-13,134181,522038386,40509509,0.299779679419973,95.3347309981148,0.0857405756678267
554.24,555,20454,20457,1431780,1554732,2025-07-08,2025-08-01,620.68,3,122952,34440445,8262067,4.51426222860942,48.7434555505889,0.0790824399317696
593.37,615,469,713,932372,1542219,2025-07-08,2025-12-19,620.68,244,609847,522038386,40509509,0.295422528564786,95.6301535266796,0.395434759914124
574.64,575,42463,42782,1656057,1540152,2025-07-08,2025-07-18,620.68,319,-115905,131764767,24110937,1.16886481497744,71.4675995290911,-0.0752555591915605
584.25,600,217,974,304668,1534050,2025-07-08,2025-11-21,620.68,757,1229382,23945131,16405869,6.40652164316829,70.647168311587,0.801396303901437
572.93,575,7356,7338,1272588,1518966,2025-07-08,2025-08-08,620.68,-18,246378,23649737,8175363,6.42276064211623,63.0332252743445,0.162201128925861
493.57,495,10491,10527,1363830,1505361,2025-07-08,2025-09-19,620.68,36,141531,397445891,51899302,0.378758727688041,96.5119551330322,0.0940179797404076
607.8,615,1599,2044,911430,1471680,2025-07-08,2025-08-01,620.68,445,560250,34440445,8262067,4.2731155186874,53.0165710692763,0.380687377690802
615.73,619,4125,4494,878625,1469538,2025-07-08,2025-07-11,620.68,369,590913,35723216,11601493,4.11367778309769,42.7946324877357,0.402108009456033
461.79,465,4472,4474,1301352,1436154,2025-07-08,2025-12-19,620.68,2,134802,522038386,40509509,0.275105057121221,95.9052585838008,0.0938631929444892
530.68,535,3314,3318,1282518,1433376,2025-07-08,2025-10-17,620.68,4,150858,130178883,18894460,1.10108180909802,93.3124245658184,0.105246634518786
596.21,600,1909,3731,586063,1414049,2025-07-08,2025-08-01,620.68,1822,827986,34440445,8262067,4.1057802824557,57.122351351732,0.585542650926524
524.23,525,18272,18363,1315584,1413951,2025-07-08,2025-08-15,620.68,91,98367,296966434,50073190,0.47613158866298,88.7397307670132,0.0695688888794591
514.82,515,78331,78347,1644951,1410246,2025-07-08,2025-07-25,620.68,16,-234705,47357171,17128032,2.97789325295635,51.995531996622,-0.166428410362447
509.82,510,77685,77719,1398330,1398942,2025-07-08,2025-07-25,620.68,34,612,47357171,17128032,2.95402358388342,54.9495555805054,0.000437473462087778
437.51,440,5600,5611,1276800,1397139,2025-07-08,2025-12-19,620.68,11,120339,522038386,40509509,0.267631468770957,96.1728900525717,0.0861324463779198
409.82,410,77137,77151,1234192,1388718,2025-07-08,2025-08-15,620.68,14,154526,296966434,50073190,0.467634668772027,89.2073654357853,0.111272410957444
479.91,480,151550,152501,1515500,1372509,2025-07-08,2025-07-25,620.68,951,-142991,47357171,17128032,2.8982073274605,57.8477629079659,-0.104182194797994
559.79,560,64016,63721,1600400,1338141,2025-07-08,2025-07-18,620.68,-295,-262259,131764767,24110937,1.01555296644664,72.4831524955378,-0.195987567827307
618.19,624,2075,2288,744925,1329328,2025-07-08,2025-07-11,620.68,213,584403,35723216,11601493,3.72118792440188,46.5158204121376,0.439622877122877
464.02,465,13317,13460,1225164,1319080,2025-07-08,2025-09-19,620.68,143,93915.9999999998,397445891,51899302,0.331889203000969,96.8438443360332,0.0711981077720834
608.92,610,10486,12104,838880,1307232,2025-07-08,2025-07-11,620.68,1618,468352,35723216,11601493,3.65933459070426,50.1751550028419,0.358277643142151
601.75,605,4023,3940,1017819,1280500,2025-07-08,2025-07-25,620.68,-83,262681,47357171,17128032,2.70391996177305,60.551682869739,0.205139398672394
274.46,275,22878,23428,1189656,1265112,2025-07-08,2025-12-19,620.68,550,75455.9999999998,522038386,40509509,0.242340799820035,96.4152308523918,0.059643731147914
619.65,630,1719,1216,1134540,1258560,2025-07-08,2025-07-11,620.68,-503,124020,35723216,11601493,3.52308705912704,53.6982420619689,0.0985411899313501
607.95,611,3284,4104,722480,1251720,2025-07-08,2025-07-18,620.68,820,529240,131764767,24110937,0.949965630797192,73.433118126335,0.42281021314671
615.73,625,1369,1337,992525,1239399,2025-07-08,2025-07-25,620.68,-32,246874,47357171,17128032,2.61713057141863,63.1688134411576,0.199188477641179
617.8,623,1463,2380,474012,1237600,2025-07-08,2025-07-11,620.68,917,763588,35723216,11601493,3.46441373027557,57.1626557922445,0.616990950226244
469.4,470,20536,20536,1150016,1232160,2025-07-08,2025-08-29,620.68,0,82143.9999999998,90008549,22549292,1.36893663289695,62.0256049233723,0.0666666666666665
540.93,542,11428,11489,1108516,1229323,2025-07-08,2025-08-15,620.68,61,120807,296966434,50073190,0.413960252491027,89.6213256882763,0.0982711622576005
618.83,626,1496,1714,658240,1228938,2025-07-08,2025-07-11,620.68,218,570698,35723216,11601493,3.44016619332369,60.6028219855682,0.464383068958727
615.1,618,4562,4184,866780,1213360,2025-07-08,2025-07-11,620.68,-378,346580,35723216,11601493,3.39655869729086,63.999380682859,0.285636579415837
547.81,550,5432,5501,1053808,1204719,2025-07-08,2025-08-29,620.68,69,150911,90008549,22549292,1.33844952883309,63.3640544522054,0.12526655593545
612.35,617,2213,2588,745781,1203420,2025-07-08,2025-07-18,620.68,375,457639,131764767,24110937,0.913309397799793,74.3464275241347,0.380282029549118
610.24,614,3323,3193,887241,1200568,2025-07-08,2025-07-18,620.68,-130,313327,131764767,24110937,0.911144934518041,75.2575724586528,0.260982301710524
614.4,617,3302,4553,558038,1183780,2025-07-08,2025-07-11,620.68,1251,625742,35723216,11601493,3.31375540208922,67.3131360849482,0.528596529760598
588.49,595,1791,1814,994005,1180914,2025-07-08,2025-08-29,620.68,23,186909,90008549,22549292,1.31200204105057,64.676056493256,0.15827486167494
594.86,597,418,5517,73986,1180638,2025-07-08,2025-07-25,620.68,5099,1106652,47357171,17128032,2.49305010216932,65.661863543327,0.937333882189122
616.44,624,1449,1561,794052,1180116,2025-07-08,2025-07-18,620.68,112,386064,131764767,24110937,0.895623334574712,76.1531957932275,0.327140721759556
575.18,578,4115,4184,975255,1179888,2025-07-08,2025-08-15,620.68,69,204633,296966434,50073190,0.397313589993137,90.0186392782694,0.173434258166877
616.96,645,225,420,540000,1177680,2025-07-08,2025-09-19,620.68,195,637680,397445891,51899302,0.296312033076221,97.1401563691094,0.541471367434278
600.38,602,7538,7162,1002554,1160244,2025-07-08,2025-07-18,620.68,-376,157690,131764767,24110937,0.88054191299864,77.0337377062261,0.135911066982462
617.95,640,372,526,680016,1159830,2025-07-08,2025-08-15,620.68,154,479814,296966434,50073190,0.39055929129014,90.4091985695596,0.413693386099687
602.65,630,405,424,997920,1159640,2025-07-08,2025-12-19,620.68,19,161720,522038386,40509509,0.222136921555803,96.6373677739476,0.139457072884688
388.47,390,7410,7554,1067040,1155762,2025-07-08,2025-12-19,620.68,144,88722,522038386,40509509,0.221394064305455,96.858761838253,0.0767649394944634
570.57,573,4608,4749,967680,1154007,2025-07-08,2025-08-15,620.68,141,186327,296966434,50073190,0.388598463622997,90.7977970331826,0.161460892351606
608.35,640,364,363,1037400,1148895,2025-07-08,2025-12-19,620.68,-1,111495,522038386,40509509,0.220078643795363,97.0788404820484,0.0970454219053961
490.43,495,2495,2502,1035425,1143414,2025-07-08,2025-12-19,620.68,7,107989,522038386,40509509,0.219028721002903,97.2978692030513,0.0944443569870582
619.14,630,555,1041,436785,1130526,2025-07-08,2025-07-18,620.68,486,693741,131764767,24110937,0.857988084174277,77.8917257904004,0.61364444515208
555.41,557,7077,7077,962472,1125243,2025-07-08,2025-08-15,620.68,0,162771,296966434,50073190,0.378912520463508,91.1767095536461,0.144654088050314
617.35,622,2051,2395,596841,1113675,2025-07-08,2025-07-11,620.68,344,516834,35723216,11601493,3.11751047274131,70.4306465576896,0.464079736009159
464.93,465,158837,158815,1429533,1111705,2025-07-08,2025-07-25,620.68,-22,-317828,47357171,17128032,2.34749030933457,68.0093538526615,-0.285892390517269
424.79,425,52499,52498,997481,1102458,2025-07-08,2025-08-15,620.68,-1,104977,296966434,50073190,0.371239936160597,91.5479494898066,0.0952208610214629
576.33,590,693,797,846153,1089499,2025-07-08,2025-11-21,620.68,104,243346,23945131,16405869,4.54998137199584,75.1971496835829,0.223355872745179
489.23,490,14029,14037,996059,1080849,2025-07-08,2025-08-29,620.68,8,84790,90008549,22549292,1.20082926789543,65.8768857611514,0.0784475907365414
483.68,485,7945,8187,913675,1080684,2025-07-08,2025-09-19,620.68,242,167009,397445891,51899302,0.27190720157678,97.4120635706862,0.154540087574166
575.52,580,2239,2378,866493,1065344,2025-07-08,2025-08-29,620.68,139,198851,90008549,22549292,1.18360312640969,67.0604888875611,0.186654263787096
614.75,621,1718,1630,757638,1018750,2025-07-08,2025-07-18,620.68,-88,261112,131764767,24110937,0.773158123521745,78.6648839139222,0.256306257668712
542.91,545,3030,4862,506010,1016158,2025-07-08,2025-08-29,620.68,1832,510148,90008549,22549292,1.12895720605384,68.189446093615,0.50203610068513
479.33,480,15079,15079,919819,1010293,2025-07-08,2025-08-29,620.68,0,90474,90008549,22549292,1.1224411583393,69.3118872519543,0.0895522388059701
613.58,619,1441,1860,554785,1008120,2025-07-08,2025-07-18,620.68,419,453335,131764767,24110937,0.76509071654944,79.4299746304716,0.449683569416339
473.9,475,9221,9136,940542,1004960,2025-07-08,2025-09-19,620.68,-85,64418,397445891,51899302,0.252854545173798,97.66491811586,0.0641000636841267
612.22,619,3096,1481,1582056,1004118,2025-07-08,2025-07-25,620.68,-1615,-577938,47357171,17128032,2.12030824223009,70.1296620948916,-0.575567811751209
611.33,620,925,1152,637325,998784,2025-07-08,2025-08-01,620.68,227,361459,34440445,8262067,2.9000322150309,60.0223835667629,0.36189906926823
608.76,612,2675,3081,628625,998244,2025-07-08,2025-07-18,620.68,406,369619,131764767,24110937,0.757595541454568,80.1875701719262,0.370269192702385
478.1,480,5128,5234,887144,994460,2025-07-08,2025-10-17,620.68,106,107316,130178883,18894460,0.763918061887196,94.0763426277056,0.107913842688494
615.45,622,936,1509,442728,988395,2025-07-08,2025-07-18,620.68,573,545667,131764767,24110937,0.75012085742162,80.9376910293478,0.552073816642132
590.84,598,1329,1345,830625,963020,2025-07-08,2025-08-29,620.68,16,132395,90008549,22549292,1.06992059165402,70.3818078436083,0.137478972399327
603.98,615,771,866,717030,954332,2025-07-08,2025-08-29,620.68,95,237302,90008549,22549292,1.060268175193,71.4420760188013,0.248657699836116
591.94,595,1585,3105,401005,950130,2025-07-08,2025-08-01,620.68,1520,549125,34440445,8262067,2.75876226337958,62.7811458301424,0.577947228274026
610,620,525,947,420000,947000,2025-07-08,2025-08-08,620.68,422,527000,23649737,8175363,4.00427285935569,67.0374981337002,0.55649419218585
534.53,535,20058,20111,942726,945217,2025-07-08,2025-08-01,620.68,53,2491,34440445,8262067,2.74449705861815,65.5256428887606,0.00263537367609766
610.58,612,4632,6647,463200,943874,2025-07-08,2025-07-11,620.68,2015,480674,35723216,11601493,2.64218652654341,73.072833084233,0.509256532121872
602.4,613,889,887,799211,940220,2025-07-08,2025-08-29,620.68,-2,141009,90008549,22549292,1.04458966447732,72.4866656832786,0.149974474059263
343.98,345,8999,9122,854905,930444,2025-07-08,2025-12-19,620.68,123,75539.0000000001,522038386,40509509,0.178232870408116,97.4761020734594,0.0811859714286944
569.54,572,3735,3762,761940,925452,2025-07-08,2025-08-15,620.68,27,163512,296966434,50073190,0.311635220026247,91.8595847098329,0.176683393628195
459.06,460,9729,9753,846423,916782,2025-07-08,2025-09-19,620.68,24,70359,397445891,51899302,0.230668380466412,97.8955864963264,0.0767456167333128
613.66,616,2579,3898,392008,912132,2025-07-08,2025-07-11,620.68,1319,520124,35723216,11601493,2.55333114465394,75.6261642288869,0.570228870382795
529.16,530,10724,10856,836472,911904,2025-07-08,2025-08-15,620.68,132,75431.9999999998,296966434,50073190,0.307073088266939,92.1666577980998,0.082719233603537
607.7,630,231,400,450681,892000,2025-07-08,2025-10-17,620.68,169,441319,130178883,18894460,0.68521098003276,94.7615536077384,0.494752242152466
596.4,604,1210,1160,838530,881600,2025-07-08,2025-08-29,620.68,-50,43070.0000000001,90008549,22549292,0.97946251749931,73.4661282007779,0.0488543557168785
603.85,606,3871,3952,646457,849680,2025-07-08,2025-07-18,620.68,81,203223,131764767,24110937,0.644846129466461,81.5825371588142,0.239175925054138
619.06,627,1048,1048,513520,832112,2025-07-08,2025-07-11,620.68,0,318592,35723216,11601493,2.32933115540325,77.9554953842902,0.382871536523929
606.35,609,2566,3116,505502,825740,2025-07-08,2025-07-18,620.68,550,320238,131764767,24110937,0.626677387893837,82.2092145467081,0.387819410468186
542.37,550,1079,1079,744510,823277,2025-07-08,2025-11-21,620.68,0,78767,23945131,16405869,3.43818123191725,78.6353309155001,0.0956749672346003
259.53,260,13478,17481,606510,821607,2025-07-08,2025-12-19,620.68,4003,215097,522038386,40509509,0.157384403529284,97.6334864769887,0.261800349802278
561.04,563,4143,4152,646308,813792,2025-07-08,2025-08-15,620.68,9,167484,296966434,50073190,0.274035010973664,92.4406928090735,0.20580688922968
607.14,608,17843,9442,1159795,812012,2025-07-08,2025-07-11,620.68,-8401,-347783,35723216,11601493,2.27306522458672,80.2285606088769,-0.428297857667128
557.13,560,2284,2828,550444,811636,2025-07-08,2025-08-29,620.68,544,261192,90008549,22549292,0.901732123245315,74.3678603240232,0.321809283964733
358.79,360,6707,6707,771305,811547,2025-07-08,2025-12-19,620.68,0,40242,522038386,40509509,0.155457342173301,97.788943819162,0.0495867768595041
521.11,525,1817,2072,597793,806008,2025-07-08,2025-10-17,620.68,255,208215,130178883,18894460,0.61915418340162,95.38070779114,0.258328701452095
599.67,600,24552,24346,785664,803418,2025-07-08,2025-07-11,620.68,-206,17754,35723216,11601493,2.2490080400376,82.4775686489145,0.0220980859278732
610.21,625,528,541,660000,800139,2025-07-08,2025-08-29,620.68,13,140139,90008549,22549292,0.888958892115903,75.2568192161391,0.17514331884835
552.53,555,3232,3230,688416,797810,2025-07-08,2025-08-29,620.68,-2,109394,90008549,22549292,0.886371360124914,76.143190576264,0.137117860142139
591.68,610,432,433,715824,793256,2025-07-08,2025-11-21,620.68,1,77432,23945131,16405869,3.3128071005333,81.9481380160334,0.0976128765493107
584.92,591,1353,1304,683265,792832,2025-07-08,2025-08-29,620.68,-49,109567,90008549,22549292,0.880840774358,77.024031350622,0.13819699507588
592.15,593,9576,9235,794808,784975,2025-07-08,2025-07-18,620.68,-341,-9833,131764767,24110937,0.595739679029676,82.8049542257378,-0.0125265135832351
616.9,621,1428,1913,374136,784330,2025-07-08,2025-07-11,620.68,485,410194,35723216,11601493,2.19557500086218,84.6731436497767,0.522986498030166
586.67,590,1369,2337,377844,778221,2025-07-08,2025-08-08,620.68,968,400377,23649737,8175363,3.29061164612528,70.3281097798255,0.514477250035658
591.18,592,9699,9443,746823,774326,2025-07-08,2025-07-18,620.68,-256,27502.9999999999,131764767,24110937,0.587657852421202,83.392612078159,0.0355186316874287
549.85,550,53344,51591,1013536,773865,2025-07-08,2025-07-18,620.68,-1753,-239671,131764767,24110937,0.587307986512054,83.979920064671,-0.309706473351295
507,510,2597,2578,677817,773400,2025-07-08,2025-10-17,620.68,-19,95583,130178883,18894460,0.594105573943202,95.9748133650832,0.123588052754073
617.18,628,40,710,33800,768220,2025-07-08,2025-07-25,620.68,670,734420,47357171,17128032,1.62218304805412,71.7518451429457,0.956002186873552
601.27,603,4552,4430,632728,766390,2025-07-08,2025-07-18,620.68,-122,133662,131764767,24110937,0.581634998071981,84.561555062743,0.174404676470204
619.54,635,481,493,538720,762178,2025-07-08,2025-07-18,620.68,12,223458,131764767,24110937,0.578438392411835,85.1399934551548,0.293183482073741
567.73,568,27624,27623,966840,745821,2025-07-08,2025-07-18,620.68,-1,-221019,131764767,24110937,0.566024603526981,85.7060180586818,-0.296343224446617
591.57,599,995,998,611925,741514,2025-07-08,2025-08-29,620.68,3,129589,90008549,22549292,0.823826190110008,77.847857540732,0.174762715201601
611.39,613,2282,4593,251020,739473,2025-07-08,2025-07-11,620.68,2311,488453,35723216,11601493,2.07000679893994,86.7431504487166,0.660542034665228
587.59,589,240,5231,30720,737571,2025-07-08,2025-07-25,620.68,4991,706851,47357171,17128032,1.55746423281914,73.3093093757649,0.958349772428688
564,566,3585,3641,605865,728200,2025-07-08,2025-08-15,620.68,56,122335,296966434,50073190,0.245212898370864,92.6859057074444,0.167996429552321
409.45,410,12508,13000,637908,715000,2025-07-08,2025-09-19,620.68,492,77092.0000000001,397445891,51899302,0.179898702236174,98.0754851985625,0.107820979020979
566.53,569,2885,2893,539495,714571,2025-07-08,2025-08-15,620.68,8,175076,296966434,50073190,0.240623490801657,92.926529198246,0.245008543587691
616.84,635,392,389,605248,706424,2025-07-08,2025-08-15,620.68,-3,101176,296966434,50073190,0.237880083107305,93.1644092813533,0.143222767063407
583.49,584,13762,13802,743148,703902,2025-07-08,2025-07-18,620.68,40,-39246,131764767,24110937,0.534211091497623,86.2402291501794,-0.0557549204292643
424.36,425,10967,10985,658020,703040,2025-07-08,2025-09-19,620.68,18,45020,397445891,51899302,0.176889487580587,98.2523746861431,0.0640361857077833
598.48,620,274,322,521696,692944,2025-07-08,2025-11-21,620.68,48,171248,23945131,16405869,2.89388268537767,84.8420207014111,0.247131081299499
602.58,606,2060,2019,545900,690498,2025-07-08,2025-07-25,620.68,-41,144598,47357171,17128032,1.4580642918894,74.7673736676543,0.209411178598635
595.83,597,6018,5895,607818,689715,2025-07-08,2025-07-18,620.68,-123,81897,131764767,24110937,0.523444176848884,86.7636733270283,0.1187403492747
454.1,455,7660,7661,612800,689490,2025-07-08,2025-09-19,620.68,1,76690,397445891,51899302,0.17348021846828,98.4258549046114,0.111227138899767
444.22,445,8779,8800,632088,686400,2025-07-08,2025-09-19,620.68,21,54312,397445891,51899302,0.172702754146727,98.5985576587581,0.0791258741258741
439.25,440,9113,9147,637910,686025,2025-07-08,2025-09-19,620.68,34,48115,397445891,51899302,0.17260840168052,98.7711660604386,0.0701359279909624
299.31,300,9864,9865,631296,680685,2025-07-08,2025-12-19,620.68,1,49389,522038386,40509509,0.130389836888355,97.9193336560503,0.072557791048723
539.88,540,55473,56644,887568,679728,2025-07-08,2025-07-18,620.68,1171,-207840,131764767,24110937,0.515864760721658,87.27953808775,-0.305769366570157
573.29,576,2315,2499,527820,677229,2025-07-08,2025-08-15,620.68,184,149409,296966434,50073190,0.228049005700085,93.3924582870534,0.220618136553514
581.69,587,280,1257,126560,667467,2025-07-08,2025-08-29,620.68,977,540907,90008549,22549292,0.741559560081343,78.5894171008134,0.810387629650604
605.15,617,530,563,515690,667155,2025-07-08,2025-08-29,620.68,33,151465,90008549,22549292,0.74121292634103,79.3306300271544,0.227031199646259
593.05,595,2318,3371,370880,657345,2025-07-08,2025-07-25,620.68,1053,286465,47357171,17128032,1.3880579986503,76.1554316663046,0.435790946915242
348.99,350,6478,6478,654278,654278,2025-07-08,2025-12-19,620.68,0,0,522038386,40509509,0.125331396607299,98.0446650526576,0
566.67,567,19675,19673,668950,649209,2025-07-08,2025-07-18,620.68,-2,-19741.0000000001,131764767,24110937,0.49270303039355,87.7722411181435,-0.0304077731516355
608.75,616,863,889,509170,644525,2025-07-08,2025-08-01,620.68,26,135355,34440445,8262067,1.87141890878588,67.3970617975465,0.210007369768434
373.62,375,4654,4656,586404,642528,2025-07-08,2025-12-19,620.68,2,56124,522038386,40509509,0.123080604268055,98.1677456569257,0.0873487225459435
597.69,599,3871,4832,421939,632992,2025-07-08,2025-07-18,620.68,961,211053,131764767,24110937,0.480395491459413,88.2526366096029,0.333421275466357
583.38,589,1878,1116,935244,627192,2025-07-08,2025-08-29,620.68,-762,-308052,90008549,22549292,0.696813810430385,80.0274438375848,-0.491160601538285
583.82,585,2654,5302,276016,625636,2025-07-08,2025-07-25,620.68,2648,349620,47357171,17128032,1.32110087403658,77.4765325403411,0.558823341367824
606.04,618,492,519,497904,620724,2025-07-08,2025-08-29,620.68,27,122820,90008549,22549292,0.689627826352361,80.7170716639372,0.197865718096932
599.48,601,4297,4069,532828,618488,2025-07-08,2025-07-18,620.68,-228,85660,131764767,24110937,0.469387996565121,88.7220246061681,0.138499049294408
474.37,475,9596,9596,566164,604548,2025-07-08,2025-08-29,620.68,0,38384,90008549,22549292,0.671656200123835,81.388727864061,0.0634920634920635
565.85,568,2690,2802,489580,602430,2025-07-08,2025-08-15,620.68,112,112850,296966434,50073190,0.202861310581653,93.5953195976351,0.187324668426207
594.91,596,5616,5421,522288,590889,2025-07-08,2025-07-18,620.68,-195,68601,131764767,24110937,0.448442336637684,89.1704669428057,0.116097947330209
562.08,564,3057,3074,501348,590208,2025-07-08,2025-08-15,620.68,17,88860.0000000001,296966434,50073190,0.198745693932534,93.7940652915676,0.15055709173715
582.88,585,2813,2782,492275,589784,2025-07-08,2025-08-01,620.68,-31,97509,34440445,8262067,1.71247496947266,69.1095367670191,0.165330019125646
509.39,510,9612,9604,528660,585844,2025-07-08,2025-08-15,620.68,-8,57184,296966434,50073190,0.197276167581956,93.9913414591495,0.0976096025563119
610.06,616,1027,982,444691,583308,2025-07-08,2025-07-25,620.68,-45,138617,47357171,17128032,1.23172053499564,78.7082530753368,0.237639463199545
534.06,535,6017,6191,505428,581954,2025-07-08,2025-08-15,620.68,174,76526,296966434,50073190,0.195966255230044,94.1873077143796,0.131498365850222
590.23,591,4542,7487,331566,576499,2025-07-08,2025-07-18,620.68,2945,244933,131764767,24110937,0.437521359560405,89.6079883023661,0.424862835841866
529.9,530,57292,57154,802088,571540,2025-07-08,2025-07-18,620.68,-138,-230548,131764767,24110937,0.433757834520362,90.0417461368865,-0.403380340833538
614.72,635,195,281,326040,569868,2025-07-08,2025-08-29,620.68,86,243828,90008549,22549292,0.633126526681371,82.0218543907424,0.427867506159321
587.43,590,2120,2200,436720,565400,2025-07-08,2025-08-01,620.68,80,128680,34440445,8262067,1.64167449055899,70.7512112575781,0.227591085956845
449.89,450,51301,51391,564311,565301,2025-07-08,2025-08-01,620.68,90,990,34440445,8262067,1.64138703782718,72.3925982954053,0.00175127940690004
593.03,594,5676,5800,482460,562600,2025-07-08,2025-07-18,620.68,124,80140.0000000001,131764767,24110937,0.426973016238855,90.4687191531254,0.142445787415571
609.85,618,541,690,346240,562350,2025-07-08,2025-08-01,620.68,149,216110,34440445,8262067,1.63281862356889,74.0254169189742,0.384298035031564
529.79,530,26552,26582,610696,558222,2025-07-08,2025-07-25,620.68,30,-52474.0000000001,47357171,17128032,1.17874862077382,79.8870016961106,-0.0940020278670495
599.38,605,559,990,257140,556380,2025-07-08,2025-08-08,620.68,431,299240,23649737,8175363,2.35258430146602,72.6806940812915,0.537833854559833
547.67,549,4142,4167,468046,554211,2025-07-08,2025-08-15,620.68,25,86165.0000000001,296966434,50073190,0.186624121970633,94.3739318363502,0.155473276423601
589.87,590,42205,42108,675280,547404,2025-07-08,2025-07-11,620.68,-97,-127876,35723216,11601493,1.53234803943743,88.275498488154,-0.233604431096594
449.53,450,11323,11527,486889,541769,2025-07-08,2025-08-29,620.68,204,54879.9999999999,90008549,22549292,0.601908380947236,82.6237627716896,0.101297785587584
383.55,385,3740,3736,516120,541720,2025-07-08,2025-12-19,620.68,-4,25600,522038386,40509509,0.103770146894907,98.2715158038206,0.0472568854758916
561.8,565,1511,1670,410992,534400,2025-07-08,2025-08-29,620.68,159,123408,90008549,22549292,0.593721380843502,83.2174841525331,0.230928143712575
612.86,625,341,440,330088,534160,2025-07-08,2025-08-08,620.68,99,204072,23649737,8175363,2.25862976827184,74.9393238495633,0.382042833607908
617.48,629,49,463,43757,533376,2025-07-08,2025-07-25,620.68,414,489619,47357171,17128032,1.12628349358115,81.0132851896918,0.917962188024958
606.72,615,303,636,197556,526608,2025-07-08,2025-08-08,620.68,333,329052,23649737,8175363,2.22669706644095,77.1660209160043,0.624851882234983
595.45,615,150,269,264000,525895,2025-07-08,2025-11-21,620.68,119,261895,23945131,16405869,2.19625025229555,87.0382709537066,0.497998649920612
483.03,485,2655,2656,491175,523232,2025-07-08,2025-10-17,620.68,1,32057,130178883,18894460,0.401933084646302,96.3767464497295,0.0612672772307504
399.19,400,6427,6424,501306,520344,2025-07-08,2025-10-17,620.68,-3,19038,130178883,18894460,0.399714598872384,96.7764610486019,0.03658733453254
587.55,594,801,806,440550,519870,2025-07-08,2025-08-29,620.68,5,79320,90008549,22549292,0.577578469796241,83.7950626223294,0.152576605689884
593.99,602,630,649,411390,519849,2025-07-08,2025-08-29,620.68,19,108459,90008549,22549292,0.577555138679105,84.3726177610085,0.208635584563979
606.4,613,758,773,390370,510180,2025-07-08,2025-08-01,620.68,15,119810,34440445,8262067,1.48133974459389,75.5067566635681,0.234838684385903
619.29,628,620,581,333560,506051,2025-07-08,2025-07-11,620.68,-39,172491,35723216,11601493,1.41658858485753,89.6920870730116,0.340856949200772
468.3,470,2953,2955,460668,502350,2025-07-08,2025-10-17,620.68,2,41682,130178883,18894460,0.385892080515086,97.162353129117,0.0829740220961481
571.39,574,1915,1907,415555,497727,2025-07-08,2025-08-15,620.68,-8,82172,296966434,50073190,0.167603790534792,94.541535626885,0.165094519686495
438.77,440,4041,4046,484920,497658,2025-07-08,2025-10-17,620.68,5,12738,130178883,18894460,0.382287809306214,97.5446409384232,0.0255958911541661
610.19,645,142,142,494302,494302,2025-07-08,2025-12-19,620.68,0,0,522038386,40509509,0.0946869067976928,98.3662027106183,0
611.46,618,819,755,398034,493770,2025-07-08,2025-07-25,620.68,-64,95736,47357171,17128032,1.04265096409581,82.0559361537876,0.193887842517771
618.37,628,330,506,239250,487278,2025-07-08,2025-07-18,620.68,176,248028,131764767,24110937,0.369809024896618,90.838528178022,0.509007178653664
617.97,629,439,440,335835,485320,2025-07-08,2025-07-18,620.68,1,149485,131764767,24110937,0.368323043443017,91.206851221465,0.308013269595318
469.65,470,13838,13854,456654,484890,2025-07-08,2025-08-15,620.68,16,28235.9999999999,296966434,50073190,0.16328107977348,94.7048167066585,0.0582317639052155
568.08,580,382,399,403774,475608,2025-07-08,2025-11-21,620.68,17,71834,23945131,16405869,1.98624096063621,89.0245119143429,0.151036147415519
554.41,556,3003,2969,399399,472071,2025-07-08,2025-08-15,620.68,-34,72672,296966434,50073190,0.158964430303258,94.8637811369618,0.1539429450231
573.67,574,14298,14297,543324,471801,2025-07-08,2025-07-18,620.68,-1,-71523,131764767,24110937,0.358063092844842,91.5649143143098,-0.151595693947236
576.62,577,12535,12258,513935,465804,2025-07-08,2025-07-18,620.68,-277,-48130.9999999999,131764767,24110937,0.353511800313053,91.9184261146229,-0.10332886793587
249.58,250,10976,11006,471968,462252,2025-07-08,2025-12-19,620.68,30,-9716.00000000006,522038386,40509509,0.0885475115234151,98.4547502221417,-0.0210188382094616
427.94,430,2236,2236,460616,460616,2025-07-08,2025-12-19,620.68,0,0,522038386,40509509,0.0882341246070744,98.5429843467488,0
499.95,500,93138,91749,745104,458745,2025-07-08,2025-07-18,620.68,-1389,-286359,131764767,24110937,0.348154526012253,92.2665806406351,-0.62422260733087
581.53,582,9802,9726,509704,457122,2025-07-08,2025-07-18,620.68,-76,-52582.0000000001,131764767,24110937,0.346922785512154,92.6135034261473,-0.115028373169526
612.2,622,217,464,165788,454720,2025-07-08,2025-08-01,620.68,247,288932,34440445,8262067,1.32030814352137,76.8270648070895,0.635406403940887
444.94,445,75677,75677,454062,454062,2025-07-08,2025-07-25,620.68,0,0,47357171,17128032,0.958803050123074,83.0147392039106,0
509.93,510,64851,64817,583659,453719,2025-07-08,2025-07-18,620.68,-34,-129940,131764767,24110937,0.34434015278151,92.9578435789288,-0.286388711956078
574.26,577,1669,1647,393884,451278,2025-07-08,2025-08-15,620.68,-22,57394.0000000001,296966434,50073190,0.151962628880812,95.0157437658426,0.127181028102412
586.01,592,734,749,375074,448651,2025-07-08,2025-08-29,620.68,15,73577,90008549,22549292,0.49845376354195,84.8710715245504,0.163996068213377
449.7,450,14849,14841,371225,445230,2025-07-08,2025-08-15,620.68,-8,74005,296966434,50073190,0.149926035075062,95.1656698009176,0.166217460638322
589.52,597,591,595,341007,445060,2025-07-08,2025-08-29,620.68,4,104053,90008549,22549292,0.494464142511619,85.365535667062,0.233795443311014
509.01,510,4394,4375,408642,433125,2025-07-08,2025-08-29,620.68,-19,24483,90008549,22549292,0.481204290939075,85.8467399580011,0.0565264069264069
559.3,561,2542,2542,373674,432140,2025-07-08,2025-08-15,620.68,0,58465.9999999999,296966434,50073190,0.145518129500117,95.3111879304178,0.135294117647059
499.15,500,5080,5080,411480,431800,2025-07-08,2025-08-29,620.68,0,20320,90008549,22549292,0.479732208548324,86.3264721665494,0.0470588235294118
514.35,515,6574,6601,394440,429065,2025-07-08,2025-08-15,620.68,27,34625.0000000001,296966434,50073190,0.144482658939158,95.4556705893569,0.0806987286308604
554.81,555,22753,22574,477813,428906,2025-07-08,2025-07-18,620.68,-179,-48906.9999999999,131764767,24110937,0.325508866873343,93.2833524458021,-0.114027316008636
413.05,415,2175,2199,389325,428805,2025-07-08,2025-12-19,620.68,24,39480,522038386,40509509,0.0821405114067608,98.6251248581556,0.0920698219470389
565.72,566,15244,15237,487808,426636,2025-07-08,2025-07-18,620.68,-7,-61171.9999999999,131764767,24110937,0.323786099815287,93.6071385456174,-0.14338218059423
617.59,626,534,501,332148,421341,2025-07-08,2025-07-18,620.68,-33,89193,131764767,24110937,0.319767574893522,93.926906120511,0.211688394910536
610.52,619,450,482,297450,408736,2025-07-08,2025-08-01,620.68,32,111286,34440445,8262067,1.18679070494008,78.0138555120295,0.272268652626634
615.47,630,209,277,247665,402481,2025-07-08,2025-08-08,620.68,68,154816,23649737,8175363,1.70184133548716,78.8678622514914,0.384654182433457
530.05,531,4248,4229,335592,401755,2025-07-08,2025-08-15,620.68,-19,66163,296966434,50073190,0.135286333404266,95.5909569227612,0.16468494480467
353.84,355,3411,3411,382032,395676,2025-07-08,2025-12-19,620.68,0,13644,522038386,40509509,0.0757944263508623,98.7009192845064,0.0344827586206897
378.59,380,2815,2793,371580,393813,2025-07-08,2025-12-19,620.68,-22,22232.9999999999,522038386,40509509,0.0754375560420953,98.7763568405485,0.0564557289881237
604.1,611,473,567,230824,391230,2025-07-08,2025-08-01,620.68,94,160406,34440445,8262067,1.13596093197983,79.1498164440094,0.410004345270046
489.54,490,8638,8424,371434,387504,2025-07-08,2025-08-15,620.68,-214,16070,296966434,50073190,0.130487474554111,95.7214443973153,0.0414705396589455
448.65,450,2740,2854,347980,385290,2025-07-08,2025-10-17,620.68,114,37310,130178883,18894460,0.295969661991953,97.8406106004151,0.096836149393963
592.2,594,3414,2124,501858,382320,2025-07-08,2025-07-25,620.68,-1290,-119538,47357171,17128032,0.807311737434654,83.8220509413453,-0.312664783427495
609.07,617,478,480,291580,380640,2025-07-08,2025-08-01,620.68,2,89060,34440445,8262067,1.10521220036501,80.2550286443744,0.233974358974359
572.68,573,12312,11893,480168,380576,2025-07-08,2025-07-18,620.68,-419,-99592,131764767,24110937,0.288829866029361,94.2157359865403,-0.261687547296729
603.42,607,1004,1061,282124,379838,2025-07-08,2025-07-25,620.68,57,97714,47357171,17128032,0.802070714908203,84.6241216562535,0.257251775757033
523.71,525,2740,2938,323320,379002,2025-07-08,2025-08-29,620.68,198,55682,90008549,22549292,0.421073336045002,86.7475455025944,0.146917430514879
557.33,559,2277,2252,330165,376084,2025-07-08,2025-08-15,620.68,-25,45919,296966434,50073190,0.126641922096825,95.8480863194121,0.122097722849151
368.71,370,2906,2904,351626,374616,2025-07-08,2025-12-19,620.68,-2,22990.0000000001,522038386,40509509,0.0717602402517581,98.8481170808003,0.0613695090439278
585.44,586,8421,6670,496839,373520,2025-07-08,2025-07-18,620.68,-1751,-123319,131764767,24110937,0.28347486851322,94.4992108550535,-0.330153673163418
611.75,623,106,330,94340,371250,2025-07-08,2025-08-08,620.68,224,276910,23649737,8175363,1.56978489866505,80.4376471501565,0.745885521885522
568.67,569,11255,11162,405180,368346,2025-07-08,2025-07-18,620.68,-93,-36834,131764767,24110937,0.279548173906003,94.7787590289595,-0.0999983710967406
612.6,623,286,347,225654,360880,2025-07-08,2025-08-01,620.68,61,135226,34440445,8262067,1.04783779652092,81.3028664408953,0.37471181556196
560.2,562,2047,1995,317285,359100,2025-07-08,2025-08-15,620.68,-52,41815,296966434,50073190,0.120922757216393,95.9690090766285,0.116443887496519
469.96,470,89416,89431,357664,357724,2025-07-08,2025-07-18,620.68,15,60,131764767,24110937,0.271486838359453,95.050245867319,0.000167727074504366
620.3,650,50,120,128350,356400,2025-07-08,2025-08-15,620.68,70,228050,296966434,50073190,0.120013563553112,96.0890226401816,0.639870931537598
618.67,635,221,218,276250,355994,2025-07-08,2025-07-25,620.68,-3,79744,47357171,17128032,0.751721423562231,85.3758430798157,0.224003775344528
573.59,575,1894,2480,232962,349680,2025-07-08,2025-08-01,620.68,586,116718,34440445,8262067,1.01531789150808,82.3181843324034,0.333785175017159
149.9,150,34902,34899,383922,348990,2025-07-08,2025-12-19,620.68,-3,-34932,522038386,40509509,0.0668514058274634,98.9149684866277,-0.100094558583341
613.62,625,432,306,376272,348228,2025-07-08,2025-08-01,620.68,-126,-28044,34440445,8262067,1.0111019181082,83.3292862505116,-0.0805334436059134
389.55,390,7675,7731,314675,347895,2025-07-08,2025-09-19,620.68,56,33220,397445891,51899302,0.0875326699502851,98.8586987303889,0.095488581324825
613.09,624,319,316,267960,344756,2025-07-08,2025-08-01,620.68,-3,76796,34440445,8262067,1.00102074755422,84.3303069980658,0.222754643864066
618.8,640,131,162,215888,343440,2025-07-08,2025-08-01,620.68,31,127552,34440445,8262067,0.997199658715211,85.327506656781,0.371395294665735
199.77,200,14878,14890,327316,342470,2025-07-08,2025-12-19,620.68,12,15154,522038386,40509509,0.0656024555251767,98.9805709421529,0.0442491313107718
568.66,571,1468,1450,290664,339300,2025-07-08,2025-08-15,620.68,-18,48636,296966434,50073190,0.114255337018998,96.2032779772006,0.143342175066313
617.7,650,94,105,261038,339150,2025-07-08,2025-09-19,620.68,11,78111.9999999999,397445891,51899302,0.0853323704383196,98.9440311008273,0.23031696889282
434.29,435,4736,4750,307840,337250,2025-07-08,2025-09-19,620.68,14,29410,397445891,51899302,0.0848543179428669,99.0288854187701,0.0872053372868792
589.11,596,487,489,270285,336921,2025-07-08,2025-08-29,620.68,2,66636,90008549,22549292,0.37432111032031,87.1218666129147,0.197779301379255
614.67,623,380,404,247380,336532,2025-07-08,2025-07-25,620.68,24,89152,47357171,17128032,0.710625218723475,86.0864682985392,0.264913886346618
617.44,627,240,352,160800,336512,2025-07-08,2025-07-18,620.68,112,175712,131764767,24110937,0.255388452969374,95.3056343202884,0.522156713579308
582.38,588,593,595,272780,334390,2025-07-08,2025-08-29,620.68,2,61610,90008549,22549292,0.37150915520258,87.4933757681173,0.18424594036903
610.79,626,202,219,258358,333099,2025-07-08,2025-08-29,620.68,17,74741,90008549,22549292,0.370074847001478,87.8634506151188,0.224380739659981
299.83,300,19357,19381,290355,329477,2025-07-08,2025-09-19,620.68,24,39122.0000000001,397445891,51899302,0.0828985800233119,99.1117839987934,0.118739699584493
414.42,415,5598,5642,302292,327236,2025-07-08,2025-09-19,620.68,44,24943.9999999999,397445891,51899302,0.0823347296852542,99.1941187284787,0.0762263320661539
608.57,624,211,212,253833,327116,2025-07-08,2025-08-29,620.68,1,73283,90008549,22549292,0.363427700628748,88.2268783157475,0.224027562088067
544.8,546,2719,2709,285495,325080,2025-07-08,2025-08-15,620.68,-10,39585,296966434,50073190,0.109466917059051,96.3127448942597,0.121770025839793
590.11,593,1114,1124,257334,324836,2025-07-08,2025-08-01,620.68,10,67502,34440445,8262067,0.943181773638523,86.2706884304195,0.207803322291864
604.23,608,664,858,188576,323466,2025-07-08,2025-07-25,620.68,194,134890,47357171,17128032,0.683034888211545,86.7695031867507,0.4170144621073
329.12,330,3649,3647,306516,320936,2025-07-08,2025-12-19,620.68,-2,14420,522038386,40509509,0.0614774715053234,99.0420484136582,0.0449310766009422
604.69,616,283,279,266020,315549,2025-07-08,2025-08-29,620.68,-4,49529,90008549,22549292,0.350576699108881,88.5774550148564,0.156961359408523
429.31,430,4517,4555,280054,314295,2025-07-08,2025-09-19,620.68,38,34241,397445891,51899302,0.0790786889780677,99.2731974174568,0.108945417521755
602.53,603,7367,6684,294680,314148,2025-07-08,2025-07-11,620.68,-683,19468,35723216,11601493,0.879394509161773,90.5714815821733,0.0619707908374397
494.19,495,3863,3873,289725,313713,2025-07-08,2025-08-29,620.68,10,23988,90008549,22549292,0.34853689286781,88.9259919077242,0.0764647942546213
419.96,420,77646,77648,543522,310592,2025-07-08,2025-07-25,620.68,2,-232930,47357171,17128032,0.655849987322934,87.4253531740737,-0.74995492478879
532.99,534,3071,3071,251822,310171,2025-07-08,2025-08-15,620.68,0,58349,296966434,50073190,0.10444648434577,96.4171913786054,0.188118811881188
549.75,551,2455,2447,289690,305875,2025-07-08,2025-08-15,620.68,-8,16185.0000000001,296966434,50073190,0.102999856205971,96.5201912348114,0.0529137719656724
479.6,480,7687,7621,292106,304840,2025-07-08,2025-08-15,620.68,-66,12734,296966434,50073190,0.10265133196838,96.6228425667798,0.041772733237108
486.64,490,906,907,326160,304752,2025-07-08,2025-11-21,620.68,1,-21408,23945131,16405869,1.27270967947513,90.297221593818,-0.0702472830366987
588.5,590,2171,2021,275717,303150,2025-07-08,2025-07-25,620.68,-150,27433,47357171,17128032,0.640135366194066,88.0654885402677,0.0904931552036945
576.42,581,304,660,119776,302280,2025-07-08,2025-08-29,620.68,356,182504,90008549,22549292,0.335834766095385,89.2618266738196,0.603758105068149
363.72,365,2350,2350,291400,300800,2025-07-08,2025-12-19,620.68,0,9400,522038386,40509509,0.0576202838846414,99.0996686975429,0.03125
504.94,505,50078,50047,400624,300282,2025-07-08,2025-07-18,620.68,-31,-100342,131764767,24110937,0.227892483580228,95.5335268038686,-0.33415922366309
571.69,572,9667,9677,348012,299987,2025-07-08,2025-07-18,620.68,10,-48025,131764767,24110937,0.227668599755502,95.7611954036241,-0.160090270578392
159.87,160,22908,22913,274896,297869,2025-07-08,2025-12-19,620.68,5,22973,522038386,40509509,0.0570588309189968,99.1567275284619,0.0771245077534084
612.81,630,154,172,224840,295668,2025-07-08,2025-08-29,620.68,18,70828,90008549,22549292,0.32848879721414,89.5903154710338,0.239552471014787
580.55,581,7544,6565,362112,295425,2025-07-08,2025-07-18,620.68,-979,-66687,131764767,24110937,0.224206369218564,95.9854017728427,-0.225732419395786
539.96,541,2666,2840,301258,295360,2025-07-08,2025-08-15,620.68,174,-5898,296966434,50073190,0.0994590519950817,96.7223016187749,-0.0199688515709642
551.58,553,2002,2076,248248,294792,2025-07-08,2025-08-15,620.68,74,46544,296966434,50073190,0.0992677845873989,96.8215694033623,0.157887595321447
609.27,623,87,213,99354,292449,2025-07-08,2025-08-29,620.68,126,193095,90008549,22549292,0.324912470258797,89.9152279412926,0.660268969974252
549.65,550,8352,8348,309024,292180,2025-07-08,2025-07-25,620.68,-4,-16844,47357171,17128032,0.616970975736705,88.6824595160045,-0.0576493942090492
384.28,385,4054,4055,320266,291960,2025-07-08,2025-10-17,620.68,1,-28306.0000000001,130178883,18894460,0.224276006424176,98.0648866068393,-0.096951637210577
408.18,410,1596,1596,290472,290472,2025-07-08,2025-12-19,620.68,0,0,522038386,40509509,0.0556418853076448,99.2123694137695,0
594.75,603,366,352,247416,290400,2025-07-08,2025-08-29,620.68,-14,42984,90008549,22549292,0.322636019829627,90.2378639611222,0.14801652892562
324.11,325,3248,3248,289072,289072,2025-07-08,2025-12-19,620.68,0,0,522038386,40509509,0.0553737057948838,99.2677431195644,0
587.34,588,4392,4303,281088,283998,2025-07-08,2025-07-18,620.68,-89,2910,131764767,24110937,0.21553409645539,96.200935869298,0.0102465510320495
519.92,520,34994,34921,384934,279368,2025-07-08,2025-07-18,620.68,-73,-105566,131764767,24110937,0.212020258799532,96.4129561280976,-0.37787434495003
574.27,575,3798,3806,269658,277838,2025-07-08,2025-07-25,620.68,8,8180,47357171,17128032,0.586686227519799,89.2691457435243,0.029441617057422
542.86,544,1694,2406,171094,274284,2025-07-08,2025-08-15,620.68,712,103190,296966434,50073190,0.0923619536071878,96.9139313569695,0.376215893015998
614.5,626,394,238,358146,273700,2025-07-08,2025-08-01,620.68,-156,-84446,34440445,8262067,0.79470517875132,87.0653936091708,-0.308534892217757
611.28,622,95,254,81130,272288,2025-07-08,2025-08-08,620.68,159,191158,23649737,8175363,1.15133627067396,81.5889834208304,0.702043424609237
419.39,420,4386,4444,254388,271084,2025-07-08,2025-09-19,620.68,58,16696,397445891,51899302,0.0682065171985889,99.3414039346554,0.0615897655339306
598.83,608,280,294,214760,269598,2025-07-08,2025-08-29,620.68,14,54838,90008549,22549292,0.299524881797617,90.5373888429198,0.203406553461079
607.08,614,305,385,164395,266420,2025-07-08,2025-08-01,620.68,80,102025,34440445,8262067,0.773567240492973,87.8389608496638,0.382947976878613
502.29,505,958,976,234710,264496,2025-07-08,2025-10-17,620.68,18,29786,130178883,18894460,0.203178882707113,98.2680654895464,0.112614179420483
537.98,539,2588,2583,232920,263466,2025-07-08,2025-08-15,620.68,-5,30546,296966434,50073190,0.0887191176629747,97.0026504746324,0.115939058550249
586.21,593,435,388,226635,263452,2025-07-08,2025-08-29,620.68,-47,36817,90008549,22549292,0.292696641515685,90.8300854844355,0.139748417168972
484.55,485,5841,5850,233640,263250,2025-07-08,2025-08-15,620.68,9,29610,296966434,50073190,0.0886463821699122,97.0912968568024,0.112478632478632
516.31,517,3768,3756,237384,259164,2025-07-08,2025-08-15,620.68,-12,21780,296966434,50073190,0.0872704690928134,97.1785673258952,0.0840394499236005
588.35,589,4134,3979,276978,258635,2025-07-08,2025-07-18,620.68,-155,-18343,131764767,24110937,0.196285400026549,96.6092415281241,-0.0709223422970596
570.7,571,8498,8508,305928,255240,2025-07-08,2025-07-18,620.68,10,-50688,131764767,24110937,0.193708838721659,96.8029503668458,-0.198589562764457
605.65,612,359,398,180577,252730,2025-07-08,2025-08-01,620.68,39,72153,34440445,8262067,0.733817463740669,88.5727783134045,0.285494401139556
579.1,580,2601,2784,221085,250560,2025-07-08,2025-07-25,620.68,183,29475,47357171,17128032,0.52908565843175,89.798231401956,0.117636494252874
393.78,395,2053,2053,231989,250466,2025-07-08,2025-11-21,620.68,0,18477,23945131,16405869,1.04599970657918,91.3432213003972,0.0737704918032787
609.76,611,1344,2011,120960,249364,2025-07-08,2025-07-11,620.68,667,128404,35723216,11601493,0.698044655330024,91.2695262375034,0.514925971671933
603.21,614,236,231,212400,249249,2025-07-08,2025-08-29,620.68,-5,36849,90008549,22549292,0.276917029292406,91.1070025137279,0.147840111695533
584.91,585,27080,27643,324960,248787,2025-07-08,2025-07-11,620.68,563,-76173,35723216,11601493,0.696429459206584,91.96595569671,-0.306177573587044
612.52,640,86,90,206314,247320,2025-07-08,2025-10-17,620.68,4,41006,130178883,18894460,0.18998473047276,98.4580502200192,0.165801390910561
536.98,538,2409,2423,216810,247146,2025-07-08,2025-08-15,620.68,14,30336,296966434,50073190,0.0832235470760308,97.2617908729712,0.122745259886868
601.04,611,222,248,185592,247008,2025-07-08,2025-08-29,620.68,26,61416.0000000001,90008549,22549292,0.274427265792275,91.3814297795202,0.248639720171007
487.8,490,1115,1119,219655,246180,2025-07-08,2025-10-17,620.68,4,26525,130178883,18894460,0.189109012404109,98.6471592324233,0.107746364448777
606.39,611,480,529,162720,243869,2025-07-08,2025-07-25,620.68,49,81149,47357171,17128032,0.514956858381596,90.3131882603376,0.332756520919018
616.18,630,115,176,121325,243232,2025-07-08,2025-08-01,620.68,61,121907,34440445,8262067,0.7062394228646,89.2790177362691,0.501196388633075
612,624,42,202,39480,242400,2025-07-08,2025-08-08,620.68,160,202920,23649737,8175363,1.02495854393645,82.6139419647669,0.837128712871287
607.16,612,475,500,171475,242000,2025-07-08,2025-07-25,620.68,25,70525,47357171,17128032,0.511010254392096,90.8241985147297,0.291425619834711
562.77,563,10464,10506,292992,241638,2025-07-08,2025-07-18,620.68,42,-51354,131764767,24110937,0.183385897081274,96.9863362639271,-0.212524520149976
561.72,562,8888,8592,239976,240576,2025-07-08,2025-07-18,620.68,-296,600,131764767,24110937,0.182579915312263,97.1689161792393,0.00249401436552275
611.1,625,158,173,182490,240470,2025-07-08,2025-08-22,620.68,15,57980,1750119,1049799,13.7402085229633,13.7402085229633,0.241111157316921
556.37,558,1437,1468,205491,239284,2025-07-08,2025-08-15,620.68,31,33793,296966434,50073190,0.0805761098239136,97.3423669827951,0.14122548937664
552.47,554,1517,1554,192659,237762,2025-07-08,2025-08-15,620.68,37,45103,296966434,50073190,0.0800635939885381,97.4224305767837,0.189698101462807
544.86,545,16603,16701,298854,233814,2025-07-08,2025-07-18,620.68,98,-65040,131764767,24110937,0.177448042692627,97.346364221932,-0.278169827298622
608.52,622,58,170,66004,229160,2025-07-08,2025-08-29,620.68,112,163156,90008549,22549292,0.254598038237457,91.6360278177576,0.711974166521208
569.37,570,3718,3632,226798,228816,2025-07-08,2025-07-25,620.68,-86,2018,47357171,17128032,0.483170753590834,91.3073692683205,0.00881931333473184
612.76,628,30,150,40560,228600,2025-07-08,2025-08-29,620.68,120,188040,90008549,22549292,0.253975875113818,91.8900036928714,0.82257217847769
601.71,625,51,97,106029,225913,2025-07-08,2025-11-21,620.68,46,119884,23945131,16405869,0.943461115330712,92.2866824157279,0.530664459327263
606.72,619,168,178,175224,218584,2025-07-08,2025-08-29,620.68,10,43360,90008549,22549292,0.242848043245314,92.1328517361168,0.198367675584672
604.49,612,187,289,110517,217039,2025-07-08,2025-08-08,620.68,102,106522,23649737,8175363,0.917722679114783,83.5316646438817,0.490796584945563
550.62,552,1565,1566,187800,216108,2025-07-08,2025-08-15,620.68,1,28308,296966434,50073190,0.0727718608090233,97.4952024375927,0.130990060525293
494.5,495,4732,4320,222404,216000,2025-07-08,2025-08-15,620.68,-412,-6404,296966434,50073190,0.072735493062492,97.5679379306552,-0.0296481481481482
546.73,548,1661,1696,184371,215392,2025-07-08,2025-08-15,620.68,35,31021,296966434,50073190,0.0725307561190569,97.6404686867742,0.144021133561135
403.26,405,1241,1236,222139,215064,2025-07-08,2025-12-19,620.68,-5,-7075,522038386,40509509,0.04119697052316,99.3089400900875,-0.0328971840940371
607.9,617,213,236,150804,214760,2025-07-08,2025-08-08,620.68,23,63956,23649737,8175363,0.908086208315974,84.4397508521976,0.297802197802198
608.04,609,1709,2229,123048,213984,2025-07-08,2025-07-11,620.68,520,90936,35723216,11601493,0.599005419892767,92.5649611166027,0.424966352624495
607.26,616,225,242,152550,211508,2025-07-08,2025-08-08,620.68,17,58958,23649737,8175363,0.894335526860193,85.3340863790579,0.278750685553265
608.32,620,82,181,80688,211408,2025-07-08,2025-08-22,620.68,99,130720,1750119,1049799,12.0796357276277,25.819844250591,0.618330432150155
592.85,593,18697,14055,373940,210825,2025-07-08,2025-07-11,620.68,-4642,-163115,35723216,11601493,0.590162431064437,93.1551235476672,-0.773698565160678
597.45,607,198,220,147708,210100,2025-07-08,2025-08-29,620.68,22,62392,90008549,22549292,0.233422271922193,92.366274008039,0.29696335078534
399.85,400,13838,13890,179894,208350,2025-07-08,2025-08-15,620.68,52,28456,296966434,50073190,0.0701594443498621,97.7106281311241,0.136577873770098
568.8,570,1188,1733,125928,207960,2025-07-08,2025-08-01,620.68,545,82032,34440445,8262067,0.603824950577729,89.8828426868468,0.394460473167917
551.19,560,233,236,183837,207916,2025-07-08,2025-11-21,620.68,3,24079,23945131,16405869,0.868301785444398,93.1549842011723,0.115811192981781
533.43,535,1279,1316,179060,206612,2025-07-08,2025-08-29,620.68,37,27552,90008549,22549292,0.229547084466388,92.5958210925053,0.133351402629083
604.87,609,454,499,141194,206087,2025-07-08,2025-07-25,620.68,45,64893,47357171,17128032,0.435175910317785,91.7425451786383,0.314881579138907
608.64,614,380,381,147820,204216,2025-07-08,2025-07-25,620.68,1,56396,47357171,17128032,0.431225083103043,92.1737702617414,0.276158577192776
580.63,586,373,378,167850,202986,2025-07-08,2025-08-29,620.68,5,35136,90008549,22549292,0.225518578240829,92.8213396707462,0.17309568147557
595.3,599,532,541,158004,200170,2025-07-08,2025-08-01,620.68,9,42166,34440445,8262067,0.581206195216119,90.4640488820629,0.210650946695309
504.06,505,2013,2126,171105,199844,2025-07-08,2025-08-29,620.68,113,28739,90008549,22549292,0.222027798714986,93.0433674694611,0.143807169592282
608,613,373,397,139129,198500,2025-07-08,2025-07-25,620.68,24,59371,47357171,17128032,0.419155105358806,92.5929253671002,0.299098236775819
619.5,629,160,208,94560,197600,2025-07-08,2025-07-11,620.68,48,103040,35723216,11601493,0.553141688027192,93.7082652356943,0.521457489878543
573.32,578,440,421,158840,197028,2025-07-08,2025-08-29,620.68,-19,38188,90008549,22549292,0.218899207007548,93.2622666764687,0.193820167691902
565.46,569,428,554,126688,196116,2025-07-08,2025-08-29,620.68,126,69428,90008549,22549292,0.217885969920479,93.4801526463892,0.354014970731608
458.48,460,1284,1289,178476,195928,2025-07-08,2025-10-17,620.68,5,17452,130178883,18894460,0.150506745398945,98.7976659778222,0.0890735372177536
610.32,635,77,79,166782,194972,2025-07-08,2025-10-17,620.68,2,28190,130178883,18894460,0.149772371299268,98.9474383491215,0.144584863467575
587.34,605,78,110,117858,194260,2025-07-08,2025-11-21,620.68,32,76402,23945131,16405869,0.811271402106758,93.966255603279,0.393297642335015
601.68,612,179,188,151971,194016,2025-07-08,2025-08-29,620.68,9,42045,90008549,22549292,0.215552858206835,93.695705504596,0.216708931222167
269.88,270,16210,16099,178310,193188,2025-07-08,2025-09-19,620.68,-111,14878,397445891,51899302,0.0486073713113315,99.3900113059667,0.0770130649936849
214.73,215,7140,7140,192780,192780,2025-07-08,2025-12-19,620.68,0,0,522038386,40509509,0.0369283189071847,99.3458684089947,0
593.17,601,250,246,160500,192618,2025-07-08,2025-08-29,620.68,-4,32118,90008549,22549292,0.213999672408895,93.9097051770049,0.166744541008628
600.1,603,648,663,148392,192270,2025-07-08,2025-07-25,620.68,15,43878,47357171,17128032,0.405999758727142,92.9989251258273,0.228210329224528
522.29,523,2697,2697,191487,191487,2025-07-08,2025-08-15,620.68,0,0,296966434,50073190,0.0644810248150806,97.7751091559391,0
309.26,310,2580,2579,180600,190846,2025-07-08,2025-12-19,620.68,-1,10246,522038386,40509509,0.0365578480659849,99.3824262570607,0.0536872661727258
600.96,604,615,624,146370,189696,2025-07-08,2025-07-25,620.68,9,43326,47357171,17128032,0.400564467839517,93.3994895936668,0.228397014170041
563.76,564,7815,7815,226635,187560,2025-07-08,2025-07-18,620.68,0,-39075,131764767,24110937,0.142344576832136,97.4887087987641,-0.208333333333333
219.71,220,6415,6451,186035,187079,2025-07-08,2025-12-19,620.68,36,1044,522038386,40509509,0.0358362536198631,99.4182625106806,0.00558053015036429
563.39,567,431,518,121542,186998,2025-07-08,2025-08-29,620.68,87,65456,90008549,22549292,0.207755821060953,94.1174609980659,0.350035829260206
579,584,311,372,129376,186000,2025-07-08,2025-08-29,620.68,61,56624,90008549,22549292,0.206647037494183,94.32410803556,0.304430107526882
534.9,535,18736,18583,299776,185830,2025-07-08,2025-07-18,620.68,-153,-113946,131764767,24110937,0.14103163101256,97.6297404297767,-0.613173330463327
532.12,533,2002,2101,164164,184888,2025-07-08,2025-08-15,620.68,99,20724,296966434,50073190,0.0622588881543427,97.8373680440935,0.112089481199429
354.68,355,5733,5733,166257,183456,2025-07-08,2025-09-19,620.68,0,17199,397445891,51899302,0.0461587361083071,99.436170042075,0.09375
528.58,530,1199,1280,155870,181760,2025-07-08,2025-08-29,620.68,81,25890,90008549,22549292,0.201936373843778,94.5260444094038,0.142440580985916
609.93,623,115,139,122245,181673,2025-07-08,2025-08-22,620.68,24,59428,1750119,1049799,10.3806084043428,36.2004526549338,0.327115201488388
545.82,547,1942,1539,209736,181602,2025-07-08,2025-08-15,620.68,-403,-28134,296966434,50073190,0.0611523657922902,97.8985204098858,-0.154921201308356
324.58,325,4210,4271,168400,179382,2025-07-08,2025-10-17,620.68,61,10982,130178883,18894460,0.137796542623584,99.0852348917451,0.0612213042557224
514.94,515,29874,29854,268866,179124,2025-07-08,2025-07-18,620.68,-20,-89742,131764767,24110937,0.135942258373211,97.7656826881499,-0.501004890466939
607.59,621,131,133,145279,178353,2025-07-08,2025-08-29,620.68,2,33074,90008549,22549292,0.198151177839785,94.7241955872436,0.185441231714633
568.31,570,1024,1049,150528,177281,2025-07-08,2025-08-08,620.68,25,26753,23649737,8175363,0.749610873051146,86.083697252109,0.150907316632916
194.78,195,8018,8028,160360,176616,2025-07-08,2025-12-19,620.68,10,16256,522038386,40509509,0.0338319948755646,99.4520945055562,0.0920414911446302
603.64,607.5,500,452,146000,174472,2025-07-08,2025-07-25,620.68,-48,28472,47357171,17128032,0.368417277290487,93.7679068709573,0.163189508918336
393.41,395,1094,1095,165194,174105,2025-07-08,2025-12-19,620.68,1,8911.00000000003,522038386,40509509,0.0333509957637483,99.4854455013199,0.0511817581344593
616.11,650,63,51,186669,172839,2025-07-08,2025-10-17,620.68,-12,-13830,130178883,18894460,0.132770381813769,99.2180052735588,-0.0800166629059412
582.51,583,3452,3526,193312,172774,2025-07-08,2025-07-18,620.68,74,-20538,131764767,24110937,0.131123064179972,97.8968057523298,-0.118872052507901
498.48,499,3300,3315,178200,172380,2025-07-08,2025-08-15,620.68,15,-5820.00000000003,296966434,50073190,0.0580469643245943,97.9565673742104,-0.0337626174730249
599.45,602.5,622,562,139328,171410,2025-07-08,2025-07-25,620.68,-60,32082,47357171,17128032,0.361951519443592,94.1298583904009,0.187165276238259
555.52,565,106,179,92220,169692,2025-07-08,2025-11-21,620.68,73,77472,23945131,16405869,0.70867016764285,94.6749257709219,0.456544798811965
598.14,606,55,215,34870,168990,2025-07-08,2025-08-22,620.68,160,134120,1750119,1049799,9.65591482636324,45.856367481297,0.793656429374519
595.98,601,224,336,88928,168672,2025-07-08,2025-08-08,620.68,112,79744,23649737,8175363,0.713208776909443,86.7969060290184,0.47277556440903
609.34,619,153,174,115515,168084,2025-07-08,2025-08-08,620.68,21,52569,23649737,8175363,0.710722491332567,87.507628520351,0.312754337117156
525.26,526,2272,2267,163584,167758,2025-07-08,2025-08-15,620.68,-5,4174,296966434,50073190,0.0564905594684145,98.0130579336788,0.0248810786966941
571.84,576,346,403,128020,167648,2025-07-08,2025-08-29,620.68,57,39628,90008549,22549292,0.18625786312809,94.9104534503717,0.236376216835274
595.76,598,723,747,130863,167328,2025-07-08,2025-07-25,620.68,24,36465,47357171,17128032,0.353331916722813,94.4831903071237,0.217925272518646
577.61,578,4224,4270,185856,166530,2025-07-08,2025-07-18,620.68,46,-19326,131764767,24110937,0.126384316377989,98.0231900687078,-0.116051161952801
556.79,557,8074,7923,193776,166383,2025-07-08,2025-07-18,620.68,-151,-27393,131764767,24110937,0.126272753929736,98.1494628226376,-0.164638214240638
580.46,595,112,114,147392,165756,2025-07-08,2025-11-21,620.68,2,18364,23945131,16405869,0.692232587911087,95.367158358833,0.110789353024928
620.6,660,20,42,68000,165480,2025-07-08,2025-08-15,620.68,22,97480,296966434,50073190,0.0557234694073203,98.0687814030861,0.589074208363549
619.62,645,60,64,127860,162432,2025-07-08,2025-08-15,620.68,4,34572,296966434,50073190,0.054697090782994,98.1234784938691,0.212839834515367
560.67,564,482,485,127248,161505,2025-07-08,2025-08-29,620.68,3,34257,90008549,22549292,0.179432955862893,95.0898864062346,0.212111080152317
439.6,440,4002,4021,160080,160840,2025-07-08,2025-08-29,620.68,19,759.999999999971,90008549,22549292,0.178694137153572,95.2685805433882,0.00472519273812466
164.86,165,11454,11468,148902,160552,2025-07-08,2025-12-19,620.68,14,11650,522038386,40509509,0.0307548265234273,99.5162003278433,0.0725621605461161
618.25,645,73,60,152570,160500,2025-07-08,2025-08-08,620.68,-13,7930.00000000003,23649737,8175363,0.678654481443071,88.1862830017941,0.0494080996884737
570.11,574,344,412,114552,160268,2025-07-08,2025-08-29,620.68,68,45716,90008549,22549292,0.178058641962998,95.4466391853512,0.285247210921706
593.95,597.5,448,448,124992,159040,2025-07-08,2025-08-01,620.68,0,34048,34440445,8262067,0.461782651182353,90.9258315332453,0.214084507042254
625.46,660,46,46,158884,158884,2025-07-08,2025-08-29,620.68,0,0,90008549,22549292,0.176521010243149,95.6231601955943,0
577.59,580,405,658,79785,158578,2025-07-08,2025-08-08,620.68,253,78793,23649737,8175363,0.67052754117308,88.8568105429672,0.496872201692543
557.88,561,130,507,40040,158184,2025-07-08,2025-08-29,620.68,377,118144,90008549,22549292,0.175743306338601,95.7989035019329,0.746877054569362
553.21,556,563,564,123860,157356,2025-07-08,2025-08-29,620.68,1,33496,90008549,22549292,0.174823393720079,95.973726895653,0.212867637713211
524.92,525,19605,19605,254865,156840,2025-07-08,2025-07-18,620.68,0,-98025,131764767,24110937,0.119030301931927,98.2684931245695,-0.625
594.8,595,7573,7773,166606,155460,2025-07-08,2025-07-11,620.68,200,-11146,35723216,11601493,0.43517918431532,94.1434444200097,-0.0716968995239933
379.59,380,3727,3746,149080,153586,2025-07-08,2025-09-19,620.68,19,4505.99999999997,397445891,51899302,0.0386432476666365,99.4748132897416,0.0293386115922022
453.57,455,1036,1074,137788,153582,2025-07-08,2025-10-17,620.68,38,15794,130178883,18894460,0.117977660017255,99.3359829335761,0.102837572111315
464.98,465,76679,76486,306716,152972,2025-07-08,2025-07-18,620.68,-193,-153744,131764767,24110937,0.116094767579257,98.3845878921488,-1.00504667520854
535.04,536,1310,1592,113970,152832,2025-07-08,2025-08-15,620.68,282,38862,296966434,50073190,0.0514644022024388,98.1749428960715,0.254279208542714
578.19,583,303,317,124836,152477,2025-07-08,2025-08-29,620.68,14,27641,90008549,22549292,0.169402797505379,96.1431296931584,0.181279799576329
556.04,559,334,515,77822,152440,2025-07-08,2025-08-29,620.68,181,74618,90008549,22549292,0.169361690298996,96.3124913834574,0.489490947257938
606.28,607,1599,2116,95940,152352,2025-07-08,2025-07-11,620.68,517,56412,35723216,11601493,0.426478959789063,94.5699233797987,0.370274102079395
453.7,454,5053,5053,151590,151590,2025-07-08,2025-08-15,620.68,0,0,296966434,50073190,0.0510461731173295,98.2259890691889,0
613.23,621,282,194,163560,150738,2025-07-08,2025-07-25,620.68,-88,-12822,47357171,17128032,0.318300263332875,94.8014905704566,-0.0850614974326315
601.14,607,256,255,99840,149430,2025-07-08,2025-08-01,620.68,-1,49590,34440445,8262067,0.433879411256156,91.3597109445015,0.331861072073881
564.81,568,410,468,116440,149292,2025-07-08,2025-08-29,620.68,58,32852,90008549,22549292,0.165864244739686,96.4783556281971,0.220051978672668
615.66,626,89,144,66127,148896,2025-07-08,2025-07-25,620.68,55,82769,47357171,17128032,0.314410672884155,95.1159012433407,0.555884644315495
339.01,340,1501,1496,138092,148104,2025-07-08,2025-12-19,620.68,-5,10012,522038386,40509509,0.0283703275413927,99.5445706553847,0.0676011451412521
549.5,552,581,592,151060,148000,2025-07-08,2025-08-29,620.68,11,-3060,90008549,22549292,0.164428825533006,96.6427844537301,-0.0206756756756757
319.21,320,1873,1873,147967,147967,2025-07-08,2025-12-19,620.68,0,0,522038386,40509509,0.0283440842605011,99.5729147396452,0
601.47,608,212,226,107696,147578,2025-07-08,2025-08-08,620.68,14,39882,23649737,8175363,0.624015396027448,89.4808259389946,0.270243532233802
613.52,631,57,84,84075,146832,2025-07-08,2025-08-29,620.68,27,62757,90008549,22549292,0.163131171017989,96.805915624748,0.427406832298137
593.57,598,48,328,16800,145304,2025-07-08,2025-08-08,620.68,280,128504,23649737,8175363,0.614400067112797,90.0952260061074,0.884380333645323
584.72,586,1123,1130,119038,144640,2025-07-08,2025-07-25,620.68,7,25602,47357171,17128032,0.305423649567243,95.421324892908,0.177004977876106
577.29,582,392,307,157192,144597,2025-07-08,2025-08-29,620.68,-85,-12595,90008549,22549292,0.160648073551325,96.9665636982994,-0.0871041584541863
289.38,290,2023,2327,121380,144274,2025-07-08,2025-12-19,620.68,304,22894,522038386,40509509,0.0276366650171966,99.6005514046624,0.158684170397993
189.79,190,6816,6822,129504,143262,2025-07-08,2025-12-19,620.68,6,13758,522038386,40509509,0.0274428095408294,99.6279942142032,0.0960338400971646
613.63,626,110,115,111100,142255,2025-07-08,2025-08-08,620.68,5,31155,23649737,8175363,0.601507746153795,90.6967337522612,0.219008119222523
602.39,609,187,215,98362,142115,2025-07-08,2025-08-08,620.68,28,43753,23649737,8175363,0.600915773397396,91.2976495256586,0.307870386658692
609.11,640,37,46,108780,142094,2025-07-08,2025-11-21,620.68,9,33314,23945131,16405869,0.593415003659826,95.9605733624928,0.234450434219601
618.1,635,13,84,17264,141960,2025-07-08,2025-08-01,620.68,71,124696,34440445,8262067,0.412189796037769,91.7719007405392,0.878388278388279
606.72,607.5,1445,1809,85255,141102,2025-07-08,2025-07-11,620.68,364,55847,35723216,11601493,0.394986834332049,94.9649102141308,0.395791696786722
605.09,635,45,47,117855,140577,2025-07-08,2025-12-19,620.68,2,22722,522038386,40509509,0.0269284795467129,99.65492269375,0.161633837683263
608.95,618,131,152,96940,137560,2025-07-08,2025-08-08,620.68,21,40620,23649737,8175363,0.581655516930273,91.8793050425889,0.295289328293108
609.07,622,52,106,55224,137058,2025-07-08,2025-08-22,620.68,54,81834,1750119,1049799,7.83135318226932,53.6877206635663,0.597075690583549
515.33,516,2045,2044,126790,136948,2025-07-08,2025-08-15,620.68,-1,10158,296966434,50073190,0.0461156495551952,98.2721047187441,0.0741741390892893
596.78,606,145,146,104255,134612,2025-07-08,2025-08-29,620.68,1,30357,90008549,22549292,0.149554682855736,97.1161183811551,0.225514812943868
614.94,624,143,147,97097,133182,2025-07-08,2025-07-25,620.68,4,36085,47357171,17128032,0.281228792150612,95.7025536850586,0.270945022600652
604.72,615,19,129,16150,132612,2025-07-08,2025-08-22,620.68,110,116462,1750119,1049799,7.57731331412321,61.2650339776895,0.878216149368081
521.29,522,1873,1858,125491,131918,2025-07-08,2025-08-15,620.68,-15,6426.99999999996,296966434,50073190,0.0444218554343418,98.3165265741784,0.0487196591822189
494.95,495,24030,26199,192240,130995,2025-07-08,2025-07-18,620.68,2169,-61245,131764767,24110937,0.0994158021013311,98.4840036942501,-0.467536928890416
294.33,295,1947,1947,120714,130449,2025-07-08,2025-12-19,620.68,0,9734.99999999999,522038386,40509509,0.0249883923286821,99.6799110860787,0.0746268656716417
618.9,655,25,36,96675,129960,2025-07-08,2025-09-19,620.68,11,33285,397445891,51899302,0.0326987906889695,99.5075120804306,0.256117266851339
548.6,551,538,539,105986,129360,2025-07-08,2025-08-29,620.68,1,23374,90008549,22549292,0.14371968156047,97.2598380627156,0.180689548546691
517.36,518,2014,2013,126882,128832,2025-07-08,2025-08-15,620.68,-1,1950,296966434,50073190,0.0433826807510508,98.3599092549295,0.0151359910581222
541.89,543,1160,1159,114840,128649,2025-07-08,2025-08-15,620.68,-1,13809,296966434,50073190,0.043321057624984,98.4032303125544,0.107338572394655
597.32,602,269,272,87963,127296,2025-07-08,2025-08-01,620.68,3,39333,34440445,8262067,0.369611948974527,92.1415126895137,0.308988499245852
606.15,614,150,162,94350,127170,2025-07-08,2025-08-08,620.68,12,32820,23649737,8175363,0.537722681651809,92.4170277242407,0.258079735786742
459.69,460,4100,4101,118900,127131,2025-07-08,2025-08-15,620.68,1,8231,296966434,50073190,0.0428098887431837,98.4460402012976,0.0647442401931866
614.2,632,51,71,187578,126380,2025-07-08,2025-08-29,620.68,20,-61198,90008549,22549292,0.140408884938252,97.4002469476538,-0.484238012343725
605.34,606,1851,1890,96252,124740,2025-07-08,2025-07-11,620.68,39,28488,35723216,11601493,0.349184687067368,95.3140949011981,0.228379028379028
605.62,616,8,119,6840,123522,2025-07-08,2025-08-22,620.68,111,116682,1750119,1049799,7.05792006143582,68.3229540391254,0.944625248943508
610.23,627,35,73,45360,122421,2025-07-08,2025-08-29,620.68,38,77061,90008549,22549292,0.136010413855244,97.5362573615091,0.629475335114074
284.87,285,9371,9385,121823,122005,2025-07-08,2025-09-19,620.68,14,182,397445891,51899302,0.0306972603724817,99.5382093408031,0.0014917421417155
458.65,459,3479,3479,121765,121765,2025-07-08,2025-08-15,620.68,0,0,296966434,50073190,0.0410029505220108,98.4870431518196,0
576.32,578,708,724,96996,121632,2025-07-08,2025-08-01,620.68,16,24636,34440445,8262067,0.353166168439461,92.4946788579532,0.202545382794002
616.58,660,27,28,105840,121576,2025-07-08,2025-12-19,620.68,1,15736,522038386,40509509,0.0232887088881621,99.7031997949668,0.129433440810686
558.69,560,312,927,34320,121437,2025-07-08,2025-08-08,620.68,615,87117,23649737,8175363,0.513481397277272,92.9305091215179,0.717384322735245
204.75,205,4781,4781,119525,119525,2025-07-08,2025-12-19,620.68,0,0,522038386,40509509,0.0228958259019673,99.7260956208688,0
535.97,537,1157,1158,100659,119274,2025-07-08,2025-08-15,620.68,1,18615,296966434,50073190,0.0401641351830355,98.5272072870027,0.15606921877358
617.26,640,56,52,109648,118248,2025-07-08,2025-08-29,620.68,-4,8600,90008549,22549292,0.13137418757856,97.6676315490876,0.0727285028076585
389.24,390,1536,1538,115200,116888,2025-07-08,2025-10-17,620.68,2,1688.00000000001,130178883,18894460,0.0897902926390911,99.4257732262152,0.0144411744576006
563.98,565,1096,1143,98640,116586,2025-07-08,2025-08-01,620.68,47,17946,34440445,8262067,0.338514789805997,92.8331936477592,0.153929288250733
527.22,528,1493,1492,111975,116376,2025-07-08,2025-08-15,620.68,-1,4401,296966434,50073190,0.0391882673177804,98.5663955543205,0.0378170756857084
613.29,629,5,74,6985,116254,2025-07-08,2025-08-29,620.68,69,109269,90008549,22549292,0.129158842456176,97.7967903915438,0.939916045899496
489.95,490,22947,23216,137682,116080,2025-07-08,2025-07-18,620.68,269,-21602,131764767,24110937,0.088096387708863,98.5721000819589,-0.186095796002757
616.31,627,49,108,38661,115452,2025-07-08,2025-07-25,620.68,59,76791,47357171,17128032,0.243789900372216,95.9463435854308,0.665133561999792
409.08,410,1253,1254,107758,115368,2025-07-08,2025-10-17,620.68,1,7610,130178883,18894460,0.0886226685475555,99.5143958947627,0.0659628319811386
593.99,596,558,572,92628,114972,2025-07-08,2025-07-25,620.68,14,22344,47357171,17128032,0.242776326313918,96.1891199117447,0.194342970462373
592.62,596,320,340,83840,114920,2025-07-08,2025-08-01,620.68,20,31080,34440445,8262067,0.333677453935337,93.1668711016945,0.270449008005569
531.19,532,1418,1418,114858,114858,2025-07-08,2025-08-15,620.68,0,0,296966434,50073190,0.0386770984359801,98.6050726527564,0
564.5,565,2132,2289,110864,114450,2025-07-08,2025-07-25,620.68,157,3585.99999999999,47357171,17128032,0.241674064525518,96.4307939762702,0.0313324595893402
579.81,581,810,956,72900,113764,2025-07-08,2025-07-25,620.68,146,40864,47357171,17128032,0.2402254982672,96.6710194745374,0.359199746844344
334.08,335,1232,1230,121968,113160,2025-07-08,2025-12-19,620.68,-2,-8807.99999999999,522038386,40509509,0.0216765669028791,99.7477721877716,-0.0778366914103922
594.35,598,345,308,94530,112420,2025-07-08,2025-08-01,620.68,-37,17890,34440445,8262067,0.326418546566399,93.4932896482609,0.159135385162782
599.25,602,410,398,90200,109450,2025-07-08,2025-07-25,620.68,-12,19250,47357171,17128032,0.231116001418244,96.9021354759557,0.175879396984925
518.29,519,1536,1536,99840,109056,2025-07-08,2025-08-15,620.68,0,9215.99999999999,296966434,50073190,0.0367233422751071,98.6417959950315,0.084507042253521
575.63,576,2907,2904,119187,107448,2025-07-08,2025-07-18,620.68,-3,-11739,131764767,24110937,0.0815453193189345,98.6536454012779,-0.109252847889211
572.82,577,311,256,131553,107008,2025-07-08,2025-08-29,620.68,-55,-24545,90008549,22549292,0.118886484882675,97.9156768764265,-0.229375373803828
224.69,225,3402,3441,102060,106671,2025-07-08,2025-12-19,620.68,39,4611.00000000002,522038386,40509509,0.020433554861232,99.7682057426329,0.0432263689287624
598.28,601,400,392,82800,106624,2025-07-08,2025-07-25,620.68,-8,23824,47357171,17128032,0.225148584150012,97.1272840601057,0.2234393757503
546.74,555,109,129,80115,106554,2025-07-08,2025-11-21,620.68,20,26439,23945131,16405869,0.444992345207884,96.4055657077007,0.248127709893575
349.7,350,3541,3549,99148,106470,2025-07-08,2025-09-19,620.68,8,7321.99999999999,397445891,51899302,0.026788552205714,99.5649978930088,0.0687705456936225
513.9,515,968,963,97768,105930,2025-07-08,2025-08-29,620.68,-5,8162.00000000002,90008549,22549292,0.117688820869671,98.0333656972962,0.0770508826583594
568.25,572,169,282,53911,105750,2025-07-08,2025-08-29,620.68,113,51839,90008549,22549292,0.117488839865644,98.1508545371618,0.490203309692671
184.81,185,5526,5527,99468,105013,2025-07-08,2025-12-19,620.68,1,5545.00000000002,522038386,40509509,0.0201159536954051,99.7883216963283,0.0528029862969348
563.55,565,345,720,43470,104400,2025-07-08,2025-08-08,620.68,375,60930,23649737,8175363,0.441442541200353,93.3719516627183,0.583620689655172
492.68,495,438,450,91542,104400,2025-07-08,2025-10-17,620.68,12,12858,130178883,18894460,0.0801973389186324,99.5945932336814,0.12316091954023
304.22,305,1334,1334,104052,104052,2025-07-08,2025-12-19,620.68,0,0,522038386,40509509,0.0199318676155742,99.8082535639439,0
602.77,608,176,196,73040,102508,2025-07-08,2025-08-01,620.68,20,29468,34440445,8262067,0.297638430630034,93.790928078891,0.287470246224685
374.61,375,2599,2616,90965,102024,2025-07-08,2025-09-19,620.68,17,11059,397445891,51899302,0.0256699093663545,99.5906678023751,0.108396063671293
585.71,588,421,444,82095,101676,2025-07-08,2025-08-01,620.68,23,19581,34440445,8262067,0.295222666257651,94.0861507451486,0.192582320311578
604.08,614,76,102,61104,101184,2025-07-08,2025-08-22,620.68,26,40080,1750119,1049799,5.78154971176246,74.1045037508878,0.396110056925996
314.17,315,1216,1216,100928,100928,2025-07-08,2025-12-19,620.68,0,0,522038386,40509509,0.0193334441885275,99.8275870081324,0
526.2,527,1252,1254,91396,100320,2025-07-08,2025-08-15,620.68,2,8924.00000000002,296966434,50073190,0.0337815956668019,98.6755775906984,0.0889553429027115
495.51,496,2045,2045,94070,100205,2025-07-08,2025-08-15,620.68,0,6135,296966434,50073190,0.033742870751514,98.7093204614499,0.0612244897959184
601.6,602,2462,2495,88632,99800,2025-07-08,2025-07-11,620.68,33,11168,35723216,11601493,0.27937014405422,95.5934650452524,0.11190380761523
523.24,524,1311,1310,117990,99560,2025-07-08,2025-08-15,620.68,-1,-18430,296966434,50073190,0.0335256744875079,98.7428461359374,-0.185114503816794
598.52,603,188,221,64484,99008,2025-07-08,2025-08-01,620.68,33,34524,34440445,8262067,0.287475960313521,94.3736267054621,0.348699095022624
618.23,640,45,45,65430,97965,2025-07-08,2025-07-18,620.68,0,32535,131764767,24110937,0.0743484030142898,98.7279938042922,0.33210840606339
578.59,579,2396,2387,119800,97867,2025-07-08,2025-07-18,620.68,-9,-21933,131764767,24110937,0.0742740280487879,98.8022678323409,-0.224110272103978
614.67,633,23,53,36616,97149,2025-07-08,2025-08-29,620.68,30,60533,90008549,22549292,0.107933080889905,98.2587876180517,0.623094421970375
439.76,440,4011,3999,92253,95976,2025-07-08,2025-08-15,620.68,-12,3722.99999999999,296966434,50073190,0.0323188040841006,98.7751649400215,0.0387909477369341
279.45,280,1734,1732,95370,95260,2025-07-08,2025-12-19,620.68,-2,-110,522038386,40509509,0.0182477002754353,99.8458347084078,-0.00115473441108545
601.12,606,189,193,73332,94184,2025-07-08,2025-08-01,620.68,4,20852,34440445,8262067,0.273469172654418,94.6470958781166,0.221396415527053
404.48,405,1797,1797,88053,93444,2025-07-08,2025-09-19,620.68,0,5391,397445891,51899302,0.0235111249395204,99.6141789273147,0.0576923076923077
563.98,575,47,83,46295,91466,2025-07-08,2025-11-21,620.68,36,45171,23945131,16405869,0.381981622902794,96.7875473306035,0.493855640347233
234.64,235,2536,2535,101440,91260,2025-07-08,2025-12-19,620.68,-1,-10180,522038386,40509509,0.0174814730961183,99.8633161815039,-0.111549419241727
239.56,240,2067,2067,90948,90948,2025-07-08,2025-12-19,620.68,0,0,522038386,40509509,0.0174217073761315,99.8807378888801,0
414.82,415,5025,5025,85425,90450,2025-07-08,2025-08-15,620.68,0,5024.99999999999,296966434,50073190,0.0304579877199185,98.8056229277414,0.0555555555555554
554.97,555,30076,30088,150380,90264,2025-07-08,2025-07-11,620.68,12,-60116,35723216,11601493,0.252676018866834,95.8461410641192,-0.666001949836037
589.35,591,675,547,91800,90255,2025-07-08,2025-07-25,620.68,-128,-1545.00000000001,47357171,17128032,0.190583597149416,97.3178676572551,-0.0171181651986041
429.98,430,45094,45075,90188,90150,2025-07-08,2025-07-18,620.68,-19,-38,131764767,24110937,0.0684173789796175,98.8706852113206,-0.000421519689406545
603.43,609,169,161,73853,89677,2025-07-08,2025-08-01,620.68,-8,15824,34440445,8262067,0.260382814449697,94.9074786925662,0.176455501410618
544.12,545,769,1014,59213,89232,2025-07-08,2025-08-08,620.68,245,30019,23649737,8175363,0.377306521421359,93.7492581841396,0.336415187376726
596.85,601,161,215,52325,89225,2025-07-08,2025-08-01,620.68,54,36900,34440445,8262067,0.259070403997393,95.1665490965637,0.413561221630709
554.2,557,341,318,76384,89040,2025-07-08,2025-08-29,620.68,-23,12656,90008549,22549292,0.0989239366585056,98.3577115547102,0.142138364779874
574.53,579,198,199,75636,88953,2025-07-08,2025-08-29,620.68,1,13317,90008549,22549292,0.0988272791732261,98.4565388338834,0.149708272908165
384.57,385,2029,2030,87247,87290,2025-07-08,2025-09-19,620.68,1,43,397445891,51899302,0.0219627380674065,99.6361416653821,0.000492610837438424
618.85,660,21,21,74886,86415,2025-07-08,2025-09-19,620.68,0,11529,397445891,51899302,0.0217425823129217,99.657884247695,0.133414337788579
174.84,175,5317,5322,85072,85152,2025-07-08,2025-12-19,620.68,5,80,522038386,40509509,0.0163114441933011,99.8970493330734,0.000939496429913566
604.08,611,97,122,55678,84424,2025-07-08,2025-08-08,620.68,25,28746,23649737,8175363,0.356976485615887,94.1062346697555,0.340495593670046
599.33,604,179,180,64261,84060,2025-07-08,2025-08-01,620.68,1,19799,34440445,8262067,0.244073501373168,95.4106225979368,0.235534142279324
512.22,515,302,302,83956,83956,2025-07-08,2025-10-17,620.68,0,0,130178883,18894460,0.064492794887478,99.6590860285689,0
618.53,633,47,58,39151,83926,2025-07-08,2025-07-11,620.68,11,44775,35723216,11601493,0.234934055209363,96.0810751193286,0.533505707408908
451.01,452,846,846,83754,83754,2025-07-08,2025-08-15,620.68,0,0,296966434,50073190,0.0282031874349813,98.8338261151764,0
611.71,621,22,90,15686,83610,2025-07-08,2025-08-01,620.68,68,67924,34440445,8262067,0.242766898046759,95.6533894959836,0.812390862337041
618.4,632,54,61,68688,82960,2025-07-08,2025-08-08,620.68,7,14272,23649737,8175363,0.350786141934686,94.4570208116902,0.172034715525555
617.97,631,59,63,66493,82089,2025-07-08,2025-08-01,620.68,4,15596,34440445,8262067,0.238350578803497,95.8917400747871,0.189988914470879
511.39,512,1344,1345,87360,82045,2025-07-08,2025-08-15,620.68,1,-5315,296966434,50073190,0.0276277015199637,98.8614538166963,-0.0647815223353038
557.78,558,3727,3727,100629,81994,2025-07-08,2025-07-18,620.68,0,-18635,131764767,24110937,0.0622275604221271,98.9329127717427,-0.227272727272727
614.13,622,73,104,44530,81848,2025-07-08,2025-07-25,620.68,31,37318,47357171,17128032,0.172831269840844,97.490698927096,0.455942723096472
209.73,210,2972,2974,89160,80298,2025-07-08,2025-12-19,620.68,2,-8862,522038386,40509509,0.0153816275111999,99.9124309605846,-0.110363894493014
559.46,570,58,76,52606,80104,2025-07-08,2025-11-21,620.68,18,27498,23945131,16405869,0.33453147531329,97.1220788059168,0.343278737641067
359.91,360,8798,8798,79182,79182,2025-07-08,2025-08-15,620.68,0,0,296966434,50073190,0.0266636194984919,98.8881174361948,0
553.9,555,139,716,13483,78760,2025-07-08,2025-08-08,620.68,577,65277,23649737,8175363,0.333026959242718,94.7900477709329,0.828809040121889
606.03,612.5,111,121,54834,78287,2025-07-08,2025-08-01,620.68,10,23453,34440445,8262067,0.227311232476816,96.1190513072639,0.299577196724871
289.86,290,5448,5560,76272,77840,2025-07-08,2025-09-19,620.68,112,1568.00000000001,397445891,51899302,0.0195850559189704,99.677469303614,0.0201438848920865
584.99,587.5,309,310,58092,77810,2025-07-08,2025-08-01,620.68,1,19718,34440445,8262067,0.225926232950823,96.3449775402147,0.253412157820332
434.98,435,38901,38901,77802,77802,2025-07-08,2025-07-18,620.68,0,0,131764767,24110937,0.0590461333263694,98.9919589050691,0
543.83,544,4533,4552,86127,77384,2025-07-08,2025-07-18,620.68,19,-8743,131764767,24110937,0.0587289013306569,99.0506878063997,-0.112982011785382
513.32,514,1140,1136,67260,77248,2025-07-08,2025-08-15,620.68,-4,9988.00000000002,296966434,50073190,0.0260123674448675,98.9141298036397,0.129297845898923
614.7,629,16,54,17952,77220,2025-07-08,2025-08-08,620.68,38,59268,23649737,8175363,0.32651525892233,95.1165630298553,0.767521367521368
493.51,494,1575,1575,70875,77175,2025-07-08,2025-08-15,620.68,0,6300,296966434,50073190,0.0259877855421196,98.9401175891818,0.0816326530612245
610.79,621,21,75,17598,76575,2025-07-08,2025-08-08,620.68,54,58977,23649737,8175363,0.323787955866063,95.4403509857213,0.770186092066601
596.76,597,3007,3182,75175,76368,2025-07-08,2025-07-11,620.68,175,1193,35723216,11601493,0.213776945502331,96.2948520648309,0.0156217263775403
588.4,591,289,293,60690,76180,2025-07-08,2025-08-01,620.68,4,15490,34440445,8262067,0.221193425346275,96.566170965561,0.203334208453662
514.99,520,26,151,11752,75651,2025-07-08,2025-11-21,620.68,125,63899,23945131,16405869,0.315934792755989,97.4380135986728,0.844655060739448
419.81,420,4003,3966,72054,75354,2025-07-08,2025-08-15,620.68,-37,3300,296966434,50073190,0.0253745849269955,98.9654921741088,0.0437932956445577
528.25,529,1003,1003,75225,75225,2025-07-08,2025-08-15,620.68,0,0,296966434,50073190,0.0253311456741943,98.990823319783,0
519.75,525,143,143,69069,75075,2025-07-08,2025-11-21,620.68,0,6006,23945131,16405869,0.313529293283048,97.7515428919558,0.08
508.43,509,1317,1315,94824,74955,2025-07-08,2025-08-15,620.68,-2,-19869,296966434,50073190,0.0252402263078662,99.0160635460909,-0.265079047428457
479.96,480,18764,18698,93820,74792,2025-07-08,2025-07-18,620.68,-66,-19028,131764767,24110937,0.0567617593859518,99.1074495657857,-0.254412236602845
619.65,655,33,21,99330,74235,2025-07-08,2025-08-15,620.68,-12,-25095,296966434,50073190,0.0249977746643245,99.0410613207552,-0.338048090523338
591.26,593,426,426,61344,74124,2025-07-08,2025-07-25,620.68,0,12780,47357171,17128032,0.156521173952726,97.6472201010487,0.172413793103448
364.65,365,2070,2114,70380,73990,2025-07-08,2025-09-19,620.68,44,3610,397445891,51899302,0.0186163705992371,99.6960856742132,0.0487903770779835
564.96,565,12000,18280,96000,73120,2025-07-08,2025-07-11,620.68,6280,-22880,35723216,11601493,0.204684818970386,96.4995368838013,-0.312910284463895
590.08,594,65,186,20280,72912,2025-07-08,2025-08-08,620.68,121,52632,23649737,8175363,0.308299411532568,95.7486503972539,0.721856484529296
617.93,670,11,14,52800,72898,2025-07-08,2025-12-19,620.68,3,20098,522038386,40509509,0.0139641072294634,99.926395067814,0.275700293560866
608.37,621,4,57,4016,71991,2025-07-08,2025-08-22,620.68,53,67975,1750119,1049799,4.11349171113507,78.2179954620229,0.944215249128363
598.71,599,2072,2470,60088,71630,2025-07-08,2025-07-11,620.68,398,11542,35723216,11601493,0.200513861909857,96.7000507457112,0.161133603238866
394.52,395,1454,1488,63976,71424,2025-07-08,2025-09-19,620.68,34,7448,397445891,51899302,0.0179707481237993,99.714056422337,0.104278673835125
601.34,610,51,82,36669,71012,2025-07-08,2025-08-22,620.68,31,34343,1750119,1049799,4.05755265784784,82.2755481198707,0.483622486340337
484.29,485,995,995,64675,70645,2025-07-08,2025-08-29,620.68,0,5970,90008549,22549292,0.0784869890525621,98.535025822936,0.0845070422535211
596.56,599,279,285,52731,69540,2025-07-08,2025-07-25,620.68,6,16809,47357171,17128032,0.146841541695977,97.7940616427447,0.241716997411562
559.12,560,812,790,64960,69520,2025-07-08,2025-08-01,620.68,-22,4560,34440445,8262067,0.201855696115425,96.7680266616764,0.0655926352128884
600.64,601,1811,1927,61574,69372,2025-07-08,2025-07-11,620.68,116,7798,35723216,11601493,0.194193042418129,96.8942437881293,0.112408464510177
588.86,589,2789,4947,41835,69258,2025-07-08,2025-07-11,620.68,2158,27423,35723216,11601493,0.193873922213498,97.0881177103428,0.395954257991857
619.71,640,50,34,73750,68986,2025-07-08,2025-07-11,620.68,-16,-4764,35723216,11601493,0.193112512602449,97.2812302229452,-0.0690574899254921
597.73,598,2347,2552,63369,68904,2025-07-08,2025-07-11,620.68,205,5535.00000000001,35723216,11601493,0.192882969999118,97.4741131929443,0.0803291536050158
593.72,597,184,210,48576,68880,2025-07-08,2025-08-01,620.68,26,20304,34440445,8262067,0.199997415828977,96.9680240775054,0.294773519163763
596.82,602,48,132,19632,68376,2025-07-08,2025-08-08,620.68,84,48744,23649737,8175363,0.289119494225242,96.0377698914791,0.712881712881713
604.79,630,12,27,26880,68067,2025-07-08,2025-11-21,620.68,15,41187,23945131,16405869,0.284262383028934,98.0358052749847,0.605094979946229
496.43,497,1193,1193,68001,68001,2025-07-08,2025-08-15,620.68,0,0,296966434,50073190,0.0228985475173265,99.0639598682725,0
476.56,477,1544,1544,67936,67936,2025-07-08,2025-08-15,620.68,0,0,296966434,50073190,0.022876659521729,99.0868365277943,0
617.87,650,25,21,65825,67473,2025-07-08,2025-08-29,620.68,-4,1648,90008549,22549292,0.0749628793593818,98.6099887022954,0.0244245846486743
619.78,631,63,60,45171,67320,2025-07-08,2025-07-11,620.68,-3,22149,35723216,11601493,0.18844887873477,97.6625620716791,0.329010695187166
474.96,475,16808,16808,100848,67232,2025-07-08,2025-07-18,620.68,0,-33616,131764767,24110937,0.0510242620472285,99.1584738278329,-0.5
503.44,504,1201,1200,69658,67200,2025-07-08,2025-08-15,620.68,-1,-2457.99999999999,296966434,50073190,0.0226288200638864,99.1094653478581,-0.0365773809523807
580.97,583,338,331,55094,67193,2025-07-08,2025-08-01,620.68,-7,12099,34440445,8262067,0.195099105136417,97.1631231826418,0.180063399461254
591,594,201,222,49647,66600,2025-07-08,2025-08-01,620.68,21,16953,34440445,8262067,0.193377292308505,97.3565004749503,0.25454954954955
603.5,604,1316,1331,59220,66550,2025-07-08,2025-07-11,620.68,15,7329.99999999999,35723216,11601493,0.18629341770349,97.8488554893826,0.110142749812171
510.42,511,1137,1147,83001,66526,2025-07-08,2025-08-15,620.68,10,-16475,296966434,50073190,0.0224018583864599,99.1318672062446,-0.247647536301596
550.84,551,4144,4157,95312,66512,2025-07-08,2025-07-18,620.68,13,-28800,131764767,24110937,0.0504778337292548,99.2089516615622,-0.433004570603801
394.85,395,4282,4281,59948,64215,2025-07-08,2025-08-15,620.68,-1,4267,296966434,50073190,0.02162365595837,99.153490862203,0.066448649069532
586.55,588,437,440,51129,63800,2025-07-08,2025-07-25,620.68,3,12671,47357171,17128032,0.134720885248825,97.9287825279935,0.198605015673981
379.88,380,5264,5295,52640,63540,2025-07-08,2025-08-15,620.68,31,10900,296966434,50073190,0.0213963575425497,99.1748872197455,0.171545483160214
473.64,474,1749,1764,61215,63504,2025-07-08,2025-08-15,620.68,15,2289,296966434,50073190,0.0213842349603727,99.1962714547059,0.0360449735449735
551.58,554,262,262,55282,63404,2025-07-08,2025-08-29,620.68,0,8122.00000000001,90008549,22549292,0.070442197662802,98.6804308999582,0.128099173553719
615.9,627,57,57,53580,63270,2025-07-08,2025-08-01,620.68,0,9689.99999999999,34440445,8262067,0.18370842769308,97.5402089026434,0.153153153153153
339.73,340,2269,2342,56725,63234,2025-07-08,2025-09-19,620.68,73,6509,397445891,51899302,0.0159100902618213,99.7299665125988,0.102935129835215
519.63,520,1704,1705,61344,63085,2025-07-08,2025-08-01,620.68,1,1741.00000000001,34440445,8262067,0.183171268547779,97.7233801711912,0.0275976856622019
501.5,502,1259,1259,62950,62950,2025-07-08,2025-08-15,620.68,0,0,296966434,50073190,0.0211976818902031,99.2174691365961,0
620.07,634,48,45,50640,62685,2025-07-08,2025-07-18,620.68,-3,12045,131764767,24110937,0.047573415433581,99.2565250769957,0.192151232352237
463.4,465,391,391,57086,62560,2025-07-08,2025-10-17,620.68,0,5474,130178883,18894460,0.048056949451625,99.7071429780205,0.0875
539.72,540,2186,2230,65580,62440,2025-07-08,2025-07-25,620.68,44,-3139.99999999999,47357171,17128032,0.131849092083647,98.0606316200771,-0.0502882767456757
559.55,560,1446,1374,67962,61830,2025-07-08,2025-07-25,620.68,-72,-6131.99999999999,47357171,17128032,0.130561008384559,98.1911926284617,-0.0991751576904414
344.72,345,2180,2208,63220,61824,2025-07-08,2025-09-19,620.68,28,-1395.99999999999,397445891,51899302,0.0155553249888801,99.7455218375877,-0.0225802277432711
551,553,306,306,61200,61200,2025-07-08,2025-08-29,620.68,0,0,90008549,22549292,0.0679935413690537,98.7484244413272,0
577.07,578,584,658,46136,61194,2025-07-08,2025-07-25,620.68,74,15058,47357171,17128032,0.129218022757314,98.320410651219,0.246069876131647
520.3,521,873,873,66348,61110,2025-07-08,2025-08-15,620.68,0,-5238.00000000001,296966434,50073190,0.0205780832455967,99.2380472198417,-0.0857142857142858
369.63,370,1661,1651,58135,61087,2025-07-08,2025-09-19,620.68,-10,2952.00000000001,397445891,51899302,0.0153698909419597,99.7608917285297,0.0483245207654658
569.23,573,134,161,43148,60697,2025-07-08,2025-08-29,620.68,27,17549,90008549,22549292,0.0674347055633571,98.8158591468906,0.289124668435013
329.76,330,2358,2528,61308,60672,2025-07-08,2025-09-19,620.68,170,-636.000000000007,397445891,51899302,0.0152654742126897,99.7761572027424,-0.010482594936709
599.6,609,68,64,54400,60160,2025-07-08,2025-08-29,620.68,-4,5760,90008549,22549292,0.066838095568011,98.8826972424586,0.0957446808510638
604.53,613,65,71,39260,60137,2025-07-08,2025-08-08,620.68,6,20877,23649737,8175363,0.254281897511165,96.2920517889903,0.347157324109949
507.43,508,1052,1052,57860,59964,2025-07-08,2025-08-15,620.68,0,2104,296966434,50073190,0.0201921810462929,99.258239400888,0.0350877192982456
618.92,635,327,37,333213,59496,2025-07-08,2025-07-11,620.68,-290,-273717,35723216,11601493,0.166547155216932,98.0154026445995,-4.60059499798306
466.5,467,1171,1171,58550,58550,2025-07-08,2025-08-15,620.68,0,0,296966434,50073190,0.0197160329574487,99.2779554338454,0
582.83,584,493,500,48807,58500,2025-07-08,2025-07-25,620.68,7,9693,47357171,17128032,0.123529338355114,98.4439399895741,0.165692307692308
620,635,40,39,56320,58500,2025-07-08,2025-08-08,620.68,-1,2179.99999999999,23649737,8175363,0.247360044638129,96.5394118336284,0.0372649572649571
429.6,430,1284,1457,44940,58280,2025-07-08,2025-08-29,620.68,173,13340,90008549,22549292,0.0647494050815107,98.9474466475401,0.228894989704873
607.35,619,4,50,3784,58250,2025-07-08,2025-08-22,620.68,46,54466,1750119,1049799,3.32834510110455,85.6038932209753,0.935038626609442
544.85,547,268,268,48508,57620,2025-07-08,2025-08-29,620.68,0,9111.99999999999,90008549,22549292,0.0640161414000797,99.0114627889402,0.158139534883721
512.36,513,898,897,67350,57408,2025-07-08,2025-08-15,620.68,-1,-9941.99999999999,296966434,50073190,0.0193314777117201,99.2972869115572,-0.17318143812709
149.98,150,28639,28591,57278,57182,2025-07-08,2025-09-19,620.68,-48,-95.9999999999927,397445891,51899302,0.014387367260516,99.7905445700029,-0.00167884998775826
576.13,577,642,657,49434,57159,2025-07-08,2025-07-25,620.68,15,7725,47357171,17128032,0.120697665829743,98.5646376554039,0.13514932031701
506.42,507,967,967,52218,56086,2025-07-08,2025-08-15,620.68,0,3867.99999999999,296966434,50073190,0.0188863095551062,99.3161732211123,0.0689655172413792
419.67,420,1675,1668,58625,55044,2025-07-08,2025-08-29,620.68,-7,-3580.99999999999,90008549,22549292,0.061154191031343,99.0726169799715,-0.0650570452728725
534.72,535,1961,1958,50986,54824,2025-07-08,2025-07-25,620.68,-3,3838,47357171,17128032,0.115767050358646,98.6804047057625,0.0700058368597694
464.47,465,1012,1012,51612,53636,2025-07-08,2025-08-29,620.68,0,2024,90008549,22549292,0.0595898951776236,99.1322068751492,0.0377358490566038
229.63,230,1448,1448,53576,53576,2025-07-08,2025-12-19,620.68,0,0,522038386,40509509,0.0102628468397724,99.9366579146538,0
449.97,450,17882,17744,53646,53232,2025-07-08,2025-07-18,620.68,-138,-414.000000000007,131764767,24110937,0.0403992669755186,99.2969243439713,-0.00777727682596948
560.06,563,182,181,47320,53214,2025-07-08,2025-08-29,620.68,-1,5894,90008549,22549292,0.059121050823739,99.1913279259729,0.11076032622994
559.07,562,168,179,42000,52447,2025-07-08,2025-08-29,620.68,11,10447,90008549,22549292,0.05826890954547,99.2495968355184,0.199191564817816
577.9,578,5211,5211,46899,52110,2025-07-08,2025-07-11,620.68,0,5211,35723216,11601493,0.145871525116888,98.1612741697164,0.1
487.57,488,1208,1207,61608,51901,2025-07-08,2025-08-15,620.68,-1,-9707.00000000001,296966434,50073190,0.0174770593770204,99.3336502804893,-0.187029151654111
581.87,583,461,459,45178,51867,2025-07-08,2025-07-25,620.68,-2,6688.99999999999,47357171,17128032,0.109523011837004,98.7899277175995,0.128964466809339
459.49,460,1006,1013,48288,51663,2025-07-08,2025-08-29,620.68,7,3375,90008549,22549292,0.0573978811723762,99.3069947166907,0.0653272167702224
589.27,592,166,189,37350,51597,2025-07-08,2025-08-01,620.68,23,14247,34440445,8262067,0.149815137406035,97.8731953085972,0.276120704692133
594.9,597.5,149,198,26522,51480,2025-07-08,2025-07-25,620.68,49,24958,47357171,17128032,0.1087058177525,98.898633535352,0.484809634809635
428.9,430,425,467,43775,51370,2025-07-08,2025-10-17,620.68,42,7595.00000000001,130178883,18894460,0.0394610852514382,99.7466040632719,0.147848939069496
553.82,554,2820,2836,70500,51048,2025-07-08,2025-07-18,620.68,16,-19452,131764767,24110937,0.0387417677443318,99.3356661117156,-0.381053126469206
551.81,552,2687,2684,64488,50996,2025-07-08,2025-07-18,620.68,-3,-13492,131764767,24110937,0.0387023034769226,99.3743684151925,-0.264569770178053
609.51,635,20,20,49500,50980,2025-07-08,2025-11-21,620.68,0,1479.99999999999,23945131,16405869,0.212903408212718,98.2487086831974,0.0290309925460964
554.61,555,1338,1289,53520,50271,2025-07-08,2025-07-25,620.68,-49,-3249.00000000001,47357171,17128032,0.106152878093161,99.0047864134452,-0.0646297069881245
500.47,501,634,948,31700,50244,2025-07-08,2025-08-15,620.68,314,18544,296966434,50073190,0.0169190838584808,99.3505693643478,0.369078894992437
502.45,503,912,911,46512,50105,2025-07-08,2025-08-15,620.68,-1,3593.00000000001,296966434,50073190,0.0168722772217415,99.3674416415695,0.0717094102384993
600.89,607,77,82,37422,50102,2025-07-08,2025-08-08,620.68,5,12680,23649737,8175363,0.211850136007855,96.7512619696363,0.253083709233164
583.02,586,142,168,33796,50064,2025-07-08,2025-08-08,620.68,26,16268,23649737,8175363,0.211689457688261,96.9629514273245,0.324944071588367
505.42,506,878,862,52680,49996,2025-07-08,2025-08-15,620.68,-16,-2683.99999999999,296966434,50073190,0.0168355727368164,99.3842772143063,-0.0536842947435793
562.71,566,148,149,40848,49021,2025-07-08,2025-08-29,620.68,1,8173.00000000001,90008549,22549292,0.0544626044354965,99.3614573211262,0.166724465025193
454.54,455,1061,1061,48806,48806,2025-07-08,2025-08-29,620.68,0,0,90008549,22549292,0.0542237382362424,99.4156810593625,0
477.6,478,1217,1217,55982,48680,2025-07-08,2025-08-15,620.68,0,-7302.00000000001,296966434,50073190,0.0163924250105653,99.4006696393169,-0.15
577.27,579,250,279,34750,48267,2025-07-08,2025-08-01,620.68,29,13517,34440445,8262067,0.14014627279061,98.0133415813878,0.280046408519278
473.2,475,257,268,42148,48240,2025-07-08,2025-10-17,620.68,11,6092.00000000001,130178883,18894460,0.0370567014313681,99.7836607647033,0.126285240464345
497.52,498,1004,1004,48192,48192,2025-07-08,2025-08-15,620.68,0,0,296966434,50073190,0.0162280966743871,99.4168977359913,0
567.54,571,78,138,24024,47748,2025-07-08,2025-08-29,620.68,60,23724,90008549,22549292,0.053048294334797,99.4687293536973,0.496858507162604
598.2,602.5,108,111,36396,47730,2025-07-08,2025-08-01,620.68,3,11334,34440445,8262067,0.138587059487762,98.1519286408756,0.237460716530484
314.91,315,5237,5293,57607,47637,2025-07-08,2025-08-29,620.68,56,-9970.00000000001,90008549,22549292,0.0529249727156473,99.5216543264129,-0.209291097256335
284.43,285,831,831,47367,47367,2025-07-08,2025-12-19,620.68,0,0,522038386,40509509,0.00907347070067755,99.9457313853545,0
364.92,365,5877,5877,47016,47016,2025-07-08,2025-08-15,620.68,0,0,296966434,50073190,0.0158320923232691,99.4327298283145,0
591.86,592,2954,3351,56126,46914,2025-07-08,2025-07-11,620.68,397,-9211.99999999999,35723216,11601493,0.131326362105808,98.2926005318222,-0.196359295732617
585.6,587,351,335,39312,46900,2025-07-08,2025-07-25,620.68,-16,7587.99999999999,47357171,17128032,0.0990346319462368,99.1038210453914,0.161791044776119
579.93,580,6842,6686,68420,46802,2025-07-08,2025-07-11,620.68,-156,-21618,35723216,11601493,0.131012840501258,98.4236133723235,-0.461903337464211
430.75,431,1872,1872,46800,46800,2025-07-08,2025-08-15,620.68,0,0,296966434,50073190,0.0157593568302066,99.4484891851447,0
574.94,575,7678,7788,61424,46728,2025-07-08,2025-07-11,620.68,110,-14696,35723216,11601493,0.130805692298252,98.5544190646217,-0.314500941619586
533.34,540,35,68,20965,45288,2025-07-08,2025-11-21,620.68,33,24323,23945131,16405869,0.189132396059976,98.4378410792574,0.537073838544427
444.76,445,1863,1864,50301,44736,2025-07-08,2025-08-15,620.68,1,-5565.00000000002,296966434,50073190,0.0150643287853872,99.4635535139301,-0.124396459227468
543.8,546,201,202,37386,44440,2025-07-08,2025-08-29,620.68,1,7054,90008549,22549292,0.0493730878830188,99.5710274142959,0.158730873087309
586.49,589,169,176,34307,44176,2025-07-08,2025-08-01,620.68,7,9869,34440445,8262067,0.12826779677208,98.2801964376477,0.223401847156827
619.81,632,34,36,26860,43884,2025-07-08,2025-07-11,620.68,2,17024,35723216,11601493,0.122844482982719,98.6772635476044,0.387931820253395
224.94,225,7300,7300,43800,43800,2025-07-08,2025-09-19,620.68,0,0,397445891,51899302,0.0110203680530691,99.8015649380559,0
595.81,596,2339,2303,58475,43757,2025-07-08,2025-07-11,620.68,-36,-14718,35723216,11601493,0.12248897187756,98.799752519482,-0.336357611353612
269.97,270,14566,14566,43698,43698,2025-07-08,2025-08-15,620.68,0,0,296966434,50073190,0.0147147943326147,99.4782683082627,0
484.95,485,8726,8725,61082,43625,2025-07-08,2025-07-18,620.68,-1,-17457,131764767,24110937,0.0331082435716674,99.4074766587642,-0.400160458452722
244.62,245,1142,1142,43396,43396,2025-07-08,2025-12-19,620.68,0,0,522038386,40509509,0.00831279866841057,99.9540441840229,0
575.18,576,325,528,24700,43296,2025-07-08,2025-07-25,620.68,203,18596,47357171,17128032,0.0914243800585132,99.1952454254499,0.429508499630451
478.57,479,996,1006,36852,43258,2025-07-08,2025-08-15,620.68,10,6406,296966434,50073190,0.0145666294393393,99.4928349377021,0.148088214896667
544.4,545,714,718,39270,43080,2025-07-08,2025-08-01,620.68,4,3809.99999999999,34440445,8262067,0.125085491781538,98.4052819294292,0.0884401114206126
617.47,634,0,26,0,42978,2025-07-08,2025-08-01,620.68,26,42978,34440445,8262067,0.124789328360885,98.5300712577901,1
500.89,505,54,104,19764,42744,2025-07-08,2025-11-21,620.68,50,22980,23945131,16405869,0.178508106721154,98.6163491859786,0.537619314991578
581.02,582,419,431,38548,42238,2025-07-08,2025-07-25,620.68,12,3690,47357171,17128032,0.0891902939050139,99.284435719355,0.087362091008097
254.5,255,841,841,42050,42050,2025-07-08,2025-12-19,620.68,0,0,522038386,40509509,0.00805496322257038,99.9620991472455,0
319.78,320,1826,1894,36520,41668,2025-07-08,2025-09-19,620.68,68,5147.99999999999,397445891,51899302,0.0104839428318558,99.8120488808878,0.123548046462513
558.81,559,2190,2189,54750,41591,2025-07-08,2025-07-18,620.68,-1,-13159,131764767,24110937,0.0315645835733918,99.4390412423376,-0.316390565266524
552.83,553,2425,2425,55775,41225,2025-07-08,2025-07-18,620.68,0,-14550,131764767,24110937,0.0312868158450886,99.4703280581827,-0.352941176470588
549.05,550,127,432,11176,41040,2025-07-08,2025-08-08,620.68,305,29864,23649737,8175363,0.173532585161518,97.1364840124861,0.727680311890838
460.7,461,1355,1363,39295,40890,2025-07-08,2025-08-15,620.68,8,1595,296966434,50073190,0.0137692329228023,99.5066041706249,0.0390070921985816
591.76,596,83,96,28220,40704,2025-07-08,2025-08-08,620.68,13,12484,23649737,8175363,0.17211185054616,97.3085958630322,0.306702044025157
588.31,592,78,110,23088,40590,2025-07-08,2025-08-08,620.68,32,17502,23649737,8175363,0.171629815587378,97.4802256786196,0.431189948263119
549.34,550,727,614,44347,40524,2025-07-08,2025-08-01,620.68,-113,-3823,34440445,8262067,0.117663984887536,98.6477352426776,-0.0943391570427401
584.81,588,114,127,37278,40513,2025-07-08,2025-08-08,620.68,13,3235,23649737,8175363,0.171304230571359,97.651529909191,0.0798509120529213
614.17,628,29,29,28739,40107,2025-07-08,2025-08-01,620.68,0,11368,34440445,8262067,0.116453199138397,98.764188441816,0.283441793203181
490.55,491,807,887,35508,39915,2025-07-08,2025-08-15,620.68,80,4407,296966434,50073190,0.0134409129888397,99.5200450836137,0.110409620443442
269.48,270,757,761,37850,39572,2025-07-08,2025-12-19,620.68,4,1722,522038386,40509509,0.00758028548498347,99.9696794327305,0.0435156171030021
624.05,690,6,6,39570,39570,2025-07-08,2025-09-19,620.68,0,0,397445891,51899302,0.00995607223424534,99.822004953122,0
294.85,295,2455,2593,36825,38895,2025-07-08,2025-09-19,620.68,138,2070,397445891,51899302,0.00978623779507133,99.8317911909171,0.0532202082529888
600.8,607.5,21,58,10542,38860,2025-07-08,2025-08-08,620.68,37,28318,23649737,8175363,0.16431472366902,97.81584463286,0.728718476582604
199.96,200,8486,9711,42430,38844,2025-07-08,2025-09-19,620.68,1225,-3586,397445891,51899302,0.00977340585966707,99.8415645967768,-0.0923179899083514
514.68,515,1113,1211,35616,38752,2025-07-08,2025-08-01,620.68,98,3136,34440445,8262067,0.112518871344432,98.8767073131604,0.0809248554913295
309.81,310,1942,2034,34956,38646,2025-07-08,2025-09-19,620.68,92,3690,397445891,51899302,0.00972358775750936,99.8512881845343,0.0954820680018631
589.66,592.5,120,134,27000,38056,2025-07-08,2025-08-01,620.68,14,11056,34440445,8262067,0.11049799153292,98.9872053046934,0.290519234811856
334.75,335,1053,1507,26325,37675,2025-07-08,2025-09-19,620.68,454,11350,397445891,51899302,0.00947927777167534,99.860767462306,0.301260783012608
373.93,375,334,351,32398,37557,2025-07-08,2025-11-21,620.68,17,5159.00000000001,23945131,16405869,0.156846082821597,98.7731952688002,0.137364539233698
486.59,487,908,908,37228,37228,2025-07-08,2025-08-15,620.68,0,0,296966434,50073190,0.012536096924678,99.5325811805384,0
359.67,360,1039,1104,32209,36432,2025-07-08,2025-09-19,620.68,65,4223,397445891,51899302,0.00916653079701861,99.869933993103,0.115914580588494
454.97,455,11995,11994,35985,35982,2025-07-08,2025-07-18,620.68,-1,-3,131764767,24110937,0.0273077551907332,99.4976358133734,-8.33750208437552e-05
602.13,607.5,68,67,27540,35979,2025-07-08,2025-08-01,620.68,-1,8439,34440445,8262067,0.104467291290806,99.0916725959842,0.234553489535563
559.96,560,9024,8986,54144,35944,2025-07-08,2025-07-11,620.68,-38,-18200,35723216,11601493,0.100618040660169,98.9003705601422,-0.506343200534164
544.7,545,1176,1197,42336,35910,2025-07-08,2025-07-25,620.68,21,-6425.99999999999,47357171,17128032,0.075828009236447,99.3602637285914,-0.178947368421052
204.95,205,7146,7146,35730,35730,2025-07-08,2025-09-19,620.68,0,0,397445891,51899302,0.00898990298027763,99.8789238960833,0
374.9,375,3387,3549,30483,35490,2025-07-08,2025-08-15,620.68,162,5007,296966434,50073190,0.01195084559624,99.5445320261346,0.141081994928149
611.3,626,26,24,31330,35280,2025-07-08,2025-08-22,620.68,-2,3949.99999999999,1750119,1049799,2.01586292132135,87.6197561422966,0.111961451247165
594.43,599,51,77,18921,35189,2025-07-08,2025-08-08,620.68,26,16268,23649737,8175363,0.148792352320874,97.9646369851809,0.462303560771832
459.98,460,17087,17167,68348,34334,2025-07-08,2025-07-18,620.68,80,-34014,131764767,24110937,0.0260570414851491,99.5236928548585,-0.990679792625386
448.68,449,1070,1070,34240,34240,2025-07-08,2025-08-15,620.68,0,0,296966434,50073190,0.0115299226039802,99.5560619487386,0
505.74,510,80,80,34080,34080,2025-07-08,2025-11-21,620.68,0,0,23945131,16405869,0.142325385482335,98.9155206542825,0
565.96,566,889,8474,8001,33896,2025-07-08,2025-07-11,620.68,7585,25895,35723216,11601493,0.0948850741769722,98.9952556343192,0.763954448902525
555.81,556,1785,1784,44625,33896,2025-07-08,2025-07-18,620.68,-1,-10729,131764767,24110937,0.0257246309250484,99.5494174857836,-0.316527023837621
229.91,230,3754,3754,33786,33786,2025-07-08,2025-09-19,620.68,0,0,397445891,51899302,0.00850077979545649,99.8874246758787,0
463.7,464,1120,1120,33600,33600,2025-07-08,2025-08-15,620.68,0,0,296966434,50073190,0.0113144100319432,99.5673763587706,0
423.92,425,306,310,30600,33480,2025-07-08,2025-10-17,620.68,4,2880,130178883,18894460,0.0257184569635614,99.8093792216669,0.0860215053763441
545.86,546,2317,2381,46340,33334,2025-07-08,2025-07-18,620.68,64,-13006,131764767,24110937,0.0252981132657412,99.5747155990493,-0.390172196556069
540.87,541,2558,2560,40928,33280,2025-07-08,2025-07-18,620.68,2,-7648,131764767,24110937,0.0252571311418932,99.5999727301912,-0.229807692307692
585.8,589,94,104,24252,33280,2025-07-08,2025-08-08,620.68,10,9028,23649737,8175363,0.140720380949691,98.1053573661305,0.271274038461538
597.72,603,42,63,17430,33264,2025-07-08,2025-08-08,620.68,21,15834,23649737,8175363,0.140652726920388,98.2460100930509,0.476010101010101
284.97,285,11238,11046,33714,33138,2025-07-08,2025-08-15,620.68,-192,-576,296966434,50073190,0.011158836894004,99.5785351956646,-0.0173818576860402
546.13,548,177,177,33099,33099,2025-07-08,2025-08-29,620.68,0,0,90008549,22549292,0.0367731736237632,99.6078005879197,0
471.58,472,785,785,32970,32970,2025-07-08,2025-08-15,620.68,0,0,296966434,50073190,0.0111022648438443,99.5896374605084,0
590.09,592,170,172,24480,32852,2025-07-08,2025-07-25,620.68,2,8372,47357171,17128032,0.0693706978400378,99.4296344264314,0.254839887982467
472.61,473,851,840,35742,32760,2025-07-08,2025-08-15,620.68,-11,-2981.99999999999,296966434,50073190,0.0110315497811446,99.6006690102896,-0.0910256410256407
219.94,220,5437,5439,38059,32634,2025-07-08,2025-09-19,620.68,2,-5425,397445891,51899302,0.00821092901926617,99.895635604898,-0.166237666237666
619.74,685,0,5,0,32630,2025-07-08,2025-11-21,620.68,5,32630,23945131,16405869,0.136269874656355,99.0517905289389,1
619.82,685,5,5,32590,32590,2025-07-08,2025-09-19,620.68,0,0,397445891,51899302,0.00819985832989779,99.9038354632279,0
349.93,350,4614,4614,32298,32298,2025-07-08,2025-08-15,620.68,0,0,296966434,50073190,0.0108759766432054,99.6115449869328,0
431.78,432,1461,1462,29220,32164,2025-07-08,2025-08-15,620.68,1,2944,296966434,50073190,0.0108308536984352,99.6223758406312,0.0915309041164034
620.35,645,4,13,8220,32045,2025-07-08,2025-08-01,620.68,9,23825,34440445,8262067,0.0930446746550458,99.1847172706392,0.743485723201748
605.14,617,2,27,1770,32022,2025-07-08,2025-08-22,620.68,25,30252,1750119,1049799,1.82970415154627,89.4494602938429,0.944725501217913
541.87,542,2446,2446,39136,31798,2025-07-08,2025-07-18,620.68,0,-7338,131764767,24110937,0.0241323995207308,99.624105129712,-0.230769230769231
492.55,493,706,705,39536,31725,2025-07-08,2025-08-15,620.68,-1,-7811,296966434,50073190,0.0106830255435535,99.6330588661748,-0.246209613869188
584.78,587,124,142,23560,31524,2025-07-08,2025-08-01,620.68,18,7964,34440445,8262067,0.0915319183593592,99.2762491889986,0.252632914604746
399.74,400,1201,1205,31226,31330,2025-07-08,2025-08-29,620.68,4,104,90008549,22549292,0.0348078047564126,99.6426083926761,0.0033195020746888
264.5,265,621,623,31050,31150,2025-07-08,2025-12-19,620.68,2,100,522038386,40509509,0.00596699415893145,99.9756464268894,0.00321027287319422
614.5,628,23,23,25024,31050,2025-07-08,2025-08-08,620.68,0,6026,23649737,8175363,0.131291100615622,98.3773011936666,0.194074074074074
274.88,275,2452,2587,29424,31044,2025-07-08,2025-09-19,620.68,135,1620,397445891,51899302,0.00781087456254517,99.9116463377904,0.052183996907615
369.91,370,3412,3437,27296,30933,2025-07-08,2025-08-15,620.68,25,3637,296966434,50073190,0.0104163287356577,99.6434751949104,0.117576698024763
546.84,547,1989,1922,35802,30752,2025-07-08,2025-07-18,620.68,-67,-5050,131764767,24110937,0.0233385606032302,99.6474436903152,-0.164216961498439
264.9,265,3016,3051,33176,30510,2025-07-08,2025-09-19,620.68,35,-2666,397445891,51899302,0.00767651665066529,99.9193228544411,-0.0873811864962306
547.83,548,1790,1788,39380,30396,2025-07-08,2025-07-18,620.68,-2,-8984,131764767,24110937,0.023068382157121,99.6705120724723,-0.295565205948151
467.67,468,919,918,30327,30294,2025-07-08,2025-08-15,620.68,-1,-33.0000000000036,296966434,50073190,0.0102011529020145,99.6536763478124,-0.0010893246187365
499.75,500,974,1210,25324,30250,2025-07-08,2025-08-01,620.68,236,4926,34440445,8262067,0.0878327791641484,99.3640819681627,0.162842975206612
619.45,632,10,24,9280,30120,2025-07-08,2025-07-18,620.68,14,20840,131764767,24110937,0.0228589179685644,99.6933709904409,0.691899070385126
548.84,549,1873,1873,33714,29968,2025-07-08,2025-07-18,620.68,0,-3746,131764767,24110937,0.0227435608792144,99.7161145513201,-0.125
324.77,325,1220,1300,25620,29900,2025-07-08,2025-09-19,620.68,80,4280,397445891,51899302,0.00752303663896729,99.9268458910801,0.14314381270903
560.75,561,1188,1188,34452,29700,2025-07-08,2025-07-18,620.68,0,-4752,131764767,24110937,0.0225401681164131,99.7386547194365,-0.16
344.94,345,4942,4942,29652,29652,2025-07-08,2025-08-15,620.68,0,0,296966434,50073190,0.00998496685318988,99.6636613146656,0
444.6,445,741,741,29640,29640,2025-07-08,2025-08-29,620.68,0,0,90008549,22549292,0.0329302053297182,99.6755385980058,0
480.62,481,777,779,37296,29602,2025-07-08,2025-08-15,620.68,2,-7694,296966434,50073190,0.00996812993349949,99.6736294445991,-0.25991487061685
587.42,591,45,82,12825,29356,2025-07-08,2025-08-08,620.68,37,16531,23649737,8175363,0.124128230263195,98.5014294239298,0.563121678702821
468.59,469,701,701,28741,28741,2025-07-08,2025-08-15,620.68,0,0,296966434,50073190,0.00967819817643094,99.6833076427755,0
482.59,483,697,698,34153,28618,2025-07-08,2025-08-15,620.68,1,-5535,296966434,50073190,0.00963677935399258,99.6929444221296,-0.193409742120344
485.56,486,641,641,26281,28204,2025-07-08,2025-08-15,620.68,0,1923,296966434,50073190,0.00949736965895614,99.7024417917885,0.0681818181818183
524.8,525,1024,1402,24576,28040,2025-07-08,2025-07-25,620.68,378,3464,47357171,17128032,0.0592096179055966,99.488844044337,0.123537803138374
339.94,340,4669,4669,28014,28014,2025-07-08,2025-08-15,620.68,0,0,296966434,50073190,0.00943338936413265,99.7118751811526,0
414.68,415,854,860,25620,27520,2025-07-08,2025-08-29,620.68,6,1900,90008549,22549292,0.0305748735045157,99.7061134715103,0.0690406976744186
582.03,584,121,139,20570,27383,2025-07-08,2025-08-01,620.68,18,6813,34440445,8262067,0.0795082641934505,99.4435902323562,0.248804002483293
442.78,443,1225,1225,26950,26950,2025-07-08,2025-08-15,620.68,0,0,296966434,50073190,0.00907509971312111,99.7209502808658,0
620.1,665,7,6,28343,26940,2025-07-08,2025-09-19,620.68,-1,-1403,397445891,51899302,0.00677828117236718,99.9336241722524,-0.0520786933927247
481.6,482,666,666,31302,26640,2025-07-08,2025-08-15,620.68,0,-4662,296966434,50073190,0.00897071081104069,99.7299209916768,-0.175
194.96,195,6651,6650,19953,26600,2025-07-08,2025-09-19,620.68,-1,6647,397445891,51899302,0.00669273493633879,99.9403169071888,0.249887218045113
279.97,280,8933,8823,26799,26469,2025-07-08,2025-08-15,620.68,-110,-330,296966434,50073190,0.00891312854569955,99.7388341202225,-0.0124674147115494
601.91,611,6,29,4380,26361,2025-07-08,2025-08-22,620.68,23,21981,1750119,1049799,1.50624043279343,90.9557007266363,0.833845453510868
618.84,645,6,10,14328,26160,2025-07-08,2025-08-29,620.68,4,11832,90008549,22549292,0.0290639059185367,99.7351773774289,0.452293577981651
475.64,476,716,719,25776,25884,2025-07-08,2025-08-15,620.68,3,107.999999999996,296966434,50073190,0.00871613658532196,99.7475502568078,0.0041724617524338
439.99,440,25717,25694,77151,25694,2025-07-08,2025-07-18,620.68,-23,-51457,131764767,24110937,0.0194999016694653,99.758154621106,-2.00268545185646
623.64,645,12,12,23868,25632,2025-07-08,2025-07-25,620.68,0,1764,47357171,17128032,0.0541248547131331,99.5429688990502,0.0688202247191011
590.82,592.5,147,149,20580,25032,2025-07-08,2025-07-25,620.68,2,4452,47357171,17128032,0.0528578871402601,99.5958267861904,0.177852348993289
624.2,645,12,12,24960,24960,2025-07-08,2025-07-18,620.68,0,0,131764767,24110937,0.0189428483564199,99.7770974694624,0
456.72,457,889,889,24892,24892,2025-07-08,2025-08-15,620.68,0,0,296966434,50073190,0.00838209209866459,99.7559323489065,0
590.87,591,1879,1899,39459,24687,2025-07-08,2025-07-11,620.68,20,-14772,35723216,11601493,0.0691063201028709,99.064361954422,-0.598371612589622
605.02,612.5,31,33,18910,24684,2025-07-08,2025-08-08,620.68,2,5774,23649737,8175363,0.104373253706796,98.6058026776366,0.233916707178739
610.34,624,16,18,17408,24588,2025-07-08,2025-08-22,620.68,2,7180,1750119,1049799,1.40493303598212,92.3606337626184,0.292012363754677
600.02,606,21,41,9954,24518,2025-07-08,2025-08-08,620.68,20,14564,23649737,8175363,0.10367134315278,98.7094740207893,0.594012562199201
179.82,180,1352,1362,21632,24516,2025-07-08,2025-12-19,620.68,10,2884,522038386,40509509,0.00469620638203414,99.9803426332714,0.117637461249796
447.91,450,56,117,10696,24453,2025-07-08,2025-11-21,620.68,61,13757,23945131,16405869,0.102120969812193,99.1539114987511,0.562589457326299
592.65,597,34,56,11526,24360,2025-07-08,2025-08-08,620.68,22,12834,23649737,8175363,0.103003259613416,98.8124772804028,0.526847290640394
539.47,540,405,459,20250,24327,2025-07-08,2025-08-01,620.68,54,4077,34440445,8262067,0.0706349758256608,99.5142252081818,0.167591564927858
383.87,385,215,215,24295,24295,2025-07-08,2025-11-21,620.68,0,0,23945131,16405869,0.101461127942879,99.2553726266939,0
394.17,395,289,292,23120,24236,2025-07-08,2025-10-17,620.68,3,1116,130178883,18894460,0.0186174588700381,99.8279966805369,0.0460472025086648
154.88,155,2014,2018,22154,24216,2025-07-08,2025-12-19,620.68,4,2062,522038386,40509509,0.00463873934358536,99.984981372615,0.0851503138420879
616.95,665,5,5,24025,24025,2025-07-08,2025-12-19,620.68,0,0,522038386,40509509,0.00460215199577297,99.9895835246108,0
427.7,428,799,799,23970,23970,2025-07-08,2025-08-15,620.68,0,0,296966434,50073190,0.00807161929957377,99.7640039682061,0
620.3,700,3,3,22266,23910,2025-07-08,2025-09-19,620.68,0,1644,397445891,51899302,0.00601591324540829,99.9463328204342,0.068757841907152
457.71,458,818,818,23722,23722,2025-07-08,2025-08-15,620.68,0,0,296966434,50073190,0.00798810817790943,99.771992076384,0
606.77,618,6,21,5586,23583,2025-07-08,2025-08-22,620.68,15,17997,1750119,1049799,1.34750836943088,93.7081421320493,0.76313446126447
598.11,604,38,40,16606,23560,2025-07-08,2025-08-08,620.68,2,6954,23649737,8175363,0.0996205581482788,98.912097838551,0.295161290322581
389.76,390,978,978,22494,23472,2025-07-08,2025-08-29,620.68,0,978,90008549,22549292,0.0260775229250724,99.761254900354,0.0416666666666667
601.93,612,11,23,7579,23161,2025-07-08,2025-08-22,620.68,12,15582,1750119,1049799,1.32339572337652,95.0315378554258,0.672768878718536
443.75,445,185,185,21645,23125,2025-07-08,2025-10-17,620.68,0,1480,130178883,18894460,0.0177640178399749,99.8457606983769,0.064
542.87,543,1735,1734,31230,22542,2025-07-08,2025-07-18,620.68,-1,-8688,131764767,24110937,0.0171077599218917,99.7942052293843,-0.385413894064413
578.07,579,348,242,29580,22506,2025-07-08,2025-07-25,620.68,-106,-7074,47357171,17128032,0.0475239536584649,99.6433507398489,-0.314316182351373
613,628,0,15,0,22500,2025-07-08,2025-08-22,620.68,15,22500,1750119,1049799,1.2856268630876,96.3171647185134,1
465.69,466,723,723,22413,22413,2025-07-08,2025-08-15,620.68,0,0,296966434,50073190,0.00754731762041497,99.7795393940044,0
169.85,170,1490,1490,20860,22350,2025-07-08,2025-12-19,620.68,0,1490,522038386,40509509,0.00428129436443396,99.9938648189752,0.0666666666666665
399.99,400,22308,22305,44616,22305,2025-07-08,2025-07-18,620.68,-3,-22311,131764767,24110937,0.0169278939338921,99.8111331233182,-1.00026899798252
304.96,305,6080,5572,18240,22288,2025-07-08,2025-08-15,620.68,-508,4048,296966434,50073190,0.00750522532118899,99.7870446193256,0.1816223977028
587.9,588,1691,2214,27056,22140,2025-07-08,2025-07-11,620.68,523,-4916,35723216,11601493,0.061976502899403,99.1263384573214,-0.222041553748871
489.67,490,636,670,20352,22110,2025-07-08,2025-08-08,620.68,34,1758,23649737,8175363,0.0934894117427183,99.0055872502938,0.0795115332428767
619.74,730,2,2,20760,22052,2025-07-08,2025-08-29,620.68,0,1292,90008549,22549292,0.0244998950044179,99.7857547953584,0.0585887901324143
441.77,442,951,951,21873,21873,2025-07-08,2025-08-15,620.68,0,0,296966434,50073190,0.00736547888775874,99.7944100982133,0
334.94,335,3645,3645,18225,21870,2025-07-08,2025-08-15,620.68,0,3645,296966434,50073190,0.00736446867257732,99.8017745668859,0.166666666666667
573.25,574,284,290,19596,21750,2025-07-08,2025-07-25,620.68,6,2154,47357171,17128032,0.045927574516645,99.6892783143655,0.0990344827586209
349.45,350,389,395,19450,21725,2025-07-08,2025-10-17,620.68,6,2275,130178883,18894460,0.016688574597771,99.8624492729746,0.104718066743383
618.98,655,6,6,19650,21612,2025-07-08,2025-10-17,620.68,0,1962,130178883,18894460,0.0166017709646502,99.8790510439393,0.0907828983897835
470.63,471,578,576,18496,21312,2025-07-08,2025-08-15,620.68,-2,2816,296966434,50073190,0.00717656864883255,99.8089511355347,0.132132132132132
476.96,480,45,70,12105,21280,2025-07-08,2025-11-21,620.68,25,9175,23945131,16405869,0.0888698416392042,99.3442424683331,0.431156015037594
581.88,582,1595,1765,17545,21180,2025-07-08,2025-07-11,620.68,170,3635,35723216,11601493,0.0592891748604045,99.1856276321818,0.17162417374882
619.91,634,13,15,12350,21135,2025-07-08,2025-07-11,620.68,2,8785,35723216,11601493,0.0591632063585765,99.2447908385404,0.415661225455406
488.56,489,498,478,23904,21032,2025-07-08,2025-08-15,620.68,-20,-2872,296966434,50073190,0.00708228189856636,99.8160334174333,-0.136553822746291
249.92,250,2523,2623,22707,20984,2025-07-08,2025-09-19,620.68,100,-1723,397445891,51899302,0.00527971240241102,99.9516125328366,-0.0821101791841403
509.66,510,244,613,7076,20842,2025-07-08,2025-08-01,620.68,369,13766,34440445,8262067,0.0605160589533614,99.5747412671352,0.660493234814317
583.75,586,75,92,13200,20700,2025-07-08,2025-08-01,620.68,17,7500,34440445,8262067,0.0601037530148057,99.63484502015,0.36231884057971
433.75,434,820,820,20500,20500,2025-07-08,2025-08-15,620.68,0,0,296966434,50073190,0.00690313707306059,99.8229365545064,0
433.9,435,186,186,20460,20460,2025-07-08,2025-10-17,620.68,0,0,130178883,18894460,0.0157168348110653,99.8947678787503,0
329.95,330,4061,4061,20305,20305,2025-07-08,2025-08-15,620.68,0,0,296966434,50073190,0.00683747308626806,99.8297740275926,0
446.7,447,675,675,20250,20250,2025-07-08,2025-08-15,620.68,0,0,296966434,50073190,0.00681895247460863,99.8365929800672,0
389.99,390,20181,20192,40362,20192,2025-07-08,2025-07-18,620.68,11,-20170,131764767,24110937,0.0153242786062833,99.8264574019245,-0.998910459587956
546.61,549,83,84,15770,20076,2025-07-08,2025-08-29,620.68,1,4306.00000000001,90008549,22549292,0.0223045479824367,99.8080593433408,0.214484957162782
614.9,655,3,5,17685,20050,2025-07-08,2025-12-19,620.68,2,2365,522038386,40509509,0.00384071373632666,99.9977055327115,0.117955112219451
279.87,280,1389,1520,18057,19760,2025-07-08,2025-09-19,620.68,131,1703,397445891,51899302,0.00497174595270882,99.9565842787893,0.0861842105263158
579.38,581,120,121,18600,19602,2025-07-08,2025-08-01,620.68,1,1002,34440445,8262067,0.0569156408983682,99.6917606610484,0.0511172329354148
586.11,587.5,144,141,15840,19599,2025-07-08,2025-07-25,620.68,-3,3759,47357171,17128032,0.0413854957678954,99.7306638101334,0.191795499770396
309.95,310,3802,3860,19010,19300,2025-07-08,2025-08-15,620.68,58,289.999999999996,296966434,50073190,0.00649905100049119,99.8430920310677,0.0150259067357511
259.98,260,8863,9590,8863,19180,2025-07-08,2025-08-15,620.68,727,10317,296966434,50073190,0.00645864239323425,99.849550673461,0.537904066736184
499.61,500,405,490,14985,19110,2025-07-08,2025-08-08,620.68,85,4125,23649737,8175363,0.0808042812484553,99.0863915315422,0.21585557299843
436.79,437,904,904,18984,18984,2025-07-08,2025-08-15,620.68,0,0,296966434,50073190,0.00639264166804791,99.855943315129,0
404.85,405,1255,1265,17570,18975,2025-07-08,2025-08-15,620.68,10,1405,296966434,50073190,0.00638961102250364,99.8623329261515,0.0740447957839262
244.98,245,9539,9449,9539,18898,2025-07-08,2025-08-15,620.68,-90,9359,296966434,50073190,0.00636368216618044,99.8686966083177,0.495237591279501
426.67,427,570,570,18810,18810,2025-07-08,2025-08-15,620.68,0,0,296966434,50073190,0.00633404918752535,99.8750306575052,0
432.78,433,834,834,16680,18348,2025-07-08,2025-08-15,620.68,0,1668,296966434,50073190,0.00617847604958613,99.8812091335548,0.0909090909090909
389.88,390,1494,1506,16434,18072,2025-07-08,2025-08-15,620.68,12,1638,296966434,50073190,0.00608553625289517,99.8872946698077,0.0906374501992032
583.99,587,53,60,13462,18060,2025-07-08,2025-08-08,620.68,7,4598,23649737,8175363,0.0763644855754633,99.1627560171177,0.254595791805094
608.5,617.5,21,20,14742,18000,2025-07-08,2025-08-08,620.68,-1,3258,23649737,8175363,0.076110782965578,99.2388668000832,0.181
537.83,545,19,25,12160,17925,2025-07-08,2025-11-21,620.68,6,5765,23945131,16405869,0.0748586424521962,99.4191011107853,0.321617852161785
364.81,365,929,943,14864,17917,2025-07-08,2025-08-29,620.68,14,3053,90008549,22549292,0.019905886939695,99.8279652302805,0.170396829826422
414.1,415,198,198,17820,17820,2025-07-08,2025-10-17,620.68,0,0,130178883,18894460,0.0136888561257666,99.9084567348761,0
483.56,484,402,403,20100,17732,2025-07-08,2025-08-15,620.68,1,-2368,296966434,50073190,0.0059710451990005,99.8932657150067,-0.133543875479359
404.08,405,192,192,17664,17664,2025-07-08,2025-10-17,620.68,0,0,130178883,18894460,0.0135690210216353,99.9220257558978,0
259.9,260,1737,1747,17370,17470,2025-07-08,2025-09-19,620.68,10,100,397445891,51899302,0.00439556689239995,99.9609798456817,0.00572409845449342
462.7,463,578,578,22542,17340,2025-07-08,2025-08-15,620.68,0,-5202,296966434,50073190,0.00583904374862783,99.8991047587553,-0.3
534.32,535,136,254,8704,17272,2025-07-08,2025-08-08,620.68,118,8568,23649737,8175363,0.0730325246323035,99.3118993247155,0.496062992125984
404.74,405,666,660,17316,17160,2025-07-08,2025-08-29,620.68,-6,-156,90008549,22549292,0.0190648557172053,99.8470300859977,-0.00909090909090909
434.78,435,778,778,17894,17116,2025-07-08,2025-08-15,620.68,0,-778,296966434,50073190,0.00576361434841488,99.9048683731037,-0.0454545454545455
299.97,300,5369,5574,16107,16722,2025-07-08,2025-08-15,620.68,205,615,296966434,50073190,0.00563093942125459,99.910499312525,0.0367778973806961
214.95,215,2587,3341,12935,16705,2025-07-08,2025-09-19,620.68,754,3770,397445891,51899302,0.00420308786133607,99.965182933543,0.22568093385214
569.96,570,3941,4161,39410,16644,2025-07-08,2025-07-11,620.68,220,-22766,35723216,11601493,0.0465915498761366,99.2913823884165,-1.36782023552031
598.28,607,11,19,7150,16568,2025-07-08,2025-08-22,620.68,8,9418,1750119,1049799,0.946678483006013,97.2638432015195,0.568445195557702
620.55,675,3,3,16506,16335,2025-07-08,2025-08-15,620.68,0,-170.999999999998,296966434,50073190,0.00550062166285096,99.9159999341879,-0.0104683195592285
435.79,436,768,769,21504,16149,2025-07-08,2025-08-15,620.68,1,-5355.00000000001,296966434,50073190,0.0054379883216027,99.9214379225095,-0.331599479843954
339.53,340,338,338,17914,15886,2025-07-08,2025-10-17,620.68,0,-2028,130178883,18894460,0.0122032081040364,99.9342289640018,-0.127659574468085
443.77,444,685,685,15755,15755,2025-07-08,2025-08-15,620.68,0,0,296966434,50073190,0.00530531339444242,99.9267432359039,0
434.62,435,412,412,15656,15656,2025-07-08,2025-08-29,620.68,0,0,90008549,22549292,0.017393903328005,99.8644239893257,0
424.65,425,444,445,14652,15575,2025-07-08,2025-08-29,620.68,1,922.999999999998,90008549,22549292,0.017303911876193,99.8817279012019,0.0592616372391652
491.51,492,315,315,15435,15435,2025-07-08,2025-08-15,620.68,0,0,296966434,50073190,0.00519755710842391,99.9319407930123,0
580.12,582,73,80,11023,15040,2025-07-08,2025-08-01,620.68,7,4017,34440445,8262067,0.0436695867315303,99.7354302477799,0.267087765957447
589.34,593,37,41,11137,15006,2025-07-08,2025-08-08,620.68,4,3869,23649737,8175363,0.0634510227323035,99.3753503474478,0.257830201252832
438.73,439,555,555,14985,14985,2025-07-08,2025-08-15,620.68,0,0,296966434,50073190,0.00504602483121039,99.9369868178435,0
418.96,420,141,142,13254,14768,2025-07-08,2025-10-17,620.68,1,1514,130178883,18894460,0.0113443898577621,99.9455733538596,0.102518959913326
618.17,655,0,4,0,14732,2025-07-08,2025-11-21,620.68,4,14732,23945131,16405869,0.0615239899919529,99.4806251007773,1
394.75,395,582,582,13968,14550,2025-07-08,2025-08-29,620.68,0,582,90008549,22549292,0.0161651311588191,99.8978930323607,0.04
586.9,587,1136,1443,15904,14430,2025-07-08,2025-07-11,620.68,307,-1474,35723216,11601493,0.0403938995861963,99.3317762880027,-0.102148302148302
621.4,650,2,5,4944,14300,2025-07-08,2025-08-08,620.68,3,9356,23649737,8175363,0.0604657886893203,99.4358161361372,0.654265734265734
593.83,594,846,836,20304,14212,2025-07-08,2025-07-11,620.68,-10,-6092,35723216,11601493,0.0397836521773404,99.3715599401801,-0.428651843512525
614.66,650,3,4,9690,14136,2025-07-08,2025-11-21,620.68,1,4446,23945131,16405869,0.0590349662317571,99.539660067009,0.314516129032258
504.87,505,1086,1086,17376,14118,2025-07-08,2025-07-25,620.68,0,-3258,47357171,17128032,0.0298117469897009,99.7604755571231,-0.230769230769231
620.21,631,13,13,11323,14027,2025-07-08,2025-07-18,620.68,0,2704,131764767,24110937,0.0106454861336339,99.8371028880581,0.192771084337349
445.76,446,581,581,13944,13944,2025-07-08,2025-08-15,620.68,0,0,296966434,50073190,0.00469548016325643,99.9416822980068,0
304.82,305,688,774,11696,13932,2025-07-08,2025-09-19,620.68,86,2236,397445891,51899302,0.00350538282455158,99.9686883163676,0.160493827160494
461.7,462,463,463,13890,13890,2025-07-08,2025-08-15,620.68,0,0,296966434,50073190,0.00467729628999081,99.9463595942968,0
474.99,475,13865,13868,13865,13868,2025-07-08,2025-07-11,620.68,3,3,35723216,11601493,0.0388206929633659,99.4103806331434,0.00021632535333141
239.92,240,1713,1719,17130,13752,2025-07-08,2025-09-19,620.68,6,-3378,397445891,51899302,0.00346009364077185,99.9721484100083,-0.245636998254799
154.98,155,6769,6769,13538,13538,2025-07-08,2025-09-19,620.68,0,0,397445891,51899302,0.00340624983338927,99.9755546598417,0
566.95,567,2662,2668,15972,13340,2025-07-08,2025-07-11,620.68,6,-2632,35723216,11601493,0.0373426625419167,99.4477232956854,-0.197301349325337
613.37,630,7,8,9443,13304,2025-07-08,2025-08-22,620.68,1,3861,1750119,1049799,0.760176879400772,98.0240200809202,0.290213469633193
384.87,385,1022,1023,10220,13299,2025-07-08,2025-08-15,620.68,1,3079,296966434,50073190,0.00447828389925038,99.950837878196,0.231521167005038
529.98,530,6619,6632,19857,13264,2025-07-08,2025-07-11,620.68,13,-6593,35723216,11601493,0.0371299157388293,99.4848532114242,-0.497059710494572
534.97,535,3708,4417,11124,13251,2025-07-08,2025-07-11,620.68,709,2127,35723216,11601493,0.0370935248383012,99.5219467362625,0.16051618745755
374.99,375,12999,12999,12999,12999,2025-07-08,2025-07-18,620.68,0,0,131764767,24110937,0.00986530792408262,99.8469681959822,0
324.96,325,3249,3249,12996,12996,2025-07-08,2025-08-15,620.68,0,0,296966434,50073190,0.0043762521659266,99.955214130362,0
440.75,441,519,519,12975,12975,2025-07-08,2025-08-15,620.68,0,0,296966434,50073190,0.00436918065965664,99.9595833110216,0
388.81,390,109,109,12971,12971,2025-07-08,2025-11-21,620.68,0,0,23945131,16405869,0.0541696764991597,99.5938297435082,0
314.81,315,598,667,11362,12673,2025-07-08,2025-09-19,620.68,69,1311,397445891,51899302,0.00318861014466998,99.9787432699864,0.103448275862069
452.73,453,469,469,12663,12663,2025-07-08,2025-08-15,620.68,0,0,296966434,50073190,0.0042641182807886,99.9638474293024,0
514.51,515,236,257,12508,12593,2025-07-08,2025-08-08,620.68,21,84.9999999999982,23649737,8175363,0.0532479494380847,99.4890640855753,0.006749781624712
274.97,275,4241,4192,8482,12576,2025-07-08,2025-08-15,620.68,-49,4094,296966434,50073190,0.00423482204052731,99.9680822513429,0.325540712468193
467.63,470,53,53,12561,12561,2025-07-08,2025-11-21,620.68,0,0,23945131,16405869,0.0524574286104344,99.6462871721186,0
457.6,460,3,52,714,12480,2025-07-08,2025-11-21,620.68,49,11766,23945131,16405869,0.0521191552470521,99.6984063273657,0.942788461538461
319.96,320,3036,3044,15180,12176,2025-07-08,2025-08-15,620.68,8,-3004,296966434,50073190,0.00410012668300418,99.9721823780259,-0.246714848883049
529.48,535,22,22,12144,12144,2025-07-08,2025-11-21,620.68,0,0,23945131,16405869,0.0507159472211699,99.7491222745869,0
614.68,645,3,4,7995,12128,2025-07-08,2025-10-17,620.68,1,4133,130178883,18894460,0.00931641117246335,99.954889765032,0.340781662269129
585.89,586,455,1073,6370,11803,2025-07-08,2025-07-11,620.68,618,5433,35723216,11601493,0.0330401383794785,99.554986874642,0.460306701686012
598.97,608,1,13,708,11739,2025-07-08,2025-08-22,620.68,12,11031,1750119,1049799,0.670754388701568,98.6947744696218,0.939688218757986
450.75,451,457,462,11425,11550,2025-07-08,2025-08-15,620.68,5,125,296966434,50073190,0.00388932844848048,99.9760717064744,0.0108225108225108
617.35,640,4,5,6996,11325,2025-07-08,2025-08-08,620.68,1,4329,23649737,8175363,0.0478863676158428,99.5369504531911,0.382251655629139
622.32,650,15,4,36945,11072,2025-07-08,2025-07-25,620.68,-11,-25873,47357171,17128032,0.0233797749447491,99.7838553320679,-2.33679552023121
494.76,495,157,455,3768,10920,2025-07-08,2025-08-01,620.68,298,7152,34440445,8262067,0.0317069073875207,99.7671371551674,0.654945054945055
437.79,438,520,520,10920,10920,2025-07-08,2025-08-15,620.68,0,0,296966434,50073190,0.00367718326038154,99.9797488897348,0
209.95,210,2162,2162,10810,10810,2025-07-08,2025-09-19,620.68,0,0,397445891,51899302,0.00271986709254971,99.981463137079,0
529.38,530,76,172,4408,10664,2025-07-08,2025-08-08,620.68,96,6256,23649737,8175363,0.0450914105302736,99.5820418637214,0.586646661665416
364.37,365,169,169,10309,10647,2025-07-08,2025-10-17,620.68,0,338,130178883,18894460,0.00817874585696053,99.963068510889,0.0317460317460317
539.24,540,108,138,7884,10488,2025-07-08,2025-08-08,620.68,30,2604,23649737,8175363,0.0443472162079435,99.6263890799293,0.248283752860412
447.76,448,429,429,10296,10296,2025-07-08,2025-08-15,620.68,0,0,296966434,50073190,0.00346705850264545,99.9832159482374,0
428.78,429,467,467,10274,10274,2025-07-08,2025-08-15,620.68,0,0,296966434,50073190,0.00345965025798168,99.9866755984954,0
499.88,500,830,856,13280,10272,2025-07-08,2025-07-25,620.68,26,-3008,47357171,17128032,0.0216904848475852,99.8055458169155,-0.292834890965732
409.7,410,353,342,9531,10260,2025-07-08,2025-08-29,620.68,-11,729,90008549,22549292,0.0113989172295178,99.9092919495903,0.0710526315789474
244.91,245,1130,1130,7910,10170,2025-07-08,2025-09-19,620.68,0,2260,397445891,51899302,0.0025588388835551,99.9840219759625,0.222222222222222
424.98,425,5069,5069,10138,10138,2025-07-08,2025-07-18,620.68,0,0,131764767,24110937,0.00769401428835677,99.8546622102705,0
597.76,602.5,7,21,3129,9954,2025-07-08,2025-08-08,620.68,14,6825,23649737,8175363,0.0420892629799646,99.6684783429093,0.685654008438819
234.91,235,1058,1058,9522,9522,2025-07-08,2025-09-19,620.68,0,0,397445891,51899302,0.00239579782194804,99.9864177737845,0
414.96,415,2245,2361,8980,9444,2025-07-08,2025-07-25,620.68,116,464,47357171,17128032,0.0199420695970205,99.8254878865125,0.049131723845828
479.8,480,405,471,7290,9420,2025-07-08,2025-08-01,620.68,66,2130,34440445,8262067,0.027351562966158,99.7944887181336,0.226114649681529
524.14,530,13,16,6734,9376,2025-07-08,2025-11-21,620.68,3,2642,23945131,16405869,0.039156185865093,99.788278460452,0.281783276450512
504.98,505,4575,4593,9150,9186,2025-07-08,2025-07-11,620.68,18,36,35723216,11601493,0.0257143701731669,99.5807012448151,0.00391900718484651
404.99,405,7138,9099,7138,9099,2025-07-08,2025-07-18,620.68,1961,1961,131764767,24110937,0.00690548786839201,99.8615676981389,0.215518188811957
299.99,300,8953,8953,8953,8953,2025-07-08,2025-07-18,620.68,0,0,131764767,24110937,0.00679468434835847,99.8683623824873,0
349.99,350,8863,8863,8863,8863,2025-07-08,2025-07-18,620.68,0,0,131764767,24110937,0.00672638080861176,99.8750887632959,0
620.52,633,7,7,6636,8736,2025-07-08,2025-07-18,620.68,0,2100,131764767,24110937,0.00662999692474696,99.8817187602206,0.240384615384615
618.58,636,5,5,8710,8710,2025-07-08,2025-08-29,620.68,0,0,90008549,22549292,0.00967685858373298,99.918968808174,0
484.91,485,940,945,15980,8505,2025-07-08,2025-07-25,620.68,5,-7475,47357171,17128032,0.0179592653454743,99.843447151858,-0.878894767783657
374.8,375,427,425,8113,8500,2025-07-08,2025-08-29,620.68,-2,387,90008549,22549292,0.00944354741236858,99.9284123555864,0.0455294117647059
509.57,510,194,197,8148,8471,2025-07-08,2025-08-08,620.68,3,323,23649737,8175363,0.0358185801389673,99.7042969230482,0.0381300908983591
519.83,520,561,498,11781,8466,2025-07-08,2025-07-25,620.68,-63,-3315,47357171,17128032,0.0178769124532376,99.8613240643112,-0.391566265060241
164.97,165,2805,2805,8415,8415,2025-07-08,2025-09-19,620.68,0,0,397445891,51899302,0.00211726934170267,99.9885350431262,0
575.94,576,1328,1398,14608,8388,2025-07-08,2025-07-11,620.68,70,-6220,35723216,11601493,0.0234805287407494,99.6041817735559,-0.741535526943253
179.97,180,2154,2776,6462,8328,2025-07-08,2025-09-19,620.68,622,1866,397445891,51899302,0.00209537956954246,99.9906304226957,0.224063400576369
611.98,695,1,1,8302,8302,2025-07-08,2025-11-21,620.68,0,0,23945131,16405869,0.0346709316395053,99.8229493920915,0
613.19,627,7,6,7266,8286,2025-07-08,2025-08-08,620.68,-1,1020,23649737,8175363,0.0350363304251544,99.7393332534734,0.123099203475742
354.93,355,1141,1178,7987,8246,2025-07-08,2025-08-15,620.68,37,259,296966434,50073190,0.0027767447953394,99.9894523432908,0.0314091680814941
334.99,335,8161,8161,8161,8161,2025-07-08,2025-07-18,620.68,0,0,131764767,24110937,0.00619361319858745,99.8879123734192,0
593.22,597.5,9,19,3186,8132,2025-07-08,2025-08-08,620.68,10,4946,23649737,8175363,0.0343851603931156,99.7737184138665,0.608214461387113
309.99,310,8095,8095,8095,8095,2025-07-08,2025-07-18,620.68,0,0,131764767,24110937,0.00614352393610653,99.8940558973553,0
619.63,700,1,1,8802,8037,2025-07-08,2025-10-17,620.68,0,-765,130178883,18894460,0.00617381238399472,99.969242323273,-0.0951847704367301
619.74,700,1,1,7377,8026,2025-07-08,2025-08-29,620.68,0,649.000000000001,90008549,22549292,0.00891693076843179,99.9373292863548,0.080862197856965
464.85,465,530,533,7950,7995,2025-07-08,2025-08-01,620.68,3,45,34440445,8262067,0.0232139857658634,99.8177027038994,0.00562851782363978
189.97,190,1812,2636,5436,7908,2025-07-08,2025-09-19,620.68,824,2472,397445891,51899302,0.00198970480738974,99.9926201275031,0.312594840667678
289.97,290,2715,2618,8145,7854,2025-07-08,2025-08-15,620.68,-97,-291.000000000001,296966434,50073190,0.00264474334496672,99.9920970866357,-0.0370511841100078
583.89,584,632,711,8216,7821,2025-07-08,2025-07-11,620.68,79,-395.000000000001,35723216,11601493,0.0218933256177159,99.6260750991736,-0.0505050505050506
344.49,345,152,152,7752,7752,2025-07-08,2025-10-17,620.68,0,0,130178883,18894460,0.00595488286683179,99.9751972061398,0
409.98,410,3869,3869,7738,7738,2025-07-08,2025-07-18,620.68,0,0,131764767,24110937,0.00587258656177793,99.8999284839171,0
344.86,345,542,551,7046,7714,2025-07-08,2025-08-29,620.68,9,667.999999999999,90008549,22549292,0.00857029702811896,99.9458995833829,0.0865957998444386
324.99,325,7745,7705,7745,7705,2025-07-08,2025-07-18,620.68,-40,-40,131764767,24110937,0.00584754193053747,99.9057760258476,-0.00519143413367943
359.99,360,7705,7705,7705,7705,2025-07-08,2025-07-18,620.68,0,0,131764767,24110937,0.00584754193053747,99.9116235677782,0
504.7,505,248,256,7936,7680,2025-07-08,2025-08-01,620.68,8,-256,34440445,8262067,0.0222993634373772,99.8400020673368,-0.0333333333333333
379.78,380,313,344,7825,7568,2025-07-08,2025-08-29,620.68,31,-256.999999999999,90008549,22549292,0.00840809021374181,99.9543076735966,-0.0339587737843551
354.44,355,133,134,6783,7504,2025-07-08,2025-10-17,620.68,1,721.000000000001,130178883,18894460,0.00576437577821282,99.980961581918,0.0960820895522389
474.84,475,100,467,1900,7472,2025-07-08,2025-08-01,620.68,367,5572,34440445,8262067,0.0216954223442816,99.8616974896811,0.745717344753747
479.69,480,225,239,6075,7409,2025-07-08,2025-08-08,620.68,14,1334,23649737,8175363,0.0313280439439982,99.8050464578105,0.180051288972871
279.99,280,7341,7341,7341,7341,2025-07-08,2025-07-18,620.68,0,0,131764767,24110937,0.00557129205867301,99.9171948598369,0
618.69,637,0,4,0,7324,2025-07-08,2025-07-11,620.68,4,7324,35723216,11601493,0.0205020734975261,99.6465771726711,1
454.94,455,1201,1201,10809,7206,2025-07-08,2025-07-25,620.68,0,-3603,47357171,17128032,0.0152162805502043,99.8765403448614,-0.5
184.97,185,1584,2394,4752,7182,2025-07-08,2025-09-19,620.68,810,2430,397445891,51899302,0.00180703843281147,99.9944271659359,0.338345864661654
544.98,545,3549,3538,14196,7076,2025-07-08,2025-07-11,620.68,-11,-7120,35723216,11601493,0.0198078470874515,99.6663850197586,-1.00621820237422
619.79,690,1,1,6430,7021,2025-07-08,2025-07-11,620.68,0,590.999999999999,35723216,11601493,0.0196538855852172,99.6860389053438,0.0841760432986753
568.95,569,1390,1395,11120,6975,2025-07-08,2025-07-11,620.68,5,-4145,35723216,11601493,0.0195251177833485,99.7055640231271,-0.59426523297491
379.31,380,69,100,4554,6900,2025-07-08,2025-10-17,620.68,31,2346,130178883,18894460,0.00530039883657628,99.9862619807546,0.34
369.37,370,107,108,7704,6804,2025-07-08,2025-10-17,620.68,1,-899.999999999998,130178883,18894460,0.00522665415711087,99.9914886349117,-0.132275132275132
549.98,550,3327,3387,16635,6774,2025-07-08,2025-07-11,620.68,60,-9861,35723216,11601493,0.0189624584751832,99.7245264816023,-1.45571302037201
459.87,460,417,515,5838,6695,2025-07-08,2025-08-01,620.68,98,857,34440445,8262067,0.0194393539340157,99.8811368436151,0.128005974607916
369.81,370,352,352,5984,6688,2025-07-08,2025-08-29,620.68,0,704,90008549,22549292,0.00743040530516718,99.9617380789018,0.105263157894737
580.92,581,736,835,8096,6680,2025-07-08,2025-07-11,620.68,99,-1416,35723216,11601493,0.0186993242713646,99.7432258058737,-0.211976047904192
269.99,270,6647,6647,6647,6647,2025-07-08,2025-07-18,620.68,0,0,131764767,24110937,0.00504459587440397,99.9222394557113,0
524.59,525,163,162,6520,6642,2025-07-08,2025-08-01,620.68,-1,122,34440445,8262067,0.0192854650977942,99.9004223087129,0.0183679614573924
159.97,160,2207,2207,6621,6621,2025-07-08,2025-09-19,620.68,0,0,397445891,51899302,0.00166588714336463,99.9960930530793,0
612.4,645,2,2,6520,6520,2025-07-08,2025-11-21,620.68,0,0,23945131,16405869,0.0272289176450945,99.8501783097365,0
364.99,365,6391,6391,6391,6391,2025-07-08,2025-07-18,620.68,0,0,131764767,24110937,0.00485031025023556,99.9270897659615,0
616.03,632,3,4,4284,6388,2025-07-08,2025-08-22,620.68,1,2104,1750119,1049799,0.365003751173492,99.0597782207953,0.329367564182843
504.59,505,109,155,4360,6355,2025-07-08,2025-08-08,620.68,46,1995,23649737,8175363,0.0268713347636805,99.8319177925742,0.313926042486231
359.46,360,117,117,6318,6318,2025-07-08,2025-10-17,620.68,0,0,130178883,18894460,0.00485332171731724,99.996341956629,0
494.89,495,587,572,8218,6292,2025-07-08,2025-07-25,620.68,-15,-1926,47357171,17128032,0.0132862666141945,99.8898266114756,-0.30610298792117
573.94,574,954,1045,7632,6270,2025-07-08,2025-07-11,620.68,91,-1362,35723216,11601493,0.017551611254709,99.7607774171284,-0.217224880382775
244.99,245,6239,6239,6239,6239,2025-07-08,2025-07-18,620.68,0,0,131764767,24110937,0.00473495316088557,99.9318247191224,0
264.98,265,2643,3092,5286,6184,2025-07-08,2025-08-15,620.68,449,898,296966434,50073190,0.00208239022730764,99.994179476863,0.145213454075032
619.72,680,1,1,6028,6028,2025-07-08,2025-12-19,620.68,0,0,522038386,40509509,0.00115470435923078,99.9988602370708,0
578.93,579,842,860,12630,6020,2025-07-08,2025-07-11,620.68,18,-6610,35723216,11601493,0.0168517862445531,99.777629203373,-1.09800664451827
319.98,320,2992,2992,5984,5984,2025-07-08,2025-07-18,620.68,0,0,131764767,24110937,0.00454142646493656,99.9363661455873,0
615.5,675,1,1,5950,5950,2025-07-08,2025-12-19,620.68,0,0,522038386,40509509,0.0011397629292341,100,0
459.99,460,5870,5870,5870,5870,2025-07-08,2025-07-11,620.68,0,0,35723216,11601493,0.0164318912384596,99.7940610946114,0
612.33,627,4,4,5212,5868,2025-07-08,2025-08-22,620.68,0,656,1750119,1049799,0.335291485893245,99.3950697066885,0.111792774369461
254.91,255,329,651,3290,5859,2025-07-08,2025-09-19,620.68,322,2569,397445891,51899302,0.00147416293203041,99.9975672160113,0.43847072879331
539.98,540,2245,2918,8980,5836,2025-07-08,2025-07-11,620.68,673,-3144,35723216,11601493,0.0163367150370784,99.8103978096485,-0.538725154215216
444.89,445,136,530,1496,5830,2025-07-08,2025-08-01,620.68,394,4334,34440445,8262067,0.0169277719843632,99.9173500806973,0.743396226415094
474.91,475,643,645,7073,5805,2025-07-08,2025-07-25,620.68,2,-1268,47357171,17128032,0.0122579112675459,99.9020845227431,-0.218432385874246
294.99,295,5829,5771,5829,5771,2025-07-08,2025-07-18,620.68,-58,-58,131764767,24110937,0.00437977475420269,99.9407459203415,-0.0100502512562814
284.99,285,5577,5577,5577,5577,2025-07-08,2025-07-18,620.68,0,0,131764767,24110937,0.00423254267963757,99.9449784630212,0
379.99,380,5537,5537,5537,5537,2025-07-08,2025-07-18,620.68,0,0,131764767,24110937,0.00420218555086126,99.949180648572,0
249.99,250,5506,5506,5506,5506,2025-07-08,2025-07-18,620.68,0,0,131764767,24110937,0.00417865877605961,99.9533593073481,0
344.99,345,5465,5465,5465,5465,2025-07-08,2025-07-18,620.68,0,0,131764767,24110937,0.00414754271906389,99.9575068500671,0
444.98,445,2711,2729,8133,5458,2025-07-08,2025-07-18,620.68,18,-2675,131764767,24110937,0.00414223022152804,99.9616490802887,-0.490106266031513
359.81,360,266,286,5054,5434,2025-07-08,2025-08-29,620.68,20,380,90008549,22549292,0.00603720431044833,99.9677752832123,0.0699300699300699
354.74,355,206,206,5356,5356,2025-07-08,2025-08-29,620.68,0,0,90008549,22549292,0.00595054587537013,99.9737258290876,0
398.71,400,33,41,3960,5289,2025-07-08,2025-11-21,620.68,8,1329,23945131,16405869,0.022087997764556,99.8722663075011,0.25127623369257
582.93,583,760,755,10640,5285,2025-07-08,2025-07-11,620.68,-5,-5355,35723216,11601493,0.0147943007146949,99.8251921103632,-1.01324503311258
174.97,175,1747,1747,5241,5241,2025-07-08,2025-09-19,620.68,0,0,397445891,51899302,0.00131867006771999,99.998885886079,0
572.95,573,1028,1033,10280,5165,2025-07-08,2025-07-11,620.68,5,-5115,35723216,11601493,0.0144583847098201,99.839650495073,-0.990319457889642
469.72,470,184,184,5152,5152,2025-07-08,2025-08-01,620.68,0,0,34440445,8262067,0.0149591563059072,99.9323092370032,0
484.8,485,112,253,2352,5060,2025-07-08,2025-08-01,620.68,141,2708,34440445,8262067,0.0146920285147303,99.9470012655179,0.535177865612648
418.47,420,11,33,1595,5049,2025-07-08,2025-11-21,620.68,22,3454,23945131,16405869,0.0210857063174973,99.8933520138186,0.684095860566449
576.94,577,728,829,9464,4974,2025-07-08,2025-07-11,620.68,101,-4490,35723216,11601493,0.013923718402061,99.8535742134751,-0.902694008846
324.89,325,437,452,4370,4972,2025-07-08,2025-08-29,620.68,15,602,90008549,22549292,0.00552391973344665,99.9792497488211,0.121078037007241
616.59,633,1,3,1415,4923,2025-07-08,2025-08-08,620.68,2,3508,23649737,8175363,0.0208162991410856,99.8527340917153,0.712573633963031
384.77,385,209,210,4389,4830,2025-07-08,2025-08-29,620.68,1,441,90008549,22549292,0.0053661569413812,99.9846159057625,0.091304347826087
419.99,420,4768,4768,4768,4768,2025-07-08,2025-07-18,620.68,0,0,131764767,24110937,0.00361856975013662,99.9652676500388,0
618.47,634,0,3,0,4659,2025-07-08,2025-07-25,620.68,3,4659,47357171,17128032,0.00983800320335858,99.9119225259465,1
394.98,395,2303,2303,4606,4606,2025-07-08,2025-07-18,620.68,0,0,131764767,24110937,0.00349562337859255,99.9687632734174,0
304.99,305,4586,4586,4586,4586,2025-07-08,2025-07-18,620.68,0,0,131764767,24110937,0.00348044481420439,99.9722437182316,0
449.89,450,403,403,4433,4433,2025-07-08,2025-07-25,620.68,0,0,47357171,17128032,0.00936077875090976,99.9212833046974,0
169.97,170,1476,1476,4428,4428,2025-07-08,2025-09-19,620.68,0,0,397445891,51899302,0.00111411392098151,100,0
444.79,445,209,209,4389,4389,2025-07-08,2025-08-08,620.68,0,0,23649737,8175363,0.0185583459131068,99.8712924376284,0
384.99,385,4358,4358,4358,4358,2025-07-08,2025-07-18,620.68,0,0,131764767,24110937,0.0033074091801794,99.9755511274118,0
404.89,405,390,390,4290,4290,2025-07-08,2025-07-25,620.68,0,0,47357171,17128032,0.0090588181460417,99.9303421228434,0
349.87,350,330,330,4290,4290,2025-07-08,2025-08-29,620.68,0,0,90008549,22549292,0.00476621392930132,99.9893821196918,0
469.93,470,325,598,2600,4186,2025-07-08,2025-07-25,620.68,273,1586,47357171,17128032,0.00883921043341039,99.9391813332769,0.37888198757764
354.99,355,4167,4167,4167,4167,2025-07-08,2025-07-18,620.68,0,0,131764767,24110937,0.0031624538902725,99.978713581302,0
378.96,380,40,40,4160,4160,2025-07-08,2025-11-21,620.68,0,0,23945131,16405869,0.0173730517490174,99.9107250655676,0
469.73,470,149,151,4768,4077,2025-07-08,2025-08-08,620.68,2,-691,23649737,8175363,0.0172390923417034,99.8885315299701,-0.169487368162865
439.84,440,236,245,4720,3920,2025-07-08,2025-08-08,620.68,9,-800,23649737,8175363,0.0165752371791703,99.9051067671493,-0.204081632653061
289.99,290,3853,3853,3853,3853,2025-07-08,2025-07-18,620.68,0,0,131764767,24110937,0.00292415042937844,99.9816377317314,0
443.08,445,19,20,3420,3840,2025-07-08,2025-11-21,620.68,1,420,23945131,16405869,0.0160366631529391,99.9267617287206,0.109375
314.96,315,925,958,4625,3832,2025-07-08,2025-08-15,620.68,33,-793,296966434,50073190,0.00129038152507162,99.9954698583881,-0.206941544885177
455.69,456,123,123,3813,3813,2025-07-08,2025-08-15,620.68,0,0,296966434,50073190,0.00128398349558927,99.9967538418837,0
617.49,655,1,1,3751,3751,2025-07-08,2025-07-18,620.68,0,0,131764767,24110937,0.00284673975099884,99.9844844714824,0
571.95,572,701,745,6309,3725,2025-07-08,2025-07-11,620.68,44,-2584,35723216,11601493,0.0104273926513223,99.8640016061264,-0.693691275167785
494.98,495,1786,1848,1786,3696,2025-07-08,2025-07-11,620.68,62,1910,35723216,11601493,0.0103462129501442,99.8743478190765,0.516774891774892
519.47,520,59,69,3009,3657,2025-07-08,2025-08-08,620.68,10,648,23649737,8175363,0.0154631740725066,99.9205699412218,0.177194421657096
570.95,571,496,703,3472,3515,2025-07-08,2025-07-11,620.68,207,42.9999999999995,35723216,11601493,0.0098395396427914,99.8841873587193,0.0122332859174963
249.98,250,1755,1755,3510,3510,2025-07-08,2025-08-15,620.68,0,0,296966434,50073190,0.0011819517622655,99.997935793646,0
414.98,415,1725,1725,3450,3450,2025-07-08,2025-07-18,620.68,0,0,131764767,24110937,0.00261830235695708,99.9871027738394,0
459.94,460,571,571,5139,3426,2025-07-08,2025-07-25,620.68,0,-1713,47357171,17128032,0.00723438484110463,99.946415718118,-0.5
616.95,634,0,2,0,3410,2025-07-08,2025-08-22,620.68,2,3410,1750119,1049799,0.194843893472387,99.5899136001609,1
254.98,255,1697,1697,3394,3394,2025-07-08,2025-08-15,620.68,0,0,296966434,50073190,0.00114289010858379,99.9990786837545,0
454.88,455,246,273,3198,3276,2025-07-08,2025-08-01,620.68,27,78,34440445,8262067,0.00951207221625621,99.9565133377342,0.0238095238095238
615.97,632,0,2,0,3206,2025-07-08,2025-08-01,620.68,2,3206,34440445,8262067,0.00930882280992595,99.9658221605441,1
519.98,520,1608,1598,3216,3196,2025-07-08,2025-07-11,620.68,-10,-20.0000000000005,35723216,11601493,0.00894656292983252,99.8931339216492,-0.00625782227784745
379.91,380,350,350,3150,3150,2025-07-08,2025-08-08,620.68,0,0,23649737,8175363,0.0133193870189762,99.9338893282408,0
623.7,655,0,1,0,3130,2025-07-08,2025-08-29,620.68,1,3130,90008549,22549292,0.00347744745890749,99.9928595671507,1
509.98,510,1557,1555,1557,3110,2025-07-08,2025-07-11,620.68,-2,1553,35723216,11601493,0.0087058231263389,99.9018397447755,0.49935691318328
339.99,340,3101,3101,3101,3101,2025-07-08,2025-07-18,620.68,0,0,131764767,24110937,0.00235343640838374,99.9894562102478,0
615.72,631,1,2,1235,3056,2025-07-08,2025-08-08,620.68,1,1821,23649737,8175363,0.0129219195968226,99.9468112478376,0.595876963350785
384.98,385,365,1517,2190,3034,2025-07-08,2025-07-25,620.68,1152,844,47357171,17128032,0.0064066326934943,99.9528223508115,0.278180619644034
620.46,650,1,1,2439,2954,2025-07-08,2025-07-11,620.68,0,515,35723216,11601493,0.00826913232000165,99.9101088770955,0.174339878131347
491.75,495,9,9,2925,2925,2025-07-08,2025-11-21,620.68,0,0,23945131,16405869,0.0122154270110278,99.9389771557316,0
603.37,613,0,3,0,2889,2025-07-08,2025-08-22,620.68,3,2889,1750119,1049799,0.165074489220447,99.7549880893814,1
438.09,440,13,15,2262,2865,2025-07-08,2025-11-21,620.68,2,603,23945131,16405869,0.0119648541492632,99.9509420098808,0.210471204188482
329.99,330,2841,2841,2841,2841,2025-07-08,2025-07-18,620.68,0,0,131764767,24110937,0.0021561150713377,99.9916123253191,0
489.99,490,2753,2796,5506,2796,2025-07-08,2025-07-11,620.68,43,-2710,35723216,11601493,0.00782684291358315,99.9179357200091,-0.969241773962804
314.99,315,2792,2792,2792,2792,2025-07-08,2025-07-18,620.68,0,0,131764767,24110937,0.00211892758858671,99.9937312529077,0
514.98,515,1369,1368,1369,2736,2025-07-08,2025-07-11,620.68,-1,1367,35723216,11601493,0.00765888491114574,99.9255946049202,0.499634502923977
294.98,295,1368,1368,2736,2736,2025-07-08,2025-08-15,620.68,0,0,296966434,50073190,0.000921316245458232,100,0
399.98,400,1350,1350,2700,2700,2025-07-08,2025-07-25,620.68,0,0,47357171,17128032,0.00570135407792835,99.9585237048894,0
452.8,455,10,12,2010,2640,2025-07-08,2025-11-21,620.68,2,630,23945131,16405869,0.0110252059176456,99.9619672157985,0.238636363636364
439.95,440,517,515,3619,2575,2025-07-08,2025-07-25,620.68,-2,-1044,47357171,17128032,0.00543740250024648,99.9639611073896,-0.405436893203884
600.54,609,2,3,1390,2538,2025-07-08,2025-08-22,620.68,1,1148,1750119,1049799,0.145018710156281,99.9000067995376,0.452324665090623
489.9,490,254,250,3810,2500,2025-07-08,2025-07-25,620.68,-4,-1310,47357171,17128032,0.00527903155363736,99.9692401389433,-0.524
424.92,425,309,309,3090,2472,2025-07-08,2025-08-01,620.68,0,-618,34440445,8262067,0.00717760760640578,99.9729997681505,-0.25
616.86,629,2,2,2048,2428,2025-07-08,2025-08-01,620.68,0,380,34440445,8262067,0.00704985083671248,99.9800496189872,0.156507413509061
567.95,568,478,479,4780,2395,2025-07-08,2025-07-11,620.68,1,-2385,35723216,11601493,0.00670432359729315,99.9322989285175,-0.995824634655532
494.63,495,55,62,2090,2294,2025-07-08,2025-08-08,620.68,7,204,23649737,8175363,0.00969989645127978,99.9565111442888,0.0889276373147341
369.99,370,2276,2276,2276,2276,2025-07-08,2025-07-18,620.68,0,0,131764767,24110937,0.00172732062737226,99.9954585735351,0
403.74,405,18,18,2268,2268,2025-07-08,2025-11-21,620.68,0,0,23945131,16405869,0.00947165417470466,99.9714388699732,0
329.56,330,51,51,2244,2244,2025-07-08,2025-10-17,620.68,0,0,130178883,18894460,0.00172378188250394,99.9980657385115,0
524.99,525,2416,2226,4832,2226,2025-07-08,2025-07-11,620.68,-190,-2606,35723216,11601493,0.00623124189042778,99.938530170408,-1.1707097933513
433.29,435,13,13,2223,2223,2025-07-08,2025-11-21,620.68,0,0,23945131,16405869,0.00928372452838116,99.9807225945016,0
439.89,440,1,202,14,2222,2025-07-08,2025-08-01,620.68,201,2208,34440445,8262067,0.00645171686951199,99.9865013358567,0.993699369936994
622.3,633,2,2,2140,2140,2025-07-08,2025-07-25,620.68,0,0,47357171,17128032,0.00451885100991358,99.9737589899532,0
339.87,340,131,163,1572,2119,2025-07-08,2025-08-29,620.68,32,547,90008549,22549292,0.00235422081962459,99.9952137879703,0.258140632373761
524.41,525,30,35,1620,2065,2025-07-08,2025-08-08,620.68,5,445,23649737,8175363,0.00873159815688437,99.9652427424457,0.215496368038741
259.99,260,2057,2057,2057,2057,2025-07-08,2025-07-18,620.68,0,0,131764767,24110937,0.00156111534732194,99.9970196888824,0
334.88,335,140,170,1540,2040,2025-07-08,2025-08-29,620.68,30,500,90008549,22549292,0.00226645137896846,99.9974802393493,0.245098039215686
374.99,375,1981,1981,1981,1981,2025-07-08,2025-07-11,620.68,0,0,35723216,11601493,0.00554541338047504,99.9440755837884,0
424.98,425,973,973,1946,1946,2025-07-08,2025-07-11,620.68,0,0,35723216,11601493,0.00544743787905322,99.9495230216675,0
409.89,410,5,168,55,1848,2025-07-08,2025-08-08,620.68,163,1793,23649737,8175363,0.00781404038446601,99.9730567828302,0.970238095238095
409.97,410,315,605,1575,1815,2025-07-08,2025-07-25,620.68,290,240,47357171,17128032,0.00383257690794072,99.9775915668611,0.132231404958678
464.99,465,1815,1812,1815,1812,2025-07-08,2025-07-11,620.68,-3,-3.00000000000023,35723216,11601493,0.00507233167360968,99.9545953533411,-0.00165562913907297
615.5,633,0,1,0,1750,2025-07-08,2025-08-22,620.68,1,1750,1750119,1049799,0.0999932004623686,100,1
264.99,265,1708,1708,1708,1708,2025-07-08,2025-07-18,620.68,0,0,131764767,24110937,0.0012962493987486,99.9983159382811,0
499.99,500,1762,1698,3524,1698,2025-07-08,2025-07-11,620.68,-64,-1826,35723216,11601493,0.00475321146897861,99.9593485648101,-1.075382803298
434.96,435,423,423,2115,1692,2025-07-08,2025-07-25,620.68,0,-423,47357171,17128032,0.00357284855550176,99.9811644154166,-0.25
334.5,335,33,33,1650,1650,2025-07-08,2025-10-17,620.68,0,0,130178883,18894460,0.00126748667831172,99.9993332251898,0
424.96,425,519,401,2595,1604,2025-07-08,2025-07-25,620.68,-118,-991.000000000001,47357171,17128032,0.00338702664481373,99.9845514420614,-0.61783042394015
374.93,375,197,207,1182,1449,2025-07-08,2025-08-08,620.68,10,267,23649737,8175363,0.00612691802872903,99.9791837008589,0.184265010351967
254.98,255,695,695,1390,1390,2025-07-08,2025-07-18,620.68,0,0,131764767,24110937,0.00105491022497691,99.9993708485061,0
454.99,455,1373,1373,1373,1373,2025-07-08,2025-07-11,620.68,0,0,35723216,11601493,0.00384343895577599,99.9631920037658,0
479.99,480,1358,1368,1358,1368,2025-07-08,2025-07-11,620.68,10,10,35723216,11601493,0.00382944245557287,99.9670214462214,0.00730994152046784
429.95,430,272,272,1360,1360,2025-07-08,2025-07-25,620.68,0,0,47357171,17128032,0.00287179316517872,99.9874232352266,0
472.33,475,4,5,1012,1335,2025-07-08,2025-11-21,620.68,1,323,23945131,16405869,0.00557524617426399,99.9862978406758,0.241947565543071
319.9,320,92,130,920,1300,2025-07-08,2025-08-29,620.68,38,380,90008549,22549292,0.00144430725130343,99.9989245466006,0.292307692307692
449.99,450,1298,1293,1298,1293,2025-07-08,2025-07-11,620.68,-5,-5,35723216,11601493,0.00361949495252611,99.9706409411739,-0.00386697602474865
620,632,0,1,0,1200,2025-07-08,2025-07-25,620.68,1,1200,47357171,17128032,0.00253393514574593,99.9899571703724,1
484.99,485,1184,1184,2368,1184,2025-07-08,2025-07-11,620.68,0,-1184,35723216,11601493,0.00331437124809816,99.973955312422,-1
409.98,410,585,585,1170,1170,2025-07-08,2025-07-11,620.68,0,0,35723216,11601493,0.00327518104752943,99.9772304934696,0
434.9,435,19,114,190,1140,2025-07-08,2025-08-01,620.68,95,950,34440445,8262067,0.00331006176023568,99.989811397617,0.833333333333333
389.96,390,280,281,1400,1124,2025-07-08,2025-08-01,620.68,1,-276,34440445,8262067,0.00326360475307447,99.99307500237,-0.245551601423488
394.97,395,369,369,1107,1107,2025-07-08,2025-07-25,620.68,0,0,47357171,17128032,0.00233755517195062,99.9922947255443,0
414.99,415,1046,1046,1046,1046,2025-07-08,2025-07-11,620.68,0,0,35723216,11601493,0.00292806784249212,99.9801585613121,0
413.53,415,2,7,314,1029,2025-07-08,2025-11-21,620.68,5,715,23945131,16405869,0.00429732457926415,99.9905951652551,0.694849368318756
459.79,460,40,48,1240,1008,2025-07-08,2025-08-08,620.68,8,-232,23649737,8175363,0.00426220384607237,99.983445904705,-0.23015873015873
620.99,631,1,1,1001,1001,2025-07-08,2025-07-25,620.68,0,0,47357171,17128032,0.0021137242340764,99.9944084497784,0
469.99,470,1001,1000,1001,1000,2025-07-08,2025-07-11,620.68,-1,-1,35723216,11601493,0.00279930004062344,99.9829578613527,-0.001
329.89,330,60,88,600,968,2025-07-08,2025-08-29,620.68,28,368,90008549,22549292,0.00107545339943209,100,0.380165289256198
374.98,375,463,463,926,926,2025-07-08,2025-07-25,620.68,0,0,47357171,17128032,0.00195535328746728,99.9963638030659,0
462.76,465,4,4,896,896,2025-07-08,2025-11-21,620.68,0,0,23945131,16405869,0.00374188806901913,99.9943370533241,0
379.96,380,223,223,892,892,2025-07-08,2025-08-01,620.68,0,0,34440445,8262067,0.00258997814923704,99.9956649805193,0
379.98,380,43,438,86,876,2025-07-08,2025-07-25,620.68,395,790,47357171,17128032,0.00184977265639453,99.9982135757223,0.901826484018265
374.38,375,14,14,868,868,2025-07-08,2025-10-17,620.68,0,0,130178883,18894460,0.000666774810166408,100,0
374.97,375,35,287,140,861,2025-07-08,2025-08-01,620.68,252,721,34440445,8262067,0.00249996769786221,99.9981649482171,0.83739837398374
389.98,390,7,423,35,846,2025-07-08,2025-07-25,620.68,416,811,47357171,17128032,0.00178642427775088,100,0.958628841607565
274.99,275,829,829,829,829,2025-07-08,2025-07-18,620.68,0,0,131764767,24110937,0.000629151493889106,100,0
379.99,380,786,786,786,786,2025-07-08,2025-07-11,620.68,0,0,35723216,11601493,0.00220024983193003,99.9851581111846,0
404.98,405,376,376,752,752,2025-07-08,2025-07-11,620.68,0,0,35723216,11601493,0.00210507363054883,99.9872631848152,0
439.99,440,737,737,737,737,2025-07-08,2025-07-11,620.68,0,0,35723216,11601493,0.00206308412993948,99.9893262689451,0
484.71,485,20,25,680,725,2025-07-08,2025-08-08,620.68,5,44.9999999999998,23649737,8175363,0.00306557320278023,99.9865114779078,0.0620689655172411
389.99,390,651,651,651,651,2025-07-08,2025-07-11,620.68,0,0,35723216,11601493,0.00182234432644586,99.9911486132716,0
394.9,395,65,65,650,650,2025-07-08,2025-08-08,620.68,0,0,23649737,8175363,0.00274844494042365,99.9892599228482,0
434.99,435,644,644,644,644,2025-07-08,2025-07-11,620.68,0,0,35723216,11601493,0.0018027492261615,99.9929513624977,0
399.99,400,619,619,619,619,2025-07-08,2025-07-11,620.68,0,0,35723216,11601493,0.00173276672514591,99.9946841292229,0
482.14,485,2,2,572,572,2025-07-08,2025-11-21,620.68,0,0,23945131,16405869,0.00238879461548989,99.9967258479396,0
429.87,430,37,39,518,507,2025-07-08,2025-08-08,620.68,2,-11.0000000000001,23649737,8175363,0.00214378705353045,99.9914037099017,-0.0216962524654835
423.37,425,1,3,157,489,2025-07-08,2025-11-21,620.68,2,332,23945131,16405869,0.00204216882338209,99.998768016763,0.678936605316974
419.99,420,423,423,423,423,2025-07-08,2025-07-11,620.68,0,0,35723216,11601493,0.00118410391718372,99.99586823314,0
429.99,430,411,411,411,411,2025-07-08,2025-07-11,620.68,0,0,35723216,11601493,0.00115051231669624,99.9970187454567,0
394.99,395,390,390,390,390,2025-07-08,2025-07-11,620.68,0,0,35723216,11601493,0.00109172701584314,99.9981104724726,0
444.99,445,370,370,370,370,2025-07-08,2025-07-11,620.68,0,0,35723216,11601493,0.00103574101503067,99.9991462134876,0
399.92,400,33,46,330,368,2025-07-08,2025-08-08,620.68,13,38,23649737,8175363,0.00155604267396293,99.9929597525757,0.103260869565217
449.83,450,9,18,189,306,2025-07-08,2025-08-08,620.68,9,117,23649737,8175363,0.00129388331041483,99.9942536358861,0.382352941176471
384.99,385,305,305,305,305,2025-07-08,2025-07-11,620.68,0,0,35723216,11601493,0.00085378651239015,100,0
419.87,420,9,20,108,260,2025-07-08,2025-08-08,620.68,11,152,23649737,8175363,0.00109937797616946,99.9953530138623,0.584615384615385
434.83,435,9,12,135,204,2025-07-08,2025-08-08,620.68,3,69,23649737,8175363,0.000862588873609884,99.9962156027359,0.338235294117647
474.73,475,5,7,155,189,2025-07-08,2025-08-08,620.68,2,34,23649737,8175363,0.000799163221138569,99.997014765957,0.17989417989418
414.89,415,7,17,77,187,2025-07-08,2025-08-08,620.68,10,110,23649737,8175363,0.000790706467475727,99.9978054724245,0.588235294117647
414.92,415,20,20,160,160,2025-07-08,2025-08-01,620.68,0,0,34440445,8262067,0.000464570071612025,99.9986295182887,0
428.42,430,1,1,158,158,2025-07-08,2025-11-21,620.68,0,0,23945131,16405869,0.00065984186931364,99.9994278586323,0
464.78,465,6,7,150,154,2025-07-08,2025-08-08,620.68,1,4,23649737,8175363,0.000651170032038834,99.9984566424565,0.025974025974026
408.63,410,1,1,137,137,2025-07-08,2025-11-21,620.68,0,0,23945131,16405869,0.000572141367696005,100,0
404.92,405,17,17,136,136,2025-07-08,2025-08-01,620.68,0,0,34440445,8262067,0.000394884560870221,99.9990244028496,0
389.92,390,12,14,120,112,2025-07-08,2025-08-08,620.68,2,-8,23649737,8175363,0.000473578205119152,99.9989302206617,-0.0714285714285714
404.9,405,5,10,50,100,2025-07-08,2025-08-08,620.68,5,50,23649737,8175363,0.0004228376831421,99.9993530583448,0.5
424.87,425,7,7,91,91,2025-07-08,2025-08-08,620.68,0,0,23649737,8175363,0.000384782291659311,99.9997378406365,0
419.82,420,5,5,90,90,2025-07-08,2025-08-01,620.68,0,0,34440445,8262067,0.000261320665281764,99.9992857235149,0
399.94,400,10,11,80,66,2025-07-08,2025-08-01,620.68,1,-14,34440445,8262067,0.00019163515453996,99.9994773586694,-0.212121212121212
429.9,430,6,6,60,60,2025-07-08,2025-08-01,620.68,0,0,34440445,8262067,0.000174213776854509,99.9996515724463,0
454.74,455,2,2,52,52,2025-07-08,2025-08-08,620.68,0,0,23649737,8175363,0.000219875595233892,99.9999577162317,0
394.95,395,10,10,120,50,2025-07-08,2025-08-01,620.68,0,-70,34440445,8262067,0.000145178147378758,99.9997967505937,-1.4
384.95,385,6,8,30,40,2025-07-08,2025-08-01,620.68,2,10,34440445,8262067,0.000116142517903006,99.9999128931116,0.25
409.9,410,3,3,30,30,2025-07-08,2025-08-01,620.68,0,0,34440445,8262067,8.71068884272546e-05,100,0
384.9,385,1,1,10,10,2025-07-08,2025-08-08,620.68,0,0,23649737,8175363,4.228376831421e-05,100,0
620.62,636,0,0,0,0,2025-07-08,2025-07-11,620.68,0,0,35723216,11601493,0,100,
638,638,0,0,0,0,2025-07-08,2025-07-11,620.68,0,0,35723216,11601493,0,100,
639,639,0,0,0,0,2025-07-08,2025-07-11,620.68,0,0,35723216,11601493,0,100,
641,641,0,0,0,0,2025-07-08,2025-07-11,620.68,0,0,35723216,11601493,0,100,
618.7,642,0,0,0,0,2025-07-08,2025-07-11,620.68,0,0,35723216,11601493,0,100,
643,643,0,0,0,0,2025-07-08,2025-07-11,620.68,0,0,35723216,11601493,0,100,
644,644,0,0,0,0,2025-07-08,2025-07-11,620.68,0,0,35723216,11601493,0,100,
621.94,645,2,0,3870,0,2025-07-08,2025-07-11,620.68,-2,-3870,35723216,11601493,0,100,-Inf
646,646,0,0,0,0,2025-07-08,2025-07-11,620.68,0,0,35723216,11601493,0,100,
647,647,0,0,0,0,2025-07-08,2025-07-11,620.68,0,0,35723216,11601493,0,100,
648,648,0,0,0,0,2025-07-08,2025-07-11,620.68,0,0,35723216,11601493,0,100,
649,649,0,0,0,0,2025-07-08,2025-07-11,620.68,0,0,35723216,11601493,0,100,
620.45,655,0,0,0,0,2025-07-08,2025-07-11,620.68,0,0,35723216,11601493,0,100,
660,660,0,0,0,0,2025-07-08,2025-07-11,620.68,0,0,35723216,11601493,0,100,
665,665,0,0,0,0,2025-07-08,2025-07-11,620.68,0,0,35723216,11601493,0,100,
670,670,0,0,0,0,2025-07-08,2025-07-11,620.68,0,0,35723216,11601493,0,100,
675,675,0,0,0,0,2025-07-08,2025-07-11,620.68,0,0,35723216,11601493,0,100,
625.7,680,0,0,0,0,2025-07-08,2025-07-11,620.68,0,0,35723216,11601493,0,100,
596.65,685,0,0,0,0,2025-07-08,2025-07-11,620.68,0,0,35723216,11601493,0,100,
619.7,695,0,0,0,0,2025-07-08,2025-07-11,620.68,0,0,35723216,11601493,0,100,
620.47,700,1,0,7407,0,2025-07-08,2025-07-11,620.68,-1,-7407,35723216,11601493,0,100,-Inf
625.45,650,0,0,0,0,2025-07-08,2025-07-18,620.68,0,0,131764767,24110937,0,100,
607.02,660,0,0,0,0,2025-07-08,2025-07-18,620.68,0,0,131764767,24110937,0,100,
606.66,665,0,0,0,0,2025-07-08,2025-07-18,620.68,0,0,131764767,24110937,0,100,
609.28,670,0,0,0,0,2025-07-08,2025-07-18,620.68,0,0,131764767,24110937,0,100,
611.25,675,0,0,0,0,2025-07-08,2025-07-18,620.68,0,0,131764767,24110937,0,100,
559.85,680,0,0,0,0,2025-07-08,2025-07-18,620.68,0,0,131764767,24110937,0,100,
685,685,0,0,0,0,2025-07-08,2025-07-18,620.68,0,0,131764767,24110937,0,100,
690,690,0,0,0,0,2025-07-08,2025-07-18,620.68,0,0,131764767,24110937,0,100,
589.78,695,0,0,0,0,2025-07-08,2025-07-18,620.68,0,0,131764767,24110937,0,100,
578,700,0,0,0,0,2025-07-08,2025-07-18,620.68,0,0,131764767,24110937,0,100,
705,705,0,0,0,0,2025-07-08,2025-07-18,620.68,0,0,131764767,24110937,0,100,
710,710,0,0,0,0,2025-07-08,2025-07-18,620.68,0,0,131764767,24110937,0,100,
715,715,0,0,0,0,2025-07-08,2025-07-18,620.68,0,0,131764767,24110937,0,100,
616.83,720,0,0,0,0,2025-07-08,2025-07-18,620.68,0,0,131764767,24110937,0,100,
616.83,725,0,0,0,0,2025-07-08,2025-07-18,620.68,0,0,131764767,24110937,0,100,
730,730,0,0,0,0,2025-07-08,2025-07-18,620.68,0,0,131764767,24110937,0,100,
735,735,0,0,0,0,2025-07-08,2025-07-18,620.68,0,0,131764767,24110937,0,100,
593,740,0,0,0,0,2025-07-08,2025-07-18,620.68,0,0,131764767,24110937,0,100,
745,745,0,0,0,0,2025-07-08,2025-07-18,620.68,0,0,131764767,24110937,0,100,
750,750,0,0,0,0,2025-07-08,2025-07-18,620.68,0,0,131764767,24110937,0,100,
755,755,0,0,0,0,2025-07-08,2025-07-18,620.68,0,0,131764767,24110937,0,100,
568.76,760,0,0,0,0,2025-07-08,2025-07-18,620.68,0,0,131764767,24110937,0,100,
765,765,0,0,0,0,2025-07-08,2025-07-18,620.68,0,0,131764767,24110937,0,100,
770,770,0,0,0,0,2025-07-08,2025-07-18,620.68,0,0,131764767,24110937,0,100,
625.75,775,0,0,0,0,2025-07-08,2025-07-18,620.68,0,0,131764767,24110937,0,100,
618.19,780,0,0,0,0,2025-07-08,2025-07-18,620.68,0,0,131764767,24110937,0,100,
619.92,785,0,0,0,0,2025-07-08,2025-07-18,620.68,0,0,131764767,24110937,0,100,
598.01,790,0,0,0,0,2025-07-08,2025-07-18,620.68,0,0,131764767,24110937,0,100,
618.09,795,0,0,0,0,2025-07-08,2025-07-18,620.68,0,0,131764767,24110937,0,100,
619.99,800,0,0,0,0,2025-07-08,2025-07-18,620.68,0,0,131764767,24110937,0,100,
599.17,655,0,0,0,0,2025-07-08,2025-07-25,620.68,0,0,47357171,17128032,0,100,
620.28,660,0,0,0,0,2025-07-08,2025-07-25,620.68,0,0,47357171,17128032,0,100,
599.7,665,0,0,0,0,2025-07-08,2025-07-25,620.68,0,0,47357171,17128032,0,100,
599.68,670,0,0,0,0,2025-07-08,2025-07-25,620.68,0,0,47357171,17128032,0,100,
675,675,0,0,0,0,2025-07-08,2025-07-25,620.68,0,0,47357171,17128032,0,100,
680,680,0,0,0,0,2025-07-08,2025-07-25,620.68,0,0,47357171,17128032,0,100,
685,685,0,0,0,0,2025-07-08,2025-07-25,620.68,0,0,47357171,17128032,0,100,
690,690,0,0,0,0,2025-07-08,2025-07-25,620.68,0,0,47357171,17128032,0,100,
695,695,0,0,0,0,2025-07-08,2025-07-25,620.68,0,0,47357171,17128032,0,100,
700,700,0,0,0,0,2025-07-08,2025-07-25,620.68,0,0,47357171,17128032,0,100,
633,633,0,0,0,0,2025-07-08,2025-08-01,620.68,0,0,34440445,8262067,0,100,
619.66,650,1,0,3279,0,2025-07-08,2025-08-01,620.68,-1,-3279,34440445,8262067,0,100,-Inf
620,655,0,0,0,0,2025-07-08,2025-08-01,620.68,0,0,34440445,8262067,0,100,
660,660,0,0,0,0,2025-07-08,2025-08-01,620.68,0,0,34440445,8262067,0,100,
665,665,0,0,0,0,2025-07-08,2025-08-01,620.68,0,0,34440445,8262067,0,100,
670,670,0,0,0,0,2025-07-08,2025-08-01,620.68,0,0,34440445,8262067,0,100,
675,675,0,0,0,0,2025-07-08,2025-08-01,620.68,0,0,34440445,8262067,0,100,
680,680,0,0,0,0,2025-07-08,2025-08-01,620.68,0,0,34440445,8262067,0,100,
685,685,0,0,0,0,2025-07-08,2025-08-01,620.68,0,0,34440445,8262067,0,100,
690,690,0,0,0,0,2025-07-08,2025-08-01,620.68,0,0,34440445,8262067,0,100,
695,695,0,0,0,0,2025-07-08,2025-08-01,620.68,0,0,34440445,8262067,0,100,
616.7,700,0,0,0,0,2025-07-08,2025-08-01,620.68,0,0,34440445,8262067,0,100,
634,634,0,0,0,0,2025-07-08,2025-08-08,620.68,0,0,23649737,8175363,0,100,
625.4,655,3,0,8880,0,2025-07-08,2025-08-08,620.68,-3,-8880,23649737,8175363,0,100,-Inf
660,660,0,0,0,0,2025-07-08,2025-08-08,620.68,0,0,23649737,8175363,0,100,
665,665,0,0,0,0,2025-07-08,2025-08-08,620.68,0,0,23649737,8175363,0,100,
670,670,0,0,0,0,2025-07-08,2025-08-08,620.68,0,0,23649737,8175363,0,100,
675,675,0,0,0,0,2025-07-08,2025-08-08,620.68,0,0,23649737,8175363,0,100,
680,680,0,0,0,0,2025-07-08,2025-08-08,620.68,0,0,23649737,8175363,0,100,
685,685,0,0,0,0,2025-07-08,2025-08-08,620.68,0,0,23649737,8175363,0,100,
690,690,0,0,0,0,2025-07-08,2025-08-08,620.68,0,0,23649737,8175363,0,100,
695,695,0,0,0,0,2025-07-08,2025-08-08,620.68,0,0,23649737,8175363,0,100,
617.18,700,0,0,0,0,2025-07-08,2025-08-08,620.68,0,0,23649737,8175363,0,100,
595.82,665,0,0,0,0,2025-07-08,2025-08-15,620.68,0,0,296966434,50073190,0,100,
616.76,670,0,0,0,0,2025-07-08,2025-08-15,620.68,0,0,296966434,50073190,0,100,
620.56,680,0,0,0,0,2025-07-08,2025-08-15,620.68,0,0,296966434,50073190,0,100,
620.51,685,0,0,0,0,2025-07-08,2025-08-15,620.68,0,0,296966434,50073190,0,100,
690,690,0,0,0,0,2025-07-08,2025-08-15,620.68,0,0,296966434,50073190,0,100,
695,695,0,0,0,0,2025-07-08,2025-08-15,620.68,0,0,296966434,50073190,0,100,
602,700,0,0,0,0,2025-07-08,2025-08-15,620.68,0,0,296966434,50073190,0,100,
601.7,705,0,0,0,0,2025-07-08,2025-08-15,620.68,0,0,296966434,50073190,0,100,
710,710,0,0,0,0,2025-07-08,2025-08-15,620.68,0,0,296966434,50073190,0,100,
715,715,0,0,0,0,2025-07-08,2025-08-15,620.68,0,0,296966434,50073190,0,100,
720,720,0,0,0,0,2025-07-08,2025-08-15,620.68,0,0,296966434,50073190,0,100,
725,725,0,0,0,0,2025-07-08,2025-08-15,620.68,0,0,296966434,50073190,0,100,
730,730,0,0,0,0,2025-07-08,2025-08-15,620.68,0,0,296966434,50073190,0,100,
586.99,735,0,0,0,0,2025-07-08,2025-08-15,620.68,0,0,296966434,50073190,0,100,
740,740,0,0,0,0,2025-07-08,2025-08-15,620.68,0,0,296966434,50073190,0,100,
745,745,0,0,0,0,2025-07-08,2025-08-15,620.68,0,0,296966434,50073190,0,100,
750,750,0,0,0,0,2025-07-08,2025-08-15,620.68,0,0,296966434,50073190,0,100,
755,755,0,0,0,0,2025-07-08,2025-08-15,620.68,0,0,296966434,50073190,0,100,
760,760,0,0,0,0,2025-07-08,2025-08-15,620.68,0,0,296966434,50073190,0,100,
765,765,0,0,0,0,2025-07-08,2025-08-15,620.68,0,0,296966434,50073190,0,100,
770,770,0,0,0,0,2025-07-08,2025-08-15,620.68,0,0,296966434,50073190,0,100,
775,775,0,0,0,0,2025-07-08,2025-08-15,620.68,0,0,296966434,50073190,0,100,
780,780,0,0,0,0,2025-07-08,2025-08-15,620.68,0,0,296966434,50073190,0,100,
785,785,0,0,0,0,2025-07-08,2025-08-15,620.68,0,0,296966434,50073190,0,100,
602.96,790,0,0,0,0,2025-07-08,2025-08-15,620.68,0,0,296966434,50073190,0,100,
604.5,795,0,0,0,0,2025-07-08,2025-08-15,620.68,0,0,296966434,50073190,0,100,
553.08,800,0,0,0,0,2025-07-08,2025-08-15,620.68,0,0,296966434,50073190,0,100,
805,805,0,0,0,0,2025-07-08,2025-08-15,620.68,0,0,296966434,50073190,0,100,
810,810,0,0,0,0,2025-07-08,2025-08-15,620.68,0,0,296966434,50073190,0,100,
815,815,0,0,0,0,2025-07-08,2025-08-15,620.68,0,0,296966434,50073190,0,100,
820,820,0,0,0,0,2025-07-08,2025-08-15,620.68,0,0,296966434,50073190,0,100,
825,825,0,0,0,0,2025-07-08,2025-08-15,620.68,0,0,296966434,50073190,0,100,
830,830,0,0,0,0,2025-07-08,2025-08-15,620.68,0,0,296966434,50073190,0,100,
629,629,0,0,0,0,2025-07-08,2025-08-22,620.68,0,0,1750119,1049799,0,100,
631,631,0,0,0,0,2025-07-08,2025-08-22,620.68,0,0,1750119,1049799,0,100,
634,634,0,0,0,0,2025-07-08,2025-08-29,620.68,0,0,90008549,22549292,0,100,
561.15,665,0,0,0,0,2025-07-08,2025-08-29,620.68,0,0,90008549,22549292,0,100,
597.2,670,0,0,0,0,2025-07-08,2025-08-29,620.68,0,0,90008549,22549292,0,100,
675,675,0,0,0,0,2025-07-08,2025-08-29,620.68,0,0,90008549,22549292,0,100,
680,680,0,0,0,0,2025-07-08,2025-08-29,620.68,0,0,90008549,22549292,0,100,
685,685,0,0,0,0,2025-07-08,2025-08-29,620.68,0,0,90008549,22549292,0,100,
580.99,690,0,0,0,0,2025-07-08,2025-08-29,620.68,0,0,90008549,22549292,0,100,
580.97,695,0,0,0,0,2025-07-08,2025-08-29,620.68,0,0,90008549,22549292,0,100,
619.72,705,0,0,0,0,2025-07-08,2025-08-29,620.68,0,0,90008549,22549292,0,100,
710,710,0,0,0,0,2025-07-08,2025-08-29,620.68,0,0,90008549,22549292,0,100,
619.72,720,0,0,0,0,2025-07-08,2025-08-29,620.68,0,0,90008549,22549292,0,100,
620.2,670,0,0,0,0,2025-07-08,2025-09-19,620.68,0,0,397445891,51899302,0,100,
611.34,675,0,0,0,0,2025-07-08,2025-09-19,620.68,0,0,397445891,51899302,0,100,
680,680,0,0,0,0,2025-07-08,2025-09-19,620.68,0,0,397445891,51899302,0,100,
619.8,695,0,0,0,0,2025-07-08,2025-09-19,620.68,0,0,397445891,51899302,0,100,
613.63,705,0,0,0,0,2025-07-08,2025-09-19,620.68,0,0,397445891,51899302,0,100,
710,710,0,0,0,0,2025-07-08,2025-09-19,620.68,0,0,397445891,51899302,0,100,
715,715,0,0,0,0,2025-07-08,2025-09-19,620.68,0,0,397445891,51899302,0,100,
593.69,720,0,0,0,0,2025-07-08,2025-09-19,620.68,0,0,397445891,51899302,0,100,
553.12,725,0,0,0,0,2025-07-08,2025-09-19,620.68,0,0,397445891,51899302,0,100,
593.85,730,0,0,0,0,2025-07-08,2025-09-19,620.68,0,0,397445891,51899302,0,100,
611,735,0,0,0,0,2025-07-08,2025-09-19,620.68,0,0,397445891,51899302,0,100,
740,740,0,0,0,0,2025-07-08,2025-09-19,620.68,0,0,397445891,51899302,0,100,
745,745,0,0,0,0,2025-07-08,2025-09-19,620.68,0,0,397445891,51899302,0,100,
594.66,750,0,0,0,0,2025-07-08,2025-09-19,620.68,0,0,397445891,51899302,0,100,
594.64,755,0,0,0,0,2025-07-08,2025-09-19,620.68,0,0,397445891,51899302,0,100,
612,760,0,0,0,0,2025-07-08,2025-09-19,620.68,0,0,397445891,51899302,0,100,
765,765,0,0,0,0,2025-07-08,2025-09-19,620.68,0,0,397445891,51899302,0,100,
770,770,0,0,0,0,2025-07-08,2025-09-19,620.68,0,0,397445891,51899302,0,100,
775,775,0,0,0,0,2025-07-08,2025-09-19,620.68,0,0,397445891,51899302,0,100,
780,780,0,0,0,0,2025-07-08,2025-09-19,620.68,0,0,397445891,51899302,0,100,
785,785,0,0,0,0,2025-07-08,2025-09-19,620.68,0,0,397445891,51899302,0,100,
790,790,0,0,0,0,2025-07-08,2025-09-19,620.68,0,0,397445891,51899302,0,100,
795,795,0,0,0,0,2025-07-08,2025-09-19,620.68,0,0,397445891,51899302,0,100,
594.64,800,0,0,0,0,2025-07-08,2025-09-19,620.68,0,0,397445891,51899302,0,100,
594.62,805,0,0,0,0,2025-07-08,2025-09-19,620.68,0,0,397445891,51899302,0,100,
810,810,0,0,0,0,2025-07-08,2025-09-19,620.68,0,0,397445891,51899302,0,100,
815,815,0,0,0,0,2025-07-08,2025-09-19,620.68,0,0,397445891,51899302,0,100,
820,820,0,0,0,0,2025-07-08,2025-09-19,620.68,0,0,397445891,51899302,0,100,
594.62,825,0,0,0,0,2025-07-08,2025-09-19,620.68,0,0,397445891,51899302,0,100,
594.64,830,0,0,0,0,2025-07-08,2025-09-19,620.68,0,0,397445891,51899302,0,100,
593.62,660,0,0,0,0,2025-07-08,2025-10-17,620.68,0,0,130178883,18894460,0,100,
607.41,665,0,0,0,0,2025-07-08,2025-10-17,620.68,0,0,130178883,18894460,0,100,
594.71,670,0,0,0,0,2025-07-08,2025-10-17,620.68,0,0,130178883,18894460,0,100,
675,675,0,0,0,0,2025-07-08,2025-10-17,620.68,0,0,130178883,18894460,0,100,
680,680,0,0,0,0,2025-07-08,2025-10-17,620.68,0,0,130178883,18894460,0,100,
685,685,0,0,0,0,2025-07-08,2025-10-17,620.68,0,0,130178883,18894460,0,100,
690,690,0,0,0,0,2025-07-08,2025-10-17,620.68,0,0,130178883,18894460,0,100,
619.61,695,0,0,0,0,2025-07-08,2025-10-17,620.68,0,0,130178883,18894460,0,100,
660,660,0,0,0,0,2025-07-08,2025-11-21,620.68,0,0,23945131,16405869,0,100,
665,665,0,0,0,0,2025-07-08,2025-11-21,620.68,0,0,23945131,16405869,0,100,
670,670,0,0,0,0,2025-07-08,2025-11-21,620.68,0,0,23945131,16405869,0,100,
675,675,0,0,0,0,2025-07-08,2025-11-21,620.68,0,0,23945131,16405869,0,100,
680,680,0,0,0,0,2025-07-08,2025-11-21,620.68,0,0,23945131,16405869,0,100,
619.84,690,0,0,0,0,2025-07-08,2025-11-21,620.68,0,0,23945131,16405869,0,100,
700,700,0,0,0,0,2025-07-08,2025-11-21,620.68,0,0,23945131,16405869,0,100,
705,705,0,0,0,0,2025-07-08,2025-11-21,620.68,0,0,23945131,16405869,0,100,
710,710,0,0,0,0,2025-07-08,2025-11-21,620.68,0,0,23945131,16405869,0,100,
715,715,0,0,0,0,2025-07-08,2025-11-21,620.68,0,0,23945131,16405869,0,100,
720,720,0,0,0,0,2025-07-08,2025-11-21,620.68,0,0,23945131,16405869,0,100,
725,725,0,0,0,0,2025-07-08,2025-11-21,620.68,0,0,23945131,16405869,0,100,
730,730,0,0,0,0,2025-07-08,2025-11-21,620.68,0,0,23945131,16405869,0,100,
735,735,0,0,0,0,2025-07-08,2025-11-21,620.68,0,0,23945131,16405869,0,100,
740,740,0,0,0,0,2025-07-08,2025-11-21,620.68,0,0,23945131,16405869,0,100,
745,745,0,0,0,0,2025-07-08,2025-11-21,620.68,0,0,23945131,16405869,0,100,
750,750,0,0,0,0,2025-07-08,2025-11-21,620.68,0,0,23945131,16405869,0,100,
755,755,0,0,0,0,2025-07-08,2025-11-21,620.68,0,0,23945131,16405869,0,100,
760,760,0,0,0,0,2025-07-08,2025-11-21,620.68,0,0,23945131,16405869,0,100,
765,765,0,0,0,0,2025-07-08,2025-11-21,620.68,0,0,23945131,16405869,0,100,
770,770,0,0,0,0,2025-07-08,2025-11-21,620.68,0,0,23945131,16405869,0,100,
775,775,0,0,0,0,2025-07-08,2025-11-21,620.68,0,0,23945131,16405869,0,100,
780,780,0,0,0,0,2025-07-08,2025-11-21,620.68,0,0,23945131,16405869,0,100,
785,785,0,0,0,0,2025-07-08,2025-11-21,620.68,0,0,23945131,16405869,0,100,
790,790,0,0,0,0,2025-07-08,2025-11-21,620.68,0,0,23945131,16405869,0,100,
795,795,0,0,0,0,2025-07-08,2025-11-21,620.68,0,0,23945131,16405869,0,100,
800,800,0,0,0,0,2025-07-08,2025-11-21,620.68,0,0,23945131,16405869,0,100,
587.15,685,0,0,0,0,2025-07-08,2025-12-19,620.68,0,0,522038386,40509509,0,100,
617,690,0,0,0,0,2025-07-08,2025-12-19,620.68,0,0,522038386,40509509,0,100,
591.04,695,0,0,0,0,2025-07-08,2025-12-19,620.68,0,0,522038386,40509509,0,100,
623.59,700,0,0,0,0,2025-07-08,2025-12-19,620.68,0,0,522038386,40509509,0,100,
537.36,705,0,0,0,0,2025-07-08,2025-12-19,620.68,0,0,522038386,40509509,0,100,
601.65,710,0,0,0,0,2025-07-08,2025-12-19,620.68,0,0,522038386,40509509,0,100,
599.77,715,0,0,0,0,2025-07-08,2025-12-19,620.68,0,0,522038386,40509509,0,100,
720,720,0,0,0,0,2025-07-08,2025-12-19,620.68,0,0,522038386,40509509,0,100,
594.35,725,0,0,0,0,2025-07-08,2025-12-19,620.68,0,0,522038386,40509509,0,100,
730,730,0,0,0,0,2025-07-08,2025-12-19,620.68,0,0,522038386,40509509,0,100,
735,735,0,0,0,0,2025-07-08,2025-12-19,620.68,0,0,522038386,40509509,0,100,
557.52,740,0,0,0,0,2025-07-08,2025-12-19,620.68,0,0,522038386,40509509,0,100,
745,745,0,0,0,0,2025-07-08,2025-12-19,620.68,0,0,522038386,40509509,0,100,
593.74,750,0,0,0,0,2025-07-08,2025-12-19,620.68,0,0,522038386,40509509,0,100,
755,755,0,0,0,0,2025-07-08,2025-12-19,620.68,0,0,522038386,40509509,0,100,
760,760,0,0,0,0,2025-07-08,2025-12-19,620.68,0,0,522038386,40509509,0,100,
556.84,765,0,0,0,0,2025-07-08,2025-12-19,620.68,0,0,522038386,40509509,0,100,
770,770,0,0,0,0,2025-07-08,2025-12-19,620.68,0,0,522038386,40509509,0,100,
775,775,0,0,0,0,2025-07-08,2025-12-19,620.68,0,0,522038386,40509509,0,100,
602,780,0,0,0,0,2025-07-08,2025-12-19,620.68,0,0,522038386,40509509,0,100,
785,785,0,0,0,0,2025-07-08,2025-12-19,620.68,0,0,522038386,40509509,0,100,
790,790,0,0,0,0,2025-07-08,2025-12-19,620.68,0,0,522038386,40509509,0,100,
795,795,0,0,0,0,2025-07-08,2025-12-19,620.68,0,0,522038386,40509509,0,100,
593.9,800,0,0,0,0,2025-07-08,2025-12-19,620.68,0,0,522038386,40509509,0,100,
805,805,0,0,0,0,2025-07-08,2025-12-19,620.68,0,0,522038386,40509509,0,100,
810,810,0,0,0,0,2025-07-08,2025-12-19,620.68,0,0,522038386,40509509,0,100,
815,815,0,0,0,0,2025-07-08,2025-12-19,620.68,0,0,522038386,40509509,0,100,
820,820,0,0,0,0,2025-07-08,2025-12-19,620.68,0,0,522038386,40509509,0,100,
516.96,825,0,0,0,0,2025-07-08,2025-12-19,620.68,0,0,522038386,40509509,0,100,
830,830,0,0,0,0,2025-07-08,2025-12-19,620.68,0,0,522038386,40509509,0,100,
835,835,0,0,0,0,2025-07-08,2025-12-19,620.68,0,0,522038386,40509509,0,100,
593.89,840,0,0,0,0,2025-07-08,2025-12-19,620.68,0,0,522038386,40509509,0,100,
