Watch,strike,open_interest.yt,open_interest.td,OI_Dollar.yt,OI_Dollar.td,Date.td,expiry,stkClose,diff_oi,diff_oi_d,totalOI,totalOIdiff,OI_pct,cum_sep_OI,pct
535.41,540,84986,89722,47932104,41182398,2024-10-15,2024-12-20,584.32,4736,-6749706,401465676,-76728253,10.2580121942978,10.2580121942978,-0.163897838100637
565.99,572,65357,67115,52024172,40336115,2024-10-15,2024-11-15,584.32,1758,-11688057,392489350,-83095331,10.2769960509757,10.2769960509757,-0.289766552876994
556.04,560,84005,88074,45110685,34877304,2024-10-15,2024-11-15,584.32,4069,-10233381,392489350,-83095331,8.88617844025577,19.1631744912314,-0.293410895521053
552.92,560,35218,35324,30745314,25009392,2024-10-15,2024-12-20,584.32,106,-5735922,401465676,-76728253,6.22952184833854,16.4875340426363,-0.229350717522441
497.8,500,99999,99659,26799732,21924980,2024-10-15,2024-12-20,584.32,-340,-4874752,401465676,-76728253,5.46123400098593,21.9487680436222,-0.222337808289905
571.88,580,8599,23443,9080544,19035716,2024-10-15,2024-11-15,584.32,14844,9955172,392489350,-83095331,4.84999554764989,24.0131700388813,0.522973341270693
547.13,550,80824,57500,31683008,16502500,2024-10-15,2024-11-15,584.32,-23324,-15180508,392489350,-83095331,4.20457268458367,28.217742723465,-0.919891410392365
544.33,550,25954,28314,18141846,16054038,2024-10-15,2024-12-20,584.32,2360,-2087808,401465676,-76728253,3.99885692843141,25.9476249720537,-0.130048776513423
564.41,570,23714,27159,17690644,15181881,2024-10-15,2024-11-15,584.32,3445,-2508763,392489350,-83095331,3.86810011532797,32.085842838793,-0.165247178528142
537.86,540,67354,65279,19667368,13969706,2024-10-15,2024-11-15,584.32,-2075,-5697662,392489350,-83095331,3.55925734035841,35.6451001791514,-0.407858404464632
516.92,520,48551,44546,18400829,13720168,2024-10-15,2024-12-20,584.32,-4005,-4680661,401465676,-76728253,3.41751955900708,29.3651445310607,-0.341151872192819
568.31,580,10174,11360,14335166,13279840,2024-10-15,2024-12-20,584.32,1186,-1055326,401465676,-76728253,3.30783944777386,32.6729839788346,-0.0794682767262256
521.61,525,38223,37011,15977214,12546729,2024-10-15,2024-12-20,584.32,-1212,-3430485,401465676,-76728253,3.12523081051641,35.798214789351,-0.273416680953259
526.29,530,37385,33787,17309255,12534977,2024-10-15,2024-12-20,584.32,-3598,-4774278,401465676,-76728253,3.12230353660421,38.9205183259552,-0.380876486650115
488.14,490,65502,66769,14999958,12419034,2024-10-15,2024-12-20,584.32,1267,-2580924,401465676,-76728253,3.09342360814926,42.0139419341045,-0.207820028514295
518.69,520,86647,94145,14903284,12332995,2024-10-15,2024-11-15,584.32,7498,-2570289,392489350,-83095331,3.14224959225008,38.7873497714014,-0.208407527936239
581.3,590,251,12250,310236,10657500,2024-10-15,2024-11-01,584.32,11999,10347264,74573214,-17043443,14.2913244962192,14.2913244962192,0.970890358902182
561.02,570,11551,11707,12717651,10512886,2024-10-15,2024-12-20,584.32,156,-2204765,401465676,-76728253,2.61862635549446,44.6325682895989,-0.209720242376832
552.48,556,2596,28063,1214928,9878176,2024-10-15,2024-11-15,584.32,25467,8663248,392489350,-83095331,2.51680102912347,41.3041508005249,0.877008872893133
473.45,475,63386,63661,11789796,9867455,2024-10-15,2024-12-20,584.32,275,-1922341,401465676,-76728253,2.457857692422,47.0904259820209,-0.194816292549599
551.62,555,30875,29110,14140750,9839180,2024-10-15,2024-11-15,584.32,-1765,-4301570,392489350,-83095331,2.50686547291028,43.8110162734352,-0.437187855085485
499.09,500,103206,107462,12075102,9779042,2024-10-15,2024-11-15,584.32,4256,-2296060,392489350,-83095331,2.49154327372195,46.3025595471571,-0.234793960389985
573.05,597,4050,4050,9699750,9699750,2024-10-15,2024-12-20,584.32,0,0,401465676,-76728253,2.41608450730916,49.5065104893301,0
539.93,545,18600,18544,11680800,9401808,2024-10-15,2024-12-20,584.32,-56,-2278992,401465676,-76728253,2.34187093992065,51.8483814292508,-0.242399334255709
560.3,565,20534,19962,12956954,9382140,2024-10-15,2024-11-15,584.32,-572,-3574814,392489350,-83095331,2.39041900117799,48.6929785483351,-0.381023305983496
484.26,485,123780,123675,11387760,9151950,2024-10-15,2024-11-15,584.32,-105,-2235810,392489350,-83095331,2.33177027605972,51.0247488243949,-0.244298756002819
579.56,600,4073,4163,9815930,8509172,2024-10-15,2024-12-20,584.32,90,-1306758,401465676,-76728253,2.11952665163833,53.9679080808891,-0.153570523665522
568.23,575,10468,12447,9285116,8426619,2024-10-15,2024-11-15,584.32,1979,-858497,392489350,-83095331,2.14696755466104,53.1717163790559,-0.101879175977934
523.53,525,55768,55636,10874760,8178492,2024-10-15,2024-11-15,584.32,-132,-2696268,392489350,-83095331,2.08374876923412,55.25546514829,-0.329677891718914
502.65,505,34438,34432,10055896,8091520,2024-10-15,2024-12-20,584.32,-6,-1964376,401465676,-76728253,2.01549484394776,55.9834029248369,-0.242769714466503
528.36,530,42288,46749,9176496,7666836,2024-10-15,2024-11-15,584.32,4461,-1509660,392489350,-83095331,1.95338701546934,57.2088521637594,-0.196907824818478
530.89,535,17627,17687,9007397,7269357,2024-10-15,2024-12-20,584.32,60,-1738040,401465676,-76728253,1.81070448473408,57.7941074095709,-0.239091297896086
575.42,580,5735,15338,4014500,7024804,2024-10-15,2024-11-01,584.32,9603,3010304,74573214,-17043443,9.42000971018897,23.7113342064082,0.4285249809105
548.64,555,9470,10922,7386600,6946392,2024-10-15,2024-12-20,584.32,1452,-440208,401465676,-76728253,1.7302580059173,59.5243654154882,-0.0633721793990319
542.49,545,26956,27392,9030260,6875392,2024-10-15,2024-11-15,584.32,436,-2154868,392489350,-83095331,1.75173976058204,58.9605919243414,-0.313417474959973
576.8,582,50,13038,39350,6779760,2024-10-15,2024-11-01,584.32,12988,6740410,74573214,-17043443,9.09141451245483,32.8027487188631,0.994195959738988
513.81,515,54259,54901,8464404,6533219,2024-10-15,2024-11-15,584.32,642,-1931185,392489350,-83095331,1.66455956066069,60.6251514850021,-0.295594713723817
507.4,510,24781,24759,7731672,6437340,2024-10-15,2024-12-20,584.32,-22,-1294332,401465676,-76728253,1.60345961929757,61.1278250347858,-0.201066278928874
564.8,575,5805,6031,7180785,6151620,2024-10-15,2024-12-20,584.32,226,-1029165,401465676,-76728253,1.53229039685076,62.6601154316366,-0.167299833214665
489.22,490,78249,78411,7668402,6116058,2024-10-15,2024-11-15,584.32,162,-1552344,392489350,-83095331,1.55827361939885,62.1834251044009,-0.253814466769282
434.6,435,152796,152795,7792596,6111800,2024-10-15,2024-11-15,584.32,-1,-1680796,392489350,-83095331,1.55718874919791,63.7406138535988,-0.275008344513891
434.4,435,101645,101802,7420085,6108120,2024-10-15,2024-11-29,584.32,157,-1311965,111401771,-12544864,5.48296489828694,5.48296489828694,-0.214790311912667
483.93,485,54703,54717,7275499,5854719,2024-10-15,2024-11-29,584.32,14,-1420780,111401771,-12544864,5.2554990351096,10.7384639333965,-0.242672620154785
546.1,550,14077,14350,7122962,5596500,2024-10-15,2024-11-29,584.32,273,-1526462,111401771,-12544864,5.02370828557115,15.7621722189677,-0.272752970606629
578,590,4270,4663,6498940,5595600,2024-10-15,2024-11-15,584.32,393,-903340,392489350,-83095331,1.42566925701296,65.1662831106118,-0.16143755808135
478.36,480,32948,33045,6556652,5419380,2024-10-15,2024-12-20,584.32,97,-1137272,401465676,-76728253,1.34989871462884,64.0100141462654,-0.209852787588248
508.93,510,48226,48647,6606962,5205229,2024-10-15,2024-11-15,584.32,421,-1401733,392489350,-83095331,1.32620897866401,66.4924920892758,-0.269293243390445
583.74,610,704,1980,2129600,5199480,2024-10-15,2024-11-29,584.32,1276,3069880,111401771,-12544864,4.66732256886652,20.4294947878342,0.590420580519591
578.91,598,2667,2667,6710172,5091303,2024-10-15,2024-12-20,584.32,0,-1618869,401465676,-76728253,1.26817890155073,65.2781930478161,-0.317967522262965
533.13,535,27456,27134,6973824,5074058,2024-10-15,2024-11-15,584.32,-322,-1899766,392489350,-83095331,1.29278870878917,67.785280798065,-0.374407624035831
399.32,400,73898,74084,6059636,5037712,2024-10-15,2024-12-20,584.32,186,-1021924,401465676,-76728253,1.25483006422696,66.5330231120431,-0.202854788046637
559.05,565,8352,8378,6339168,4984910,2024-10-15,2024-11-29,584.32,26,-1354258,111401771,-12544864,4.47471342264388,24.9042082104781,-0.271671504600885
550.52,555,10107,10246,5821632,4590208,2024-10-15,2024-11-29,584.32,139,-1231424,111401771,-12544864,4.12040846280622,29.0246166732843,-0.268271938875101
561.47,568,6745,6781,5443215,4427993,2024-10-15,2024-11-29,584.32,36,-1015222,111401771,-12544864,3.97479587644976,32.9994125497341,-0.229273623512955
492.97,495,21434,21595,5208462,4383785,2024-10-15,2024-12-20,584.32,161,-824677,401465676,-76728253,1.09194515548074,67.6249682675238,-0.188119855330496
504.01,505,33472,44260,4150528,4381740,2024-10-15,2024-11-15,584.32,10788,231212,392489350,-83095331,1.11639717103152,68.9016779690965,0.0527671655552361
448.86,450,38107,38200,5220659,4354800,2024-10-15,2024-12-20,584.32,93,-865859.000000001,401465676,-76728253,1.08472536018247,68.7096936277063,-0.198828648847249
546.07,552,6816,6836,4962048,4053748,2024-10-15,2024-12-20,584.32,20,-908300.000000001,401465676,-76728253,1.00973713130086,69.7194307590072,-0.224064248690348
556.97,565,5038,4991,4836480,4007773,2024-10-15,2024-12-20,584.32,-47,-828707.000000001,401465676,-76728253,0.998285342829657,70.7177161018368,-0.206774934608323
444.81,445,201364,201157,5436828,3821983,2024-10-15,2024-11-01,584.32,-207,-1614845,74573214,-17043443,5.12514185053094,37.927890569394,-0.422514961474188
577.73,596,2075,2075,4969625,3791025,2024-10-15,2024-12-20,584.32,0,-1178600,401465676,-76728253,0.944296169418977,71.6620122712558,-0.310892172961138
483.25,485,18907,21647,3932656,3788225,2024-10-15,2024-12-20,584.32,2740,-144431,401465676,-76728253,0.943598724987887,72.6056109962437,-0.0381262992562481
453.79,455,28918,29528,4106356,3572888,2024-10-15,2024-12-20,584.32,610,-533468.000000001,401465676,-76728253,0.889961013753016,73.4955720099967,-0.149310025950996
578.84,592,2674,2679,4299792,3525564,2024-10-15,2024-11-15,584.32,5,-774228,392489350,-83095331,0.898257239336558,69.7999352084331,-0.219604012294203
494.66,495,103216,102980,4851152,3501320,2024-10-15,2024-11-01,584.32,-236,-1349832,74573214,-17043443,4.69514429135373,42.6230348607477,-0.38552088926462
567.38,570,13884,13282,5720208,3479884,2024-10-15,2024-11-01,584.32,-602,-2240324,74573214,-17043443,4.66639938570973,47.2894342464574,-0.643792724125287
512.17,515,12141,12238,4103658,3463354,2024-10-15,2024-12-20,584.32,97,-640304,401465676,-76728253,0.862677485783367,74.3582494957801,-0.184879743739739
583.92,610,1184,1304,3557920,3400832,2024-10-15,2024-11-22,584.32,120,-157088,16269713,-1546756,20.9028395276549,20.9028395276549,-0.0461910497195982
479.31,480,49182,48914,4131288,3375066,2024-10-15,2024-11-15,584.32,-268,-756222,392489350,-83095331,0.859912759416275,70.6598479678493,-0.224061396132698
580.22,585,294,6624,219324,3166272,2024-10-15,2024-10-25,584.32,6330,2946948,22997980,-5421377,13.7676091552389,13.7676091552389,0.930731156388333
548.95,550,29834,29962,4982278,3146010,2024-10-15,2024-11-01,584.32,128,-1836268,74573214,-17043443,4.21868635030267,51.5081205967601,-0.583681552188327
522.84,525,14472,14408,3950856,3112128,2024-10-15,2024-11-29,584.32,-64,-838728,111401771,-12544864,2.79360729372965,35.7930198434637,-0.269503053858967
567.49,574,4765,4777,4083605,3109827,2024-10-15,2024-11-15,584.32,12,-973778.000000001,392489350,-83095331,0.792334110466947,71.4521820783163,-0.313129315553566
568.96,576,3939,4322,3623880,3042688,2024-10-15,2024-11-15,584.32,383,-581192,392489350,-83095331,0.775228168611454,72.2274102469277,-0.191012683521938
536.97,540,10065,9982,3955545,3024546,2024-10-15,2024-11-29,584.32,-83,-930999.000000001,111401771,-12544864,2.71498915398751,38.5080089974512,-0.307814462071333
541.57,544,12365,12351,3981530,3001293,2024-10-15,2024-11-15,584.32,-14,-980237.000000001,392489350,-83095331,0.764681385622311,72.99209163255,-0.326604899954786
531.23,533,16727,16628,3964299,2943156,2024-10-15,2024-11-15,584.32,-99,-1021143,392489350,-83095331,0.749869009184581,73.7419606417346,-0.346955105335905
429.71,430,100849,100921,3630564,2926709,2024-10-15,2024-11-08,584.32,72,-703855.000000001,28140084,-4440601,10.4004984491162,10.4004984491162,-0.240493673952552
439.58,440,69672,69682,3692616,2926644,2024-10-15,2024-11-15,584.32,10,-765972.000000001,392489350,-83095331,0.745662016052155,74.4876226577868,-0.261723667108128
577.45,591,2132,2141,3302468,2901055,2024-10-15,2024-11-15,584.32,9,-401413,392489350,-83095331,0.73914234870322,75.22676500649,-0.138367938560282
568.45,577,342,3335,357732,2851425,2024-10-15,2024-11-29,584.32,2993,2493693,111401771,-12544864,2.55958677712583,41.0675957745771,0.874542728635682
458.71,460,21909,22000,3308259,2838000,2024-10-15,2024-12-20,584.32,91,-470259.000000001,401465676,-76728253,0.706909748369123,75.0651592441492,-0.165700845665962
535.05,537,14217,14215,3767505,2771925,2024-10-15,2024-11-15,584.32,-2,-995580,392489350,-83095331,0.706242092938318,75.9330070994283,-0.359165561838794
543.41,546,10694,10670,3582490,2763530,2024-10-15,2024-11-15,584.32,-24,-818960,392489350,-83095331,0.704103181398425,76.6371102808267,-0.296345615933245
539.72,542,12043,12039,3588814,2744892,2024-10-15,2024-11-15,584.32,-4,-843922,392489350,-83095331,0.699354517517482,77.3364647983442,-0.30745180502548
479.47,480,51205,51243,3328325,2715879,2024-10-15,2024-11-08,584.32,38,-612446,28140084,-4440601,9.65128249084118,20.0517809399574,-0.225505628196249
530.42,533,10460,10523,3347200,2714934,2024-10-15,2024-11-29,584.32,63,-632266,111401771,-12544864,2.43706538561223,43.5046611601893,-0.23288448264304
559.53,564,5845,6023,3536225,2692281,2024-10-15,2024-11-15,584.32,178,-843944,392489350,-83095331,0.685950077371526,78.0224148757158,-0.313468022097248
563.08,570,3606,3832,3133614,2651744,2024-10-15,2024-11-29,584.32,226,-481870,111401771,-12544864,2.38034276851846,45.8850039287077,-0.181718144737954
578.5,580,5755,17533,2192655,2629950,2024-10-15,2024-10-18,584.32,11778,437295,37570248,-36451733,7.00008687725458,7.00008687725458,0.166275024240005
419.16,420,31155,31159,3084345,2617356,2024-10-15,2024-12-20,584.32,4,-466989,401465676,-76728253,0.651950130850041,75.7171093749992,-0.178420130849605
561.13,566,5314,5366,3454100,2613242,2024-10-15,2024-11-15,584.32,52,-840858,392489350,-83095331,0.665812206114637,78.6882270818304,-0.321768133223023
439.83,440,152255,151996,3654120,2583932,2024-10-15,2024-11-01,584.32,-259,-1070188,74573214,-17043443,3.46495995197418,54.9730805487343,-0.414170341943983
468.54,470,17495,17697,3009140,2583762,2024-10-15,2024-12-20,584.32,202,-425378,401465676,-76728253,0.643582292200741,76.3606916672,-0.16463513280248
577.17,595,1431,1441,2944998,2569303,2024-10-15,2024-12-20,584.32,10,-375695,401465676,-76728253,0.639980738976051,77.000672406176,-0.14622448189256
489.67,490,76846,76840,3534916,2535720,2024-10-15,2024-11-01,584.32,-6,-999196.000000001,74573214,-17043443,3.40030939259236,58.3733899413267,-0.394048238764533
576.68,594,1444,1444,2501008,2501008,2024-10-15,2024-11-15,584.32,0,0,392489350,-83095331,0.637216780531752,79.3254438623621,0
494.16,495,29309,29756,3077445,2499504,2024-10-15,2024-11-15,584.32,447,-577941,392489350,-83095331,0.636833585420853,79.962277447783,-0.231222274499261
434.03,435,25107,25447,2862198,2468359,2024-10-15,2024-12-20,584.32,340,-393839,401465676,-76728253,0.614836870886068,77.6155092770621,-0.159554991798194
584.28,615,0,798,0,2451456,2024-10-15,2024-11-29,584.32,798,2451456,111401771,-12544864,2.20055388526992,48.0855578139777,1
538.8,541,11244,11109,3373200,2443980,2024-10-15,2024-11-15,584.32,-135,-929220,392489350,-83095331,0.622686959531514,80.5849644073145,-0.380207694007316
574.25,575,28204,32369,5951044,2427675,2024-10-15,2024-10-18,584.32,4165,-3523369,37570248,-36451733,6.4616954351752,13.4617823124298,-1.45133471325445
566.73,573,3484,3848,2877784,2412696,2024-10-15,2024-11-15,584.32,364,-465088,392489350,-83095331,0.614716297397624,81.1996807047121,-0.192766929609035
479.71,480,82409,82414,3296360,2390006,2024-10-15,2024-11-01,584.32,5,-906354,74573214,-17043443,3.20491215518752,61.5783020965142,-0.379226663029298
569.71,577,2985,3245,2811870,2365605,2024-10-15,2024-11-15,584.32,260,-446265,392489350,-83095331,0.602718264839543,81.8023989695517,-0.188647301641652
575.45,599,996,996,2345580,2345580,2024-10-15,2024-12-20,584.32,0,0,401465676,-76728253,0.584254181670066,78.1997634587322,0
579.37,593,1704,1706,2942808,2325278,2024-10-15,2024-11-15,584.32,2,-617530,392489350,-83095331,0.592443591144575,82.3948425606962,-0.265572546594429
389.78,390,104373,104473,2818071,2298406,2024-10-15,2024-11-15,584.32,100,-519665.000000001,392489350,-83095331,0.585597035945052,82.9804395966413,-0.226098000092238
562.98,565,10874,11153,3490554,2252906,2024-10-15,2024-11-01,584.32,279,-1237648,74573214,-17043443,3.02106598221715,64.5993680787313,-0.549356253656389
580.12,595,1464,1501,2639592,2233488,2024-10-15,2024-11-15,584.32,37,-406104,392489350,-83095331,0.569056969316492,83.5494965659578,-0.18182501987922
554.89,560,4019,4346,2652540,2220806,2024-10-15,2024-11-29,584.32,327,-431734,111401771,-12544864,1.993510498141,50.0790683121187,-0.194404193792704
577.65,593,1415,1432,2869620,2198120,2024-10-15,2024-11-29,584.32,17,-671500,111401771,-12544864,1.97314636945942,52.0522146815781,-0.305488326388004
569.6,570,52175,54918,6313175,2196720,2024-10-15,2024-10-18,584.32,2743,-4116455,37570248,-36451733,5.8469669936701,19.3087493060999,-1.87390973815507
429.86,430,152284,152222,3197964,2131108,2024-10-15,2024-11-01,584.32,-62,-1066856,74573214,-17043443,2.85773924133134,67.4571073200627,-0.500610949797007
565.22,571,3453,3687,2627733,2131086,2024-10-15,2024-11-15,584.32,234,-496647,392489350,-83095331,0.542966579857517,84.0924631458153,-0.23304878357795
563.56,569,3937,3917,2759837,2130848,2024-10-15,2024-11-15,584.32,-20,-628989,392489350,-83095331,0.542905941269489,84.6353690870848,-0.295182481340762
438.97,440,20832,20632,2562336,2125096,2024-10-15,2024-12-20,584.32,-200,-437240,401465676,-76728253,0.529334418118475,78.7290978768506,-0.205750704909331
562.78,568,3684,3945,2553012,2059290,2024-10-15,2024-11-15,584.32,261,-493722,392489350,-83095331,0.524674108991747,85.1600431960765,-0.23975350727678
583.14,605,935,938,2528240,2050468,2024-10-15,2024-11-22,584.32,3,-477772,16269713,-1546756,12.6029758484369,33.5058153760918,-0.23300631855752
572.01,597,801,801,2001699,2001699,2024-10-15,2024-11-29,584.32,0,0,111401771,-12544864,1.79682870571241,53.8490433872905,0
577.46,589,1723,1722,2410477,1987188,2024-10-15,2024-11-15,584.32,-1,-423289,392489350,-83095331,0.506303674227084,85.6663468703036,-0.213009035883872
558.61,567,1935,2273,1973700,1907047,2024-10-15,2024-12-20,584.32,338,-66653,401465676,-76728253,0.475021182134634,79.2041190589853,-0.0349508952846993
567.85,601,575,575,1906125,1906125,2024-10-15,2024-12-20,584.32,0,0,401465676,-76728253,0.474791523646968,79.6789105826322,0
463.64,465,13663,14003,2199743,1904408,2024-10-15,2024-12-20,584.32,340,-295335,401465676,-76728253,0.474363840758332,80.1532744233906,-0.15507968880618
568.71,570,9414,14756,2391156,1903524,2024-10-15,2024-10-25,584.32,5342,-487632,22997980,-5421377,8.27691823368835,22.0445273889272,-0.256173287019234
566.23,577,1459,1703,1861684,1834131,2024-10-15,2024-12-20,584.32,244,-27553.0000000002,401465676,-76728253,0.456858732799862,80.6101331561904,-0.015022372992987
538.07,543,3702,3706,2191584,1827058,2024-10-15,2024-12-20,584.32,4,-364526,401465676,-76728253,0.455096938349469,81.0652300945399,-0.199515286323697
558.6,563,3809,4140,2228265,1821600,2024-10-15,2024-11-15,584.32,331,-406665,392489350,-83095331,0.464114503998644,86.1304613743023,-0.22324604743083
513.25,515,10465,10385,2344160,1817375,2024-10-15,2024-11-29,584.32,-80,-526785,111401771,-12544864,1.63136993576161,55.4804133230521,-0.289860375541647
556.87,561,4110,4353,2276940,1797789,2024-10-15,2024-11-15,584.32,243,-479151,392489350,-83095331,0.458047842572034,86.5885092168743,-0.266522378321371
576.74,594,1032,1034,2097024,1784684,2024-10-15,2024-12-20,584.32,2,-312340,401465676,-76728253,0.444542113234109,81.509772207774,-0.175011374562668
529.4,530,29823,29671,2624424,1780260,2024-10-15,2024-11-01,584.32,-152,-844164,74573214,-17043443,2.38726468192721,69.8443720019899,-0.474180175929359
555.13,559,4401,4524,2266515,1750788,2024-10-15,2024-11-15,584.32,123,-515727,392489350,-83095331,0.446072740572451,87.0345819574468,-0.294568502868423
540.81,546,3364,3366,2089044,1746954,2024-10-15,2024-12-20,584.32,2,-342090,401465676,-76728253,0.43514404952517,81.9449162572992,-0.1958208401595
581.83,585,1689,5493,1148520,1741281,2024-10-15,2024-10-18,584.32,3804,592761,37570248,-36451733,4.63473384578138,23.9434831518813,0.340416624312791
574.51,584,60,1805,73080,1712945,2024-10-15,2024-11-15,584.32,1745,1639865,392489350,-83095331,0.436430950292027,87.4710129077388,0.957336633692267
389.39,390,28127,28024,2081398,1709464,2024-10-15,2024-12-20,584.32,-103,-371934,401465676,-76728253,0.425805766767468,82.3707220240666,-0.217573461623058
384.67,385,51759,51760,2070360,1708080,2024-10-15,2024-11-29,584.32,1,-362280,111401771,-12544864,1.53326108253701,57.0136744055891,-0.212097794014332
555.39,563,2267,2242,2074305,1706162,2024-10-15,2024-12-20,584.32,-25,-368143,401465676,-76728253,0.424983280513376,82.79570530458,-0.215772593692744
429.07,430,18062,18064,1986820,1679952,2024-10-15,2024-12-20,584.32,2,-306868,401465676,-76728253,0.418454702463779,83.2141600070438,-0.182664742802175
556.24,564,2305,2155,2162090,1672280,2024-10-15,2024-12-20,584.32,-150,-489810,401465676,-76728253,0.416543704722593,83.6307037117664,-0.292899514435382
557.74,562,3732,3912,2119776,1666512,2024-10-15,2024-11-15,584.32,180,-453264,392489350,-83095331,0.424600565594965,87.8956134733337,-0.2719836400818
443.91,445,15320,15275,1976280,1664975,2024-10-15,2024-12-20,584.32,-45,-311305,401465676,-76728253,0.414724122019338,84.0454278337857,-0.18697277736903
384.79,385,78918,78919,2051868,1657299,2024-10-15,2024-11-15,584.32,1,-394569,392489350,-83095331,0.422253240756724,88.3178667140905,-0.238079549918271
551.24,558,2400,2440,1932000,1649440,2024-10-15,2024-12-20,584.32,40,-282560,401465676,-76728253,0.410854550863272,84.456282384649,-0.171306625278883
532.69,537,3817,3811,1954304,1642541,2024-10-15,2024-12-20,584.32,-6,-311763,401465676,-76728253,0.409136097602526,84.8654184822515,-0.189805307751831
529.52,532,6528,6513,2010624,1615224,2024-10-15,2024-11-29,584.32,-15,-395400,111401771,-12544864,1.44990872721404,58.4635831328032,-0.244795768264959
550.34,557,2390,2397,1914390,1596402,2024-10-15,2024-12-20,584.32,7,-317988,401465676,-76728253,0.397643458814646,85.2630619410662,-0.199190429478289
554.26,558,4206,4176,2094588,1561824,2024-10-15,2024-11-15,584.32,-30,-532764,392489350,-83095331,0.397927739950141,88.7157944540406,-0.341116540660151
549.83,553,4941,4926,2104866,1561542,2024-10-15,2024-11-15,584.32,-15,-543324,392489350,-83095331,0.397855890866848,89.1136503449075,-0.347940689395482
577.02,580,2519,5212,1347665,1553176,2024-10-15,2024-10-25,584.32,2693,205511,22997980,-5421377,6.75353226674691,28.7980596556741,0.132316620910959
552.75,554,12752,12416,2601408,1552000,2024-10-15,2024-11-01,584.32,-336,-1049408,74573214,-17043443,2.08117622501828,71.9255482270082,-0.676164948453608
535.95,538,7200,7525,1915200,1542625,2024-10-15,2024-11-15,584.32,325,-372575,392489350,-83095331,0.39303614225456,89.506686487162,-0.241520136131594
559.38,568,1743,1700,1777860,1465400,2024-10-15,2024-12-20,584.32,-43,-312460,401465676,-76728253,0.365012524756911,85.6280744658231,-0.21322505800464
566.92,575,1523,1807,1556506,1460056,2024-10-15,2024-11-29,584.32,284,-96450.0000000002,111401771,-12544864,1.31062189307565,59.7742050258788,-0.0660591100615321
561.94,567,2897,2881,1946784,1457786,2024-10-15,2024-11-15,584.32,-16,-488998,392489350,-83095331,0.37142052389447,89.8781070110565,-0.335438809262814
575.1,585,671,1460,851499,1445400,2024-10-15,2024-11-15,584.32,789,593901,392489350,-83095331,0.368264769477185,90.2463717805337,0.410890410958904
580.62,583,1252,6063,678584,1442994,2024-10-15,2024-10-18,584.32,4811,764410,37570248,-36451733,3.84078912654503,27.7842722784263,0.529738862393052
574.84,590,923,947,1690936,1435652,2024-10-15,2024-12-20,584.32,24,-255284,401465676,-76728253,0.357602675851173,85.9856771416743,-0.177817465513927
424.12,425,16273,16158,1708665,1421904,2024-10-15,2024-12-20,584.32,-115,-286761,401465676,-76728253,0.354178223694521,86.3398553653688,-0.201673952671911
570.5,580,588,1475,699132,1401250,2024-10-15,2024-11-29,584.32,887,702118,111401771,-12544864,1.2578345814628,61.0320396073416,0.501065477252453
537.23,542,3038,2935,1792420,1399995,2024-10-15,2024-12-20,584.32,-103,-392425,401465676,-76728253,0.348720970108538,86.6885763354773,-0.28030457251633
553.37,557,3870,3838,1892430,1393194,2024-10-15,2024-11-15,584.32,-32,-499236,392489350,-83095331,0.35496351684447,90.6013352973781,-0.358339183200617
545.22,551,2385,2405,1674270,1390090,2024-10-15,2024-12-20,584.32,20,-284180,401465676,-76728253,0.346253760433557,87.0348300959109,-0.204432806508931
568.62,569,39058,35873,4218264,1363174,2024-10-15,2024-10-18,584.32,-3185,-2855090,37570248,-36451733,3.62833378156035,31.4126060599866,-2.09444282241299
379.46,380,25221,25222,1639365,1361988,2024-10-15,2024-12-20,584.32,1,-277377,401465676,-76728253,0.339253909218381,87.3740840051292,-0.203655979347836
576.9,588,1129,1220,1554633,1354200,2024-10-15,2024-11-15,584.32,91,-200433,392489350,-83095331,0.345028470199255,90.9463637675774,-0.14800841825432
529.04,533,3386,3403,1598192,1347588,2024-10-15,2024-12-20,584.32,17,-250604,401465676,-76728253,0.335667052144204,87.7097510572735,-0.185964849790885
541.57,545,3822,3838,1662570,1316434,2024-10-15,2024-11-29,584.32,16,-346136,111401771,-12544864,1.18169934659297,62.2137389539346,-0.262934564133105
532.31,535,4878,4875,1702422,1311375,2024-10-15,2024-11-29,584.32,-3,-391047,111401771,-12544864,1.17715812614864,63.3908970800832,-0.298196168144124
563.29,573,1289,1339,1486217,1300169,2024-10-15,2024-12-20,584.32,50,-186048,401465676,-76728253,0.323855581616397,88.0336066388899,-0.143095243772156
512.28,514,7564,7532,1679208,1295504,2024-10-15,2024-11-29,584.32,-32,-383704,111401771,-12544864,1.16291149446807,64.5538085745513,-0.296181254554212
560.18,569,1519,1468,1596469,1294776,2024-10-15,2024-12-20,584.32,-51,-301693,401465676,-76728253,0.322512253824658,88.3561188927145,-0.23300787163185
549.89,550,118113,117100,2952825,1288100,2024-10-15,2024-10-18,584.32,-1013,-1664725,37570248,-36451733,3.4285107726731,34.8411168326597,-1.292388013353
579.27,581,4680,7441,2012400,1287293,2024-10-15,2024-10-18,584.32,2761,-725107,37570248,-36451733,3.42636279643403,38.2674796290937,-0.563280465286458
394.36,395,19964,19959,1557192,1277376,2024-10-15,2024-12-20,584.32,-5,-279816,401465676,-76728253,0.318178134860027,88.6742970275745,-0.219055313392455
545.27,548,4490,4640,1634360,1266720,2024-10-15,2024-11-15,584.32,150,-367640,392489350,-83095331,0.322739967339241,91.2691037349166,-0.290229885057471
578.74,585,12560,2010,11391920,1258260,2024-10-15,2024-11-01,584.32,-10550,-10133660,74573214,-17043443,1.68728144129607,73.6128296683042,-8.05370909033109
558.4,560,7729,7835,1963166,1253600,2024-10-15,2024-11-01,584.32,106,-709566,74573214,-17043443,1.68103254876476,75.293862217069,-0.566022654754308
548.04,551,4238,4215,1712152,1247640,2024-10-15,2024-11-15,584.32,-23,-464512,392489350,-83095331,0.317878688937674,91.5869824238543,-0.372312526049181
539,544,2461,2454,1513515,1227000,2024-10-15,2024-12-20,584.32,-7,-286515,401465676,-76728253,0.30563011319553,88.9799271407701,-0.233508557457213
554.43,562,1650,1620,1473450,1226340,2024-10-15,2024-12-20,584.32,-30,-247110,401465676,-76728253,0.30546571557963,89.2853928563497,-0.201502030432017
569.13,572,4303,4271,1953562,1225777,2024-10-15,2024-11-01,584.32,-32,-727785,74573214,-17043443,1.6437229056535,76.9375851227225,-0.593733607336408
523.47,527,3289,3451,1397825,1218203,2024-10-15,2024-12-20,584.32,162,-179622,401465676,-76728253,0.303438892245423,89.5888317485951,-0.147448331681994
464.43,465,21529,21322,1550088,1215354,2024-10-15,2024-11-15,584.32,-207,-334734,392489350,-83095331,0.309652733252507,91.8966351571068,-0.275420988452747
409.23,410,15711,15667,1413990,1206359,2024-10-15,2024-12-20,584.32,-44,-207631,401465676,-76728253,0.300488702301912,89.889320450897,-0.172113773760547
569.71,582,588,980,844956,1204420,2024-10-15,2024-12-20,584.32,392,359464,401465676,-76728253,0.300005722033383,90.1893261729304,0.298454027664768
543.4,547,3320,3328,1477400,1198080,2024-10-15,2024-11-29,584.32,8,-279320,111401771,-12544864,1.07545866573342,65.6292672402847,-0.23313969017094
553.7,555,2127,9208,436035,1197040,2024-10-15,2024-11-01,584.32,7081,761005,74573214,-17043443,1.6051876213891,78.5427727441116,0.635738989507452
538.38,540,7052,7358,1593752,1191996,2024-10-15,2024-11-08,584.32,306,-401756,28140084,-4440601,4.23593618270649,24.2877171226639,-0.337044755183742
557.87,566,1434,1453,1419660,1181289,2024-10-15,2024-12-20,584.32,19,-238371,401465676,-76728253,0.294244083770688,90.4835702567011,-0.201788893319078
414.2,415,14897,14715,1415215,1177200,2024-10-15,2024-12-20,584.32,-182,-238015,401465676,-76728253,0.293225565814,90.7767958225151,-0.202187393815834
498.66,500,8570,8753,1414050,1172902,2024-10-15,2024-11-29,584.32,183,-241148,111401771,-12544864,1.05285758877209,66.6821248290568,-0.205599444795899
561.82,571,1272,1270,1383936,1165860,2024-10-15,2024-12-20,584.32,-2,-218076,401465676,-76728253,0.290400915868085,91.0671967383832,-0.187051618547682
554.5,555,23396,23287,2362996,1164350,2024-10-15,2024-10-25,584.32,-109,-1198646,22997980,-5421377,5.06283595341852,33.8608956090926,-1.02945506076352
384.42,385,20092,19845,1446624,1151010,2024-10-15,2024-12-20,584.32,-247,-295614,401465676,-76728253,0.28670196951034,91.3538987078935,-0.256830088357182
579.2,595,558,721,1047924,1139180,2024-10-15,2024-11-29,584.32,163,91256,111401771,-12544864,1.02258697485159,67.7047118039084,0.0801067434470409
533.63,538,2565,2583,1379970,1128771,2024-10-15,2024-12-20,584.32,18,-251199,401465676,-76728253,0.281162517116407,91.6350612250099,-0.222542039084987
546.93,553,1819,1856,1347879,1126592,2024-10-15,2024-12-20,584.32,37,-221287,401465676,-76728253,0.280619755896641,91.9156809809066,-0.196421597170937
573.83,583,208,1219,240240,1117823,2024-10-15,2024-11-15,584.32,1011,877583,392489350,-83095331,0.284803396576238,92.1814385536831,0.785082253630494
547.86,554,1807,1799,1355250,1104586,2024-10-15,2024-12-20,584.32,-8,-250664,401465676,-76728253,0.275138340842867,92.1908193217494,-0.226930270707759
379.78,380,50073,50073,1101606,1101606,2024-10-15,2024-11-08,584.32,0,0,28140084,-4440601,3.91472178974306,28.2024389124069,0
449.51,450,22192,22408,1331520,1097992,2024-10-15,2024-11-15,584.32,216,-233528,392489350,-83095331,0.279750775403205,92.4611893290863,-0.212686431230829
553.72,561,1580,1506,1361960,1096368,2024-10-15,2024-12-20,584.32,-74,-265592,401465676,-76728253,0.273091341437618,92.4639106631871,-0.242247128701312
549.65,556,1704,1722,1325712,1093470,2024-10-15,2024-12-20,584.32,18,-232242,401465676,-76728253,0.27236948645144,92.7362801496385,-0.2123899146753
404.28,405,14960,14962,1286560,1077264,2024-10-15,2024-12-20,584.32,2,-209296,401465676,-76728253,0.268332777719209,93.0046129273577,-0.194284780703709
569.94,576,1732,1776,1421972,1076256,2024-10-15,2024-11-08,584.32,44,-345716,28140084,-4440601,3.82463677080708,32.027075683214,-0.321220973448696
539.23,540,14036,13932,1628176,1072764,2024-10-15,2024-11-01,584.32,-104,-555412,74573214,-17043443,1.43853797155638,79.981310715668,-0.51773922316558
571.14,579,895,1360,914690,1068960,2024-10-15,2024-11-15,584.32,465,154270,392489350,-83095331,0.272353886799731,92.733543215886,0.144317841640473
572.5,581,1134,1256,1238328,1067600,2024-10-15,2024-11-15,584.32,122,-170728,392489350,-83095331,0.272007380582429,93.0055505964684,-0.159917572124391
508.4,510,6205,6613,1241000,1058080,2024-10-15,2024-11-29,584.32,408,-182920,111401771,-12544864,0.949787414061847,68.6544992179702,-0.172879177377892
449.29,450,14259,14797,1240533,1050587,2024-10-15,2024-11-29,584.32,538,-189946,111401771,-12544864,0.943061309142024,69.5975605271123,-0.180799876640392
581.28,584,140,3859,84560,1049648,2024-10-15,2024-10-18,584.32,3719,965088,37570248,-36451733,2.79382771175745,41.0613073408512,0.919439659771657
577.7,594,562,643,1375214,1048090,2024-10-15,2024-11-29,584.32,81,-327124,111401771,-12544864,0.940819872603282,70.5383803997156,-0.312114417654972
581.97,605,452,454,1236220,1045562,2024-10-15,2024-12-20,584.32,2,-190658,401465676,-76728253,0.260436212235489,93.2650491395932,-0.182349779353113
567.68,579,868,923,1188292,1044836,2024-10-15,2024-12-20,584.32,55,-143456,401465676,-76728253,0.260255374857999,93.5253045144512,-0.137300016461914
454.49,455,20477,20444,1290051,1042644,2024-10-15,2024-11-15,584.32,-33,-247407,392489350,-83095331,0.265648991494928,93.2711995879633,-0.237288086825417
572.73,580,683,1422,650216,1033794,2024-10-15,2024-11-08,584.32,739,383578,28140084,-4440601,3.67374169885207,35.7008173820661,0.371039104502444
469.39,470,16660,16671,1249500,1016931,2024-10-15,2024-11-15,584.32,11,-232569,392489350,-83095331,0.259097730932062,93.5302973188954,-0.228696932240241
532.18,534,5347,5547,1304668,1009554,2024-10-15,2024-11-15,584.32,200,-295114,392489350,-83095331,0.25721818948718,93.7875155083826,-0.292321163602937
573.11,577,12902,2564,7663788,997396,2024-10-15,2024-11-01,584.32,-10338,-6666392,74573214,-17043443,1.33747219209299,81.318782907761,-6.68379660636297
564.09,565,9218,10848,1677676,987168,2024-10-15,2024-10-25,584.32,1630,-690508,22997980,-5421377,4.29241176833791,38.1533073774305,-0.69948377581121
577.99,592,652,695,1283136,973695,2024-10-15,2024-11-29,584.32,43,-309441,111401771,-12544864,0.874039067116806,71.4124194668324,-0.317800748694406
573.09,575,4363,5073,1592495,968943,2024-10-15,2024-10-25,584.32,710,-623552,22997980,-5421377,4.21316567802911,42.3664730554597,-0.643538371194178
474.35,475,14788,14771,1197828,960115,2024-10-15,2024-11-15,584.32,-17,-237713,392489350,-83095331,0.244621924136286,94.0321374325189,-0.247588049348255
573.74,585,664,852,899056,959352,2024-10-15,2024-11-29,584.32,188,60296,111401771,-12544864,0.861164047383053,72.2735835142154,0.0628507575947098
349.62,350,25419,25231,1220112,958778,2024-10-15,2024-12-20,584.32,-188,-261334,401465676,-76728253,0.238819420268447,93.7641239347196,-0.272569875403899
559.83,560,58169,56094,2675774,953598,2024-10-15,2024-10-18,584.32,-2075,-1722176,37570248,-36451733,2.53817329073793,43.5994806315891,-1.80597694206573
484.88,485,78500,78499,1570000,941988,2024-10-15,2024-10-25,584.32,-1,-628012,22997980,-5421377,4.0959597321156,46.4624327875753,-0.66668789835964
571.54,575,1926,2722,1026558,941812,2024-10-15,2024-11-01,584.32,796,-84745.9999999999,74573214,-17043443,1.26293604564234,82.5817189534033,-0.0899818647458302
527.2,531,2472,2477,1124760,941260,2024-10-15,2024-12-20,584.32,5,-183500,401465676,-76728253,0.234455909002791,93.9985798437224,-0.194951448058985
536.29,541,1972,1980,1120096,932580,2024-10-15,2024-12-20,584.32,8,-187516,401465676,-76728253,0.232293831266412,94.2308736749889,-0.201072294065925
541.69,547,1752,1755,1110768,931905,2024-10-15,2024-12-20,584.32,3,-178863,401465676,-76728253,0.23212569734106,94.4629993723299,-0.191932654079547
579.98,582,442,4598,213928,928796,2024-10-15,2024-10-18,584.32,4156,714868,37570248,-36451733,2.47215828865436,46.0716389202435,0.769671704012507
552.07,559,1367,1338,1137344,927234,2024-10-15,2024-12-20,584.32,-29,-210110,401465676,-76728253,0.230962210577624,94.6939615829075,-0.226598679513478
555.7,561,1723,1735,1137180,919550,2024-10-15,2024-11-29,584.32,12,-217630,111401771,-12544864,0.825435710532825,73.0990192247482,-0.236670110380077
570.44,578,1226,1216,1203932,919296,2024-10-15,2024-11-15,584.32,-10,-284636,392489350,-83095331,0.234221896721529,94.2663593292404,-0.309623886104149
564.07,574,1069,922,1294559,915546,2024-10-15,2024-12-20,584.32,-147,-379013,401465676,-76728253,0.228050878252416,94.9220124611599,-0.413974830319831
573.35,574,15680,14075,2932160,914875,2024-10-15,2024-10-18,584.32,-1605,-2017285,37570248,-36451733,2.43510503311024,48.5067439533537,-2.20498428747097
582.02,600,454,506,998800,909788,2024-10-15,2024-11-15,584.32,52,-89011.9999999999,392489350,-83095331,0.231799410608211,94.4981587398486,-0.0978381776853507
548.91,552,2906,2906,1194366,897954,2024-10-15,2024-11-15,584.32,0,-296412,392489350,-83095331,0.228784296949713,94.7269430367983,-0.330097087378641
561.11,567,1493,1524,1124229,897636,2024-10-15,2024-11-22,584.32,31,-226593,16269713,-1546756,5.51722086308468,39.0230362391764,-0.252433057497694
575.16,576,10428,10602,2471436,890568,2024-10-15,2024-10-18,584.32,174,-1580868,37570248,-36451733,2.37040756292053,50.8771515162743,-1.77512329210122
573.16,582,640,1007,723200,890188,2024-10-15,2024-11-15,584.32,367,166988,392489350,-83095331,0.226805644535323,94.9537486813337,0.187587341100981
559.52,565,1577,1606,1127555,880088,2024-10-15,2024-11-22,584.32,29,-247467,16269713,-1546756,5.40936401275179,44.4324002519282,-0.281184381561844
565.55,576,758,840,952806,877800,2024-10-15,2024-12-20,584.32,82,-75006,401465676,-76728253,0.218648829146729,95.1406612903067,-0.0854477101845523
561.09,565,2055,2228,1089150,871148,2024-10-15,2024-11-08,584.32,173,-218002,28140084,-4440601,3.09575479589897,38.7965721779651,-0.250246800773233
556.79,560,2526,2708,1134174,869268,2024-10-15,2024-11-08,584.32,182,-264906,28140084,-4440601,3.0890739345341,41.8856461124992,-0.304746062204061
580,596,541,542,1027359,867200,2024-10-15,2024-11-15,584.32,1,-160159,392489350,-83095331,0.220948670326978,95.1746973516606,-0.184685193726937
583.34,605,317,400,823249,866400,2024-10-15,2024-11-15,584.32,83,43151,392489350,-83095331,0.22074484314033,95.395442194801,0.0498049399815328
568.19,571,3069,3077,1319670,864637,2024-10-15,2024-11-01,584.32,8,-455033,74573214,-17043443,1.15944714411799,83.7411660975213,-0.526270562097157
319.73,320,31948,31945,1086232,862515,2024-10-15,2024-12-20,584.32,-3,-223717,401465676,-76728253,0.214841529814868,95.3555028201215,-0.25937751807215
515.18,517,4702,4701,1095566,855582,2024-10-15,2024-11-29,584.32,-1,-239984,111401771,-12544864,0.768014720340487,73.8670339450887,-0.280492109464669
566.83,572,1079,1629,755300,842193,2024-10-15,2024-11-08,584.32,550,86893,28140084,-4440601,2.99285886993088,44.8785049824301,0.103174687987195
570.32,583,400,662,6e+05,839416,2024-10-15,2024-12-20,584.32,262,239416,401465676,-76728253,0.209087862345672,95.5645906824672,0.285217341580337
557.84,558,52770,52210,2110800,835360,2024-10-15,2024-10-18,584.32,-560,-1275440,37570248,-36451733,2.22346150070662,53.1006130169809,-1.52681478643938
546.19,549,2994,2963,1125744,832603,2024-10-15,2024-11-15,584.32,-31,-293141,392489350,-83095331,0.21213390885638,95.6075761036573,-0.352077760949696
394.92,395,100440,100437,1205280,803496,2024-10-15,2024-11-01,584.32,-3,-401784,74573214,-17043443,1.07745926037196,84.8186253578933,-0.500044804205622
540.66,543,3346,3430,1027222,802620,2024-10-15,2024-11-15,584.32,84,-224602,392489350,-83095331,0.204494720684778,95.8120708243421,-0.279836036978894
565.23,570,1635,1679,1057845,800883,2024-10-15,2024-11-08,584.32,44,-256962,28140084,-4440601,2.84605760238669,47.7245625848167,-0.320848363618656
542.56,548,1442,1444,934416,785536,2024-10-15,2024-12-20,584.32,2,-148880,401465676,-76728253,0.195667038793125,95.7602577212603,-0.189526641681603
504.52,506,5272,5271,954232,780108,2024-10-15,2024-11-29,584.32,-1,-174124,111401771,-12544864,0.700265348564342,74.5672992936531,-0.223204992129295
576.5,591,536,537,1023760,778650,2024-10-15,2024-11-29,584.32,1,-245110,111401771,-12544864,0.698956572243362,75.2662558658964,-0.314788415847942
374.49,375,15241,15245,944942,777495,2024-10-15,2024-12-20,584.32,4,-167447,401465676,-76728253,0.193664127839412,95.9539218490997,-0.215367301397437
533.21,536,2742,2778,967926,775062,2024-10-15,2024-11-29,584.32,36,-192864,111401771,-12544864,0.695735797593379,75.9619916634898,-0.248836867244169
493.76,495,6122,6160,924422,763840,2024-10-15,2024-11-29,584.32,38,-160582,111401771,-12544864,0.685662349120105,76.6476540126099,-0.210229891076665
527.6,530,2461,3172,753066,761280,2024-10-15,2024-11-29,584.32,711,8213.99999999988,111401771,-12544864,0.683364360518111,77.331018373128,0.0107897225725093
557.35,563,1336,1347,936536,761055,2024-10-15,2024-11-29,584.32,11,-175481,111401771,-12544864,0.683162388863638,78.0141807619917,-0.23057597676909
434.95,435,152059,152060,1216472,760300,2024-10-15,2024-10-25,584.32,1,-456172,22997980,-5421377,3.30594252190845,49.7683753094837,-0.599989477837696
518.07,520,3889,3924,964472,757332,2024-10-15,2024-11-29,584.32,35,-207140,111401771,-12544864,0.679820431220972,78.6940011932126,-0.273512805480291
563.57,570,642,1168,532218,751024,2024-10-15,2024-11-22,584.32,526,218806,16269713,-1546756,4.6160863439939,49.0484865959221,0.291343552269968
559.33,560,8921,11196,1177572,750132,2024-10-15,2024-10-25,584.32,2275,-427440,22997980,-5421377,3.26172994323849,53.0301052527222,-0.569819711730735
562.59,572,802,788,914280,741508,2024-10-15,2024-12-20,584.32,-14,-172772,401465676,-76728253,0.184700223288827,96.1386220723886,-0.233000857711583
561.91,568,1206,1216,940680,740544,2024-10-15,2024-11-22,584.32,10,-200136,16269713,-1546756,4.55167217762231,53.6001587735444,-0.270255379828882
558.68,564,1379,1387,926688,737884,2024-10-15,2024-11-22,584.32,8,-188804,16269713,-1546756,4.53532278043257,58.135481553977,-0.255872196713846
547.8,550,2679,3325,846564,731500,2024-10-15,2024-11-08,584.32,646,-115064,28140084,-4440601,2.59949472787643,50.3240573126932,-0.157298701298701
564.76,565,31344,30461,2288112,731064,2024-10-15,2024-10-18,584.32,-883,-1557048,37570248,-36451733,1.94585886151191,55.0464718784928,-2.12983815370474
554.86,555,36029,51950,1188957,727300,2024-10-15,2024-10-18,584.32,15921,-461657,37570248,-36451733,1.93584029575743,56.9823121742502,-0.634754571703561
524.4,528,1821,1989,786672,716040,2024-10-15,2024-12-20,584.32,168,-70632,401465676,-76728253,0.17835646801347,96.316978540402,-0.0986425339366516
544.36,547,2796,2712,970212,715968,2024-10-15,2024-11-15,584.32,-84,-254244,392489350,-83095331,0.182417178962945,95.9944880033051,-0.355105256100832
529.29,531,4171,4144,896765,708624,2024-10-15,2024-11-15,584.32,-27,-188141,392489350,-83095331,0.180546045389512,96.1750340486946,-0.265501874054506
369.52,370,14531,14534,871860,697632,2024-10-15,2024-12-20,584.32,3,-174228,401465676,-76728253,0.173771269053646,96.4907498094557,-0.249741984312646
529.95,534,1713,1714,841083,694170,2024-10-15,2024-12-20,584.32,1,-146913,401465676,-76728253,0.172908928832063,96.6636587382878,-0.211638359479666
577.7,579,5134,5317,1735292,691210,2024-10-15,2024-10-18,584.32,183,-1044082,37570248,-36451733,1.83978024313281,58.822092417383,-1.51051344743276
555.11,558,2356,2361,968316,682329,2024-10-15,2024-11-08,584.32,5,-285987,28140084,-4440601,2.42475822033794,52.7488155330311,-0.41913358511803
569.15,575,867,1146,686664,670410,2024-10-15,2024-11-08,584.32,279,-16254,28140084,-4440601,2.38240227001455,55.1312178030457,-0.0242448650825614
526.42,528,4145,4241,866305,670078,2024-10-15,2024-11-15,584.32,96,-196227,392489350,-83095331,0.17072514196882,96.3457591906634,-0.29284202734607
503.54,505,4535,4555,834440,665030,2024-10-15,2024-11-29,584.32,20,-169410,111401771,-12544864,0.596965374993904,79.2909665682065,-0.254740387651685
558.57,562.5,1666,1681,862988,660633,2024-10-15,2024-11-08,584.32,15,-202355,28140084,-4440601,2.34765823726752,57.4788760403132,-0.306304710784959
444.55,445,14651,14631,791154,658395,2024-10-15,2024-11-15,584.32,-20,-132759,392489350,-83095331,0.167748500691802,96.5135076913552,-0.201640352675825
522.53,526,1672,1889,700568,655483,2024-10-15,2024-12-20,584.32,217,-45085,401465676,-76728253,0.16327248858007,96.8269312268678,-0.0687813413925304
576.02,577,5349,6623,1422834,649054,2024-10-15,2024-10-18,584.32,1274,-773780,37570248,-36451733,1.72757443602715,60.5496668534102,-1.19216582903734
571.67,585,272,485,428128,646505,2024-10-15,2024-12-20,584.32,213,218377,401465676,-76728253,0.161036182829239,96.9879674096971,0.337780836961818
528.11,532,1602,1603,764154,623567,2024-10-15,2024-12-20,584.32,1,-140587,401465676,-76728253,0.155322618414831,97.1432900281119,-0.225456125805246
550.72,554,1838,1900,803206,623200,2024-10-15,2024-11-15,584.32,62,-180006,392489350,-83095331,0.158781378399185,96.6722890697544,-0.288841463414634
560.18,564,1561,1619,782061,618458,2024-10-15,2024-11-08,584.32,58,-163603,28140084,-4440601,2.19778306276556,59.6766591030787,-0.264533727431774
584.5,610,16,241,48640,614550,2024-10-15,2024-11-15,584.32,225,565910,392489350,-83095331,0.156577496943548,96.8288665666979,0.920852656415263
584.33,600,16,391,31808,612697,2024-10-15,2024-10-25,584.32,375,580889,22997980,-5421377,2.66413398046263,55.6942392331848,0.948085268901268
569.11,578,623,687,689661,610743,2024-10-15,2024-11-29,584.32,64,-78918,111401771,-12544864,0.548234551854656,79.8392011200612,-0.129216380703504
566.07,571,1087,1194,735899,588642,2024-10-15,2024-11-08,584.32,107,-147257,28140084,-4440601,2.09182744443833,61.7684865475171,-0.250163936654197
564.45,571,302,897,256700,587535,2024-10-15,2024-11-22,584.32,595,330835,16269713,-1546756,3.61121920220719,61.7467007561842,0.563089858476516
527.39,529,3512,3603,741032,580083,2024-10-15,2024-11-15,584.32,91,-160949,392489350,-83095331,0.14779585739078,96.9766624240887,-0.277458570583865
329.7,330,19275,19277,713175,578310,2024-10-15,2024-12-20,584.32,2,-134865,401465676,-76728253,0.144049674622744,97.2873397027347,-0.23320537428023
556.49,562,965,1049,654270,577999,2024-10-15,2024-11-29,584.32,84,-76271,111401771,-12544864,0.51884184139227,80.3580429614535,-0.13195697570411
582.35,586,597,1576,429840,575240,2024-10-15,2024-10-18,584.32,979,145400,37570248,-36451733,1.53110514468789,62.0807719980981,0.252764063695153
339.89,340,52099,52099,729386,573089,2024-10-15,2024-11-15,584.32,0,-156297,392489350,-83095331,0.146013898211506,97.1226763223002,-0.272727272727273
576.87,578,3860,4989,1158000,563757,2024-10-15,2024-10-18,584.32,1129,-594243,37570248,-36451733,1.50054106643108,63.5813130645292,-1.05407649040278
534.06,536,3002,2830,771514,549020,2024-10-15,2024-11-15,584.32,-172,-222494,392489350,-83095331,0.139881502517202,97.2625578248174,-0.405256639102401
529.94,530,92359,91314,1293026,547884,2024-10-15,2024-10-18,584.32,-1045,-745142,37570248,-36451733,1.45829221036816,65.0396052748973,-1.36003606602858
524.51,526,3763,3663,730022,545787,2024-10-15,2024-11-15,584.32,-100,-184235,392489350,-83095331,0.139057785899159,97.4016156107166,-0.337558424806747
510.34,512,3272,3264,693664,541824,2024-10-15,2024-11-29,584.32,-8,-151840,111401771,-12544864,0.486369287612133,80.8444122490656,-0.280238601464682
389.93,390,76499,76499,1453481,535493,2024-10-15,2024-11-01,584.32,0,-917988,74573214,-17043443,0.718076868726618,85.5367022266199,-1.71428571428571
563.74,571,728,734,642824,532884,2024-10-15,2024-11-29,584.32,6,-109940,111401771,-12544864,0.478344280541106,81.3227565296067,-0.206311317284812
571.5,572,9219,10640,1382850,532000,2024-10-15,2024-10-18,584.32,1421,-850850,37570248,-36451733,1.41601407581872,66.455619350716,-1.59934210526316
534.52,539,1176,1181,633864,529088,2024-10-15,2024-12-20,584.32,5,-104776,401465676,-76728253,0.131789099698775,97.4191288024334,-0.19803132938188
567.67,568,14982,15914,1453254,525162,2024-10-15,2024-10-18,584.32,932,-928092,37570248,-36451733,1.39781350391938,67.8534328546354,-1.76724896317708
558.54,562,1520,1511,709840,522806,2024-10-15,2024-11-08,584.32,-9,-187034,28140084,-4440601,1.85786936527979,63.6263559127969,-0.357750293607954
556.15,561,1045,1074,638495,520890,2024-10-15,2024-11-22,584.32,29,-117605,16269713,-1546756,3.20159304592527,64.9482938021095,-0.225777035458543
576.75,590,344,387,543864,512775,2024-10-15,2024-11-29,584.32,43,-31089,111401771,-12544864,0.460293400542079,81.7830499301488,-0.0606289308176101
364.54,365,11107,11107,688634,510922,2024-10-15,2024-12-20,584.32,0,-177712,401465676,-76728253,0.127264179864781,97.5463929822982,-0.347826086956522
573.88,576,1875,2410,731250,510920,2024-10-15,2024-10-25,584.32,535,-220330,22997980,-5421377,2.22158641758972,57.9158256507746,-0.431241681672277
536.94,539,2451,2470,686280,508820,2024-10-15,2024-11-15,584.32,19,-177460,392489350,-83095331,0.129639186388115,97.5312547971047,-0.348767737117251
499.62,500,13253,13365,662650,507870,2024-10-15,2024-11-01,584.32,112,-154780,74573214,-17043443,0.681035418427855,86.2177376450477,-0.304763029909229
354.54,355,11032,11031,573664,507426,2024-10-15,2024-12-20,584.32,-1,-66238,401465676,-76728253,0.126393370675106,97.6727863529733,-0.130537260605487
566.52,569,2023,2035,724234,504680,2024-10-15,2024-11-01,584.32,12,-219554,74573214,-17043443,0.676757743068443,86.8944953881162,-0.435036062455417
477.96,479,4831,4831,594213,502424,2024-10-15,2024-11-29,584.32,0,-91789,111401771,-12544864,0.451001806784562,82.2340517369334,-0.182692307692308
574.08,582,165,633,165165,501336,2024-10-15,2024-11-08,584.32,468,336171,28140084,-4440601,1.78157250703303,65.4079284198299,0.670550289626119
359.57,360,11600,11610,603200,499230,2024-10-15,2024-12-20,584.32,10,-103970,401465676,-76728253,0.124351851190387,97.7971382041637,-0.208260721511127
559.98,566,837,828,633609,498456,2024-10-15,2024-11-29,584.32,-9,-135153,111401771,-12544864,0.44743992445147,82.6814916613848,-0.271143290481005
563.23,567.5,1168,1166,677440,497882,2024-10-15,2024-11-08,584.32,-2,-179558,28140084,-4440601,1.7692982010999,67.1772266209298,-0.360643686656678
487.87,489,4404,4402,634176,497426,2024-10-15,2024-11-29,584.32,-2,-136750,111401771,-12544864,0.446515343099887,83.1280070044847,-0.274915263777929
571.03,584,278,380,442576,492860,2024-10-15,2024-12-20,584.32,102,50284.0000000001,401465676,-76728253,0.122765165109657,97.9199033692733,0.10202491579759
549.59,550,15393,11908,1200654,488228,2024-10-15,2024-10-25,584.32,-3485,-712426,22997980,-5421377,2.12291688226531,60.0387425330399,-1.45920758334221
566.93,578,561,438,747813,484866,2024-10-15,2024-12-20,584.32,-123,-262947,401465676,-76728253,0.120773961258895,98.0406773305322,-0.542308596601948
559.33,561,2818,2898,752406,483966,2024-10-15,2024-11-01,584.32,80,-268440,74573214,-17043443,0.648981013477574,87.5434764015937,-0.554667063388751
572.43,573,5891,8455,983797,481935,2024-10-15,2024-10-18,584.32,2564,-501862,37570248,-36451733,1.28275703689792,69.1361898915333,-1.04134789961302
553.88,554,39748,39677,1232188,476124,2024-10-15,2024-10-18,584.32,-71,-756064,37570248,-36451733,1.26729001096825,70.4034799025016,-1.58795607866858
572.05,579,697,682,646119,473990,2024-10-15,2024-11-08,584.32,-15,-172129,28140084,-4440601,1.68439440337136,68.8616210243011,-0.363149011582523
549.6,554,1057,1074,607775,472560,2024-10-15,2024-11-29,584.32,17,-135215,111401771,-12544864,0.42419433349942,83.5522013379841,-0.286132977822922
576.22,579,1467,1696,724698,471488,2024-10-15,2024-10-25,584.32,229,-253210,22997980,-5421377,2.05012788079649,62.0888704138364,-0.53704442106692
564.68,572,627,640,587499,468480,2024-10-15,2024-11-29,584.32,13,-119019,111401771,-12544864,0.420531914164991,83.9727332521491,-0.254053534836066
539.93,540,68966,66611,1172422,466277,2024-10-15,2024-10-18,584.32,-2355,-706145,37570248,-36451733,1.24108044216264,71.6445603446642,-1.51443240820371
531.83,536,1125,1115,568125,464955,2024-10-15,2024-12-20,584.32,-10,-103170,401465676,-76728253,0.115814384091954,98.1564917146242,-0.221892441203988
572.4,576,620,1290,350300,464400,2024-10-15,2024-11-01,584.32,670,114100,74573214,-17043443,0.622743710630468,88.1662201122242,0.245693367786391
574.85,583,58,566,62118,461290,2024-10-15,2024-11-08,584.32,508,399172,28140084,-4440601,1.63926305266182,70.500884076963,0.865338507229726
509.96,510,114326,114358,1028934,457432,2024-10-15,2024-10-18,584.32,32,-571502,37570248,-36451733,1.21753787731186,72.8620982219761,-1.24937039822312
379.94,380,75733,75730,681597,454380,2024-10-15,2024-11-01,584.32,-3,-227217,74573214,-17043443,0.609307250724101,88.7755273629483,-0.500059421629473
554.72,556,2233,3527,462231,451456,2024-10-15,2024-11-01,584.32,1294,-10774.9999999999,74573214,-17043443,0.605386271805316,89.3809136347536,-0.0238672207258291
299.8,300,22379,22507,559475,450140,2024-10-15,2024-12-20,584.32,128,-109335,401465676,-76728253,0.112124155789597,98.2686158704138,-0.242891100546496
525.34,529,1069,1215,473567,444690,2024-10-15,2024-12-20,584.32,146,-28876.9999999999,401465676,-76728253,0.11076663002194,98.3793825004357,-0.0649373721019136
485.8,487,3681,3679,544788,441480,2024-10-15,2024-11-29,584.32,-2,-103308,111401771,-12544864,0.396295315628331,84.3690285677774,-0.234003805381897
566.7,567,14414,14540,1254018,436200,2024-10-15,2024-10-18,584.32,126,-817818,37570248,-36451733,1.1610250749476,74.0231232969237,-1.87486932599725
525.46,527,2798,2799,556802,431046,2024-10-15,2024-11-15,584.32,1,-125756,392489350,-83095331,0.109823616870114,97.6410784139748,-0.291746124543552
560.24,562,2417,2449,633254,431024,2024-10-15,2024-11-01,584.32,32,-202230,74573214,-17043443,0.577987694080075,89.9589013288337,-0.469185010579457
555.9,559,1386,1384,573804,429040,2024-10-15,2024-11-08,584.32,-2,-144764,28140084,-4440601,1.52465785105688,72.0255419280198,-0.337413760954689
544.91,545,47364,47155,994644,424395,2024-10-15,2024-10-18,584.32,-209,-570249,37570248,-36451733,1.12960393553963,75.1527272324633,-1.34367511398579
519.04,520,4300,4309,559000,413664,2024-10-15,2024-11-08,584.32,9,-145336,28140084,-4440601,1.47001693385137,73.4955588618712,-0.351338284211341
577.75,581,415,1252,241115,406900,2024-10-15,2024-10-25,584.32,837,165785,22997980,-5421377,1.76928582423326,63.8581562380696,0.407434259031703
570.55,571,8817,8856,1181478,398520,2024-10-15,2024-10-18,584.32,39,-782958,37570248,-36451733,1.06073295017909,76.2134601826424,-1.96466425775369
530.25,532,2381,2276,547630,398300,2024-10-15,2024-11-15,584.32,-105,-149330,392489350,-83095331,0.101480460552624,97.7425588745274,-0.374918403213658
533.62,535,3818,2879,725420,397302,2024-10-15,2024-11-08,584.32,-939,-328118,28140084,-4440601,1.41187211807897,74.9074309799502,-0.825865462544865
572.51,583,15,375,19395,393375,2024-10-15,2024-11-29,584.32,360,373980,111401771,-12544864,0.35311377590218,84.7221423436796,0.95069590085796
583.71,590,190,625,208240,393125,2024-10-15,2024-10-18,584.32,435,184885,37570248,-36451733,1.04637318337638,77.2598333660188,0.470295707472178
581.75,600,170,215,375530,392375,2024-10-15,2024-11-29,584.32,45,16845,111401771,-12544864,0.352216124104526,85.0743584677842,0.0429308697037273
429.43,430,6836,6830,464848,389310,2024-10-15,2024-11-29,584.32,-6,-75538.0000000001,111401771,-12544864,0.349464821344716,85.4238232891289,-0.19403046415453
560.71,567,583,615,472230,386835,2024-10-15,2024-11-29,584.32,32,-85395,111401771,-12544864,0.347243133145522,85.7710664222744,-0.220753034239404
479,480,3861,3863,471042,386300,2024-10-15,2024-11-29,584.32,2,-84742,111401771,-12544864,0.346762889433778,86.1178293117082,-0.219368366554491
554.01,559,766,772,476452,385228,2024-10-15,2024-11-29,584.32,6,-91224,111401771,-12544864,0.345800606706692,86.4636299184149,-0.236805216650918
562.21,569,549,564,456219,382956,2024-10-15,2024-11-29,584.32,15,-73263.0000000001,111401771,-12544864,0.343761141822422,86.8073910602373,-0.191309184344938
575.65,586,46,365,58420,377775,2024-10-15,2024-11-15,584.32,319,319355,392489350,-83095331,0.0962510192951732,97.8388098938226,0.845357686453577
575.47,578,1435,1490,654360,376970,2024-10-15,2024-10-25,584.32,55,-277390,22997980,-5421377,1.63914395959993,65.4973001976695,-0.735841048359286
543.46,549,690,678,464370,375612,2024-10-15,2024-12-20,584.32,-12,-88758.0000000001,401465676,-76728253,0.0935601777323549,98.4729426781681,-0.236302354557363
570.47,572,2326,2405,683844,367965,2024-10-15,2024-10-25,584.32,79,-315879,22997980,-5421377,1.59998834680263,67.0972885444722,-0.858448493742611
399.75,400,14671,14691,484143,367275,2024-10-15,2024-11-15,584.32,20,-116868,392489350,-83095331,0.0935757874704116,97.932385681293,-0.318202981417194
339.65,340,10415,10493,437430,367255,2024-10-15,2024-12-20,584.32,78,-70175,401465676,-76728253,0.0914785551928479,98.5644212333609,-0.191079767464024
560.81,561,11679,19319,583950,367061,2024-10-15,2024-10-18,584.32,7640,-216889,37570248,-36451733,0.976999140383636,78.2368325064024,-0.590879989974418
324.71,325,12505,12505,450180,362645,2024-10-15,2024-12-20,584.32,0,-87535,401465676,-76728253,0.0903302627545175,98.6547514961155,-0.241379310344828
563.65,568,798,833,478800,362355,2024-10-15,2024-11-08,584.32,35,-116445,28140084,-4440601,1.28768272333515,76.1951137032853,-0.32135612865836
544.15,545,4144,4250,580160,361250,2024-10-15,2024-11-01,584.32,106,-218910,74573214,-17043443,0.484423267582379,90.4433245964161,-0.605979238754325
521.6,523,2583,2578,477855,360920,2024-10-15,2024-11-15,584.32,-5,-116935,392489350,-83095331,0.0919566352564726,98.0243423165495,-0.323991466252909
506.47,508,2343,2338,442827,357714,2024-10-15,2024-11-29,584.32,-5,-85113,111401771,-12544864,0.321102615146038,87.1284936753833,-0.237935892920042
274.85,275,23739,23739,403563,356085,2024-10-15,2024-12-20,584.32,0,-47478,401465676,-76728253,0.0886962500873923,98.7434477462029,-0.133333333333333
562.8,567,616,841,353584,353220,2024-10-15,2024-11-08,584.32,225,-364,28140084,-4440601,1.25522013367124,77.4503338369566,-0.00103051922314705
582.5,590,366,470,404064,352500,2024-10-15,2024-10-25,584.32,104,-51564,22997980,-5421377,1.53274331049944,68.6300318549716,-0.14628085106383
570.98,580,315,388,353430,349976,2024-10-15,2024-11-22,584.32,73,-3454,16269713,-1546756,2.15108895897549,67.099382761085,-0.00986924817701785
429.62,430,9193,9191,432071,349258,2024-10-15,2024-11-15,584.32,-2,-82813,392489350,-83095331,0.088985344443104,98.1133276609926,-0.23711124727279
543.09,545,2002,1822,526526,348002,2024-10-15,2024-11-08,584.32,-180,-178524,28140084,-4440601,1.23667718973405,78.6870110266906,-0.512997051741082
569.01,581,147,290,209034,347710,2024-10-15,2024-12-20,584.32,143,138676,401465676,-76728253,0.0866101439765426,98.8300578901794,0.398826608380547
524.95,525,71826,68814,861912,344070,2024-10-15,2024-10-18,584.32,-3012,-517842,37570248,-36451733,0.915804441855162,79.1526369482576,-1.50504839131572
574.62,579,576,783,380160,342954,2024-10-15,2024-11-01,584.32,207,-37206,74573214,-17043443,0.459888989094663,90.9032135855107,-0.108486852464179
515.76,517,2857,2753,437121,341372,2024-10-15,2024-11-15,584.32,-104,-95749,392489350,-83095331,0.0869761179507164,98.2003037789433,-0.280482874986818
567.7,573,639,641,453051,339730,2024-10-15,2024-11-08,584.32,2,-113321,28140084,-4440601,1.20728139972859,79.8942924264192,-0.333561946251435
547.06,548,2298,3602,344700,338588,2024-10-15,2024-11-01,584.32,1304,-6112.00000000006,74573214,-17043443,0.454034339997737,91.3572479255085,-0.0180514371448488
569.88,573,1055,1082,502180,337584,2024-10-15,2024-11-01,584.32,27,-164596,74573214,-17043443,0.452688012078975,91.8099359375875,-0.48757050097161
567.67,576,278,401,288008,334033,2024-10-15,2024-11-29,584.32,123,46025,111401771,-12544864,0.299845322925791,87.4283389983091,0.137785787631761
519.51,520,6709,6773,462921,331877,2024-10-15,2024-11-01,584.32,64,-131044,74573214,-17043443,0.445035130174221,92.2549710677617,-0.394857130804485
519.66,521,2451,2443,426474,327362,2024-10-15,2024-11-15,584.32,-8,-99111.9999999999,392489350,-83095331,0.0834065943445345,98.2837103732878,-0.30275963612148
558.18,564,554,561,401650,326502,2024-10-15,2024-11-29,584.32,7,-75148,111401771,-12544864,0.293085107237658,87.7214241055468,-0.230160917850427
579.73,584,231,752,163317,321104,2024-10-15,2024-10-25,584.32,521,157787,22997980,-5421377,1.39622697297763,70.0262588279492,0.491389082664806
562.8,563,17274,15973,1019166,319460,2024-10-15,2024-10-18,584.32,-1301,-699706,37570248,-36451733,0.850300482445578,80.0029374307031,-2.19027734301634
526.67,529,1162,1371,464800,319443,2024-10-15,2024-11-29,584.32,209,-145357,111401771,-12544864,0.286748583198018,88.0081726887448,-0.455032666234665
519.96,522,1541,1565,392955,319260,2024-10-15,2024-11-29,584.32,24,-73695,111401771,-12544864,0.286584312919047,88.2947570016638,-0.230830670926518
579.1,583,32,813,20096,317070,2024-10-15,2024-10-25,584.32,781,296974,22997980,-5421377,1.37868630201435,71.4049451299636,0.936619673889047
567.78,569,2536,2575,613712,314150,2024-10-15,2024-10-25,584.32,39,-299562,22997980,-5421377,1.36598953473305,72.7709346646966,-0.953563584275028
583.74,595,250,275,375000,309650,2024-10-15,2024-10-25,584.32,25,-65350,22997980,-5421377,1.34642259885433,74.117357263551,-0.211044727918618
511.86,513,2710,2715,392950,309510,2024-10-15,2024-11-15,584.32,5,-83440,392489350,-83095331,0.0788581906744731,98.3625685639623,-0.269587412361475
573.24,593,156,156,308256,308256,2024-10-15,2024-12-20,584.32,0,0,401465676,-76728253,0.0767826537678903,98.9068405439473,0
569.59,571,2112,2133,580800,300753,2024-10-15,2024-10-25,584.32,21,-280047,22997980,-5421377,1.30773659251813,75.4250938560691,-0.931152806455796
562.71,569,447,473,346425,297517,2024-10-15,2024-11-22,584.32,26,-48908,16269713,-1546756,1.82865549011221,68.9280382511972,-0.164387245098599
419.67,420,7663,9002,321846,297066,2024-10-15,2024-11-15,584.32,1339,-24779.9999999999,392489350,-83095331,0.0756876587861556,98.4382562227485,-0.0834158065884347
565.66,568,1204,1269,451500,296946,2024-10-15,2024-11-01,584.32,65,-154554,74573214,-17043443,0.398193914506622,92.6531649822683,-0.520478470833081
569.86,579,297,324,332046,296136,2024-10-15,2024-11-29,584.32,27,-35910,111401771,-12544864,0.265827012750094,88.5605840144139,-0.12126185266229
571.35,573,1839,1781,582963,293865,2024-10-15,2024-10-25,584.32,-58,-289098,22997980,-5421377,1.27778613599977,76.7028799920689,-0.983778265530091
544.65,545,8431,8368,522722,292880,2024-10-15,2024-10-25,584.32,-63,-229842,22997980,-5421377,1.27350315114632,77.9763831432152,-0.784765091505053
570.35,579,318,334,348528,288910,2024-10-15,2024-11-22,584.32,16,-59618,16269713,-1546756,1.77575351206257,70.7037917632598,-0.206354920217369
582.7,587,899,671,721897,288530,2024-10-15,2024-10-18,584.32,-228,-433367,37570248,-36451733,0.767974701684162,80.7709121323873,-1.50198246282882
552.32,555,954,1076,349164,288368,2024-10-15,2024-11-08,584.32,122,-60796.0000000001,28140084,-4440601,1.02475884578028,80.9190512721995,-0.2108278311047
545.17,549,732,751,344772,287633,2024-10-15,2024-11-29,584.32,19,-57139,111401771,-12544864,0.258194279514641,88.8187782939286,-0.198652449475547
561.81,562,15347,15038,844085,285722,2024-10-15,2024-10-18,584.32,-309,-558363,37570248,-36451733,0.760500702577209,81.5314128349645,-1.95421773612112
552.21,557,587,595,350439,285005,2024-10-15,2024-11-29,584.32,8,-65434,111401771,-12544864,0.255835250590406,89.074613544519,-0.229588954579744
564.42,569,295,618,186145,283044,2024-10-15,2024-11-08,584.32,323,96899,28140084,-4440601,1.00583921497889,81.9248904871784,0.342346066335976
566.21,574,394,363,385332,282777,2024-10-15,2024-11-29,584.32,-31,-102555,111401771,-12544864,0.253835282385232,89.3284488269042,-0.362670938584114
500.08,501,3042,3053,355914,280876,2024-10-15,2024-11-15,584.32,11,-75038,392489350,-83095331,0.0715627060963565,98.5098189288448,-0.267157037269115
567.42,575,277,369,265089,279702,2024-10-15,2024-11-22,584.32,92,14613,16269713,-1546756,1.71915755367043,72.4229493169302,0.0522448892035095
583.85,600,133,173,276773,279395,2024-10-15,2024-11-01,584.32,40,2622,74573214,-17043443,0.374658654245477,93.0278236365138,0.00938456307378443
404.47,405,5263,5263,278939,278939,2024-10-15,2024-11-29,584.32,0,0,111401771,-12544864,0.250390094785836,89.57883892169,0
561.95,566,699,687,374664,278235,2024-10-15,2024-11-08,584.32,-12,-96429.0000000001,28140084,-4440601,0.98874971375352,82.9136402009319,-0.346573939295919
565.85,573,343,388,304584,277420,2024-10-15,2024-11-22,584.32,45,-27164,16269713,-1546756,1.70513149187082,74.128080808801,-0.0979165164732175
499.32,500,4047,4079,356136,277372,2024-10-15,2024-11-08,584.32,32,-78764,28140084,-4440601,0.985682914095068,83.899323115027,-0.2839652163881
444.34,445,4161,4192,332880,276672,2024-10-15,2024-11-29,584.32,31,-56208,111401771,-12544864,0.248355118160554,89.8271940398506,-0.203157529493407
459.46,460,5072,5100,329680,275400,2024-10-15,2024-11-15,584.32,28,-54280,392489350,-83095331,0.0701675090037475,98.5799864378486,-0.197095134350036
512.85,514,2391,2388,351477,274620,2024-10-15,2024-11-15,584.32,-3,-76857,392489350,-83095331,0.0699687774967652,98.6499552153453,-0.279866724928993
559.4,563,754,761,362674,273960,2024-10-15,2024-11-08,584.32,7,-88714,28140084,-4440601,0.973557861447748,84.8728809764747,-0.323820995765805
579.95,602,122,124,414312,273420,2024-10-15,2024-12-20,584.32,2,-140892,401465676,-76728253,0.0681054486959428,98.9749459926432,-0.515295150318192
520.64,522,2019,2010,359382,273360,2024-10-15,2024-11-15,584.32,-9,-86022,392489350,-83095331,0.0696477496777938,98.7196029650231,-0.314683933274802
528.53,531,1093,1094,404410,270218,2024-10-15,2024-11-29,584.32,1,-134192,111401771,-12544864,0.242561673458495,90.0697557133091,-0.496606443686209
556.54,558,1845,1842,426195,268932,2024-10-15,2024-11-01,584.32,-3,-157263,74573214,-17043443,0.360628147259417,93.3884517837732,-0.584768640399804
414.52,415,5602,5598,330518,268704,2024-10-15,2024-11-29,584.32,-4,-61814,111401771,-12544864,0.241202628636846,90.3109583419459,-0.230044956532095
574.71,577,1126,1158,477424,265182,2024-10-15,2024-10-25,584.32,32,-212242,22997980,-5421377,1.15306648670883,79.129449629924,-0.800363523919422
577.38,583,53,470,42718,264140,2024-10-15,2024-11-01,584.32,417,221422,74573214,-17043443,0.35420224747186,93.7426540312451,0.838275157113652
560.3,561,2122,3767,297080,263690,2024-10-15,2024-10-25,584.32,1645,-33390.0000000001,22997980,-5421377,1.14657896041304,80.2760285903371,-0.126625962304221
576.27,587,37,245,48729,262885,2024-10-15,2024-11-15,584.32,208,214156,392489350,-83095331,0.066978887452615,98.7865818524758,0.814637579169599
572.39,591,140,140,260540,260540,2024-10-15,2024-12-20,584.32,0,0,401465676,-76728253,0.0648972043129286,99.0398431969562,0
546.51,550,707,739,320978,257911,2024-10-15,2024-11-22,584.32,32,-63067,16269713,-1546756,1.58522157090294,75.7133023797039,-0.244530089837192
334.6,335,6445,6445,257800,257800,2024-10-15,2024-12-20,584.32,0,0,401465676,-76728253,0.0642147051196476,99.1040579020758,0
570.86,577,406,417,345912,256038,2024-10-15,2024-11-08,584.32,11,-89874,28140084,-4440601,0.90986935220236,85.7827503286771,-0.351018208234715
409.71,410,8018,8818,296666,255722,2024-10-15,2024-11-15,584.32,800,-40944,392489350,-83095331,0.0651538697801609,98.8517357222559,-0.160111370941882
571.35,578,232,384,206480,255360,2024-10-15,2024-11-08,584.32,152,48880,28140084,-4440601,0.90745997773141,86.6902103064085,0.191416040100251
564.79,567,1229,1152,427692,254592,2024-10-15,2024-11-01,584.32,-77,-173100,74573214,-17043443,0.341398722602998,94.0840527538481,-0.679911387631976
575.8,592,156,157,309192,254340,2024-10-15,2024-12-20,584.32,1,-54852,401465676,-76728253,0.0633528630726578,99.1674107651485,-0.215664071715027
384.97,385,84619,84632,338476,253896,2024-10-15,2024-10-25,584.32,13,-84580,22997980,-5421377,1.10399261152501,81.3800212018621,-0.333128525065381
498.87,500,2223,2245,313443,253685,2024-10-15,2024-11-22,584.32,22,-59758,16269713,-1546756,1.55924692709699,77.2725493068009,-0.235559847842797
565.4,573,304,332,284544,252320,2024-10-15,2024-11-29,584.32,28,-32224,111401771,-12544864,0.226495501584082,90.53745384353,-0.127710843373494
536.05,539,844,853,306372,251635,2024-10-15,2024-11-29,584.32,9,-54737,111401771,-12544864,0.225880610102689,90.7633344536327,-0.217525383988714
574.05,589,67,167,120198,249665,2024-10-15,2024-12-20,584.32,100,129467,401465676,-76728253,0.0621883799600342,99.2295991451085,0.518562874251497
540.58,544,718,727,299406,248634,2024-10-15,2024-11-29,584.32,9,-50772,111401771,-12544864,0.223186757057929,90.9865212106906,-0.20420376939598
554.15,557,876,864,346020,246240,2024-10-15,2024-11-08,584.32,-12,-99780,28140084,-4440601,0.875050692812431,87.5652609992209,-0.405214424951267
562.04,564,1254,1246,382470,244216,2024-10-15,2024-11-01,584.32,-8,-138254,74573214,-17043443,0.327484879490376,94.4115376333384,-0.566113604350247
519.96,520,61105,61007,672155,244028,2024-10-15,2024-10-18,584.32,-98,-428127,37570248,-36451733,0.649524591905808,82.1809374268703,-1.75441752585769
576.6,586,190,256,222490,240640,2024-10-15,2024-11-08,584.32,66,18150,28140084,-4440601,0.855150254704286,88.4204112539252,0.0754238696808511
560.34,566,421,425,297647,240550,2024-10-15,2024-11-22,584.32,4,-57097,16269713,-1546756,1.47851409548527,78.7510634022862,-0.237360216171274
571.07,581,135,242,164430,240306,2024-10-15,2024-11-29,584.32,107,75876,111401771,-12544864,0.215711112887065,91.2022323235777,0.315747422036903
581.81,598,144,148,299088,239612,2024-10-15,2024-11-15,584.32,4,-59476,392489350,-83095331,0.0610492998090267,98.9127850220649,-0.248217952356309
575.97,585,154,265,178640,239295,2024-10-15,2024-11-08,584.32,111,60655,28140084,-4440601,0.850370595908669,89.2707818498339,0.253473745794939
578.43,582,126,670,77616,239190,2024-10-15,2024-10-25,584.32,544,161574,22997980,-5421377,1.04004786507337,82.4200690669355,0.675504828797191
563.77,564,6999,10294,461934,236762,2024-10-15,2024-10-18,584.32,3295,-225172,37570248,-36451733,0.630184820712389,82.8111222475827,-0.951047887752258
269.86,270,16817,16814,285889,235396,2024-10-15,2024-12-20,584.32,-3,-50493.0000000001,401465676,-76728253,0.05863415332174,99.2882332984302,-0.214502370473585
493.94,495,2166,2208,283746,234048,2024-10-15,2024-11-22,584.32,42,-49698,16269713,-1546756,1.43855026821924,80.1896136705054,-0.212341058244463
344.64,345,6447,6440,290115,231840,2024-10-15,2024-12-20,584.32,-7,-58275,401465676,-76728253,0.0577483988942557,99.3459816973245,-0.251358695652174
537.34,540,827,871,291104,231686,2024-10-15,2024-11-22,584.32,44,-59418,16269713,-1546756,1.42403249522595,81.6136461657314,-0.256459173191302
572.24,574,1164,1310,395760,230560,2024-10-15,2024-10-25,584.32,146,-165200,22997980,-5421377,1.00252283026596,83.4225918972014,-0.716516308119362
537.73,541,693,694,275121,226938,2024-10-15,2024-11-29,584.32,1,-48183,111401771,-12544864,0.203711303656025,91.4059436272337,-0.21231790180578
479.93,481,2114,2114,289618,226198,2024-10-15,2024-11-29,584.32,0,-63420,111401771,-12544864,0.203047041325761,91.6089906685595,-0.280373831775701
566.86,568,2177,1969,483294,224466,2024-10-15,2024-10-25,584.32,-208,-258828,22997980,-5421377,0.976024850878208,84.3986167480796,-1.15308331774077
546.9,551,528,533,265584,218530,2024-10-15,2024-11-29,584.32,5,-47054,111401771,-12544864,0.19616384734135,91.8051545159008,-0.215320550954103
553.04,558,351,440,219726,218240,2024-10-15,2024-11-29,584.32,89,-1485.99999999997,111401771,-12544864,0.19590352832003,92.0010580442209,-0.00680901759530778
578.1,584,17,364,15810,214760,2024-10-15,2024-11-01,584.32,347,198950,74573214,-17043443,0.287985442065029,94.6995230754035,0.926382939094804
565.73,566,7255,7925,573145,213975,2024-10-15,2024-10-18,584.32,670,-359170,37570248,-36451733,0.569533105025019,83.3806553526077,-1.67856057950695
409.55,410,4513,4714,252728,212130,2024-10-15,2024-11-29,584.32,201,-40598,111401771,-12544864,0.190418875836364,92.1914769200572,-0.191382642719087
570.71,574,631,640,317393,210560,2024-10-15,2024-11-01,584.32,9,-106833,74573214,-17043443,0.282353393002479,94.981876468406,-0.507375569908815
394.59,395,5101,5102,239747,209182,2024-10-15,2024-11-29,584.32,1,-30565,111401771,-12544864,0.187772598336879,92.3792495183941,-0.146116778690327
534.73,535,7833,7705,336819,208035,2024-10-15,2024-10-25,584.32,-128,-128784,22997980,-5421377,0.904579445673055,85.3031961937527,-0.619049679140529
534.94,535,37034,33961,629578,203766,2024-10-15,2024-10-18,584.32,-3073,-425812,37570248,-36451733,0.542360007844505,83.9230153604522,-2.08971074664076
575.42,584,66,234,88242,200772,2024-10-15,2024-11-08,584.32,168,112530,28140084,-4440601,0.713473349972943,89.9842551998068,0.560486522024984
454.24,455,2633,2633,265933,200108,2024-10-15,2024-11-29,584.32,0,-65825,111401771,-12544864,0.179627305924966,92.5588768243191,-0.328947368421053
424.64,425,5133,5543,230985,199548,2024-10-15,2024-11-15,584.32,410,-31437,392489350,-83095331,0.0508416343016696,98.9636266563666,-0.15754104275663
548.65,553,434,448,230888,194880,2024-10-15,2024-11-29,584.32,14,-36008,111401771,-12544864,0.17493438232683,92.7338112066459,-0.184770114942529
568.39,574,376,346,284632,194106,2024-10-15,2024-11-08,584.32,-30,-90526,28140084,-4440601,0.689784721324926,90.6740399211317,-0.466374043048643
510.89,512,1700,1737,238000,192807,2024-10-15,2024-11-15,584.32,37,-45193,392489350,-83095331,0.0491241354701726,99.0127507918368,-0.234395016778436
514.79,516,1620,1592,264060,192632,2024-10-15,2024-11-15,584.32,-28,-71428,392489350,-83095331,0.0490795482730933,99.0618303401099,-0.370800282403754
551.5,556,412,425,242668,191250,2024-10-15,2024-11-29,584.32,13,-51418,111401771,-12544864,0.171675906301346,92.9054871129472,-0.268852287581699
574.4,582.5,70,236,74480,191160,2024-10-15,2024-11-08,584.32,166,116680,28140084,-4440601,0.679315669420177,91.3533555905519,0.610378740322243
573.44,581,232,247,222488,186732,2024-10-15,2024-11-08,584.32,15,-35756,28140084,-4440601,0.663580108716093,92.016935699268,-0.191482980956665
524.45,525,2851,3391,210974,186505,2024-10-15,2024-11-01,584.32,540,-24468.9999999999,74573214,-17043443,0.250096502478759,95.2319729708847,-0.131197555025334
570.87,603,58,58,186354,186354,2024-10-15,2024-12-20,584.32,0,0,401465676,-76728253,0.0464184141111979,99.3924001114357,0
555.32,560,468,398,287352,186264,2024-10-15,2024-11-22,584.32,-70,-101088,16269713,-1546756,1.14485117223641,82.7584973379678,-0.542713567839196
583.14,588,84,383,76524,186138,2024-10-15,2024-10-18,584.32,299,109614,37570248,-36451733,0.495439902339745,84.418455262792,0.588885665474003
501.93,503,1738,1738,210298,185966,2024-10-15,2024-11-15,584.32,0,-24332,392489350,-83095331,0.0473811582403446,99.1092114983502,-0.130841121495327
581.01,597,115,116,258175,185484,2024-10-15,2024-11-15,584.32,1,-72691,392489350,-83095331,0.0472583523603889,99.1564698507106,-0.391899031722413
573.65,584,137,179,173990,185265,2024-10-15,2024-11-22,584.32,42,11275,16269713,-1546756,1.13871092870538,83.8972082666732,0.060858769870186
582.9,595,135,152,213300,183920,2024-10-15,2024-11-01,584.32,17,-29380,74573214,-17043443,0.246630110377166,95.4786030812619,-0.159743366681166
583.41,589,102,328,102714,183352,2024-10-15,2024-10-18,584.32,226,80638,37570248,-36451733,0.488024460205852,84.9064797229979,0.439798856843667
565.03,566,936,1889,182520,183233,2024-10-15,2024-10-25,584.32,953,713,22997980,-5421377,0.796735191525517,86.0999313852782,0.00389122046792881
516.11,518,971,969,223330,183141,2024-10-15,2024-11-29,584.32,-2,-40189,111401771,-12544864,0.164396847874169,93.0698839608214,-0.219442942869155
517.71,519,1669,1383,283730,178407,2024-10-15,2024-11-15,584.32,-286,-105323,392489350,-83095331,0.0454552461104996,99.2019250968211,-0.590352396486685
499.97,500,57895,58775,405265,176325,2024-10-15,2024-10-18,584.32,880,-228940,37570248,-36451733,0.469320830674314,85.3758005536722,-1.2983978448887
541.94,545,528,574,211728,175644,2024-10-15,2024-11-22,584.32,46,-36084,16269713,-1546756,1.07957651127589,84.9767847779491,-0.205438272870123
534.36,535,2654,2733,252130,174912,2024-10-15,2024-11-01,584.32,79,-77218,74573214,-17043443,0.23455070610206,95.7131537873639,-0.441467709476765
578.38,596,98,98,190316,172676,2024-10-15,2024-11-29,584.32,0,-17640,111401771,-12544864,0.155002921811719,93.2248868826331,-0.102156640181612
547.86,552,415,415,215800,171810,2024-10-15,2024-11-29,584.32,0,-43990,111401771,-12544864,0.15422555535495,93.3791124379881,-0.256038647342995
514.2,516,954,951,217512,171180,2024-10-15,2024-11-29,584.32,-3,-46332,111401771,-12544864,0.153660034722428,93.5327724727105,-0.270662460567823
459.22,460,2197,2190,206518,170820,2024-10-15,2024-11-29,584.32,-7,-35698,111401771,-12544864,0.153336880075273,93.6861093527858,-0.208980213089802
474.06,475,1815,1809,201465,170046,2024-10-15,2024-11-29,584.32,-6,-31419,111401771,-12544864,0.152642097583888,93.8387514503697,-0.184767651106171
544.3,548,442,459,218348,169830,2024-10-15,2024-11-29,584.32,17,-48518,111401771,-12544864,0.152448204795595,93.9911996551653,-0.285685685685686
522.58,524,1297,1185,246430,168270,2024-10-15,2024-11-15,584.32,-112,-78160,392489350,-83095331,0.0428725008716797,99.2447975976928,-0.464491590895585
482.54,484,1148,1148,167608,167608,2024-10-15,2024-11-29,584.32,0,0,111401771,-12544864,0.150453622501208,94.1416532776665,0
580.74,586,130,317,108810,166742,2024-10-15,2024-10-25,584.32,187,57932,22997980,-5421377,0.725028893841981,86.8249602791202,0.347434959398352
573.93,578,309,404,194670,164428,2024-10-15,2024-11-01,584.32,95,-30242,74573214,-17043443,0.220492038870686,95.9336458262346,-0.183922446298684
404.73,405,5820,5933,203700,160191,2024-10-15,2024-11-15,584.32,113,-43509,392489350,-83095331,0.0408141010705131,99.2856116987633,-0.271607019120924
572.62,586,110,119,177540,159222,2024-10-15,2024-12-20,584.32,9,-18318,401465676,-76728253,0.0396601775739354,99.4320602890096,-0.115046915627237
477.03,478,1640,1637,218120,158789,2024-10-15,2024-11-29,584.32,-3,-59331,111401771,-12544864,0.142537231297696,94.2841905089642,-0.373646789135268
573.18,584,30,146,39000,157972,2024-10-15,2024-11-29,584.32,116,118972,111401771,-12544864,0.141803849779013,94.4259943587432,0.753120806218824
546.91,547,17296,17509,415104,157581,2024-10-15,2024-10-18,584.32,213,-257523,37570248,-36451733,0.419430289627047,85.7952308432992,-1.63422620747425
399.6,400,3936,3933,200736,157320,2024-10-15,2024-11-29,584.32,-3,-43416,111401771,-12544864,0.141218580806942,94.5672129395501,-0.275972540045767
507.44,509,1014,1007,192660,157092,2024-10-15,2024-11-29,584.32,-7,-35568,111401771,-12544864,0.141013916197077,94.7082268557472,-0.226415094339623
409.99,410,155623,155623,155623,155623,2024-10-15,2024-10-18,584.32,0,0,37570248,-36451733,0.414218719024692,86.2094495623239,0
518.59,521,645,645,155445,155445,2024-10-15,2024-11-29,584.32,0,0,111401771,-12544864,0.139535483686341,94.8477623394336,0
374.81,375,8135,8135,178970,154565,2024-10-15,2024-11-15,584.32,0,-24405,392489350,-83095331,0.0393806863804075,99.3249923851437,-0.157894736842105
359.98,360,76607,76607,153214,153214,2024-10-15,2024-10-18,584.32,0,0,37570248,-36451733,0.407806730474603,86.6172562927985,0
570.12,599,53,53,153064,153064,2024-10-15,2024-11-29,584.32,0,0,111401771,-12544864,0.137398174756127,94.9851605141897,0
528.78,530,1192,1253,193104,152866,2024-10-15,2024-11-08,584.32,61,-40238,28140084,-4440601,0.543232209257087,92.5601679085251,-0.263224000104667
516.68,519,658,658,152656,152656,2024-10-15,2024-11-29,584.32,0,0,111401771,-12544864,0.137031932822684,95.1221924470124,0
472.09,473,1460,1668,166440,151788,2024-10-15,2024-11-29,584.32,208,-14652,111401771,-12544864,0.13625277106232,95.2584452180747,-0.0965293699106649
561.16,563,840,820,245280,150880,2024-10-15,2024-11-01,584.32,-20,-94400,74573214,-17043443,0.202324657751777,96.1359704839864,-0.625662778366914
577.9,588,87,148,114318,149480,2024-10-15,2024-11-08,584.32,61,35162,28140084,-4440601,0.531199551500983,93.0913674600261,0.235228793149585
516.75,518,1464,1194,237168,149250,2024-10-15,2024-11-15,584.32,-270,-87918,392489350,-83095331,0.0380265095091115,99.3630188946528,-0.589065326633166
531.35,534,557,561,181025,148665,2024-10-15,2024-11-29,584.32,4,-32360,111401771,-12544864,0.133449404498246,95.3918946225729,-0.21767060168836
578.14,601,65,65,148590,148590,2024-10-15,2024-11-15,584.32,0,0,392489350,-83095331,0.0378583520801265,99.4008772467329,0
576.13,581,186,304,138198,148048,2024-10-15,2024-11-01,584.32,118,9850,74573214,-17043443,0.198527047526743,96.3344975315131,0.0665324759537447
284.82,285,8182,8182,163640,147276,2024-10-15,2024-12-20,584.32,0,-16364,401465676,-76728253,0.0366845807261491,99.4687448697358,-0.111111111111111
481.81,483,1230,1230,161130,146370,2024-10-15,2024-11-29,584.32,0,-14760,111401771,-12544864,0.13138929362263,95.5232839161956,-0.100840336134454
509.37,511,889,882,176022,143766,2024-10-15,2024-11-29,584.32,-7,-32256,111401771,-12544864,0.129051808341539,95.6523357245371,-0.224364592462752
504.96,505,35846,35810,286768,143240,2024-10-15,2024-10-18,584.32,-36,-143528,37570248,-36451733,0.381259128233596,86.9985154210321,-1.00201061156102
349.87,350,11008,11007,176128,143091,2024-10-15,2024-11-15,584.32,-1,-33037,392489350,-83095331,0.0364572949559014,99.4373345416889,-0.230881047724874
539.72,543,434,436,175336,143008,2024-10-15,2024-11-29,584.32,2,-32328,111401771,-12544864,0.128371388278917,95.780707112816,-0.226057283508615
304.77,305,6214,6214,167778,142922,2024-10-15,2024-12-20,584.32,0,-24856,401465676,-76728253,0.035600054635804,99.5043449243716,-0.173913043478261
501.07,502,1539,1535,184680,142755,2024-10-15,2024-11-15,584.32,-4,-41925,392489350,-83095331,0.036371687537509,99.4737062292264,-0.293684984764106
538.8,542,444,445,177600,142400,2024-10-15,2024-11-29,584.32,1,-35200,111401771,-12544864,0.127825615985943,95.908532728802,-0.247191011235955
568.93,577,162,176,167508,142032,2024-10-15,2024-11-22,584.32,14,-25476,16269713,-1546756,0.872984053252814,85.8497688312019,-0.179368029739777
501.6,503,980,981,178360,137340,2024-10-15,2024-11-29,584.32,1,-41020,111401771,-12544864,0.123283497889814,96.0318162266918,-0.298674821610601
249.9,250,13670,13667,205050,136670,2024-10-15,2024-12-20,584.32,-3,-68380,401465676,-76728253,0.0340427608560987,99.5383876852277,-0.500329260261945
568.11,576,142,173,140012,136497,2024-10-15,2024-11-22,584.32,31,-3515,16269713,-1546756,0.838963785040339,86.6887326162422,-0.0257514817175469
569.67,578,133,163,141778,135779,2024-10-15,2024-11-22,584.32,30,-5999,16269713,-1546756,0.834550677077094,87.5232832933193,-0.0441820900139197
565.02,572,187,194,164373,135412,2024-10-15,2024-11-22,584.32,7,-28961,16269713,-1546756,0.832294951976104,88.3555782452954,-0.213873216553924
488.86,490,986,1184,140012,134976,2024-10-15,2024-11-29,584.32,198,-5036,111401771,-12544864,0.121161449040159,96.1529776757319,-0.0373103366524419
514.15,515,1380,1581,160080,134385,2024-10-15,2024-11-08,584.32,201,-25695,28140084,-4440601,0.477557209850546,93.5689246698766,-0.191204375488336
572.07,582,35,135,43960,134055,2024-10-15,2024-11-29,584.32,100,90095,111401771,-12544864,0.12033471173452,96.2733123874665,0.6720748946328
500.6,502,952,950,166600,133000,2024-10-15,2024-11-29,584.32,-2,-33600,111401771,-12544864,0.119387689087995,96.3927000765544,-0.252631578947368
449.98,450,66129,66194,132258,132388,2024-10-15,2024-10-18,584.32,65,130,37570248,-36451733,0.352374570431369,87.3508899914635,0.00098196211136961
509.58,510,3152,3147,179664,132174,2024-10-15,2024-11-01,584.32,-5,-47490,74573214,-17043443,0.177240583998431,96.5117381155116,-0.359299105724273
539.69,540,4524,4262,230724,132122,2024-10-15,2024-10-25,584.32,-262,-98602,22997980,-5421377,0.574493933815057,87.3994542129352,-0.746295090900834
518.31,520,761,780,162854,131820,2024-10-15,2024-11-22,584.32,19,-31034,16269713,-1546756,0.810217119380041,89.1657953646755,-0.235427097557275
572.85,588,87,87,152946,131805,2024-10-15,2024-12-20,584.32,0,-21141,401465676,-76728253,0.0328309511570797,99.5712186363848,-0.16039603960396
505.98,507,1296,1291,169776,131682,2024-10-15,2024-11-15,584.32,-5,-38094,392489350,-83095331,0.0335504644903104,99.5072566937167,-0.289287829771723
494.37,495,2080,2063,168480,129969,2024-10-15,2024-11-08,584.32,-17,-38511,28140084,-4440601,0.461864292942409,94.030788962819,-0.296309119867045
528.95,529,25895,25892,336635,129460,2024-10-15,2024-10-18,584.32,-3,-207175,37570248,-36451733,0.344581169653179,87.6954711611167,-1.60030125135177
509.93,511,1216,1209,165376,129363,2024-10-15,2024-11-15,584.32,-7,-36013,392489350,-83095331,0.032959620433013,99.5402163141497,-0.27838717407605
556.87,557,10324,9915,371664,128895,2024-10-15,2024-10-18,584.32,-409,-242769,37570248,-36451733,0.34307732011777,88.0385484812344,-1.88346328406843
563.16,564,1195,1528,205540,128352,2024-10-15,2024-10-25,584.32,333,-77188,22997980,-5421377,0.558101189756666,87.9575554026919,-0.601377461979556
399.99,400,127299,127717,127299,127717,2024-10-15,2024-10-18,584.32,418,418,37570248,-36451733,0.339941860378457,88.3784903416129,0.00327286109131909
465.15,466,1500,1500,156000,127500,2024-10-15,2024-11-29,584.32,0,-28500,111401771,-12544864,0.114450604200897,96.5071506807553,-0.223529411764706
264.84,265,7868,7868,125888,125888,2024-10-15,2024-12-20,584.32,0,0,401465676,-76728253,0.0313571016218084,99.6025757380066,0
563.96,566,452,615,152776,125460,2024-10-15,2024-11-01,584.32,163,-27316,74573214,-17043443,0.168237351282727,96.6799754667943,-0.217726765502949
558.84,559,7205,7815,309815,125040,2024-10-15,2024-10-18,584.32,610,-184775,37570248,-36451733,0.332816541429271,88.7113068830421,-1.47772712731926
555.6,557,913,885,202686,123900,2024-10-15,2024-11-01,584.32,-28,-78786,74573214,-17043443,0.166145447345209,96.8461209141395,-0.63588377723971
566.65,574,165,168,150150,123480,2024-10-15,2024-11-22,584.32,3,-26670,16269713,-1546756,0.758956227439292,89.9247515921148,-0.215986394557823
419.48,420,2370,2370,151680,123240,2024-10-15,2024-11-29,584.32,0,-28440,111401771,-12544864,0.110626607542891,96.6177772882982,-0.230769230769231
469.12,470,1422,1397,154998,122936,2024-10-15,2024-11-29,584.32,-25,-32062,111401771,-12544864,0.110353721396404,96.7281310096946,-0.260802368712176
574.25,585,38,114,49286,122550,2024-10-15,2024-11-22,584.32,76,73264,16269713,-1546756,0.753240084812805,90.6779916769275,0.597829457364341
531.94,532,20048,20043,280672,120258,2024-10-15,2024-10-18,584.32,-5,-160414,37570248,-36451733,0.320088384830465,89.0313952678726,-1.33391541519067
514.54,515,2719,2602,165859,119692,2024-10-15,2024-11-01,584.32,-117,-46167,74573214,-17043443,0.160502670570159,97.0066235847097,-0.385715001838051
556.99,562,238,238,150416,119238,2024-10-15,2024-11-22,584.32,0,-31178,16269713,-1546756,0.732883241394609,91.4108749183222,-0.261477045908184
359.81,360,6261,6261,118959,118959,2024-10-15,2024-11-15,584.32,0,0,392489350,-83095331,0.0303088478706492,99.5705251620203,0
524.77,525,5437,5160,195732,118680,2024-10-15,2024-10-25,584.32,-277,-77052,22997980,-5421377,0.516045322241345,88.4736007249332,-0.649241658240647
439.36,440,1835,1854,139460,118656,2024-10-15,2024-11-29,584.32,19,-20804,111401771,-12544864,0.106511771702444,96.8346427813971,-0.175330366774542
523.15,525,616,632,147224,116920,2024-10-15,2024-11-22,584.32,16,-30304,16269713,-1546756,0.718635909557839,92.12951082788,-0.259185768046528
475,476,1166,1168,139920,116800,2024-10-15,2024-11-29,584.32,2,-23120,111401771,-12544864,0.104845729965998,96.9394885113631,-0.197945205479452
565.96,567,1206,1123,252054,116792,2024-10-15,2024-10-25,584.32,-83,-135262,22997980,-5421377,0.50783590558823,88.9814366305215,-1.15814439345161
530.94,531,19468,19463,272552,116778,2024-10-15,2024-10-18,584.32,-5,-155774,37570248,-36451733,0.310825736364583,89.3422210042372,-1.33393276130778
550.95,555,241,287,126284,116235,2024-10-15,2024-11-22,584.32,46,-10049,16269713,-1546756,0.714425632461986,92.843936460342,-0.0864541661289631
495.73,497,909,910,147258,115570,2024-10-15,2024-11-29,584.32,1,-31688,111401771,-12544864,0.103741618254884,97.043230129618,-0.274188803322662
504.28,505,1579,1582,146847,113904,2024-10-15,2024-11-08,584.32,3,-32943,28140084,-4440601,0.404774911119668,94.4355638739387,-0.289217235566793
474.73,475,4105,4204,160095,113508,2024-10-15,2024-11-01,584.32,99,-46587,74573214,-17043443,0.152210148807587,97.1588337335172,-0.41042922084787
514.96,515,27479,28014,274790,112056,2024-10-15,2024-10-18,584.32,535,-162734,37570248,-36451733,0.298257280601395,89.6404782848386,-1.45225601484972
555.86,556,7795,7999,272825,111986,2024-10-15,2024-10-18,584.32,204,-160839,37570248,-36451733,0.29807096295984,89.9385492477984,-1.43624203025378
502.56,504,774,774,143190,111456,2024-10-15,2024-11-29,584.32,0,-31734,111401771,-12544864,0.100048678759335,97.1432788083773,-0.284722222222222
379.69,380,3555,3569,142200,110639,2024-10-15,2024-11-29,584.32,14,-31561,111401771,-12544864,0.0993152972406516,97.2425941056179,-0.285261074304721
561.74,562.5,1322,1449,203588,110124,2024-10-15,2024-10-25,584.32,127,-93464,22997980,-5421377,0.478842054823945,89.4602786853454,-0.848715992880753
557.53,559,657,748,147825,109956,2024-10-15,2024-11-01,584.32,91,-37869,74573214,-17043443,0.147447044457545,97.3062807779748,-0.344401396922405
562.22,563,1304,1408,202120,109824,2024-10-15,2024-10-25,584.32,104,-92296,22997980,-5421377,0.477537592432031,89.9378162777775,-0.840399184149184
309.77,310,4737,4739,156321,108997,2024-10-15,2024-12-20,584.32,2,-47324,401465676,-76728253,0.0271497680912577,99.6297255060978,-0.434177087442774
489.98,490,54354,54434,271770,108868,2024-10-15,2024-10-18,584.32,80,-162902,37570248,-36451733,0.289771842868857,90.2283210906673,-1.49632582577066
354.87,355,8301,8301,166020,107913,2024-10-15,2024-11-15,584.32,0,-58107,392489350,-83095331,0.027494503991,99.5980196660113,-0.538461538461538
503.04,504,1118,1124,136396,107904,2024-10-15,2024-11-15,584.32,6,-28492,392489350,-83095331,0.0274922109351502,99.6255118769465,-0.264049525504152
543.92,544,13293,13188,265860,105504,2024-10-15,2024-10-18,584.32,-105,-160356,37570248,-36451733,0.280817949351838,90.5091390400191,-1.51990445859873
572.77,587,10,74,16550,105302,2024-10-15,2024-12-20,584.32,64,88752,401465676,-76728253,0.0262293905295157,99.6559548966273,0.842832994624983
535.93,536,15025,15021,240400,105147,2024-10-15,2024-10-18,584.32,-4,-135253,37570248,-36451733,0.279867729379907,90.789006769399,-1.28632295738347
520.95,523,512,512,132608,104960,2024-10-15,2024-11-29,584.32,0,-27648,111401771,-12544864,0.094217532681774,97.3368116382997,-0.263414634146342
506.97,508,1020,1019,131580,104957,2024-10-15,2024-11-15,584.32,-1,-26623,392489350,-83095331,0.0267413625363338,99.6522532394828,-0.25365625922997
494.48,496,683,683,103816,103816,2024-10-15,2024-11-29,584.32,0,0,111401771,-12544864,0.0931906190252577,97.430002257325,0
289.82,290,5736,5740,131928,103320,2024-10-15,2024-12-20,584.32,4,-28608,401465676,-76728253,0.0257356995072226,99.6816905961346,-0.276887340301974
369.72,370,3673,3674,128555,102872,2024-10-15,2024-11-29,584.32,1,-25683,111401771,-12544864,0.0923432357282722,97.5223454930533,-0.249659771366358
529.75,530,4145,4094,169945,102350,2024-10-15,2024-10-25,584.32,-51,-67595,22997980,-5421377,0.44503908604147,90.3828553638189,-0.660429897410845
314.74,315,3914,3917,121334,101842,2024-10-15,2024-12-20,584.32,3,-19492,401465676,-76728253,0.0253675484825258,99.7070581446171,-0.191394513069264
527.91,530,471,486,127170,101574,2024-10-15,2024-11-22,584.32,15,-25596,16269713,-1546756,0.624313409830893,93.4682498701729,-0.251993620414673
578.76,582.5,12,269,7440,100606,2024-10-15,2024-10-25,584.32,257,93166,22997980,-5421377,0.437455811336474,90.8203111751554,0.926048148221776
526.95,527,19885,20110,278390,100550,2024-10-15,2024-10-18,584.32,225,-177840,37570248,-36451733,0.267631983690925,91.0566387530899,-1.76867230233715
584.2,593,20,114,27620,100320,2024-10-15,2024-10-18,584.32,94,72700,37570248,-36451733,0.267019797154387,91.3236585502443,0.724681020733652
542.44,546,269,279,121319,99324,2024-10-15,2024-11-29,584.32,10,-21995,111401771,-12544864,0.0891583671501955,97.6115038602035,-0.221446981595586
489.41,490,1661,1662,127897,98058,2024-10-15,2024-11-08,584.32,1,-29839,28140084,-4440601,0.348463778572942,94.7840276525116,-0.304299496216525
294.8,295,4887,4896,117288,97920,2024-10-15,2024-12-20,584.32,9,-19368,401465676,-76728253,0.0243906281044061,99.7314487727215,-0.197794117647059
424.46,425,1796,1800,125720,97200,2024-10-15,2024-11-29,584.32,4,-28520,111401771,-12544864,0.0872517547319782,97.6987556149354,-0.293415637860082
551.82,553,816,818,149328,96524,2024-10-15,2024-11-01,584.32,2,-52804,74573214,-17043443,0.129435215169887,97.4357159931447,-0.547055654552236
515.96,516,23577,24028,235770,96112,2024-10-15,2024-10-18,584.32,451,-139658,37570248,-36451733,0.255819445216332,91.5794779954607,-1.45307557849176
344.89,345,8725,8713,130875,95843,2024-10-15,2024-11-15,584.32,-12,-35032,392489350,-83095331,0.0244192613124407,99.6766725007953,-0.36551443506568
484.82,486,811,810,141114,95580,2024-10-15,2024-11-29,584.32,-1,-45534,111401771,-12544864,0.0857975588197786,97.7845531737552,-0.47639673571877
566.69,572.5,163,164,113448,95284,2024-10-15,2024-11-08,584.32,1,-18164,28140084,-4440601,0.338605954410086,95.1226336069217,-0.190630116283951
470.11,471,1069,1070,116521,95230,2024-10-15,2024-11-29,584.32,1,-21291,111401771,-12544864,0.0854833806905996,97.8700365544458,-0.223574503832826
486.88,488,848,849,122960,95088,2024-10-15,2024-11-29,584.32,1,-27872,111401771,-12544864,0.0853559141353327,97.9553924685811,-0.293117953895339
582.25,610,30,34,93120,94350,2024-10-15,2024-12-20,584.32,4,1230,401465676,-76728253,0.0235013864547663,99.7549501591762,0.0130365659777425
505.01,506,992,952,127968,94248,2024-10-15,2024-11-15,584.32,-40,-33720,392489350,-83095331,0.0240128808590603,99.7006853816543,-0.357779475426534
507.94,509,874,889,116242,94234,2024-10-15,2024-11-15,584.32,15,-22008,392489350,-83095331,0.0240093138832939,99.7246946955376,-0.233546278413312
470.88,472,841,841,94192,94192,2024-10-15,2024-11-29,584.32,0,0,111401771,-12544864,0.0845516181246347,98.0399440867058,0
547.91,548,10401,10427,249624,93843,2024-10-15,2024-10-18,584.32,26,-155781,37570248,-36451733,0.249780091949353,91.82925808741,-1.66001726287523
571.74,581,18,101,20880,93526,2024-10-15,2024-11-22,584.32,83,72646,16269713,-1546756,0.574847263747062,94.0430971339199,0.776746573145435
545.11,546,1042,1047,144838,93183,2024-10-15,2024-11-01,584.32,5,-51655,74573214,-17043443,0.124955054237035,97.5606710473817,-0.554339310818497
414.69,415,3001,3004,114038,93124,2024-10-15,2024-11-15,584.32,3,-20914,392489350,-83095331,0.0237265036618191,99.7484211991994,-0.224582277393583
537.93,538,12962,13249,220354,92743,2024-10-15,2024-10-18,584.32,287,-127611,37570248,-36451733,0.246852243296345,92.0761103307064,-1.37596368459075
513.96,514,23120,23153,231200,92612,2024-10-15,2024-10-18,584.32,33,-138588,37570248,-36451733,0.246503563138577,92.322613893845,-1.49643674685786
119.98,120,46064,46065,92128,92130,2024-10-15,2024-12-20,584.32,1,2,401465676,-76728253,0.0229484126558306,99.7778985718321,2.17084554433952e-05
554.55,557.5,54,312,22248,92040,2024-10-15,2024-11-08,584.32,258,69792,28140084,-4440601,0.327077914906011,95.4497115218277,0.758279009126467
582.63,605,6,41,15636,91717,2024-10-15,2024-11-29,584.32,35,76081,111401771,-12544864,0.0823299299254408,98.1222740166312,0.829519064077543
474.51,475,1801,1871,113463,91679,2024-10-15,2024-11-08,584.32,70,-21784,28140084,-4440601,0.325795047377968,95.7755065692057,-0.237611666793922
543.13,544,1082,1052,140660,91524,2024-10-15,2024-11-01,584.32,-30,-49136,74573214,-17043443,0.122730394857328,97.683401442239,-0.536864647524147
578.86,590,53,82,74041,91348,2024-10-15,2024-11-08,584.32,29,17307,28140084,-4440601,0.32461878933979,96.1001253585455,0.18946227613084
540.92,541,12764,11334,242516,90672,2024-10-15,2024-10-18,584.32,-1430,-151844,37570248,-36451733,0.241339902786907,92.5639537966319,-1.67465149108876
459.99,460,89873,89870,269619,89870,2024-10-15,2024-10-18,584.32,-3,-179749,37570248,-36451733,0.239205234950805,92.8031590315827,-2.00010014465339
511.3,513,543,524,117831,89080,2024-10-15,2024-11-29,584.32,-19,-28751,111401771,-12544864,0.0799628221350269,98.2022368387663,-0.322754827121688
573.95,598,37,37,88985,88985,2024-10-15,2024-11-29,584.32,0,0,111401771,-12544864,0.0798775452142498,98.2821143839805,0
584.15,595,12,82,18528,88970,2024-10-15,2024-10-18,584.32,70,70442,37570248,-36451733,0.236809722416525,93.0399687539992,0.791750028099359
545.91,546,11276,9798,248072,88182,2024-10-15,2024-10-18,584.32,-1478,-159890,37570248,-36451733,0.234712318108733,93.2746810721079,-1.81318182849108
527.95,528,17358,17447,243012,87235,2024-10-15,2024-10-18,584.32,89,-155777,37570248,-36451733,0.232191706586552,93.5068727786945,-1.78571674213332
364.81,365,4583,4583,87077,87077,2024-10-15,2024-11-15,584.32,0,0,392489350,-83095331,0.0221858249147397,99.7706070241142,0
334.89,335,7800,7802,101400,85822,2024-10-15,2024-11-15,584.32,2,-15578,392489350,-83095331,0.0218660710156849,99.7924730951298,-0.181515229195311
553.24,556,294,310,111132,85560,2024-10-15,2024-11-08,584.32,16,-25572,28140084,-4440601,0.304050265095157,96.4041756236406,-0.298877980364657
524.74,527,425,376,119000,84976,2024-10-15,2024-11-29,584.32,-49,-34024,111401771,-12544864,0.0762788591574545,98.358393243138,-0.400395405761627
573.03,583,3,85,3783,84745,2024-10-15,2024-11-22,584.32,82,80962,16269713,-1546756,0.520875813851172,94.5639729477711,0.955360198241784
556.46,557,1571,1561,174381,84294,2024-10-15,2024-10-25,584.32,-10,-90087,22997980,-5421377,0.366527842880114,91.1868390180355,-1.06872375258026
533.95,534,16807,16786,252105,83930,2024-10-15,2024-10-18,584.32,-21,-168175,37570248,-36451733,0.223394852224558,93.730267630919,-2.00375312760634
469.98,470,41959,41957,167836,83914,2024-10-15,2024-10-18,584.32,-2,-83922,37570248,-36451733,0.22335226533506,93.9536198962541,-1.00009533570084
374.69,375,2698,2700,99826,83700,2024-10-15,2024-11-29,584.32,2,-16126,111401771,-12544864,0.0751334554636479,98.4335266986016,-0.192664277180406
464.45,465,1520,1520,83600,83600,2024-10-15,2024-11-08,584.32,0,0,28140084,-4440601,0.297085111757307,96.701260735398,0
584.64,600,37,54,73667,82944,2024-10-15,2024-10-18,584.32,17,9277,37570248,-36451733,0.220770435159225,94.1743903314133,0.111846547067901
556.07,557.5,641,580,144225,82940,2024-10-15,2024-11-01,584.32,-61,-61285,74573214,-17043443,0.111219559344727,97.7946210015838,-0.738907644080058
464.16,465,996,986,99600,82824,2024-10-15,2024-11-29,584.32,-10,-16776,111401771,-12544864,0.0743471124889029,98.5078738110905,-0.202549985511446
542.92,543,10483,10352,220143,82816,2024-10-15,2024-10-18,584.32,-131,-137327,37570248,-36451733,0.220429740043239,94.3948200714565,-1.6582182187017
389.6,390,2070,2070,89010,82800,2024-10-15,2024-11-29,584.32,0,-6210,111401771,-12544864,0.0743255688457592,98.5821993799363,-0.075
449.79,450,4058,3938,113624,82698,2024-10-15,2024-11-01,584.32,-120,-30926,74573214,-17043443,0.110895046041599,97.9055160476254,-0.373963094633486
461.19,462,1025,1019,110700,82539,2024-10-15,2024-11-29,584.32,-6,-28161,111401771,-12544864,0.0740912817265715,98.6562906616628,-0.341184167484462
561.25,562,1067,1096,158983,82200,2024-10-15,2024-10-25,584.32,29,-76783,22997980,-5421377,0.357422695384551,91.5442617134201,-0.934099756690997
523.8,526,375,373,120750,82060,2024-10-15,2024-11-29,584.32,-2,-38690,111401771,-12544864,0.0736613065154952,98.7299519681783,-0.471484279795272
254.85,255,5438,5438,81570,81570,2024-10-15,2024-12-20,584.32,0,0,401465676,-76728253,0.0203180508014339,99.7982166226335,0
552.89,553,7278,7343,211062,80773,2024-10-15,2024-10-18,584.32,65,-130289,37570248,-36451733,0.214991926590423,94.609811998047,-1.61302663018583
279.84,280,5057,5047,96083,80752,2024-10-15,2024-12-20,584.32,-10,-15331,401465676,-76728253,0.0201142973926369,99.8183309200262,-0.189852882900733
525.7,528,290,351,98600,80730,2024-10-15,2024-11-29,584.32,61,-17870,111401771,-12544864,0.0724674296246152,98.8024193978029,-0.221355134398613
509.19,510,970,994,101850,80514,2024-10-15,2024-11-08,584.32,24,-21336,28140084,-4440601,0.286118548899854,96.9873792842978,-0.264997391757955
259.87,260,6153,6155,104601,80015,2024-10-15,2024-12-20,584.32,2,-24586,401465676,-76728253,0.0199307200548821,99.838261640081,-0.307267387364869
550.9,551,8294,7979,232232,79790,2024-10-15,2024-10-18,584.32,-315,-152442,37570248,-36451733,0.212375494566871,94.8221874926138,-1.91054016794084
484.97,485,26959,26433,134795,79299,2024-10-15,2024-10-18,584.32,-526,-55496,37570248,-36451733,0.211068609395392,95.0332561020092,-0.699832280356625
579.68,591,60,69,88200,78108,2024-10-15,2024-11-08,584.32,9,-10092,28140084,-4440601,0.277568467812676,97.2649477521105,-0.12920571516362
582.15,589,11,114,11077,78090,2024-10-15,2024-10-25,584.32,103,67013,22997980,-5421377,0.339551560615324,91.8838132740354,0.858150851581508
523.95,525,724,732,107152,76860,2024-10-15,2024-11-08,584.32,8,-30292,28140084,-4440601,0.273133513034289,97.5380812651448,-0.394119177725735
521.89,524,363,359,98373,75749,2024-10-15,2024-11-29,584.32,-4,-22624,111401771,-12544864,0.0679962260205002,98.8704156238234,-0.298670609512997
579.2,586,13,111,12519,75480,2024-10-15,2024-11-01,584.32,98,62961,74573214,-17043443,0.101215967438389,98.0067320150638,0.834141494435612
339.82,340,4164,4167,99936,75006,2024-10-15,2024-11-29,584.32,3,-24930,111401771,-12544864,0.0673292707348432,98.9377448945583,-0.33237341012719
394.76,395,2932,3079,87960,73896,2024-10-15,2024-11-15,584.32,147,-14064,392489350,-83095331,0.0188275172307223,99.8113006123606,-0.190321532965249
574.82,586,58,66,79460,73788,2024-10-15,2024-11-22,584.32,8,-5671.99999999999,16269713,-1546756,0.453529819487289,95.0175027672584,-0.0768688675665418
472.68,474,554,554,73128,73128,2024-10-15,2024-11-29,584.32,0,0,111401771,-12544864,0.0656434806588488,99.0033883752171,0
549.91,551,665,669,114380,72921,2024-10-15,2024-11-01,584.32,4,-41459,74573214,-17043443,0.0977844404024212,98.1045164554662,-0.568546783505437
555.47,556,1510,1368,160060,72504,2024-10-15,2024-10-25,584.32,-142,-87556,22997980,-5421377,0.315262470877877,92.1990757449132,-1.20760233918129
560.71,562.5,398,400,110246,71600,2024-10-15,2024-11-01,584.32,2,-38646,74573214,-17043443,0.0960130268758431,98.200529482342,-0.539748603351955
584.01,592,35,89,44450,71111,2024-10-15,2024-10-18,584.32,54,26661,37570248,-36451733,0.189274768694633,95.2225308707039,0.374920898313904
532.64,535,290,301,89320,71036,2024-10-15,2024-11-22,584.32,11,-18284,16269713,-1546756,0.436614954424826,95.4541177216832,-0.257390618841151
494.85,495,4733,4714,113592,70710,2024-10-15,2024-10-25,584.32,-19,-42882,22997980,-5421377,0.307461785774229,92.5065375306875,-0.606448875689436
476,477,707,707,84840,70700,2024-10-15,2024-11-29,584.32,0,-14140,111401771,-12544864,0.0634639820941446,99.0668523573113,-0.2
557.67,561,203,211,91553,70263,2024-10-15,2024-11-08,584.32,8,-21290,28140084,-4440601,0.249690086212962,97.7877713513577,-0.303004426227175
369.82,370,3898,3897,81858,70146,2024-10-15,2024-11-15,584.32,-1,-11712,392489350,-83095331,0.0178720772933074,99.8291726896539,-0.166966042254726
548.9,549,6804,6938,170100,69380,2024-10-15,2024-10-18,584.32,134,-100720,37570248,-36451733,0.184667399587035,95.4071982702909,-1.4517151916979
294.95,295,13833,13741,96831,68705,2024-10-15,2024-11-15,584.32,-92,-28126,392489350,-83095331,0.0175049335733568,99.8466776232272,-0.409373408048905
552.54,553,1431,1489,125928,68494,2024-10-15,2024-10-25,584.32,58,-57434,22997980,-5421377,0.297826156905954,92.8043636875934,-0.838526002277572
551.89,552,6247,6141,181163,67551,2024-10-15,2024-10-18,584.32,-106,-113612,37570248,-36451733,0.17979918578126,95.5869974560722,-1.68186999452266
583.89,591,63,95,74907,67545,2024-10-15,2024-10-18,584.32,32,-7362,37570248,-36451733,0.179783215697698,95.7667806717699,-0.108994003997335
540.22,541,869,863,103411,67314,2024-10-15,2024-11-01,584.32,-6,-36097,74573214,-17043443,0.0902656549039176,98.2907951372459,-0.536248031613037
546.04,547,674,696,100426,66816,2024-10-15,2024-11-01,584.32,22,-33610,74573214,-17043443,0.0895978548007868,98.3803929920467,-0.503023227969349
484.69,485,2131,2151,91633,66681,2024-10-15,2024-11-01,584.32,20,-24952,74573214,-17043443,0.0894168246523477,98.4698098166991,-0.374199547097374
499.63,501,511,483,85848,66171,2024-10-15,2024-11-29,584.32,-28,-19677,111401771,-12544864,0.0593985171025692,99.1262508744138,-0.297365915582355
489.87,490,5076,5078,106596,66014,2024-10-15,2024-10-25,584.32,2,-40582,22997980,-5421377,0.287042601132795,93.0914062887262,-0.61474838670585
479.97,480,22177,22001,88708,66003,2024-10-15,2024-10-18,584.32,-176,-22705,37570248,-36451733,0.175678904222298,95.9424595759922,-0.343999515173553
577.1,582.5,49,121,40866,65340,2024-10-15,2024-11-01,584.32,72,24474,74573214,-17043443,0.0876185918445194,98.5574284085436,0.374563820018366
570.8,577.5,97,97,82353,64990,2024-10-15,2024-11-08,584.32,0,-17363,28140084,-4440601,0.230951691544347,98.0187230429021,-0.267164179104478
519.79,520,3093,3092,105162,64932,2024-10-15,2024-10-25,584.32,-1,-40230,22997980,-5421377,0.282337840105957,93.3737441288322,-0.619571243762706
558.37,559,1022,1019,128772,64197,2024-10-15,2024-10-25,584.32,-3,-64575,22997980,-5421377,0.279141907245767,93.652886036078,-1.00588812561335
584.35,609,0,26,0,64090,2024-10-15,2024-10-25,584.32,26,64090,22997980,-5421377,0.278676648992651,93.9315626850706,1
514.8,515,3205,3200,99355,64000,2024-10-15,2024-10-25,584.32,-5,-35355,22997980,-5421377,0.278285310275076,94.2098479953457,-0.552421875
537.71,538,2227,2204,106896,63916,2024-10-15,2024-10-25,584.32,-23,-42980,22997980,-5421377,0.27792006080534,94.487768056151,-0.672445084172977
494.97,495,21437,21162,128622,63486,2024-10-15,2024-10-18,584.32,-275,-65136,37570248,-36451733,0.168979454168096,96.1114390301603,-1.02598998204329
537.3,538,904,904,89496,63280,2024-10-15,2024-11-01,584.32,0,-26216,74573214,-17043443,0.0848562058757451,98.6422846144193,-0.414285714285714
541.67,542,3205,1898,163455,62634,2024-10-15,2024-10-25,584.32,-1307,-100821,22997980,-5421377,0.272345658183893,94.7601137143349,-1.60968483571223
399.8,400,103,3128,2678,62560,2024-10-15,2024-11-08,584.32,3025,59882,28140084,-4440601,0.222316322865276,98.2410393657674,0.957193094629156
545.64,546,1745,1728,99465,62208,2024-10-15,2024-10-25,584.32,-17,-37257,22997980,-5421377,0.270493321587374,95.0306070359223,-0.598910108024691
491.81,493,514,519,77100,61761,2024-10-15,2024-11-29,584.32,5,-15339,111401771,-12544864,0.0554398726749147,99.1816907470888,-0.24836061592267
548.01,549,621,616,96876,60984,2024-10-15,2024-11-01,584.32,-5,-35892,74573214,-17043443,0.0817773523882181,98.7240619668076,-0.588547815820543
309.92,310,7515,7515,60120,60120,2024-10-15,2024-11-15,584.32,0,0,392489350,-83095331,0.0153176130766351,99.8619952363039,0
575,595,30,30,60000,60000,2024-10-15,2024-11-08,584.32,0,0,28140084,-4440601,0.213218979730124,98.4542583454975,0
329.9,330,5988,5988,71856,59880,2024-10-15,2024-11-15,584.32,0,-11976,392489350,-83095331,0.0152564649206405,99.8772517012245,-0.2
552.05,552.5,1258,1329,100640,59805,2024-10-15,2024-10-25,584.32,71,-40835,22997980,-5421377,0.26004457782814,95.2906516137504,-0.682802441267453
463.17,464,723,717,83868,59511,2024-10-15,2024-11-29,584.32,-6,-24357,111401771,-12544864,0.0534201561301929,99.235110903219,-0.409285678277965
469.72,470,2122,2122,78514,59416,2024-10-15,2024-11-01,584.32,0,-19098,74573214,-17043443,0.0796747207381997,98.8037366875458,-0.321428571428571
538.93,539,8193,8370,139281,58590,2024-10-15,2024-10-18,584.32,177,-80691,37570248,-36451733,0.155947865981614,96.2673868961419,-1.37721454173067
239.89,240,5318,5318,58498,58498,2024-10-15,2024-12-20,584.32,0,0,401465676,-76728253,0.0145711086892519,99.8528327487703,0
535.12,538,199,200,85570,57600,2024-10-15,2024-11-29,584.32,1,-27970,111401771,-12544864,0.051704743544876,99.2868156467638,-0.485590277777778
459.77,460,2481,2484,79392,57132,2024-10-15,2024-11-01,584.32,3,-22260,74573214,-17043443,0.0766119588194228,98.8803486463652,-0.389624028565427
509.81,510,2982,2964,92442,56316,2024-10-15,2024-10-25,584.32,-18,-36126,22997980,-5421377,0.244873680210175,95.5355252939606,-0.641487321542723
359.75,360,2251,2250,69781,56250,2024-10-15,2024-11-29,584.32,-1,-13531,111401771,-12544864,0.0504929136180429,99.3373085603819,-0.240551111111111
492.78,494,464,461,70992,56242,2024-10-15,2024-11-29,584.32,-3,-14750,111401771,-12544864,0.0504857324036617,99.3877942927855,-0.262259521354148
464.76,465,2286,2290,75438,54960,2024-10-15,2024-11-01,584.32,4,-20478,74573214,-17043443,0.0736993848756472,98.9540480312408,-0.372598253275109
299.94,300,9138,9139,73104,54834,2024-10-15,2024-11-15,584.32,1,-18270,392489350,-83095331,0.0139708249408551,99.8912225261654,-0.333187438450596
199.95,200,10990,10932,65940,54660,2024-10-15,2024-12-20,584.32,-58,-11280,401465676,-76728253,0.0136151116440649,99.8664478604144,-0.206366630076839
349.78,350,2474,2474,61850,54428,2024-10-15,2024-11-29,584.32,0,-7422,111401771,-12544864,0.0488573920427172,99.4366516848283,-0.136363636363636
490.82,492,464,461,66816,54398,2024-10-15,2024-11-29,584.32,-3,-12418,111401771,-12544864,0.0488304624887875,99.485482147317,-0.228280451487187
536.3,537,771,771,77871,53970,2024-10-15,2024-11-01,584.32,0,-23901,74573214,-17043443,0.0723718304537605,99.0264198616946,-0.442857142857143
583.32,591,0,69,0,52992,2024-10-15,2024-10-25,584.32,69,52992,22997980,-5421377,0.230420236907763,95.7659455308684,1
349.99,350,52699,52699,52699,52699,2024-10-15,2024-10-18,584.32,0,0,37570248,-36451733,0.140267905604456,96.4076548017463,0
454.8,455,2846,2623,85380,52460,2024-10-15,2024-11-01,584.32,-223,-32920,74573214,-17043443,0.0703469747193677,99.096766836414,-0.62752573389249
550.84,552,452,451,80908,52316,2024-10-15,2024-11-01,584.32,-1,-28592,74573214,-17043443,0.070153875894366,99.1669207123083,-0.546524963682239
499.84,500,3385,3265,88010,52240,2024-10-15,2024-10-25,584.32,-120,-35770,22997980,-5421377,0.227150384512031,95.9930959153804,-0.684724349157734
379.81,380,2658,2657,66450,50483,2024-10-15,2024-11-15,584.32,-1,-15967,392489350,-83095331,0.0128622598294705,99.9040847859948,-0.316284689895608
541.19,542,585,618,77220,50058,2024-10-15,2024-11-01,584.32,33,-27162,74573214,-17043443,0.0671259790412145,99.2340466913495,-0.542610571736785
541.93,542,7400,7142,148000,49994,2024-10-15,2024-10-18,584.32,-258,-98006,37570248,-36451733,0.133068059598648,96.540722861345,-1.96035524262912
474.19,475,598,612,58604,49572,2024-10-15,2024-11-22,584.32,14,-9032,16269713,-1546756,0.304688841161488,95.7588065628447,-0.182199628822723
584.76,620,7,14,29568,49336,2024-10-15,2024-12-20,584.32,7,19768,401465676,-76728253,0.0122889708758066,99.8787368312902,0.400681044267877
581.74,588,28,77,26124,48202,2024-10-15,2024-10-25,584.32,49,22078,22997980,-5421377,0.209592320716863,96.2026882360973,0.45803078710427
557.42,558,842,831,100198,48198,2024-10-15,2024-10-25,584.32,-11,-52000,22997980,-5421377,0.209574927884971,96.4122631639822,-1.07888294120088
484.45,485,871,873,60970,48015,2024-10-15,2024-11-08,584.32,2,-12955,28140084,-4440601,0.170628488529032,98.6248868340265,-0.269811517234198
506.93,507,6856,6856,47992,47992,2024-10-15,2024-10-18,584.32,0,0,37570248,-36451733,0.127739375050173,96.6684622363952,0
534.15,537,159,168,58671,47880,2024-10-15,2024-11-29,584.32,9,-10791,111401771,-12544864,0.0429795680716781,99.5284617153887,-0.225375939849624
468.12,469,544,543,59840,47784,2024-10-15,2024-11-29,584.32,-1,-12056,111401771,-12544864,0.0428933934991034,99.5713551088878,-0.252302025782689
424.85,425,3171,3150,63420,47250,2024-10-15,2024-11-01,584.32,-21,-16170,74573214,-17043443,0.0633605519536814,99.2974072433032,-0.342222222222222
364.67,365,1411,1411,46563,46563,2024-10-15,2024-11-29,584.32,0,0,111401771,-12544864,0.0417973606541677,99.613152469542,0
434.84,435,2986,2873,65692,45968,2024-10-15,2024-11-01,584.32,-113,-19724,74573214,-17043443,0.0616414360255413,99.3590486793288,-0.42908109989558
536.8,537.5,652,650,68460,45500,2024-10-15,2024-11-01,584.32,-2,-22960,74573214,-17043443,0.0610138648442858,99.420062544173,-0.504615384615385
551.37,552.5,400,402,73600,45426,2024-10-15,2024-11-01,584.32,2,-28174,74573214,-17043443,0.0609146335036599,99.4809771776767,-0.620217496587857
505.5,507,301,301,64414,45150,2024-10-15,2024-11-29,584.32,0,-19264,111401771,-12544864,0.0405289786640825,99.6536814482061,-0.426666666666667
269.97,270,14979,14979,74895,44937,2024-10-15,2024-11-15,584.32,0,-29958,392489350,-83095331,0.0114492278580298,99.9155340138529,-0.666666666666667
462.19,463,553,549,56959,44469,2024-10-15,2024-11-29,584.32,-4,-12490,111401771,-12544864,0.03991767778988,99.6935991259959,-0.280869819424768
581.78,600,17,24,37893,43728,2024-10-15,2024-11-22,584.32,7,5835,16269713,-1546756,0.268769338463438,96.0275759013082,0.133438529088913
536.93,537,6116,6154,97856,43078,2024-10-15,2024-10-18,584.32,38,-54778,37570248,-36451733,0.114659876613005,96.7831221130082,-1.27160035284832
542.17,543,517,510,63591,42330,2024-10-15,2024-11-01,584.32,-7,-21261,74573214,-17043443,0.0567630087661235,99.5377401864428,-0.502267895109852
204.95,205,8264,8264,49584,41320,2024-10-15,2024-12-20,584.32,0,-8263.99999999999,401465676,-76728253,0.0102922871045145,99.8890291183947,-0.2
577.16,590,23,32,35305,41088,2024-10-15,2024-11-22,584.32,9,5783,16269713,-1546756,0.252542869072122,96.2801187703803,0.140746690031153
553.51,554,709,834,65228,40866,2024-10-15,2024-10-25,584.32,125,-24362,22997980,-5421377,0.177693867026582,96.5899570310088,-0.59614349336857
550.57,551,965,946,75270,40678,2024-10-15,2024-10-25,584.32,-19,-34592,22997980,-5421377,0.176876403927649,96.7668334349365,-0.850385958011702
556.92,557.5,547,699,62358,40542,2024-10-15,2024-10-25,584.32,152,-21816,22997980,-5421377,0.176285047643315,96.9431184825798,-0.538108628089389
578.53,589,39,38,51948,39786,2024-10-15,2024-11-08,584.32,-1,-12162,28140084,-4440601,0.141385505459046,98.7662723394856,-0.305685416980848
344.78,345,1800,1803,45000,39666,2024-10-15,2024-11-29,584.32,3,-5334,111401771,-12544864,0.0356062562057474,99.7292053822017,-0.134472848283164
434.49,435,753,773,54216,39423,2024-10-15,2024-11-22,584.32,20,-14793,16269713,-1546756,0.242309129853735,96.522427900234,-0.375237805342059
229.92,230,4910,4911,44190,39288,2024-10-15,2024-12-20,584.32,1,-4902,401465676,-76728253,0.00978614171738059,99.8988152601121,-0.124770922419059
584.5,620,2,11,8634,39050,2024-10-15,2024-11-15,584.32,9,30416,392489350,-83095331,0.0099493145482801,99.9254833284012,0.778898847631242
378.89,379,3547,3547,39017,39017,2024-10-15,2024-10-18,584.32,0,0,37570248,-36451733,0.103850791722216,96.8869729047304,0
504.84,505,2433,2427,65691,38832,2024-10-15,2024-10-25,584.32,-6,-26859,22997980,-5421377,0.168849612009403,97.1119680945892,-0.691671817058097
480.83,482,328,328,47232,38376,2024-10-15,2024-11-29,584.32,0,-8856,111401771,-12544864,0.0344482853867736,99.7636536675885,-0.230769230769231
572.41,582,0,40,0,38360,2024-10-15,2024-11-22,584.32,40,38360,16269713,-1546756,0.235775517367762,96.7582034176018,1
284.96,285,8597,9455,42985,37820,2024-10-15,2024-11-15,584.32,858,-5165,392489350,-83095331,0.00963593024880802,99.93511925865,-0.136567953463776
219.94,220,6824,6274,61416,37644,2024-10-15,2024-12-20,584.32,-550,-23772,401465676,-76728253,0.00937664220141201,99.9081919023135,-0.631495058973542
459.58,460,653,894,33956,37548,2024-10-15,2024-11-08,584.32,241,3591.99999999999,28140084,-4440601,0.133432437515112,98.8997047770007,0.0956642164695854
324.92,325,4538,4658,45380,37264,2024-10-15,2024-11-15,584.32,120,-8116,392489350,-83095331,0.00949427035408731,99.944613529004,-0.217797337913268
583.69,594,0,36,0,37116,2024-10-15,2024-10-25,584.32,36,37116,22997980,-5421377,0.161388087127652,97.2733561817168,1
584.22,597,0,29,0,37062,2024-10-15,2024-10-25,584.32,29,37062,22997980,-5421377,0.161153283897107,97.434509465614,1
439.44,440,653,653,43098,36568,2024-10-15,2024-11-22,584.32,0,-6530,16269713,-1546756,0.224761186629414,96.9829646042312,-0.178571428571429
541.69,542.5,453,451,52095,36531,2024-10-15,2024-11-01,584.32,-2,-15564,74573214,-17043443,0.0489867581676177,99.5867269446104,-0.426049108975938
479.89,480,3344,3283,56848,36113,2024-10-15,2024-10-25,584.32,-61,-20735,22997980,-5421377,0.157026834530685,97.5915363001446,-0.57416996649406
489.84,491,309,308,42951,35728,2024-10-15,2024-11-29,584.32,-1,-7223,111401771,-12544864,0.0320713034265856,99.7957249710151,-0.202166368114644
264.97,265,11832,11824,47328,35472,2024-10-15,2024-11-15,584.32,-8,-11856,392489350,-83095331,0.00903769745599467,99.95365122646,-0.334235453315291
395.93,396,5038,5038,35266,35266,2024-10-15,2024-10-18,584.32,0,0,37570248,-36451733,0.0938668278154565,96.9808397325458,0
538.7,539,1171,1170,58550,35100,2024-10-15,2024-10-25,584.32,-1,-23450,22997980,-5421377,0.152622099853987,97.7441583999986,-0.668091168091168
434.69,435,700,1132,27300,35092,2024-10-15,2024-11-08,584.32,432,7792,28140084,-4440601,0.124704673944825,99.0244094509455,0.222044910520916
411.92,412,4381,4381,35048,35048,2024-10-15,2024-10-18,584.32,0,0,37570248,-36451733,0.0932865814460421,97.0741263139919,0
522.95,523,6940,6935,83280,34675,2024-10-15,2024-10-18,584.32,-5,-48605,37570248,-36451733,0.0922937745846128,97.1664200885765,-1.40173035328046
504.6,505,697,860,36941,34400,2024-10-15,2024-11-01,584.32,163,-2541,74573214,-17043443,0.0461291637504051,99.6328561083608,-0.0738662790697675
497.57,499,240,240,38400,34320,2024-10-15,2024-11-29,584.32,0,-4080,111401771,-12544864,0.0308074096954886,99.8265323807105,-0.118881118881119
557.91,563,49,67,32977,34103,2024-10-15,2024-11-22,584.32,18,1125.99999999999,16269713,-1546756,0.209610335474264,97.1925749397055,0.033017623083013
513.49,515,216,223,40176,33673,2024-10-15,2024-11-22,584.32,7,-6503.00000000001,16269713,-1546756,0.206967387808255,97.3995423275137,-0.193122085944229
460.21,461,425,424,40800,33496,2024-10-15,2024-11-29,584.32,-1,-7304,111401771,-12544864,0.0300677446142216,99.8566001253248,-0.218055887270122
289.95,290,1120,6629,6720,33145,2024-10-15,2024-11-15,584.32,5509,26425,392489350,-83095331,0.00844481512683083,99.9620960415869,0.797254487856389
496.69,498,257,252,45746,33012,2024-10-15,2024-11-29,584.32,-5,-12734,111401771,-12544864,0.029633281144157,99.8862334064689,-0.385738519326306
474.9,475,3304,3301,59472,33010,2024-10-15,2024-10-25,584.32,-3,-26462,22997980,-5421377,0.143534345190317,97.8876927451889,-0.801635867918813
469.91,470,3696,3660,51744,32940,2024-10-15,2024-10-25,584.32,-36,-18804,22997980,-5421377,0.143229970632203,98.0309227158211,-0.570856102003643
581.35,587,16,58,15296,32770,2024-10-15,2024-10-25,584.32,42,17474,22997980,-5421377,0.142490775276785,98.1734134910979,0.533231614281355
543.66,544,996,963,60756,32742,2024-10-15,2024-10-25,584.32,-33,-28014,22997980,-5421377,0.14236902545354,98.3157825165515,-0.855598314091992
474.98,475,15990,16000,79950,32000,2024-10-15,2024-10-18,584.32,10,-47950,37570248,-36451733,0.0851737789966146,97.2515938675731,-1.4984375
536.71,537,1128,1076,53016,31204,2024-10-15,2024-10-25,584.32,-52,-21812,22997980,-5421377,0.135681481590992,98.4514639981425,-0.69901294705807
577.33,587,20,32,30520,30944,2024-10-15,2024-11-08,584.32,12,424,28140084,-4440601,0.10996413514615,99.1343735860917,0.0137021716649431
399.9,400,3036,3068,39468,30680,2024-10-15,2024-11-01,584.32,32,-8788,74573214,-17043443,0.0411407774378613,99.6739968857987,-0.286440677966102
525.95,526,6071,6117,72852,30585,2024-10-15,2024-10-18,584.32,46,-42267,37570248,-36451733,0.081407500956608,97.3330013685297,-1.38195193722413
540.69,541,951,949,50403,29419,2024-10-15,2024-10-25,584.32,-2,-20984,22997980,-5421377,0.127919930359101,98.5793839285015,-0.713280532988885
532.94,533,4901,4901,73515,29406,2024-10-15,2024-10-18,584.32,0,-44109,37570248,-36451733,0.0782693795367015,97.4112707480664,-1.5
579.25,615,8,8,28600,28600,2024-10-15,2024-12-20,584.32,0,0,401465676,-76728253,0.00712389668899117,99.9153157990025,0
503.75,505,164,226,26076,28250,2024-10-15,2024-11-22,584.32,62,2174,16269713,-1546756,0.173635515266926,97.5731778427807,0.0769557522123894
579.95,720,4,2,56020,28010,2024-10-15,2024-12-20,584.32,-2,-28010,401465676,-76728253,0.00697693518386862,99.9222927341863,-1
419.86,420,1948,1948,35064,27272,2024-10-15,2024-11-01,584.32,0,-7792,74573214,-17043443,0.0365707719128211,99.7105676577115,-0.285714285714286
547.62,548,726,717,50094,27246,2024-10-15,2024-10-25,584.32,-9,-22848,22997980,-5421377,0.118471274433668,98.6978552029352,-0.838581810173971
189.96,190,6728,6728,33640,26912,2024-10-15,2024-12-20,584.32,0,-6728,401465676,-76728253,0.0067034373319626,99.9289961715183,-0.25
435.85,436,1789,1789,26835,26835,2024-10-15,2024-10-18,584.32,0,0,37570248,-36451733,0.0714261987304422,97.4826969467968,0
214.92,215,3308,3308,26464,26464,2024-10-15,2024-12-20,584.32,0,0,401465676,-76728253,0.00659184622298819,99.9355880177413,0
574.06,586,21,22,29631,26268,2024-10-15,2024-11-29,584.32,1,-3363,111401771,-12544864,0.0235795174207778,99.9098129238897,-0.128026496116948
552.7,557,50,61,27200,26230,2024-10-15,2024-11-22,584.32,11,-970,16269713,-1546756,0.1612198076266,97.7343976504072,-0.0369805566145635
244.87,245,1988,1988,25844,25844,2024-10-15,2024-12-20,584.32,0,0,401465676,-76728253,0.00643741209896111,99.9420254298403,0
129.99,130,25709,25774,51418,25774,2024-10-15,2024-12-20,584.32,65,-25644,401465676,-76728253,0.00641997598818386,99.9484454058284,-0.99495615736789
538.27,539,376,344,40608,25112,2024-10-15,2024-11-01,584.32,-32,-15496,74573214,-17043443,0.0336742895377957,99.7442419472493,-0.617075501752151
551.77,556,39,59,20631,24957,2024-10-15,2024-11-22,584.32,20,4326,16269713,-1546756,0.153395453257227,97.8877931036645,0.173338141603558
419.75,420,992,989,35712,24725,2024-10-15,2024-11-08,584.32,-3,-10987,28140084,-4440601,0.0878639878971221,99.2222375739888,-0.444368048533873
578.3,592,0,18,0,24660,2024-10-15,2024-11-22,584.32,18,24660,16269713,-1546756,0.151569975450704,98.0393630791152,1
553.59,558,49,55,28224,24255,2024-10-15,2024-11-22,584.32,6,-3969,16269713,-1546756,0.149080687532718,98.1884437666479,-0.163636363636364
582.75,600,4,14,8504,24150,2024-10-15,2024-11-08,584.32,10,15646,28140084,-4440601,0.0858206393413751,99.3080582133302,0.647867494824017
464.98,465,11922,11921,35766,23842,2024-10-15,2024-10-18,584.32,-1,-11924,37570248,-36451733,0.0634597887136651,97.5461567355105,-0.500125828370103
546.54,547.5,250,247,35750,23712,2024-10-15,2024-11-01,584.32,-3,-12038,74573214,-17043443,0.0317969398502792,99.7760388870996,-0.507675438596491
508.64,510,169,172,29237,23392,2024-10-15,2024-11-22,584.32,3,-5845,16269713,-1546756,0.143776353030935,98.3322201196788,-0.249871751025992
520.96,521,5751,5745,63261,22980,2024-10-15,2024-10-18,584.32,-6,-40281,37570248,-36451733,0.0611654200419438,97.6073221555525,-1.75287206266319
581.85,599,13,13,27677,22295,2024-10-15,2024-11-15,584.32,0,-5382,392489350,-83095331,0.0056804089079105,99.9677764504948,-0.241399416909621
279.96,280,3040,5507,15200,22028,2024-10-15,2024-11-15,584.32,2467,6828,392489350,-83095331,0.00561238158436656,99.9733888320791,0.30996913019793
546.63,547,715,592,45045,21904,2024-10-15,2024-10-25,584.32,-123,-23141,22997980,-5421377,0.0952431474416449,98.7930983503769,-1.05647370343316
584.43,598,0,16,0,21712,2024-10-15,2024-10-25,584.32,16,21712,22997980,-5421377,0.0944082915108196,98.8875066418877,1
568.15,604,6,6,21510,21510,2024-10-15,2024-12-20,584.32,0,0,401465676,-76728253,0.00535786775455245,99.953803273583,0
399.66,400,607,629,26101,21386,2024-10-15,2024-11-22,584.32,22,-4715,16269713,-1546756,0.131446694849503,98.4636668145283,-0.220471336388291
579.46,610,7,7,21378,21378,2024-10-15,2024-11-01,584.32,0,0,74573214,-17043443,0.0286671297283767,99.804706016828,0
502.97,503,7067,7078,49469,21234,2024-10-15,2024-10-18,584.32,11,-28235,37570248,-36451733,0.0565181257254411,97.6638402812779,-1.32970707356127
518.95,519,4225,4229,46475,21145,2024-10-15,2024-10-18,584.32,4,-25330,37570248,-36451733,0.0562812361526067,97.7201215174305,-1.19791912981792
319.93,320,2999,2999,29990,20993,2024-10-15,2024-11-15,584.32,0,-8997,392489350,-83095331,0.00534868016164005,99.9787375122408,-0.428571428571429
234.92,235,2634,2624,34242,20992,2024-10-15,2024-12-20,584.32,-10,-13250,401465676,-76728253,0.00522884053480079,99.9590321141178,-0.631192835365854
444.43,445,365,367,28105,20919,2024-10-15,2024-11-22,584.32,2,-7186,16269713,-1546756,0.128576330756418,98.5922431452848,-0.343515464410345
304.99,305,28312,20885,28312,20885,2024-10-15,2024-10-18,584.32,-7427,-7427,37570248,-36451733,0.0555891991982592,97.7757107166288,-0.35561407708882
464.27,465,279,279,24552,20367,2024-10-15,2024-11-22,584.32,0,-4185,16269713,-1546756,0.125183523520052,98.7174266688048,-0.205479452054795
467.13,468,233,232,24931,20184,2024-10-15,2024-11-29,584.32,-1,-4747,111401771,-12544864,0.0181182038838503,99.9279311277736,-0.235186286167261
573.58,587,15,15,24585,20130,2024-10-15,2024-11-29,584.32,0,-4455,111401771,-12544864,0.018069730686777,99.9460008584603,-0.221311475409836
585,685,0,2,0,20000,2024-10-15,2024-12-20,584.32,2,20000,401465676,-76728253,0.00498174593635746,99.9640138600541,1
551.55,552,455,442,37765,19890,2024-10-15,2024-10-25,584.32,-13,-17875,22997980,-5421377,0.0864858565839261,98.9739924984716,-0.898692810457516
407.84,408,1240,1240,19840,19840,2024-10-15,2024-10-18,584.32,0,0,37570248,-36451733,0.052807742977901,97.8285184596067,0
485.95,486,3915,3915,19575,19575,2024-10-15,2024-10-18,584.32,0,0,37570248,-36451733,0.0521023976205853,97.8806208572272,0
274.96,275,4885,4887,24425,19548,2024-10-15,2024-11-15,584.32,2,-4877,392489350,-83095331,0.00498051730575619,99.9837180295465,-0.249488438714958
209.94,210,3237,3237,25896,19422,2024-10-15,2024-12-20,584.32,0,-6474,401465676,-76728253,0.00483777347879673,99.9688516335329,-0.333333333333333
517.96,518,4798,4851,43182,19404,2024-10-15,2024-10-18,584.32,53,-23778,37570248,-36451733,0.0516472502390722,97.9322681074663,-1.22541743970315
358.97,359,6361,6361,19083,19083,2024-10-15,2024-10-18,584.32,0,0,37570248,-36451733,0.0507928507685124,97.9830609582348,0
169.97,170,6325,6344,25300,19032,2024-10-15,2024-12-20,584.32,19,-6268,401465676,-76728253,0.00474062943303776,99.973592262966,-0.329340058848256
466.14,467,224,217,24192,18662,2024-10-15,2024-11-29,584.32,-7,-5530,111401771,-12544864,0.0167519778478208,99.9627528363082,-0.296324081020255
576.49,595,10,10,18510,18510,2024-10-15,2024-11-22,584.32,0,0,16269713,-1546756,0.113769677436842,98.8311963462417,0
149.98,150,9230,9230,27690,18460,2024-10-15,2024-12-20,584.32,0,-9230,401465676,-76728253,0.00459815149925793,99.9781904144652,-0.5
581.82,592,0,18,0,18324,2024-10-15,2024-11-01,584.32,18,18324,74573214,-17043443,0.0245718254814658,99.8292778423095,1
579.74,587,0,25,0,18150,2024-10-15,2024-11-01,584.32,25,18150,74573214,-17043443,0.0243384977345887,99.853616340044,1
542.68,543,602,565,34314,18080,2024-10-15,2024-10-25,584.32,-37,-16234,22997980,-5421377,0.0786156001527091,99.0526080986243,-0.897898230088496
570.3,592,8,8,17360,17360,2024-10-15,2024-11-08,584.32,0,0,28140084,-4440601,0.0616913581352494,99.3697495714654,0
224.94,225,2779,2778,22232,16668,2024-10-15,2024-12-20,584.32,-1,-5564,401465676,-76728253,0.00415178706336031,99.9823422015286,-0.333813294936405
314.93,315,2360,2360,21240,16520,2024-10-15,2024-11-15,584.32,0,-4720,392489350,-83095331,0.00420903140429161,99.9879270609508,-0.285714285714286
418.95,419,3276,3276,16380,16380,2024-10-15,2024-10-18,584.32,0,0,37570248,-36451733,0.0435983281238921,98.0266592863587,0
580.29,588,0,21,0,16191,2024-10-15,2024-11-01,584.32,21,16191,74573214,-17043443,0.0217115491361282,99.8753278891802,1
289.99,290,15986,15986,15986,15986,2024-10-15,2024-10-18,584.32,0,0,37570248,-36451733,0.0425496259699963,98.0692089123287,0
542.19,542.5,517,515,28952,15965,2024-10-15,2024-10-25,584.32,-2,-12987,22997980,-5421377,0.0694191402897124,99.122027238914,-0.813466958972753
351.97,352,5299,5299,15897,15897,2024-10-15,2024-10-18,584.32,0,0,37570248,-36451733,0.0423127363971619,98.1115216487259,0
548.61,549,407,401,32560,15639,2024-10-15,2024-10-25,584.32,-6,-16921,22997980,-5421377,0.0680016244904988,99.1900288634045,-1.08197455080248
304.94,305,2436,2450,19488,14700,2024-10-15,2024-11-15,584.32,14,-4788,392489350,-83095331,0.00374532455466626,99.9916723855055,-0.325714285714286
583.35,620,3,4,13536,14660,2024-10-15,2024-11-01,584.32,1,1124,74573214,-17043443,0.0196585331564226,99.8949864223366,0.0766712141882675
369.98,370,7304,7304,14608,14608,2024-10-15,2024-10-18,584.32,0,0,37570248,-36451733,0.0388818301119546,98.1504034788378,0
299.99,300,14583,14583,14583,14583,2024-10-15,2024-10-18,584.32,0,0,37570248,-36451733,0.0388152880971134,98.1892187669349,0
554.32,559,14,31,8274,14508,2024-10-15,2024-11-22,584.32,17,6234,16269713,-1546756,0.0891718249731879,98.9203681712148,0.429693961952026
424.73,425,533,530,18122,14310,2024-10-15,2024-11-08,584.32,-3,-3812,28140084,-4440601,0.0508527266656347,99.420602298131,-0.26638714185884
429.95,430,2843,2843,19901,14215,2024-10-15,2024-10-25,584.32,0,-5686,22997980,-5421377,0.0618097763368783,99.2518386397414,-0.4
440.93,441,2022,2022,14154,14154,2024-10-15,2024-10-18,584.32,0,0,37570248,-36451733,0.0376734271224401,98.2268921940574,0
424.96,425,3540,3537,24780,14148,2024-10-15,2024-10-25,584.32,-3,-10632,22997980,-5421377,0.0615184464026841,99.3133570861441,-0.751484308736217
426.94,427,2357,2357,14142,14142,2024-10-15,2024-10-18,584.32,0,0,37570248,-36451733,0.0376414869553163,98.2645336810127,0
579.77,615,4,4,14092,14092,2024-10-15,2024-11-22,584.32,0,0,16269713,-1546756,0.0866149267660714,99.0069830979809,0
343.94,344,2324,2324,13944,13944,2024-10-15,2024-10-18,584.32,0,0,37570248,-36451733,0.0371144741977748,98.3016481552105,0
354.77,355,541,604,15689,13892,2024-10-15,2024-11-29,584.32,63,-1797,111401771,-12544864,0.0124701787730107,99.9752230150812,-0.129355024474517
577.18,591,0,10,0,13820,2024-10-15,2024-11-22,584.32,10,13820,16269713,-1546756,0.0849431087075722,99.0919262066885,1
379.98,380,6887,6887,13774,13774,2024-10-15,2024-10-18,584.32,0,0,37570248,-36451733,0.0366619884968553,98.3383101437073,0
419.99,420,13760,13760,13760,13760,2024-10-15,2024-10-18,584.32,0,0,37570248,-36451733,0.0366247249685443,98.3749348686759,0
454.99,455,12888,12956,38664,12956,2024-10-15,2024-10-18,584.32,68,-25708,37570248,-36451733,0.0344847337712543,98.4094196024471,-1.98425439950602
503.93,504,1839,1839,12873,12873,2024-10-15,2024-10-18,584.32,0,0,37570248,-36451733,0.0342638142819819,98.4436834167291,0
582.93,615,0,4,0,12828,2024-10-15,2024-11-15,584.32,4,12828,392489350,-83095331,0.00326836893790876,99.9949407544434,1
583.78,605,0,6,0,12732,2024-10-15,2024-11-08,584.32,6,12732,28140084,-4440601,0.0452450674987324,99.4658473656298,1
179.95,180,2527,2527,12635,12635,2024-10-15,2024-12-20,584.32,0,0,401465676,-76728253,0.00314721799529382,99.9854894195239,0
361.97,362,4188,4188,12564,12564,2024-10-15,2024-10-18,584.32,0,0,37570248,-36451733,0.0334413549785458,98.4771247717077,0
414.89,415,1111,1116,18887,12276,2024-10-15,2024-11-01,584.32,5,-6611,74573214,-17043443,0.0164616748313946,99.911448097168,-0.538530465949821
404.49,405,236,237,10384,12087,2024-10-15,2024-11-22,584.32,1,1703,16269713,-1546756,0.0742914149745604,99.166217621663,0.140895176636055
439.95,440,2401,2400,21609,12000,2024-10-15,2024-10-25,584.32,-1,-9609,22997980,-5421377,0.0521784956765768,99.3655355818207,-0.80075
404.9,405,125,1160,1750,11600,2024-10-15,2024-11-01,584.32,1035,9850,74573214,-17043443,0.0155551831251366,99.9270032802931,0.849137931034483
500.97,501,3356,3853,23492,11559,2024-10-15,2024-10-18,584.32,497,-11933,37570248,-36451733,0.0307663659819334,98.5078911376896,-1.03235574011593
581.61,598,3,7,5910,11473,2024-10-15,2024-11-08,584.32,4,5563,28140084,-4440601,0.040771022574062,99.5066183882038,0.484877538568814
139.99,140,11430,11430,11430,11430,2024-10-15,2024-12-20,584.32,0,0,401465676,-76728253,0.00284706780262829,99.9883364873265,0
582.88,640,0,2,0,11424,2024-10-15,2024-11-29,584.32,2,11424,111401771,-12544864,0.0102547741364004,99.9854777892176,1
433.92,434,1424,1424,11392,11392,2024-10-15,2024-10-18,584.32,0,0,37570248,-36451733,0.0303218653227948,98.5382130030124,0
521.96,522,2560,2842,25600,11368,2024-10-15,2024-10-18,584.32,282,-14232,37570248,-36451733,0.0302579849885473,98.568470988001,-1.25193525686137
576.79,593,7,7,11347,11347,2024-10-15,2024-11-08,584.32,0,0,28140084,-4440601,0.0403232627166287,99.5469416509204,0
459.32,460,165,166,14190,11288,2024-10-15,2024-11-22,584.32,1,-2902,16269713,-1546756,0.0693804494277189,99.2355980710908,-0.257087172218285
464.91,465,1257,1247,18855,11223,2024-10-15,2024-10-25,584.32,-10,-7632,22997980,-5421377,0.0487999380815185,99.4143355199022,-0.680032076984764
469.23,470,131,141,11790,10857,2024-10-15,2024-11-22,584.32,10,-933,16269713,-1546756,0.0667313553717881,99.3023294264625,-0.0859353412544902
505.96,506,2709,2704,21672,10816,2024-10-15,2024-10-18,584.32,-5,-10856,37570248,-36451733,0.0287887373008557,98.5972597253018,-1.00369822485207
309.99,310,10745,10745,10745,10745,2024-10-15,2024-10-18,584.32,0,0,37570248,-36451733,0.028599757978707,98.6258594832805,0
523.95,524,2204,2135,26448,10675,2024-10-15,2024-10-18,584.32,-69,-15773,37570248,-36451733,0.0284134403371519,98.6542729236177,-1.4775644028103
350.98,351,5326,5326,10652,10652,2024-10-15,2024-10-18,584.32,0,0,37570248,-36451733,0.0283522216834981,98.6826251453012,0
264.98,265,5320,5320,10640,10640,2024-10-15,2024-10-18,584.32,0,0,37570248,-36451733,0.0283202815163743,98.7109454268175,0
409.89,410,963,964,13482,10604,2024-10-15,2024-11-01,584.32,1,-2878,74573214,-17043443,0.0142195829188749,99.941222863212,-0.271407016220294
424.43,425,185,185,10545,10545,2024-10-15,2024-11-22,584.32,0,0,16269713,-1546756,0.0648136817164507,99.367143108179,0
469.53,470,213,222,12354,10434,2024-10-15,2024-11-08,584.32,9,-1920,28140084,-4440601,0.0370787805750686,99.5840204314955,-0.184013801035078
580.08,587.5,0,14,0,10388,2024-10-15,2024-11-01,584.32,14,10388,74573214,-17043443,0.0139299346813723,99.9551527978934,1
581.75,607,2,4,6252,10100,2024-10-15,2024-12-20,584.32,2,3848,401465676,-76728253,0.00251578169786052,99.9908522690244,0.380990099009901
372.98,373,5003,5003,10006,10006,2024-10-15,2024-10-18,584.32,0,0,37570248,-36451733,0.0266327760200039,98.7375782028375,0
579.79,594,6,7,10176,9947,2024-10-15,2024-11-08,584.32,1,-229,28140084,-4440601,0.0353481531895925,99.6193685846851,-0.0230220166884488
575.59,588,5,8,11275,9928,2024-10-15,2024-11-29,584.32,3,-1347,111401771,-12544864,0.00891188704710987,99.9943896762647,-0.135676873489122
184.96,185,2635,2482,10540,9928,2024-10-15,2024-12-20,584.32,-153,-612,401465676,-76728253,0.00247293868280784,99.9933252077072,-0.0616438356164384
576.76,625,2,2,9648,9648,2024-10-15,2024-11-15,584.32,0,0,392489350,-83095331,0.00245815587098096,99.9973989103144,0
584.38,594,0,10,0,9620,2024-10-15,2024-10-18,584.32,10,9620,37570248,-36451733,0.0256053673108573,98.7631835701484,1
584,680,0,1,0,9600,2024-10-15,2024-12-20,584.32,1,9600,401465676,-76728253,0.00239123804945158,99.9957164457566,1
459.91,460,1104,1065,15456,9585,2024-10-15,2024-10-25,584.32,-39,-5871,22997980,-5421377,0.0416775734216657,99.4560130933239,-0.612519561815337
442.99,443,9204,9538,92040,9538,2024-10-15,2024-10-18,584.32,334,-82502,37570248,-36451733,0.0253871095021784,98.7885706796506,-8.6498217655693
409.53,410,201,201,9447,9447,2024-10-15,2024-11-22,584.32,0,0,16269713,-1546756,0.0580649455832442,99.4252080537622,0
394.99,395,9431,9431,9431,9431,2024-10-15,2024-10-18,584.32,0,0,37570248,-36451733,0.0251023096786585,98.8136729893292,0
580.14,599,0,5,0,9430,2024-10-15,2024-11-22,584.32,5,9430,16269713,-1546756,0.057960456954588,99.4831685107168,1
501.96,502,2292,2324,16044,9296,2024-10-15,2024-10-18,584.32,32,-6748,37570248,-36451733,0.0247429827985165,98.8384159721277,-0.725903614457832
367.98,368,4608,4608,9216,9216,2024-10-15,2024-10-18,584.32,0,0,37570248,-36451733,0.024530048351025,98.8629460204788,0
374.98,375,4577,4578,22885,9156,2024-10-15,2024-10-25,584.32,1,-13729,22997980,-5421377,0.0398121922012281,99.4958252855251,-1.49945391000437
377.98,378,4564,4564,9128,9128,2024-10-15,2024-10-18,584.32,0,0,37570248,-36451733,0.0242958204587843,98.8872418409376,0
414.71,415,313,313,9077,9077,2024-10-15,2024-11-08,584.32,0,0,28140084,-4440601,0.0322564779835057,99.6516250626686,0
479.14,480,102,105,10812,9030,2024-10-15,2024-11-22,584.32,3,-1782,16269713,-1546756,0.0555019009862067,99.538670411703,-0.19734219269103
389.79,390,428,428,8988,8988,2024-10-15,2024-11-08,584.32,0,0,28140084,-4440601,0.0319402031635727,99.6835652658322,0
404.79,405,101,426,3131,8946,2024-10-15,2024-11-08,584.32,325,5815,28140084,-4440601,0.0317909498777616,99.7153562157099,0.650011178180192
419.48,420,170,170,8840,8840,2024-10-15,2024-11-22,584.32,0,0,16269713,-1546756,0.0543340869012256,99.5930044986043,0
484.07,485,94,95,10622,8835,2024-10-15,2024-11-22,584.32,1,-1787,16269713,-1546756,0.0543033549516208,99.6473078535559,-0.202263723825693
414.59,415,11,215,506,8815,2024-10-15,2024-11-22,584.32,204,8309,16269713,-1546756,0.0541804271532018,99.7014882807091,0.942597844583097
575.98,605,3,3,8706,8706,2024-10-15,2024-10-18,584.32,0,0,37570248,-36451733,0.0231725912482665,98.9104144321858,0
159.98,160,4335,4341,13005,8682,2024-10-15,2024-12-20,584.32,6,-4323,401465676,-76728253,0.00216257591097277,99.9978790216676,-0.497926744989634
376.99,377,8674,8674,8674,8674,2024-10-15,2024-10-18,584.32,0,0,37570248,-36451733,0.0230874174692698,98.9335018496551,0
510.91,511,959,959,8631,8631,2024-10-15,2024-10-18,584.32,0,0,37570248,-36451733,0.0229729652037431,98.9564748148588,0
194.95,195,1683,1703,10098,8515,2024-10-15,2024-12-20,584.32,20,-1583,401465676,-76728253,0.00212097833240419,100,-0.185907222548444
388.95,389,1654,1654,8270,8270,2024-10-15,2024-10-18,584.32,0,0,37570248,-36451733,0.0220120985094376,98.9784869133683,0
516.95,517,1645,1644,18095,8220,2024-10-15,2024-10-18,584.32,-1,-9875,37570248,-36451733,0.0218790144797554,99.000365927848,-1.20133819951338
424.99,425,8185,8166,16370,8166,2024-10-15,2024-10-18,584.32,-19,-8204,37570248,-36451733,0.0217352837276986,99.0221012115757,-1.00465344109723
444.94,445,1278,1340,21726,8040,2024-10-15,2024-10-25,584.32,62,-13686,22997980,-5421377,0.0349595921033065,99.5307848776284,-1.70223880597015
324.93,325,1043,1140,8344,7980,2024-10-15,2024-11-08,584.32,97,-363.999999999999,28140084,-4440601,0.0283581243041066,99.7437143400141,-0.0456140350877192
389.99,390,7958,7958,7958,7958,2024-10-15,2024-10-18,584.32,0,0,37570248,-36451733,0.0211816541642206,99.0432828657399,0
284.98,285,3973,3973,7946,7946,2024-10-15,2024-10-18,584.32,0,0,37570248,-36451733,0.0211497139970969,99.064432579737,0
333.95,334,1589,1589,7945,7945,2024-10-15,2024-10-18,584.32,0,0,37570248,-36451733,0.0211470523165032,99.0855796320535,0
259.97,260,2636,2641,10544,7923,2024-10-15,2024-11-15,584.32,5,-2621,392489350,-83095331,0.00201865349977012,99.9994175638142,-0.330809036980942
427.95,428,1562,1562,7810,7810,2024-10-15,2024-10-18,584.32,0,0,37570248,-36451733,0.0207877254363612,99.1063673574899,0
449.94,450,1301,1298,13010,7788,2024-10-15,2024-10-25,584.32,-3,-5222,22997980,-5421377,0.0338638436940984,99.5646487213225,-0.670518746789933
294.99,295,7780,7780,7780,7780,2024-10-15,2024-10-18,584.32,0,0,37570248,-36451733,0.0207078750185519,99.1270752325084,0
369.97,370,2568,2568,7704,7704,2024-10-15,2024-10-25,584.32,0,0,22997980,-5421377,0.0334985942243623,99.5981473155468,0
578.1,597,4,4,7560,7560,2024-10-15,2024-11-08,584.32,0,0,28140084,-4440601,0.0268655914459957,99.77057993146,0
439.67,440,229,229,10534,7557,2024-10-15,2024-11-08,584.32,0,-2977,28140084,-4440601,0.0268549304970092,99.7974348619571,-0.393939393939394
429.5,430,151,151,9513,7550,2024-10-15,2024-11-22,584.32,0,-1963,16269713,-1546756,0.0464052439031961,99.7478935246123,-0.26
512.96,513,1875,1885,13125,7540,2024-10-15,2024-10-18,584.32,10,-5585,37570248,-36451733,0.0200690716760773,99.1471443041845,-0.740716180371353
489.01,490,59,76,7316,7524,2024-10-15,2024-11-22,584.32,17,207.999999999999,16269713,-1546756,0.0462454377652513,99.7941389623775,0.0276448697501328
339.98,340,3759,3759,7518,7518,2024-10-15,2024-10-18,584.32,0,0,37570248,-36451733,0.0200105147030171,99.1671548188875,0
419.96,420,1877,1877,11262,7508,2024-10-15,2024-10-25,584.32,0,-3754,22997980,-5421377,0.0326463454616449,99.6307936610085,-0.5
575.49,650,1,1,7451,7451,2024-10-15,2024-10-25,584.32,0,0,22997980,-5421377,0.0323984976071812,99.6631921586157,0
274.99,275,7365,7367,7365,7367,2024-10-15,2024-10-18,584.32,2,1.99999999999909,37570248,-36451733,0.0196086009333769,99.1867634198209,0.000271480928464652
580.83,589,2,9,2326,7353,2024-10-15,2024-11-01,584.32,7,5027,74573214,-17043443,0.00986010875164908,99.965012906645,0.683666530667755
507.97,508,2446,2448,17122,7344,2024-10-15,2024-10-18,584.32,2,-9778,37570248,-36451733,0.019547382279723,99.2063108021006,-1.33142701525055
583.88,592,0,9,0,7308,2024-10-15,2024-10-25,584.32,9,7308,22997980,-5421377,0.0317767038670353,99.6949688624827,1
508.96,509,1797,1798,14376,7192,2024-10-15,2024-10-18,584.32,1,-7184,37570248,-36451733,0.0191428068294891,99.2254536089301,-0.99888765294772
399.97,400,1245,2377,4980,7131,2024-10-15,2024-10-25,584.32,1132,2151,22997980,-5421377,0.0310070710558058,99.7259759335385,0.301640723601178
410.96,411,1769,1769,7076,7076,2024-10-15,2024-10-18,584.32,0,0,37570248,-36451733,0.0188340518806264,99.2442876608108,0
374.99,375,6986,6986,6986,6986,2024-10-15,2024-10-18,584.32,0,0,37570248,-36451733,0.0185945006271984,99.262882161438,0
357.93,358,983,983,6881,6881,2024-10-15,2024-10-18,584.32,0,0,37570248,-36451733,0.0183150241648658,99.2811971856028,0
314.99,315,6856,6856,6856,6856,2024-10-15,2024-10-18,584.32,0,0,37570248,-36451733,0.0182484821500247,99.2994456677529,0
511.96,512,1710,1710,15390,6840,2024-10-15,2024-10-18,584.32,0,-8550,37570248,-36451733,0.0182058952605264,99.3176515630134,-1.25
583.47,593,0,7,0,6671,2024-10-15,2024-10-25,584.32,7,6671,22997980,-5421377,0.0290068953882037,99.7549828289267,1
269.99,270,6651,6651,6651,6651,2024-10-15,2024-10-18,584.32,0,0,37570248,-36451733,0.0177028376283276,99.3353544006417,0
430.95,431,1329,1329,6645,6645,2024-10-15,2024-10-18,584.32,0,0,37570248,-36451733,0.0176868675447657,99.3530412681865,0
324.98,325,3304,3304,6608,6608,2024-10-15,2024-10-18,584.32,0,0,37570248,-36451733,0.0175883853628009,99.3706296535493,0
576.5,589,4,5,6880,6250,2024-10-15,2024-11-29,584.32,1,-630,111401771,-12544864,0.0056103237353381,100,-0.1008
379.98,380,120,3099,360,6198,2024-10-15,2024-10-25,584.32,2979,5838,22997980,-5421377,0.0269501930169519,99.7819330219437,0.941916747337851
360.99,361,6179,6179,6179,6179,2024-10-15,2024-10-18,584.32,0,0,37570248,-36451733,0.0164465243881275,99.3870761779374,0
578.72,594,0,4,0,6112,2024-10-15,2024-11-22,584.32,4,6112,16269713,-1546756,0.0375667351968655,99.8317056975744,1
415.98,416,3050,3050,6100,6100,2024-10-15,2024-10-18,584.32,0,0,37570248,-36451733,0.0162362516212297,99.4033124295586,0
547.12,547.5,294,160,17934,6080,2024-10-15,2024-10-25,584.32,-134,-11854,22997980,-5421377,0.0264371044761323,99.8083701264198,-1.94967105263158
582.92,603,0,3,0,6024,2024-10-15,2024-11-08,584.32,3,6024,28140084,-4440601,0.0214071855649045,99.818842047522,1
578.28,593,0,4,0,5888,2024-10-15,2024-11-22,584.32,4,5888,16269713,-1546756,0.036189943854572,99.867895641429,1
400.99,401,5818,5752,5818,5752,2024-10-15,2024-10-18,584.32,-66,-66,37570248,-36451733,0.0153099867746415,99.4186224163333,-0.0114742698191933
398.99,399,5651,5651,5651,5651,2024-10-15,2024-10-18,584.32,0,0,37570248,-36451733,0.0150411570346834,99.433663573368,0
583.76,597,1,4,2192,5296,2024-10-15,2024-10-18,584.32,3,3104,37570248,-36451733,0.0140962604239397,99.4477598337919,0.586102719033233
449.63,450,113,138,5311,5106,2024-10-15,2024-11-08,584.32,25,-205,28140084,-4440601,0.0181449351750336,99.836986982697,-0.0401488444966706
444.99,445,4674,5080,9348,5080,2024-10-15,2024-10-18,584.32,406,-4268,37570248,-36451733,0.0135213374157126,99.4612811712076,-0.840157480314961
491.97,492,1687,1688,8435,5064,2024-10-15,2024-10-18,584.32,1,-3371,37570248,-36451733,0.0134787505262143,99.4747599217338,-0.665679304897314
574.65,587,2,4,3260,4940,2024-10-15,2024-11-22,584.32,2,1680,16269713,-1546756,0.0303631662095084,99.8982588076385,0.340080971659919
439.99,440,4940,4939,9880,4939,2024-10-15,2024-10-18,584.32,-1,-4941,37570248,-36451733,0.0131460404520087,99.4879059621858,-1.00040494027131
576.11,588,0,4,0,4756,2024-10-15,2024-11-22,584.32,4,4756,16269713,-1546756,0.0292322304640531,99.9274910381025,1
374.86,375,334,339,8016,4746,2024-10-15,2024-11-08,584.32,5,-3270,28140084,-4440601,0.0168656212966528,99.8538526039937,-0.689001264222503
342.98,343,2371,2371,4742,4742,2024-10-15,2024-10-18,584.32,0,0,37570248,-36451733,0.0126216893750608,99.5005276515609,0
454.93,455,652,659,7824,4613,2024-10-15,2024-10-25,584.32,7,-3211,22997980,-5421377,0.0200582833796707,99.8284284097995,-0.69607630609148
344.97,345,1516,1516,4548,4548,2024-10-15,2024-10-18,584.32,0,0,37570248,-36451733,0.0121053233398938,99.5126329749008,0
326.99,327,4489,4489,4489,4489,2024-10-15,2024-10-18,584.32,0,0,37570248,-36451733,0.0119482841848688,99.5245812590857,0
403.99,404,4376,4327,8752,4327,2024-10-15,2024-10-18,584.32,-49,-4425,37570248,-36451733,0.0115170919286985,99.5360983510144,-1.02264848624913
346.98,347,2091,2091,4182,4182,2024-10-15,2024-10-18,584.32,0,0,37570248,-36451733,0.0111311482426201,99.547229499257,0
279.99,280,4180,4180,4180,4180,2024-10-15,2024-10-18,584.32,0,0,37570248,-36451733,0.0111258248814328,99.5583553241384,0
409.77,410,169,174,5408,4002,2024-10-15,2024-11-08,584.32,5,-1406,28140084,-4440601,0.0142217059479993,99.8680743099417,-0.351324337831084
583,593,0,4,0,4000,2024-10-15,2024-11-01,584.32,4,4000,74573214,-17043443,0.0053638562500471,99.9703767628951,1
394.81,395,160,210,4960,3990,2024-10-15,2024-11-08,584.32,50,-970,28140084,-4440601,0.0141790621520533,99.8822533720937,-0.243107769423559
443.99,444,3959,3979,7918,3979,2024-10-15,2024-10-18,584.32,20,-3939,37570248,-36451733,0.0105908270821103,99.5689461512205,-0.989947222920332
374.91,375,442,442,3978,3978,2024-10-15,2024-11-01,584.32,0,0,74573214,-17043443,0.00533435504067184,99.9757111179357,0
356.98,357,1974,1974,3948,3948,2024-10-15,2024-10-18,584.32,0,0,37570248,-36451733,0.0105083149837073,99.5794544662042,0
402.99,403,3894,3878,3894,3878,2024-10-15,2024-10-18,584.32,-16,-16,37570248,-36451733,0.0103219973421522,99.5897764635464,-0.00412583806085611
581.5,620,0,1,0,3850,2024-10-15,2024-11-08,584.32,1,3850,28140084,-4440601,0.0136815511993497,99.8959349232931,1
576.32,589,0,3,0,3804,2024-10-15,2024-11-22,584.32,3,3804,16269713,-1546756,0.0233808672593057,99.9508719053618,1
429.99,430,3795,3794,7590,3794,2024-10-15,2024-10-18,584.32,-1,-3796,37570248,-36451733,0.0100984161722861,99.5998748797187,-1.00052714812862
394.97,395,1242,1262,4968,3786,2024-10-15,2024-10-25,584.32,20,-1182,22997980,-5421377,0.01646231538596,99.8448907251854,-0.312202852614897
389.98,390,1799,1854,7196,3708,2024-10-15,2024-10-25,584.32,55,-3488,22997980,-5421377,0.0161231551640622,99.8610138803495,-0.94066882416397
259.99,260,3666,3666,3666,3666,2024-10-15,2024-10-18,584.32,0,0,37570248,-36451733,0.00975772105629966,99.609632600775,0
454.58,455,87,87,4350,3654,2024-10-15,2024-11-08,584.32,0,-696,28140084,-4440601,0.0129850358655646,99.9089199591586,-0.19047619047619
371.95,372,726,726,3630,3630,2024-10-15,2024-10-18,584.32,0,0,37570248,-36451733,0.00966190055492846,99.6192945013299,0
385.98,386,1804,1804,3608,3608,2024-10-15,2024-10-18,584.32,0,0,37570248,-36451733,0.00960334358186829,99.6288978449117,0
584,596,0,3,0,3600,2024-10-15,2024-10-25,584.32,3,3600,22997980,-5421377,0.015653548702973,99.8766674290525,1
391.99,392,3590,3590,3590,3590,2024-10-15,2024-10-18,584.32,0,0,37570248,-36451733,0.00955543333118269,99.6384532782429,0
437.98,438,1795,1795,3590,3590,2024-10-15,2024-10-18,584.32,0,0,37570248,-36451733,0.00955543333118269,99.6480087115741,0
444.64,445,96,97,4992,3492,2024-10-15,2024-11-08,584.32,1,-1500,28140084,-4440601,0.0124093446202932,99.9213293037789,-0.429553264604811
396.99,397,3450,3450,3450,3450,2024-10-15,2024-10-18,584.32,0,0,37570248,-36451733,0.00918279804807251,99.6571915096222,0
582.82,594,0,3,0,3354,2024-10-15,2024-11-01,584.32,3,3354,74573214,-17043443,0.00449759346566449,99.9802087114014,1
383.96,384,827,827,3308,3308,2024-10-15,2024-10-18,584.32,0,0,37570248,-36451733,0.00880483940377503,99.665996349026,0
299.99,300,3091,3092,3091,3092,2024-10-15,2024-10-25,584.32,1,1,22997980,-5421377,0.0134446590526646,99.8901120881051,0.000323415265200518
413.99,414,3025,3025,3025,3025,2024-10-15,2024-10-18,584.32,0,0,37570248,-36451733,0.00805158379577372,99.6740479328217,0
335.99,336,2992,2992,2992,2992,2024-10-15,2024-10-18,584.32,0,0,37570248,-36451733,0.00796374833618346,99.6820116811579,0
344.87,345,229,229,2977,2977,2024-10-15,2024-11-08,584.32,0,0,28140084,-4440601,0.0105792150442763,99.9319085188232,0
324.99,325,1858,2958,1858,2958,2024-10-15,2024-10-25,584.32,1100,1100,22997980,-5421377,0.0128619991842762,99.9029740872894,0.371872887085869
325.99,326,2956,2956,2956,2956,2024-10-15,2024-10-18,584.32,0,0,37570248,-36451733,0.00786792783481227,99.6898796089928,0
319.99,320,2923,2923,2923,2923,2024-10-15,2024-10-18,584.32,0,0,37570248,-36451733,0.00778009237522201,99.697659701368,0
414.99,415,2919,2919,2919,2919,2024-10-15,2024-10-18,584.32,0,0,37570248,-36451733,0.00776944565284744,99.7054291470208,0
375.99,376,2894,2894,2894,2894,2024-10-15,2024-10-18,584.32,0,0,37570248,-36451733,0.00770290363800633,99.7131320506588,0
364.97,365,950,950,2850,2850,2024-10-15,2024-10-18,584.32,0,0,37570248,-36451733,0.00758578969188598,99.7207178403507,0
331.99,332,2823,2823,2823,2823,2024-10-15,2024-10-18,584.32,0,0,37570248,-36451733,0.00751392431585759,99.7282317646666,0
401.98,402,1383,1383,2766,2766,2024-10-15,2024-10-18,584.32,0,0,37570248,-36451733,0.00736220852201987,99.7355939731886,0
405.99,406,2756,2756,2756,2756,2024-10-15,2024-10-18,584.32,0,0,37570248,-36451733,0.00733559171608343,99.7429295649047,0
428.98,429,1372,1372,2744,2744,2024-10-15,2024-10-18,584.32,0,0,37570248,-36451733,0.0073036515489597,99.7502332164536,0
578.7,606,2,1,5460,2730,2024-10-15,2024-10-18,584.32,-1,-2730,37570248,-36451733,0.00726638802064868,99.7574996044743,-1
576.28,603,1,1,2672,2672,2024-10-15,2024-10-18,584.32,0,0,37570248,-36451733,0.00711201054621732,99.7646116150205,0
384.92,385,323,332,4199,2656,2024-10-15,2024-11-01,584.32,9,-1543,74573214,-17043443,0.00356160055003128,99.9837703119514,-0.580948795180723
583.68,610,0,1,0,2632,2024-10-15,2024-11-08,584.32,1,2632,28140084,-4440601,0.00935320591082813,99.941261724734,1
404.98,405,525,1303,2625,2606,2024-10-15,2024-10-25,584.32,778,-19,22997980,-5421377,0.0113314299777633,99.9143055172672,-0.00729086722947045
498.97,499,618,868,4326,2604,2024-10-15,2024-10-18,584.32,250,-1722,37570248,-36451733,0.00693101626584951,99.7715426312863,-0.661290322580646
380.99,381,2584,2584,2584,2584,2024-10-15,2024-10-18,584.32,0,0,37570248,-36451733,0.00687778265397663,99.7784204139403,0
584.21,610,5,1,15260,2579,2024-10-15,2024-10-18,584.32,-4,-12681,37570248,-36451733,0.00686447425100841,99.7852848881913,-4.91702210158976
487.94,488,425,425,2550,2550,2024-10-15,2024-10-18,584.32,0,0,37570248,-36451733,0.00678728551379272,99.7920721737051,0
434.99,435,2539,2539,5078,2539,2024-10-15,2024-10-18,584.32,0,-2539,37570248,-36451733,0.00675800702726264,99.7988301807324,-1
454.35,455,36,39,2808,2535,2024-10-15,2024-11-22,584.32,3,-273,16269713,-1546756,0.0155810984496162,99.9664530038114,-0.107692307692308
314.97,315,844,844,2532,2532,2024-10-15,2024-10-25,584.32,0,0,22997980,-5421377,0.0110096625877577,99.9253151798549,0
349.99,350,2429,2479,4858,2479,2024-10-15,2024-10-25,584.32,50,-2379,22997980,-5421377,0.0107792075651862,99.9360943874201,-0.959661153691004
408.99,409,2426,2426,2426,2426,2024-10-15,2024-10-18,584.32,0,0,37570248,-36451733,0.00645723712018084,99.8052874178526,0
387.99,388,2400,2400,2400,2400,2024-10-15,2024-10-18,584.32,0,0,37570248,-36451733,0.00638803342474609,99.8116754512773,0
369.71,370,82,82,2378,2378,2024-10-15,2024-11-08,584.32,0,0,28140084,-4440601,0.00845057889663726,99.9497123036307,0
422.97,423,792,792,2376,2376,2024-10-15,2024-10-18,584.32,0,0,37570248,-36451733,0.00632415309049863,99.8179996043678,0
575.76,599,1,1,2324,2324,2024-10-15,2024-11-08,584.32,0,0,28140084,-4440601,0.00825868181488015,99.9579709854455,0
579.14,602,1,1,2286,2286,2024-10-15,2024-11-15,584.32,0,0,392489350,-83095331,0.0005824361858481,100,0
432.99,433,2244,2242,6732,2242,2024-10-15,2024-10-18,584.32,-2,-4490,37570248,-36451733,0.00596748789095031,99.8239670922588,-2.00267618198037
397.99,398,2217,2217,2217,2217,2024-10-15,2024-10-18,584.32,0,0,37570248,-36451733,0.0059009458761092,99.8298680381349,0
582.15,604,0,1,0,2185,2024-10-15,2024-10-25,584.32,1,2185,22997980,-5421377,0.00950083442111003,99.9455952218412,1
579.38,601,1,1,2162,2162,2024-10-15,2024-11-08,584.32,0,0,28140084,-4440601,0.00768299056960882,99.9656539760151,0
449.4,450,26,36,1898,2160,2024-10-15,2024-11-22,584.32,10,262,16269713,-1546756,0.0132762022292587,99.9797292060407,0.121296296296296
352.97,353,707,707,2121,2121,2024-10-15,2024-10-18,584.32,0,0,37570248,-36451733,0.00564542453911936,99.835513462674,0
583.12,604,0,1,0,2088,2024-10-15,2024-11-08,584.32,1,2088,28140084,-4440601,0.00742002049460833,99.9730739965098,1
309.98,310,1040,1040,2080,2080,2024-10-15,2024-10-25,584.32,0,0,22997980,-5421377,0.00904427258393998,99.9546394944252,0
341.98,342,1030,1030,2060,2060,2024-10-15,2024-10-18,584.32,0,0,37570248,-36451733,0.00548306202290706,99.8409965246969,0
431.99,432,2051,2051,2051,2051,2024-10-15,2024-10-18,584.32,0,0,37570248,-36451733,0.00545910689756426,99.8464556315945,0
392.99,393,2033,2033,2033,2033,2024-10-15,2024-10-18,584.32,0,0,37570248,-36451733,0.00541119664687867,99.8518668282413,0
438.99,439,1960,1960,3920,1960,2024-10-15,2024-10-18,584.32,0,-1960,37570248,-36451733,0.00521689396354264,99.8570837222049,-1
414.96,415,489,490,2934,1960,2024-10-15,2024-10-25,584.32,1,-974,22997980,-5421377,0.00852248762717422,99.9631619820524,-0.496938775510204
359.95,360,172,392,1892,1960,2024-10-15,2024-11-01,584.32,220,68,74573214,-17043443,0.00262828956252308,99.9863986015139,0.0346938775510204
340.98,341,978,978,1956,1956,2024-10-15,2024-10-18,584.32,0,0,37570248,-36451733,0.00520624724116806,99.862289969446,0
409.95,410,384,384,1920,1920,2024-10-15,2024-10-25,584.32,0,0,22997980,-5421377,0.00834855930825229,99.9715105413606,0
348.93,349,272,272,1904,1904,2024-10-15,2024-10-18,584.32,0,0,37570248,-36451733,0.00506783985029857,99.8673578092964,0
404.99,405,1890,1890,1890,1890,2024-10-15,2024-10-18,584.32,0,0,37570248,-36451733,0.00503057632198755,99.8723883856183,0
496.97,497,412,619,2884,1857,2024-10-15,2024-10-18,584.32,207,-1027,37570248,-36451733,0.00494274086239729,99.8773311264807,-0.55304254173398
581.75,591,0,2,0,1850,2024-10-15,2024-11-01,584.32,2,1850,74573214,-17043443,0.00248078351564678,99.9888793850296,1
329.99,330,1872,1848,3744,1848,2024-10-15,2024-10-18,584.32,-24,-1896,37570248,-36451733,0.00491878573705449,99.8822499122178,-1.02597402597403
332.97,333,590,590,1770,1770,2024-10-15,2024-10-18,584.32,0,0,37570248,-36451733,0.00471117465075024,99.8869610868685,0
412.99,413,1731,1731,1731,1731,2024-10-15,2024-10-18,584.32,0,0,37570248,-36451733,0.00460736910759812,99.8915684559761,0
580.83,598,0,1,0,1717,2024-10-15,2024-11-22,584.32,1,1717,16269713,-1546756,0.0105533514942765,99.990282557535,1
337.99,338,1622,1622,1622,1622,2024-10-15,2024-10-18,584.32,0,0,37570248,-36451733,0.0043172459228909,99.895885701899,0
580.19,596,0,1,0,1581,2024-10-15,2024-11-22,584.32,1,1581,16269713,-1546756,0.00971744246502689,100,1
369.94,370,263,263,2104,1578,2024-10-15,2024-11-01,584.32,0,-526,74573214,-17043443,0.00211604129064358,99.9909954263202,-0.333333333333333
364.96,365,392,392,1568,1568,2024-10-15,2024-10-25,584.32,0,0,22997980,-5421377,0.00681799010173937,99.9783285314623,0
583.34,599,0,1,0,1566,2024-10-15,2024-11-01,584.32,1,1566,74573214,-17043443,0.00209994972189344,99.9930953760421,1
328.99,329,1561,1561,1561,1561,2024-10-15,2024-10-18,584.32,0,0,37570248,-36451733,0.0041548834066786,99.9000405853057,0
441.99,442,1530,1522,4590,1522,2024-10-15,2024-10-18,584.32,-8,-3068,37570248,-36451733,0.00405107786352648,99.9040916631692,-2.01576872536137
423.98,424,757,757,1514,1514,2024-10-15,2024-10-18,584.32,0,0,37570248,-36451733,0.00402978441877733,99.908121447588,0
349.96,350,380,375,2280,1500,2024-10-15,2024-11-01,584.32,-5,-780,74573214,-17043443,0.00201144609376766,99.9951068221359,-0.52
581.02,596,0,1,0,1498,2024-10-15,2024-11-08,584.32,1,1498,28140084,-4440601,0.00532336719392877,99.9783973637037,1
493.98,494,734,734,4404,1468,2024-10-15,2024-10-18,584.32,0,-2936,37570248,-36451733,0.00390734711146969,99.9120287946995,-2
486.98,487,863,729,4315,1458,2024-10-15,2024-10-18,584.32,-134,-2857,37570248,-36451733,0.00388073030553325,99.915909525005,-1.95953360768176
421.99,422,1454,1454,1454,1454,2024-10-15,2024-10-18,584.32,0,0,37570248,-36451733,0.00387008358315867,99.9197796085882,0
393.99,394,1395,1395,1395,1395,2024-10-15,2024-10-18,584.32,0,0,37570248,-36451733,0.00371304442813367,99.9234926530163,0
382.97,383,458,458,1374,1374,2024-10-15,2024-10-18,584.32,0,0,37570248,-36451733,0.00365714913566714,99.927149802152,0
583.39,597,0,1,0,1361,2024-10-15,2024-11-01,584.32,1,1361,74573214,-17043443,0.00182505208907853,99.996931874225,1
420.99,421,1342,1342,1342,1342,2024-10-15,2024-10-18,584.32,0,0,37570248,-36451733,0.00357197535667052,99.9307217775086,0
582.82,596,0,1,0,1318,2024-10-15,2024-11-01,584.32,1,1318,74573214,-17043443,0.00176739063439052,99.9986992648594,1
381.97,382,438,438,1314,1314,2024-10-15,2024-10-18,584.32,0,0,37570248,-36451733,0.00349744830004848,99.9342192258087,0
490.95,491,262,262,1310,1310,2024-10-15,2024-10-18,584.32,0,0,37570248,-36451733,0.00348680157767391,99.9377060273864,0
436.99,437,1310,1300,2620,1300,2024-10-15,2024-10-18,584.32,-10,-1320,37570248,-36451733,0.00346018477173747,99.9411662121581,-1.01538461538462
583.5,596,0,1,0,1250,2024-10-15,2024-10-18,584.32,1,1250,37570248,-36451733,0.00332710074205526,99.9444933129002,1
338.98,339,623,623,1246,1246,2024-10-15,2024-10-18,584.32,0,0,37570248,-36451733,0.00331645401968068,99.9478097669198,0
492.97,493,411,415,2466,1245,2024-10-15,2024-10-18,584.32,4,-1221,37570248,-36451733,0.00331379233908703,99.9511235592589,-0.980722891566265
359.77,360,53,53,1219,1219,2024-10-15,2024-11-08,584.32,0,0,28140084,-4440601,0.0043318989381837,99.9827292626419,0
336.97,337,403,403,1209,1209,2024-10-15,2024-10-18,584.32,0,0,37570248,-36451733,0.00321797183771584,99.9543415310966,0
384.69,385,38,38,1178,1178,2024-10-15,2024-11-08,584.32,0,0,28140084,-4440601,0.00418619930203478,99.9869154619439,0
334.99,335,1120,1120,1120,1120,2024-10-15,2024-10-18,584.32,0,0,37570248,-36451733,0.00298108226488151,99.9573226133615,0
319.99,320,869,1069,869,1069,2024-10-15,2024-10-25,584.32,200,200,22997980,-5421377,0.00464823432318838,99.9829767657855,0.187090739008419
406.99,407,1062,1062,1062,1062,2024-10-15,2024-10-18,584.32,0,0,37570248,-36451733,0.00282670479045015,99.960149318152,0
323.99,324,997,997,997,997,2024-10-15,2024-10-18,584.32,0,0,37570248,-36451733,0.00265369555186327,99.9628030137038,0
390.99,391,980,980,980,980,2024-10-15,2024-10-18,584.32,0,0,37570248,-36451733,0.00260844698177132,99.9654114606856,0
425.99,426,969,969,6783,969,2024-10-15,2024-10-18,584.32,0,-5814,37570248,-36451733,0.00257916849524123,99.9679906291808,-6
304.99,305,928,928,928,928,2024-10-15,2024-10-25,584.32,0,0,22997980,-5421377,0.00403513699898861,99.9870119027845,0
349.9,350,90,90,1170,900,2024-10-15,2024-11-08,584.32,0,-270,28140084,-4440601,0.00319828469595187,99.9901137466399,-0.3
354.98,355,445,445,890,890,2024-10-15,2024-10-18,584.32,0,0,37570248,-36451733,0.00236889572834334,99.9703595249092,0
330.98,331,441,441,882,882,2024-10-15,2024-10-18,584.32,0,0,37570248,-36451733,0.00234760228359419,99.9727071271928,0
345.98,346,440,440,880,880,2024-10-15,2024-10-18,584.32,0,0,37570248,-36451733,0.0023422789224069,99.9750494061152,0
354.81,355,41,41,779,779,2024-10-15,2024-11-08,584.32,0,0,28140084,-4440601,0.00276829308682945,99.9928820397267,0
417.99,418,777,777,777,777,2024-10-15,2024-10-18,584.32,0,0,37570248,-36451733,0.00206812582126155,99.9771175319365,0
416.99,417,771,771,771,771,2024-10-15,2024-10-18,584.32,0,0,37570248,-36451733,0.00205215573769968,99.9791696876741,0
362.98,363,378,378,756,756,2024-10-15,2024-10-18,584.32,0,0,37570248,-36451733,0.00201223052879502,99.9811819182029,0
347.98,348,362,362,724,724,2024-10-15,2024-10-18,584.32,0,0,37570248,-36451733,0.0019270567497984,99.9831089749527,0
384.99,385,702,702,1404,702,2024-10-15,2024-10-18,584.32,0,-702,37570248,-36451733,0.00186849977673823,99.9849774747295,-1
334.99,335,467,671,467,671,2024-10-15,2024-10-25,584.32,204,204,22997980,-5421377,0.00291764754991525,99.9899295503344,0.304023845007452
373.99,374,666,666,666,666,2024-10-15,2024-10-18,584.32,0,0,37570248,-36451733,0.00177267927536704,99.9867501540048,0
364.95,365,84,133,588,665,2024-10-15,2024-11-01,584.32,49,76.9999999999999,74573214,-17043443,0.000891741101570331,99.9995910059609,0.11578947368421
363.98,364,322,322,644,644,2024-10-15,2024-10-18,584.32,0,0,37570248,-36451733,0.00171412230230687,99.9884642763072,0
353.95,354,126,126,630,630,2024-10-15,2024-10-18,584.32,0,0,37570248,-36451733,0.00167685877399585,99.9901411350812,0
327.99,328,618,618,618,618,2024-10-15,2024-10-18,584.32,0,0,37570248,-36451733,0.00164491860687212,99.991786053688,0
365.99,366,584,584,584,584,2024-10-15,2024-10-18,584.32,0,0,37570248,-36451733,0.00155442146668822,99.9933404751547,0
344.99,345,535,545,1070,545,2024-10-15,2024-10-25,584.32,10,-525,22997980,-5421377,0.0023697733453112,99.9922993236797,-0.963302752293578
364.82,365,30,30,540,540,2024-10-15,2024-11-08,584.32,0,0,28140084,-4440601,0.00191897081757112,99.9948010105443,0
334.93,335,72,74,720,518,2024-10-15,2024-11-08,584.32,2,-202,28140084,-4440601,0.00184079052500341,99.9966418010693,-0.38996138996139
497.97,498,338,166,2028,498,2024-10-15,2024-10-18,584.32,-172,-1530,37570248,-36451733,0.00132551693563481,99.9946659920903,-3.07228915662651
329.93,330,71,71,710,497,2024-10-15,2024-11-08,584.32,0,-213,28140084,-4440601,0.00176616388209786,99.9984079649514,-0.428571428571428
339.99,340,437,488,874,488,2024-10-15,2024-10-25,584.32,51,-386,22997980,-5421377,0.00212192549084746,99.9944212491706,-0.790983606557377
354.99,355,487,487,974,487,2024-10-15,2024-10-25,584.32,0,-487,22997980,-5421377,0.00211757728287441,99.9965388264535,-1
329.99,330,190,470,190,470,2024-10-15,2024-10-25,584.32,280,280,22997980,-5421377,0.00204365774733259,99.9985824842008,0.595744680851064
339.92,340,56,56,560,448,2024-10-15,2024-11-08,584.32,0,-112,28140084,-4440601,0.0015920350486516,100,-0.25
366.98,367,205,205,410,410,2024-10-15,2024-10-18,584.32,0,0,37570248,-36451733,0.00109128904339412,99.9957572811337,0
495.98,496,442,165,2652,330,2024-10-15,2024-10-18,584.32,-277,-2322,37570248,-36451733,0.000878354595902588,99.9966356357296,-7.03636363636364
368.99,369,329,327,1316,327,2024-10-15,2024-10-18,584.32,-2,-989,37570248,-36451733,0.000870369554121655,99.9975060052838,-3.02446483180428
359.99,360,327,326,654,326,2024-10-15,2024-10-25,584.32,-1,-328,22997980,-5421377,0.00141751579921367,100,-1.00613496932515
354.95,355,83,61,581,305,2024-10-15,2024-11-01,584.32,-22,-276,74573214,-17043443,0.000408994039066091,100,-0.904918032786885
386.99,387,265,265,265,265,2024-10-15,2024-10-18,584.32,0,0,37570248,-36451733,0.000705345357315714,99.9982113506411,0
488.94,489,42,42,252,252,2024-10-15,2024-10-18,584.32,0,0,37570248,-36451733,0.00067074350959834,99.9988820941507,0
370.99,371,214,214,214,214,2024-10-15,2024-10-18,584.32,0,0,37570248,-36451733,0.00056959964703986,99.9994516937977,0
355.99,356,206,206,206,206,2024-10-15,2024-10-18,584.32,0,0,37570248,-36451733,0.000548306202290706,100,0
598,598,0,0,0,0,2024-10-15,2024-10-18,584.32,0,0,37570248,-36451733,0,100,
584.42,599,0,0,0,0,2024-10-15,2024-10-18,584.32,0,0,37570248,-36451733,0,100,
572.97,601,0,0,0,0,2024-10-15,2024-10-18,584.32,0,0,37570248,-36451733,0,100,
602,602,0,0,0,0,2024-10-15,2024-10-18,584.32,0,0,37570248,-36451733,0,100,
604,604,0,0,0,0,2024-10-15,2024-10-18,584.32,0,0,37570248,-36451733,0,100,
575.96,607,0,0,0,0,2024-10-15,2024-10-18,584.32,0,0,37570248,-36451733,0,100,
608,608,0,0,0,0,2024-10-15,2024-10-18,584.32,0,0,37570248,-36451733,0,100,
609,609,0,0,0,0,2024-10-15,2024-10-18,584.32,0,0,37570248,-36451733,0,100,
584.2,611,0,0,0,0,2024-10-15,2024-10-18,584.32,0,0,37570248,-36451733,0,100,
584.19,612,0,0,0,0,2024-10-15,2024-10-18,584.32,0,0,37570248,-36451733,0,100,
613,613,0,0,0,0,2024-10-15,2024-10-18,584.32,0,0,37570248,-36451733,0,100,
614,614,0,0,0,0,2024-10-15,2024-10-18,584.32,0,0,37570248,-36451733,0,100,
571.29,615,0,0,0,0,2024-10-15,2024-10-18,584.32,0,0,37570248,-36451733,0,100,
616,616,0,0,0,0,2024-10-15,2024-10-18,584.32,0,0,37570248,-36451733,0,100,
617,617,0,0,0,0,2024-10-15,2024-10-18,584.32,0,0,37570248,-36451733,0,100,
618,618,0,0,0,0,2024-10-15,2024-10-18,584.32,0,0,37570248,-36451733,0,100,
619,619,0,0,0,0,2024-10-15,2024-10-18,584.32,0,0,37570248,-36451733,0,100,
567.04,620,0,0,0,0,2024-10-15,2024-10-18,584.32,0,0,37570248,-36451733,0,100,
621,621,0,0,0,0,2024-10-15,2024-10-18,584.32,0,0,37570248,-36451733,0,100,
622,622,0,0,0,0,2024-10-15,2024-10-18,584.32,0,0,37570248,-36451733,0,100,
623,623,0,0,0,0,2024-10-15,2024-10-18,584.32,0,0,37570248,-36451733,0,100,
624,624,0,0,0,0,2024-10-15,2024-10-18,584.32,0,0,37570248,-36451733,0,100,
569.67,625,0,0,0,0,2024-10-15,2024-10-18,584.32,0,0,37570248,-36451733,0,100,
626,626,0,0,0,0,2024-10-15,2024-10-18,584.32,0,0,37570248,-36451733,0,100,
627,627,0,0,0,0,2024-10-15,2024-10-18,584.32,0,0,37570248,-36451733,0,100,
628,628,0,0,0,0,2024-10-15,2024-10-18,584.32,0,0,37570248,-36451733,0,100,
629,629,0,0,0,0,2024-10-15,2024-10-18,584.32,0,0,37570248,-36451733,0,100,
567.75,630,0,0,0,0,2024-10-15,2024-10-18,584.32,0,0,37570248,-36451733,0,100,
576.59,631,0,0,0,0,2024-10-15,2024-10-18,584.32,0,0,37570248,-36451733,0,100,
632,632,0,0,0,0,2024-10-15,2024-10-18,584.32,0,0,37570248,-36451733,0,100,
633,633,0,0,0,0,2024-10-15,2024-10-18,584.32,0,0,37570248,-36451733,0,100,
634,634,0,0,0,0,2024-10-15,2024-10-18,584.32,0,0,37570248,-36451733,0,100,
568.48,635,0,0,0,0,2024-10-15,2024-10-18,584.32,0,0,37570248,-36451733,0,100,
636,636,0,0,0,0,2024-10-15,2024-10-18,584.32,0,0,37570248,-36451733,0,100,
637,637,0,0,0,0,2024-10-15,2024-10-18,584.32,0,0,37570248,-36451733,0,100,
638,638,0,0,0,0,2024-10-15,2024-10-18,584.32,0,0,37570248,-36451733,0,100,
639,639,0,0,0,0,2024-10-15,2024-10-18,584.32,0,0,37570248,-36451733,0,100,
568.57,640,0,0,0,0,2024-10-15,2024-10-18,584.32,0,0,37570248,-36451733,0,100,
641,641,0,0,0,0,2024-10-15,2024-10-18,584.32,0,0,37570248,-36451733,0,100,
642,642,0,0,0,0,2024-10-15,2024-10-18,584.32,0,0,37570248,-36451733,0,100,
643,643,0,0,0,0,2024-10-15,2024-10-18,584.32,0,0,37570248,-36451733,0,100,
644,644,0,0,0,0,2024-10-15,2024-10-18,584.32,0,0,37570248,-36451733,0,100,
569.66,645,0,0,0,0,2024-10-15,2024-10-18,584.32,0,0,37570248,-36451733,0,100,
646,646,0,0,0,0,2024-10-15,2024-10-18,584.32,0,0,37570248,-36451733,0,100,
647,647,0,0,0,0,2024-10-15,2024-10-18,584.32,0,0,37570248,-36451733,0,100,
648,648,0,0,0,0,2024-10-15,2024-10-18,584.32,0,0,37570248,-36451733,0,100,
649,649,0,0,0,0,2024-10-15,2024-10-18,584.32,0,0,37570248,-36451733,0,100,
553.85,650,0,0,0,0,2024-10-15,2024-10-18,584.32,0,0,37570248,-36451733,0,100,
651,651,0,0,0,0,2024-10-15,2024-10-18,584.32,0,0,37570248,-36451733,0,100,
652,652,0,0,0,0,2024-10-15,2024-10-18,584.32,0,0,37570248,-36451733,0,100,
653,653,0,0,0,0,2024-10-15,2024-10-18,584.32,0,0,37570248,-36451733,0,100,
654,654,0,0,0,0,2024-10-15,2024-10-18,584.32,0,0,37570248,-36451733,0,100,
555.64,655,0,0,0,0,2024-10-15,2024-10-18,584.32,0,0,37570248,-36451733,0,100,
656,656,0,0,0,0,2024-10-15,2024-10-18,584.32,0,0,37570248,-36451733,0,100,
660,660,0,0,0,0,2024-10-15,2024-10-18,584.32,0,0,37570248,-36451733,0,100,
665,665,0,0,0,0,2024-10-15,2024-10-18,584.32,0,0,37570248,-36451733,0,100,
566.72,670,0,0,0,0,2024-10-15,2024-10-18,584.32,0,0,37570248,-36451733,0,100,
571.1,675,0,0,0,0,2024-10-15,2024-10-18,584.32,0,0,37570248,-36451733,0,100,
566.58,680,0,0,0,0,2024-10-15,2024-10-18,584.32,0,0,37570248,-36451733,0,100,
599,599,0,0,0,0,2024-10-15,2024-10-25,584.32,0,0,22997980,-5421377,0,100,
601,601,0,0,0,0,2024-10-15,2024-10-25,584.32,0,0,22997980,-5421377,0,100,
602,602,0,0,0,0,2024-10-15,2024-10-25,584.32,0,0,22997980,-5421377,0,100,
603,603,0,0,0,0,2024-10-15,2024-10-25,584.32,0,0,22997980,-5421377,0,100,
575.84,605,0,0,0,0,2024-10-15,2024-10-25,584.32,0,0,22997980,-5421377,0,100,
606,606,0,0,0,0,2024-10-15,2024-10-25,584.32,0,0,22997980,-5421377,0,100,
607,607,0,0,0,0,2024-10-15,2024-10-25,584.32,0,0,22997980,-5421377,0,100,
608,608,0,0,0,0,2024-10-15,2024-10-25,584.32,0,0,22997980,-5421377,0,100,
583.28,610,1,0,3152,0,2024-10-15,2024-10-25,584.32,-1,-3152,22997980,-5421377,0,100,-Inf
571.96,615,0,0,0,0,2024-10-15,2024-10-25,584.32,0,0,22997980,-5421377,0,100,
571.3,620,0,0,0,0,2024-10-15,2024-10-25,584.32,0,0,22997980,-5421377,0,100,
568.56,625,0,0,0,0,2024-10-15,2024-10-25,584.32,0,0,22997980,-5421377,0,100,
579.11,630,1,0,5089,0,2024-10-15,2024-10-25,584.32,-1,-5089,22997980,-5421377,0,100,-Inf
570.75,635,0,0,0,0,2024-10-15,2024-10-25,584.32,0,0,22997980,-5421377,0,100,
582.08,640,1,0,6024,0,2024-10-15,2024-10-25,584.32,-1,-6024,22997980,-5421377,0,100,-Inf
566.75,645,0,0,0,0,2024-10-15,2024-10-25,584.32,0,0,22997980,-5421377,0,100,
575.47,655,0,0,0,0,2024-10-15,2024-10-25,584.32,0,0,22997980,-5421377,0,100,
584.59,660,4,0,32500,0,2024-10-15,2024-10-25,584.32,-4,-32500,22997980,-5421377,0,100,-Inf
598,598,0,0,0,0,2024-10-15,2024-11-01,584.32,0,0,74573214,-17043443,0,100,
584.46,605,1,0,2976,0,2024-10-15,2024-11-01,584.32,-1,-2976,74573214,-17043443,0,100,-Inf
568,615,0,0,0,0,2024-10-15,2024-11-01,584.32,0,0,74573214,-17043443,0,100,
625,625,0,0,0,0,2024-10-15,2024-11-01,584.32,0,0,74573214,-17043443,0,100,
569.04,630,0,0,0,0,2024-10-15,2024-11-01,584.32,0,0,74573214,-17043443,0,100,
567.75,635,0,0,0,0,2024-10-15,2024-11-01,584.32,0,0,74573214,-17043443,0,100,
568.5,640,0,0,0,0,2024-10-15,2024-11-01,584.32,0,0,74573214,-17043443,0,100,
568.48,645,0,0,0,0,2024-10-15,2024-11-01,584.32,0,0,74573214,-17043443,0,100,
650,650,0,0,0,0,2024-10-15,2024-11-01,584.32,0,0,74573214,-17043443,0,100,
655,655,0,0,0,0,2024-10-15,2024-11-01,584.32,0,0,74573214,-17043443,0,100,
579.75,660,1,0,8025,0,2024-10-15,2024-11-01,584.32,-1,-8025,74573214,-17043443,0,100,-Inf
602,602,0,0,0,0,2024-10-15,2024-11-08,584.32,0,0,28140084,-4440601,0,100,
571.39,615,0,0,0,0,2024-10-15,2024-11-08,584.32,0,0,28140084,-4440601,0,100,
568.81,625,0,0,0,0,2024-10-15,2024-11-08,584.32,0,0,28140084,-4440601,0,100,
568.92,630,0,0,0,0,2024-10-15,2024-11-08,584.32,0,0,28140084,-4440601,0,100,
568.93,635,0,0,0,0,2024-10-15,2024-11-08,584.32,0,0,28140084,-4440601,0,100,
640,640,0,0,0,0,2024-10-15,2024-11-08,584.32,0,0,28140084,-4440601,0,100,
575.34,645,0,0,0,0,2024-10-15,2024-11-08,584.32,0,0,28140084,-4440601,0,100,
579,650,2,0,14200,0,2024-10-15,2024-11-08,584.32,-2,-14200,28140084,-4440601,0,100,-Inf
566.02,655,0,0,0,0,2024-10-15,2024-11-08,584.32,0,0,28140084,-4440601,0,100,
579.56,660,1,0,8044,0,2024-10-15,2024-11-08,584.32,-1,-8044,28140084,-4440601,0,100,-Inf
567.03,630,0,0,0,0,2024-10-15,2024-11-15,584.32,0,0,392489350,-83095331,0,100,
566.3,635,0,0,0,0,2024-10-15,2024-11-15,584.32,0,0,392489350,-83095331,0,100,
567.09,640,0,0,0,0,2024-10-15,2024-11-15,584.32,0,0,392489350,-83095331,0,100,
567.09,645,0,0,0,0,2024-10-15,2024-11-15,584.32,0,0,392489350,-83095331,0,100,
569,650,0,0,0,0,2024-10-15,2024-11-15,584.32,0,0,392489350,-83095331,0,100,
567.08,655,0,0,0,0,2024-10-15,2024-11-15,584.32,0,0,392489350,-83095331,0,100,
569.78,660,0,0,0,0,2024-10-15,2024-11-15,584.32,0,0,392489350,-83095331,0,100,
566.39,665,0,0,0,0,2024-10-15,2024-11-15,584.32,0,0,392489350,-83095331,0,100,
566.95,670,0,0,0,0,2024-10-15,2024-11-15,584.32,0,0,392489350,-83095331,0,100,
675,675,0,0,0,0,2024-10-15,2024-11-15,584.32,0,0,392489350,-83095331,0,100,
568.17,680,0,0,0,0,2024-10-15,2024-11-15,584.32,0,0,392489350,-83095331,0,100,
597,597,0,0,0,0,2024-10-15,2024-11-22,584.32,0,0,16269713,-1546756,0,100,
620,620,0,0,0,0,2024-10-15,2024-11-22,584.32,0,0,16269713,-1546756,0,100,
625,625,0,0,0,0,2024-10-15,2024-11-22,584.32,0,0,16269713,-1546756,0,100,
630,630,0,0,0,0,2024-10-15,2024-11-22,584.32,0,0,16269713,-1546756,0,100,
635,635,0,0,0,0,2024-10-15,2024-11-22,584.32,0,0,16269713,-1546756,0,100,
640,640,0,0,0,0,2024-10-15,2024-11-22,584.32,0,0,16269713,-1546756,0,100,
645,645,0,0,0,0,2024-10-15,2024-11-22,584.32,0,0,16269713,-1546756,0,100,
650,650,0,0,0,0,2024-10-15,2024-11-22,584.32,0,0,16269713,-1546756,0,100,
655,655,0,0,0,0,2024-10-15,2024-11-22,584.32,0,0,16269713,-1546756,0,100,
660,660,0,0,0,0,2024-10-15,2024-11-22,584.32,0,0,16269713,-1546756,0,100,
570.03,620,0,0,0,0,2024-10-15,2024-11-29,584.32,0,0,111401771,-12544864,0,100,
625,625,0,0,0,0,2024-10-15,2024-11-29,584.32,0,0,111401771,-12544864,0,100,
630,630,0,0,0,0,2024-10-15,2024-11-29,584.32,0,0,111401771,-12544864,0,100,
572.19,635,0,0,0,0,2024-10-15,2024-11-29,584.32,0,0,111401771,-12544864,0,100,
571.21,645,0,0,0,0,2024-10-15,2024-11-29,584.32,0,0,111401771,-12544864,0,100,
569.97,650,0,0,0,0,2024-10-15,2024-11-29,584.32,0,0,111401771,-12544864,0,100,
571.5,655,0,0,0,0,2024-10-15,2024-11-29,584.32,0,0,111401771,-12544864,0,100,
570.06,660,0,0,0,0,2024-10-15,2024-11-29,584.32,0,0,111401771,-12544864,0,100,
570.99,665,0,0,0,0,2024-10-15,2024-11-29,584.32,0,0,111401771,-12544864,0,100,
566.97,606,0,0,0,0,2024-10-15,2024-12-20,584.32,0,0,401465676,-76728253,0,100,
584.19,625,0,0,0,0,2024-10-15,2024-12-20,584.32,0,0,401465676,-76728253,0,100,
573.73,630,0,0,0,0,2024-10-15,2024-12-20,584.32,0,0,401465676,-76728253,0,100,
573.89,635,0,0,0,0,2024-10-15,2024-12-20,584.32,0,0,401465676,-76728253,0,100,
568.5,640,0,0,0,0,2024-10-15,2024-12-20,584.32,0,0,401465676,-76728253,0,100,
568.48,645,0,0,0,0,2024-10-15,2024-12-20,584.32,0,0,401465676,-76728253,0,100,
577.42,650,0,0,0,0,2024-10-15,2024-12-20,584.32,0,0,401465676,-76728253,0,100,
570.54,655,0,0,0,0,2024-10-15,2024-12-20,584.32,0,0,401465676,-76728253,0,100,
568.47,660,0,0,0,0,2024-10-15,2024-12-20,584.32,0,0,401465676,-76728253,0,100,
568.45,665,0,0,0,0,2024-10-15,2024-12-20,584.32,0,0,401465676,-76728253,0,100,
670,670,0,0,0,0,2024-10-15,2024-12-20,584.32,0,0,401465676,-76728253,0,100,
675,675,0,0,0,0,2024-10-15,2024-12-20,584.32,0,0,401465676,-76728253,0,100,
690,690,0,0,0,0,2024-10-15,2024-12-20,584.32,0,0,401465676,-76728253,0,100,
695,695,0,0,0,0,2024-10-15,2024-12-20,584.32,0,0,401465676,-76728253,0,100,
570.1,700,0,0,0,0,2024-10-15,2024-12-20,584.32,0,0,401465676,-76728253,0,100,
705,705,0,0,0,0,2024-10-15,2024-12-20,584.32,0,0,401465676,-76728253,0,100,
571.19,710,0,0,0,0,2024-10-15,2024-12-20,584.32,0,0,401465676,-76728253,0,100,
570.54,715,0,0,0,0,2024-10-15,2024-12-20,584.32,0,0,401465676,-76728253,0,100,
579.93,725,0,0,0,0,2024-10-15,2024-12-20,584.32,0,0,401465676,-76728253,0,100,
572.89,730,0,0,0,0,2024-10-15,2024-12-20,584.32,0,0,401465676,-76728253,0,100,
568.81,735,0,0,0,0,2024-10-15,2024-12-20,584.32,0,0,401465676,-76728253,0,100,
568.47,740,0,0,0,0,2024-10-15,2024-12-20,584.32,0,0,401465676,-76728253,0,100,
571.94,745,0,0,0,0,2024-10-15,2024-12-20,584.32,0,0,401465676,-76728253,0,100,
571.91,750,0,0,0,0,2024-10-15,2024-12-20,584.32,0,0,401465676,-76728253,0,100,
571.83,755,0,0,0,0,2024-10-15,2024-12-20,584.32,0,0,401465676,-76728253,0,100,
571.19,760,0,0,0,0,2024-10-15,2024-12-20,584.32,0,0,401465676,-76728253,0,100,
573.71,765,0,0,0,0,2024-10-15,2024-12-20,584.32,0,0,401465676,-76728253,0,100,
571.17,770,0,0,0,0,2024-10-15,2024-12-20,584.32,0,0,401465676,-76728253,0,100,
