Watch,strike,open_interest.yt,open_interest.td,OI_Dollar.yt,OI_Dollar.td,Date.td,expiry,stkClose,diff_oi,diff_oi_d,totalOI,totalOIdiff,OI_pct,cum_sep_OI,pct
626.19,630,81598,80244,60790510,30572964,2025-08-25,2025-09-19,645.31,-1354,-30217546,308081023,-281827335,9.92367647389953,9.92367647389953,-0.988374761439552
630.34,640,24589,30939,36047474,29887074,2025-08-25,2025-10-17,645.31,6350,-6160400,273584119,-124151124,10.9242722528057,10.9242722528057,-0.206122553181352
608.55,620,25081,25225,37646581,28882625,2025-08-25,2025-12-19,645.31,144,-8763956,332103998,-83576231,8.69686157767965,8.69686157767965,-0.303433500244524
631.7,635,85057,77737,64643320,25653210,2025-08-25,2025-09-12,645.31,-7320,-38990110,54744117,-73987580,46.8602133083999,46.8602133083999,-1.51989205249557
610.17,615,37826,47401,29277324,22894683,2025-08-25,2025-10-17,645.31,9575,-6382641,273584119,-124151124,8.36842543481115,19.2926976876169,-0.278782676309604
635.9,660,8932,8863,26420856,21359830,2025-08-25,2025-12-19,645.31,-69,-5061026,332103998,-83576231,6.43166903398736,15.128530611667,-0.236941305244471
616.41,630,15239,15590,26744445,21186810,2025-08-25,2025-12-19,645.31,351,-5557635,332103998,-83576231,6.37957089574092,21.5081015074079,-0.262315799310986
591.61,600,24243,25183,26691543,21128537,2025-08-25,2025-12-19,645.31,940,-5563006,332103998,-83576231,6.36202428373055,27.8701257911385,-0.263293478388967
612.37,625,15825,16368,25478250,20672784,2025-08-25,2025-12-19,645.31,543,-4805466,332103998,-83576231,6.22479227124511,34.0949180623836,-0.232453742079441
623.86,640,11960,12726,25295400,20539764,2025-08-25,2025-12-19,645.31,766,-4755636,332103998,-83576231,6.1847385528915,40.2796566152751,-0.231533137381715
617.49,620,82786,80901,42386432,20306151,2025-08-25,2025-09-19,645.31,-1885,-22080281,308081023,-281827335,6.59117228392221,16.5148487578217,-1.08736909323682
614.47,620,33258,33394,29034234,18466882,2025-08-25,2025-10-17,645.31,136,-10567352,273584119,-124151124,6.74998317427921,26.0426808618961,-0.572232605374313
622.77,630,25447,25445,28602428,18396735,2025-08-25,2025-10-17,645.31,-2,-10205693,273584119,-124151124,6.72434316262341,32.7670240245195,-0.554755667242041
634.01,640,33387,29636,37393440,17751964,2025-08-25,2025-09-19,645.31,-3751,-19641476,308081023,-281827335,5.76210888523309,22.2769576430548,-1.10643960296449
630.25,635,37923,36970,34358238,17560750,2025-08-25,2025-09-19,645.31,-953,-16797488,308081023,-281827335,5.70004274492428,27.9770003879791,-0.956535911051635
618.69,625,24454,27416,24013828,17299496,2025-08-25,2025-10-17,645.31,2962,-6714332,273584119,-124151124,6.32328223700733,39.0903062615268,-0.388122983467264
626.7,635,20016,20766,25540416,17235780,2025-08-25,2025-10-17,645.31,750,-8304636,273584119,-124151124,6.29999287348985,45.3902991350167,-0.481825365605734
596.66,600,43210,48994,23246980,16363996,2025-08-25,2025-10-17,645.31,5784,-6882984,273584119,-124151124,5.98133987448299,51.3716390094997,-0.42061755576083
621.92,625,54169,52450,33422273,16154600,2025-08-25,2025-09-19,645.31,-1719,-17267673,308081023,-281827335,5.24362060431096,33.2206209922901,-1.06890130365345
618.93,630,19640,14195,29361800,15713865,2025-08-25,2025-11-21,645.31,-5445,-13647935,116293910,-42898419,13.5121993920404,13.5121993920404,-0.86852820741428
600.04,610,15452,15627,19840368,15564492,2025-08-25,2025-12-19,645.31,175,-4275876,332103998,-83576231,4.68663192666533,44.9662885419404,-0.274719920187565
608.31,610,83698,83517,29545394,14114373,2025-08-25,2025-09-19,645.31,-181,-15431021,308081023,-281827335,4.5813834498985,37.8020044421886,-1.0932842004388
598.85,600,120154,116664,29317576,13416360,2025-08-25,2025-09-19,645.31,-3490,-15901216,308081023,-281827335,4.35481545385546,42.156819896044,-1.18521089177691
555.35,560,27695,27760,16921645,12908400,2025-08-25,2025-12-19,645.31,65,-4013245,332103998,-83576231,3.88685474361558,48.853143285556,-0.310901815871835
592.04,595,40317,40556,19513428,12004576,2025-08-25,2025-10-17,645.31,239,-7508852,273584119,-124151124,4.38789212030249,55.7595311298022,-0.625499142993472
605.73,610,26344,27366,18071984,11685282,2025-08-25,2025-10-17,645.31,1022,-6386702,273584119,-124151124,4.27118432265434,60.0307154524565,-0.546559509646408
573.72,580,15719,17337,12669514,10887636,2025-08-25,2025-12-19,645.31,1618,-1781878,332103998,-83576231,3.27838149060765,52.1315247761637,-0.163660688142036
545.96,550,25975,26005,13532975,10506020,2025-08-25,2025-12-19,645.31,30,-3026955,332103998,-83576231,3.16347290706208,55.2949976832257,-0.288116241926058
637.35,645,12005,12352,16518880,9449280,2025-08-25,2025-09-19,645.31,347,-7069600,308081023,-281827335,3.06714120460448,45.2239611006485,-0.748162822987571
529.13,530,107707,107851,14001910,9383037,2025-08-25,2025-10-17,645.31,144,-4618873,273584119,-124151124,3.42967166160694,63.4603871140635,-0.492257783913673
479.55,480,206443,206509,13625238,9292905,2025-08-25,2025-10-17,645.31,66,-4332333,273584119,-124151124,3.39672676687787,66.8571138809413,-0.466197921963046
536.49,540,25419,25805,11692740,9057555,2025-08-25,2025-12-19,645.31,386,-2635185,332103998,-83576231,2.72732489056034,58.0223225737861,-0.290937786190644
582.72,590,12109,12242,11430896,8912176,2025-08-25,2025-12-19,645.31,133,-2518720,332103998,-83576231,2.68354974757034,60.7058723213564,-0.28261560364158
630.44,650,4397,4548,10979309,8895888,2025-08-25,2025-12-19,645.31,151,-2083421,332103998,-83576231,2.67864525978998,63.3845175811464,-0.234200453063258
611.02,620,9686,9895,11942838,8885710,2025-08-25,2025-11-21,645.31,209,-3057128,116293910,-42898419,7.64073544349829,21.1529348355387,-0.3440499408601
622.84,635,6697,7118,11123717,8655488,2025-08-25,2025-11-21,645.31,421,-2468229,116293910,-42898419,7.4427697890629,28.5957046246016,-0.28516347085225
517.26,520,31534,31577,11005366,8652098,2025-08-25,2025-12-19,645.31,43,-2353268,332103998,-83576231,2.60523753164814,65.9897551127945,-0.27198813513208
587.38,590,31341,32044,13445289,8395528,2025-08-25,2025-10-17,645.31,703,-5049761,273584119,-124151124,3.06871905821405,69.9258329391554,-0.601482241498093
612.96,615,41765,40880,17917185,8339520,2025-08-25,2025-09-19,645.31,-885,-9577665,308081023,-281827335,2.7069242755663,47.9308853762148,-1.14846717796708
593.77,600,12500,12855,10825000,8008665,2025-08-25,2025-11-21,645.31,355,-2816335,116293910,-42898419,6.88657299423504,35.4822776188366,-0.351660982198656
577.91,580,37029,37917,12737976,7924653,2025-08-25,2025-10-17,645.31,888,-4813323,273584119,-124151124,2.89660563228818,72.8224385714436,-0.607385963776584
497.85,500,36445,36423,10058820,7830945,2025-08-25,2025-12-19,645.31,-22,-2227875,332103998,-83576231,2.35797974344169,68.3477348562362,-0.284496315578771
602.41,610,9590,9793,9925650,7432887,2025-08-25,2025-11-21,645.31,203,-2492763,116293910,-42898419,6.39146710261956,41.8737447214562,-0.335369419715381
603.62,605,50994,53100,14992236,7327800,2025-08-25,2025-09-19,645.31,2106,-7664436,308081023,-281827335,2.37853014400046,50.3094155202153,-1.04593957258659
598.19,605,9971,10628,9472450,7237668,2025-08-25,2025-11-21,645.31,657,-2234782,116293910,-42898419,6.22360018680256,48.0973449082588,-0.308771001930456
454.65,455,201523,201526,10277673,7053410,2025-08-25,2025-10-17,645.31,3,-3224263,273584119,-124151124,2.5781503786775,75.400588950121,-0.45712116550718
640.25,650,6530,6956,11068350,6782100,2025-08-25,2025-09-19,645.31,426,-4286250,308081023,-281827335,2.20140141510761,52.5108169353229,-0.631994514973238
626.49,640,4686,4865,8603496,6572615,2025-08-25,2025-11-21,645.31,179,-2030881,116293910,-42898419,5.65172759261426,53.749072500873,-0.308991322327567
636.84,640,20579,20571,17697940,6500436,2025-08-25,2025-09-05,645.31,-8,-11197504,34008892,-59743455,19.1139305567497,19.1139305567497,-1.72257737788665
504.37,505,102799,102801,9354709,6476463,2025-08-25,2025-10-17,645.31,2,-2878246,273584119,-124151124,2.36726569644198,77.767854646563,-0.444416342685815
600.71,602,48384,49769,12773376,6420201,2025-08-25,2025-09-19,645.31,1385,-6353175,308081023,-281827335,2.08393264131689,54.5947495766398,-0.989560139939544
550.59,555,14520,14440,8160240,6368040,2025-08-25,2025-12-19,645.31,-80,-1792200,332103998,-83576231,1.91748369135863,70.2652185475948,-0.281436674392749
578.26,585,9547,9280,8143591,6254720,2025-08-25,2025-12-19,645.31,-267,-1888871,332103998,-83576231,1.88336184980224,72.1485803973971,-0.30199129617313
614.88,625,5687,6133,7848060,6206596,2025-08-25,2025-11-21,645.31,446,-1641464,116293910,-42898419,5.33699142113289,59.0860639220059,-0.264470895157346
579.34,580,92305,92454,11538125,6101964,2025-08-25,2025-09-19,645.31,149,-5436161,308081023,-281827335,1.98063611337723,56.575385690017,-0.89088709799009
602.68,604,45118,45332,12723276,5983824,2025-08-25,2025-09-19,645.31,214,-6739452,308081023,-281827335,1.94228905816117,58.5176747481782,-1.12627844669228
633.79,645,3791,5176,6475028,5802296,2025-08-25,2025-10-17,645.31,1385,-672731.999999998,273584119,-124151124,2.12084532582098,79.888699972384,-0.115942378672167
620,635,3685,3738,7049405,5607000,2025-08-25,2025-12-19,645.31,53,-1442405,332103998,-83576231,1.68832655847763,73.8369069558747,-0.257250757981095
564.67,570,10368,10360,7309440,5521880,2025-08-25,2025-12-19,645.31,-8,-1787560,332103998,-83576231,1.66269603294568,75.4996029888204,-0.323723079820641
636.66,650,3920,4137,7804720,5518758,2025-08-25,2025-10-17,645.31,217,-2285962,273584119,-124151124,2.01720700023527,81.9059069726193,-0.414216749493274
638.13,640,22284,28398,16044480,5310426,2025-08-25,2025-08-29,645.31,6114,-10734054,32399846,-85165082,16.3902816081286,16.3902816081286,-2.0213169338957
558.63,560,38892,38639,8595132,5293543,2025-08-25,2025-10-17,645.31,-253,-3301589,273584119,-124151124,1.93488679801623,83.8407937706355,-0.623701177075543
569.27,575,9374,9234,7086744,5291082,2025-08-25,2025-12-19,645.31,-140,-1795662,332103998,-83576231,1.59320033238504,77.0928033212054,-0.339375197738383
601.24,605,13088,13871,8036032,5215496,2025-08-25,2025-10-17,645.31,783,-2820536,273584119,-124151124,1.90635919185061,85.7471529624861,-0.540799187651567
610.19,612,17253,28353,6745923,5131893,2025-08-25,2025-09-19,645.31,11100,-1614030,308081023,-281827335,1.66576082811826,60.1834355762964,-0.314509675084808
587.16,595,6485,6468,6491485,5070912,2025-08-25,2025-12-19,645.31,-17,-1420573,332103998,-83576231,1.52690483418992,78.6197081553954,-0.280141520894072
589.29,595,8179,8347,6551379,4766137,2025-08-25,2025-11-21,645.31,168,-1785242,116293910,-42898419,4.09835476337497,63.1844186853809,-0.374567915273942
595.92,605,5160,5167,5990760,4691636,2025-08-25,2025-12-19,645.31,7,-1299124,332103998,-83576231,1.41270084920808,80.0324090046034,-0.276902129662233
604.27,615,2674,4365,3719534,4683645,2025-08-25,2025-12-19,645.31,1691,964111,332103998,-83576231,1.41029467522399,81.4427036798274,0.205846301331548
605.52,607,31614,31614,10116480,4678872,2025-08-25,2025-09-19,645.31,0,-5437608,308081023,-281827335,1.51871477004281,61.7021503463393,-1.16216216216216
606.64,615,4925,5427,5594800,4536972,2025-08-25,2025-11-21,645.31,502,-1057828,116293910,-42898419,3.9012980129398,67.0857166983207,-0.233157268768686
589.18,590,56860,53628,9836780,4397496,2025-08-25,2025-09-19,645.31,-3232,-5439284,308081023,-281827335,1.42738295178928,63.1295332981285,-1.2369048203796
612.03,614,7795,22241,3227130,4381477,2025-08-25,2025-09-19,645.31,14446,1154347,308081023,-281827335,1.42218334558049,64.551716643709,0.263460700581105
627.3,645,2270,2435,5189220,4309950,2025-08-25,2025-12-19,645.31,165,-879270,332103998,-83576231,1.2977711879277,82.7404748677551,-0.204009327254377
559.99,565,8043,8576,5244036,4296576,2025-08-25,2025-12-19,645.31,533,-947460,332103998,-83576231,1.29374413613654,84.0342190038917,-0.220515126463491
582.65,585,18025,18102,7029750,4253970,2025-08-25,2025-10-17,645.31,77,-2775780,273584119,-124151124,1.55490385024871,87.3020568127348,-0.652515179937799
604.56,606,29070,29055,8953560,4183920,2025-08-25,2025-09-19,645.31,-15,-4769640,308081023,-281827335,1.35805833129813,65.9097749750071,-1.13999311650318
606.44,608,42474,26097,14356212,4071132,2025-08-25,2025-09-19,645.31,-16377,-10285080,308081023,-281827335,1.32144848142756,67.2312234564347,-2.52634402421734
643.28,660,2426,2415,6065000,4037880,2025-08-25,2025-09-19,645.31,-11,-2027120,308081023,-281827335,1.31065521682587,68.5418786732606,-0.50202581552696
629.31,635,7033,7089,7145528,4033641,2025-08-25,2025-09-26,645.31,56,-3111887,18921943,-7892956,21.3172664139195,21.3172664139195,-0.771483381887481
548.84,550,34207,34609,6225674,4014644,2025-08-25,2025-10-17,645.31,402,-2211030,273584119,-124151124,1.46742581940584,88.7694826321407,-0.550741236333782
573.13,575,19355,20890,5922630,3906430,2025-08-25,2025-10-17,645.31,1535,-2016200,273584119,-124151124,1.4278716229139,90.1973542550546,-0.516123417032943
629.88,645,2001,2572,4084041,3888864,2025-08-25,2025-11-21,645.31,571,-195177.000000001,116293910,-42898419,3.34399625913343,70.4297129574541,-0.0501886926362044
498.59,500,26568,26579,4994784,3747639,2025-08-25,2025-11-21,645.31,11,-1247145,116293910,-42898419,3.22255825777979,73.6522712152339,-0.332781519244516
604.25,605,59794,48873,11719624,3665475,2025-08-25,2025-09-12,645.31,-10921,-8054149,54744117,-73987580,6.69565096830405,53.5558642767039,-2.19730021347847
556.83,560,11531,11537,5096702,3657229,2025-08-25,2025-11-21,645.31,6,-1439473,116293910,-42898419,3.14481557976682,76.7970867950007,-0.393596627391941
488.03,490,17916,17937,4407336,3533589,2025-08-25,2025-12-19,645.31,21,-873747,332103998,-83576231,1.06400074111724,85.0982197450089,-0.247268994781227
594.03,595,36284,36057,7547072,3497529,2025-08-25,2025-09-19,645.31,-227,-4049543,308081023,-281827335,1.13526271950869,69.6771413927693,-1.15782971349201
524.74,525,130458,130456,5348778,3391856,2025-08-25,2025-09-19,645.31,-2,-1956922,308081023,-281827335,1.10096232704343,70.7781037198127,-0.5769472524777
529.73,530,124927,124986,5621715,3374622,2025-08-25,2025-09-19,645.31,59,-2247093,308081023,-281827335,1.09536834406058,71.8734720638733,-0.665879911883464
599.8,601,27214,27337,6803500,3280440,2025-08-25,2025-09-19,645.31,123,-3523060,308081023,-281827335,1.06479781456711,72.9382698784404,-1.0739595907866
609.03,610,26819,33528,6704750,3252216,2025-08-25,2025-09-12,645.31,6709,-3452534,54744117,-73987580,5.94075889469548,59.4966231713994,-1.06159430984904
561.56,565,9433,9356,4546706,3218464,2025-08-25,2025-11-21,645.31,-77,-1328242,116293910,-42898419,2.7675258317482,79.5646126267489,-0.412694378436422
448.67,450,23531,23880,3976739,3176040,2025-08-25,2025-12-19,645.31,349,-800699,332103998,-83576231,0.956338983910696,86.0545587289196,-0.252106081787383
568.32,570,19759,18412,5493002,3093216,2025-08-25,2025-10-17,645.31,-1347,-2399786,273584119,-124151124,1.13062703029192,91.3279812853465,-0.775822315674043
580.17,585,5994,6286,4021974,3036138,2025-08-25,2025-11-21,645.31,292,-985836,116293910,-42898419,2.61074548099724,82.1753581077461,-0.32470065589904
531.68,535,8899,8903,3879964,2955796,2025-08-25,2025-12-19,645.31,4,-924168,332103998,-83576231,0.890021203538778,86.9445799324584,-0.312662984860931
553.73,555,22762,22849,4643448,2901823,2025-08-25,2025-10-17,645.31,87,-1741625,273584119,-124151124,1.06066938775785,92.3886506731043,-0.600183057340162
559.58,560,64932,68363,4740036,2871246,2025-08-25,2025-09-19,645.31,3431,-1868790,308081023,-281827335,0.931977559682409,73.8702474381228,-0.650863771338297
522.1,525,9660,9662,3757740,2801980,2025-08-25,2025-12-19,645.31,2,-955760,332103998,-83576231,0.843705591282885,87.7882855237413,-0.34110164954782
574.43,575,54878,49053,6036580,2796021,2025-08-25,2025-09-19,645.31,-5825,-3240559,308081023,-281827335,0.907560281634095,74.7778077197569,-1.15898950687423
474.87,475,211971,211980,4451391,2755740,2025-08-25,2025-09-19,645.31,9,-1695651,308081023,-281827335,0.894485474361724,75.6722931941186,-0.615316031265649
526.89,530,8842,8850,3572168,2752350,2025-08-25,2025-12-19,645.31,8,-819818,332103998,-83576231,0.828761477300855,88.6170470010421,-0.297861100514106
584.8,590,4770,5286,3496410,2748720,2025-08-25,2025-11-21,645.31,516,-747690,116293910,-42898419,2.36359754349991,84.5389556512461,-0.272013882825461
507.53,510,11051,11055,3458963,2730585,2025-08-25,2025-12-19,645.31,4,-728378,332103998,-83576231,0.822207807326668,89.4392548083688,-0.266747967926287
541.24,545,7257,7239,3599472,2721864,2025-08-25,2025-12-19,645.31,-18,-877608,332103998,-83576231,0.819581822679533,90.2588366310483,-0.322429041274656
628.54,630,18571,18486,8802654,2698956,2025-08-25,2025-09-05,645.31,-85,-6103698,34008892,-59743455,7.9360303769967,27.0499609337464,-2.2615033368458
502.7,505,11376,11375,3355920,2616250,2025-08-25,2025-12-19,645.31,-1,-739670.000000001,332103998,-83576231,0.787780338615496,91.0466169696638,-0.282721452460583
642.29,655,2012,2047,4112528,2601737,2025-08-25,2025-09-19,645.31,35,-1510791,308081023,-281827335,0.844497650217164,76.5167908443358,-0.58068551894369
429.75,430,101768,101865,4477792,2546625,2025-08-25,2025-10-17,645.31,97,-1931167,273584119,-124151124,0.930838021339974,93.3194886944443,-0.75832405634909
641.62,645,3932,7301,4148260,2467738,2025-08-25,2025-08-29,645.31,3369,-1680522,32399846,-85165082,7.6165115105794,24.006793118708,-0.680996929171574
633.03,650,1279,1449,2948095,2458953,2025-08-25,2025-11-21,645.31,170,-489142,116293910,-42898419,2.11442972379207,86.6533853750381,-0.198922874898382
564.53,565,51189,51132,4248687,2403204,2025-08-25,2025-09-19,645.31,-57,-1845483,308081023,-281827335,0.780055836155802,77.2968466804916,-0.767926068698288
399.16,400,28376,28353,2922728,2381652,2025-08-25,2025-12-19,645.31,-23,-541076.000000001,332103998,-83576231,0.717140418165035,91.7637573878289,-0.227185163911436
633.99,635,16753,23518,8292735,2375318,2025-08-25,2025-08-29,645.31,6765,-5917417,32399846,-85165082,7.33126324118948,31.3380563598975,-2.49121044003371
635.56,640,4627,5331,4492817,2366964,2025-08-25,2025-09-12,645.31,704,-2125853,54744117,-73987580,4.32368650680766,63.8203096782071,-0.89813491037464
539.68,540,73583,73674,3826316,2357568,2025-08-25,2025-09-19,645.31,91,-1468748,308081023,-281827335,0.765242849768127,78.0620895302597,-0.622992846865923
616.54,619,9535,9532,4691220,2344872,2025-08-25,2025-09-19,645.31,-3,-2346348,308081023,-281827335,0.761121855921648,78.8232113861814,-1.00062945866555
615.69,618,9582,10057,4599360,2323167,2025-08-25,2025-09-19,645.31,475,-2276193,308081023,-281827335,0.754076631328246,79.5772880175096,-0.979780187993373
594.96,596,20257,22286,4436283,2317744,2025-08-25,2025-09-19,645.31,2029,-2118539,308081023,-281827335,0.752316380097193,80.3296043976068,-0.914052199034924
569.48,570,41574,41054,3907956,2134808,2025-08-25,2025-09-19,645.31,-520,-1773148,308081023,-281827335,0.692937195290993,81.0225415928978,-0.830588980367321
632.02,634,10853,10771,6533506,2132658,2025-08-25,2025-09-05,645.31,-82,-4400848,34008892,-59743455,6.27088350893643,33.3208444426828,-2.06355074278201
621.06,624,7345,7233,4487795,2126502,2025-08-25,2025-09-19,645.31,-112,-2361293,308081023,-281827335,0.690241151270132,81.7127827441679,-1.11041184066603
566.3,570,4521,5678,2359962,2100860,2025-08-25,2025-11-21,645.31,1157,-259102,116293910,-42898419,1.80650904247694,88.4598944175151,-0.123331397618118
644.03,650,2453,3465,3566662,2068605,2025-08-25,2025-08-29,645.31,1012,-1498057,32399846,-85165082,6.38461367995391,37.7226700398514,-0.724187072930791
575.6,580,4541,4560,2801797,2006400,2025-08-25,2025-11-21,645.31,19,-795397,116293910,-42898419,1.7252838089286,90.1851782264437,-0.396429924242424
607.33,609,11983,12003,4206033,2004501,2025-08-25,2025-09-19,645.31,20,-2201532,308081023,-281827335,0.650640854305395,82.3634235984733,-1.09829428870327
637.1,646,24,2221,37080,1976690,2025-08-25,2025-09-26,645.31,2197,1939610,18921943,-7892956,10.4465487503054,31.7638151642249,0.981241368145739
404.81,405,101011,103685,2828308,1970015,2025-08-25,2025-10-17,645.31,2674,-858293,273584119,-124151124,0.720076518768986,94.0395652132133,-0.435678408540036
595.93,597,18178,18375,4071872,1966125,2025-08-25,2025-09-19,645.31,197,-2105747,308081023,-281827335,0.638184390863958,83.0016079893373,-1.07101379617267
620.11,623,6718,6794,3983774,1963466,2025-08-25,2025-09-19,645.31,76,-2020308,308081023,-281827335,0.63732130622015,83.6389292955574,-1.02894982648032
619.29,620,26586,27017,7045290,1918207,2025-08-25,2025-09-05,645.31,431,-5127083,34008892,-59743455,5.64031018711224,38.9611546297951,-2.67285178294105
549.64,550,55553,53134,3444286,1912824,2025-08-25,2025-09-19,645.31,-2419,-1531462,308081023,-281827335,0.620883422605358,84.2598127181628,-0.800628808505121
563.44,565,11933,12207,2935518,1904292,2025-08-25,2025-10-17,645.31,274,-1031226,273584119,-124151124,0.696053560038695,94.735618773252,-0.541527244771285
636.65,644,1116,2583,1456380,1898505,2025-08-25,2025-09-19,645.31,1467,442125,308081023,-281827335,0.616235619290319,84.8760483374531,0.232880608689469
611.06,613,9835,9756,3924165,1892664,2025-08-25,2025-09-19,645.31,-79,-2031501,308081023,-281827335,0.614339689465391,85.4903880269185,-1.0733553340688
639.38,655,1289,1200,2954388,1874400,2025-08-25,2025-10-17,645.31,-89,-1079988,273584119,-124151124,0.685127487242781,95.4207462604947,-0.576177976952625
624.32,628,1801,5080,1271506,1869440,2025-08-25,2025-09-19,645.31,3279,597934,308081023,-281827335,0.606801412756929,86.0971894396754,0.319846585073605
512.42,515,7082,7058,2358306,1820964,2025-08-25,2025-12-19,645.31,-24,-537342,332103998,-83576231,0.548311375643241,92.3120687634721,-0.29508655854811
584.27,585,29983,24468,4377518,1786164,2025-08-25,2025-09-19,645.31,-5515,-2591354,308081023,-281827335,0.579770861121816,86.6769603007972,-1.45079287232303
418.99,420,17611,17617,2183764,1779317,2025-08-25,2025-12-19,645.31,6,-404447,332103998,-83576231,0.535771026761322,92.8478397902334,-0.22730463430631
619.26,622,5951,6023,3326609,1650302,2025-08-25,2025-09-19,645.31,72,-1676307,308081023,-281827335,0.535671423033414,87.2126317238307,-1.01575772191999
623.97,625,13107,15917,4692306,1639451,2025-08-25,2025-09-05,645.31,2810,-3052855,34008892,-59743455,4.82065396308707,43.7818085928821,-1.86212030734679
636.08,643,1272,2343,1603992,1621356,2025-08-25,2025-09-19,645.31,1071,17364,308081023,-281827335,0.526275842702587,87.7389075665332,0.0107095542249821
616.73,620,4710,4929,2854260,1611783,2025-08-25,2025-09-26,645.31,219,-1242477,18921943,-7892956,8.51806286489712,40.2818780291221,-0.770871140842161
539.02,540,15852,16434,2409504,1610532,2025-08-25,2025-10-17,645.31,582,-798972,273584119,-124151124,0.588678906468252,96.009425166963,-0.496091974577345
453.63,455,11028,11499,1698312,1575363,2025-08-25,2025-12-19,645.31,471,-122949,332103998,-83576231,0.474358336390759,93.3221981266242,-0.078044869658612
479.87,480,120302,120883,2526342,1571479,2025-08-25,2025-09-19,645.31,581,-954863,308081023,-281827335,0.510086270389981,88.2489938369232,-0.607620591811917
629.47,630,32885,29103,11180900,1542459,2025-08-25,2025-08-29,645.31,-3782,-9638441,32399846,-85165082,4.76069855393757,42.483368593789,-6.24875020989213
591.07,592,15029,16535,2675162,1537755,2025-08-25,2025-09-19,645.31,1506,-1137407,308081023,-281827335,0.499139799337787,88.748133636261,-0.739654236207979
635.86,655,326,801,840102,1533114,2025-08-25,2025-11-21,645.31,475,693012,116293910,-42898419,1.31830978939482,91.5034880158385,0.452029007627613
519.26,520,19874,19790,2245762,1464460,2025-08-25,2025-10-17,645.31,-84,-781302,273584119,-124151124,0.535286918463275,96.5447120854263,-0.533508597025525
478.2,480,8004,8027,1776888,1444860,2025-08-25,2025-12-19,645.31,23,-332028,332103998,-83576231,0.435062513158905,93.7572606397831,-0.229799426934097
443.71,445,10706,10716,1627312,1382364,2025-08-25,2025-12-19,645.31,10,-244948,332103998,-83576231,0.416244311518346,94.1735049513014,-0.177195007971851
499.41,500,22496,22707,1934656,1339713,2025-08-25,2025-10-17,645.31,211,-594943,273584119,-124151124,0.489689608043368,97.0344016934697,-0.444082426609281
639,645,1867,2230,2281474,1338000,2025-08-25,2025-09-12,645.31,363,-943474,54744117,-73987580,2.44409823981634,66.2644079180234,-0.705137518684604
543.93,545,12203,12294,2013495,1315458,2025-08-25,2025-10-17,645.31,91,-698037,273584119,-124151124,0.480823961861617,97.5152256553313,-0.530641799282075
642.2,646,909,3458,1045350,1314040,2025-08-25,2025-08-29,645.31,2549,268690,32399846,-85165082,4.05569828943014,46.5390668832191,0.204476271650787
619.81,620,68346,68874,10320246,1308606,2025-08-25,2025-08-29,645.31,528,-9011640,32399846,-85165082,4.0389266047746,50.5779934879937,-6.88644251975002
534.69,535,42195,42023,2067555,1302713,2025-08-25,2025-09-19,645.31,-172,-764842,308081023,-281827335,0.422847531248298,89.1709811675093,-0.587114736707164
634.7,641,1486,2054,1673236,1294020,2025-08-25,2025-09-19,645.31,568,-379216,308081023,-281827335,0.420025870921624,89.5910070384309,-0.29305265760962
613.86,616,6083,6019,2731267,1288066,2025-08-25,2025-09-19,645.31,-64,-1443201,308081023,-281827335,0.418093262433759,90.0091003008647,-1.12044025694336
593.06,594,13658,13585,2745258,1276990,2025-08-25,2025-09-19,645.31,-73,-1468268,308081023,-281827335,0.414498104286027,90.4235984051507,-1.14978817375234
630,633,4645,4256,3265435,1276800,2025-08-25,2025-09-12,645.31,-389,-1988635,54744117,-73987580,2.33230540552878,68.5967133235522,-1.55751488095238
596.88,598,10550,11121,2500350,1245552,2025-08-25,2025-09-19,645.31,571,-1254798,308081023,-281827335,0.404293645830954,90.8278920509817,-1.00742321476743
593.53,595,8416,8453,2305984,1242591,2025-08-25,2025-09-26,645.31,37,-1063393,18921943,-7892956,6.56693131355485,46.8488093426769,-0.855786819637354
433.53,435,8443,8443,1241121,1241121,2025-08-25,2025-12-19,645.31,0,0,332103998,-83576231,0.373714561545266,94.5472195128467,0
618.36,621,4592,4671,2470496,1233144,2025-08-25,2025-09-19,645.31,79,-1237352,308081023,-281827335,0.400266133886474,91.2281581848681,-1.00341241574382
631.14,633,6566,6621,3755752,1231506,2025-08-25,2025-09-05,645.31,55,-2524246,34008892,-59743455,3.6211294387362,47.4029380316183,-2.04972285965314
635.39,642,1038,1804,1258056,1192444,2025-08-25,2025-09-19,645.31,766,-65612,308081023,-281827335,0.387055323430291,91.6152135082984,-0.0550231289687398
499.83,500,69192,69175,1937376,1175975,2025-08-25,2025-09-19,645.31,-17,-761401,308081023,-281827335,0.381709651749631,91.9969231600481,-0.647463594038989
637.98,646,550,1445,778800,1158890,2025-08-25,2025-09-19,645.31,895,380090,308081023,-281827335,0.376164032667471,92.3730871927155,0.327977633770246
614.79,617,5198,5154,2458654,1139034,2025-08-25,2025-09-19,645.31,-44,-1319620,308081023,-281827335,0.369718974868504,92.742806167584,-1.15854311636
633.26,639,1029,1979,1107204,1135946,2025-08-25,2025-09-19,645.31,950,28742,308081023,-281827335,0.368716641141509,93.1115228087256,0.0253022590862594
636.02,639,3626,3774,2958816,1124652,2025-08-25,2025-09-05,645.31,148,-1834164,34008892,-59743455,3.3069351391983,50.7098731708166,-1.63087248322148
640.28,645,1914,2292,2185788,1081824,2025-08-25,2025-09-05,645.31,378,-1103964,34008892,-59743455,3.18100336817795,53.8908765389946,-1.02046543615228
637.61,643,1444,1982,1624500,1068298,2025-08-25,2025-09-12,645.31,538,-556202,54744117,-73987580,1.95143890986496,70.5481522334172,-0.520643116433804
423.95,425,9993,9994,1259118,1049370,2025-08-25,2025-12-19,645.31,1,-209748,332103998,-83576231,0.315976322573509,94.8631958354202,-0.199879927956774
640.33,643,4681,3901,4409502,1041567,2025-08-25,2025-08-29,645.31,-780,-3367935,32399846,-85165082,3.21472824284412,53.7927217308379,-3.23352698386182
627.47,630,4312,4108,2638944,1039324,2025-08-25,2025-09-12,645.31,-204,-1599620,54744117,-73987580,1.89851267488706,72.4466649083042,-1.53909656661445
468.4,470,6482,6466,1309364,1034560,2025-08-25,2025-12-19,645.31,-16,-274804,332103998,-83576231,0.311516876108188,95.1747127115284,-0.265624033405506
473.27,475,5919,5916,1254828,1023468,2025-08-25,2025-12-19,645.31,-3,-231360,332103998,-83576231,0.308176958471906,95.4828896700003,-0.226054942606901
636.92,642,1488,2002,1554960,1017016,2025-08-25,2025-09-12,645.31,514,-537944,54744117,-73987580,1.85776309078106,74.3044279990853,-0.528943497447434
639.64,642,1946,4253,1673560,1003708,2025-08-25,2025-08-29,645.31,2307,-669852,32399846,-85165082,3.0978789220171,56.890600652855,-0.667377364731575
534.07,535,10740,10746,1514340,999378,2025-08-25,2025-10-17,645.31,6,-514962,273584119,-124151124,0.365290940005184,97.8805165953364,-0.515282505718557
632.48,638,891,1769,925749,976488,2025-08-25,2025-09-19,645.31,878,50738.9999999999,308081023,-281827335,0.316958178887896,93.4284809876134,0.0519606999778798
640.85,646,564,1865,691464,960475,2025-08-25,2025-09-05,645.31,1301,269011,34008892,-59743455,2.82418786239787,56.7150644013924,0.280081209818059
624.7,625,35587,31998,8113836,959940,2025-08-25,2025-08-29,645.31,-3589,-7153896,32399846,-85165082,2.96279186018353,59.8533925130385,-7.4524407775486
613.81,615,7947,8065,2399994,959735,2025-08-25,2025-09-12,645.31,118,-1440259,54744117,-73987580,1.75312901658456,76.0575570156698,-1.50068404299103
641,644,2061,3152,2003292,945600,2025-08-25,2025-08-29,645.31,1091,-1057692,32399846,-85165082,2.91853239055519,62.7719249035937,-1.11854060913706
631.85,637,1204,1776,1200388,914640,2025-08-25,2025-09-19,645.31,572,-285748,308081023,-281827335,0.296882940433498,93.725363928047,-0.312415813872124
458.55,460,6183,6190,1112940,897550,2025-08-25,2025-12-19,645.31,7,-215390,332103998,-83576231,0.270261726870268,95.7531513968706,-0.239975488830706
554.6,555,21965,22208,1471655,888320,2025-08-25,2025-09-19,645.31,243,-583335,308081023,-281827335,0.288339733278541,94.0137036613255,-0.65667214517291
638.1,660,392,396,1129744,867240,2025-08-25,2025-11-21,645.31,4,-262504,116293910,-42898419,0.745731225306639,92.2492192411451,-0.302688990360223
623.04,625,3323,4417,1611655,865732,2025-08-25,2025-09-12,645.31,1094,-745923,54744117,-73987580,1.58141558845492,77.6389726041248,-0.861609597427379
637.57,641,849,2477,815040,849611,2025-08-25,2025-09-05,645.31,1628,34571,34008892,-59743455,2.49820252891509,59.2132669303075,0.0406903865416055
634.03,638,1795,2125,1599345,843625,2025-08-25,2025-09-12,645.31,330,-755720,54744117,-73987580,1.54103316708899,79.1800057712137,-0.895800859386576
627.87,632,2090,2035,1713800,840455,2025-08-25,2025-09-19,645.31,-55,-873345,308081023,-281827335,0.272803235920182,94.2865068972457,-1.03913356455729
638.56,647,384,981,614400,827964,2025-08-25,2025-09-19,645.31,597,213564,308081023,-281827335,0.26874878301089,94.5552556802565,0.257938750960187
633.04,640,1003,1189,1219648,827544,2025-08-25,2025-09-26,645.31,186,-392104,18921943,-7892956,4.37346206993648,51.2222714126134,-0.47381649797473
570.92,575,1937,2022,1092468,824976,2025-08-25,2025-11-21,645.31,85,-267492,116293910,-42898419,0.709388823542007,92.9586080646871,-0.32424215977192
483.16,485,4500,4472,1057500,822848,2025-08-25,2025-12-19,645.31,-28,-234652,332103998,-83576231,0.247768170499411,96.00091956737,-0.285170529672552
642.93,650,1047,1152,1576782,814464,2025-08-25,2025-09-05,645.31,105,-762318,34008892,-59743455,2.394856027653,61.6081229579605,-0.935975070721358
632.87,635,3955,3799,2507470,809187,2025-08-25,2025-09-05,645.31,-156,-1698283,34008892,-59743455,2.37933949744673,63.9874624554073,-2.09875220437303
638.3,642,1575,2183,1450575,807710,2025-08-25,2025-09-05,645.31,608,-642865,34008892,-59743455,2.37499651561715,66.3624589710244,-0.795910661004569
641.67,650,834,959,1419468,798847,2025-08-25,2025-09-12,645.31,125,-620621,54744117,-73987580,1.45923807666859,80.6392438478823,-0.776895951289796
634.53,637,3349,3218,2424676,794846,2025-08-25,2025-09-05,645.31,-131,-1629830,34008892,-59743455,2.33717111395455,68.699630084979,-2.05049783228449
643.22,648,915,1661,1204140,793958,2025-08-25,2025-08-29,645.31,746,-410182,32399846,-85165082,2.45049930175594,65.2224242053496,-0.516629343113867
625.8,627,6280,6356,2574800,762720,2025-08-25,2025-09-05,645.31,76,-1812080,34008892,-59743455,2.24270758365195,70.9423376686309,-2.37581288021817
537.61,540,3075,3163,990150,755957,2025-08-25,2025-11-21,645.31,88,-234193,116293910,-42898419,0.650040057987559,93.6086481226747,-0.309796721242081
513.29,515,4399,4418,998573,755478,2025-08-25,2025-11-21,645.31,19,-243095,116293910,-42898419,0.649628170555105,94.2582762932298,-0.321776411755207
523.08,525,3928,3928,1017352,754176,2025-08-25,2025-11-21,645.31,0,-263176,116293910,-42898419,0.648508593442253,94.9067848866721,-0.348958333333333
592.1,593,7850,8362,1515050,752580,2025-08-25,2025-09-19,645.31,512,-762470,308081023,-281827335,0.244279895162514,94.7995355754191,-1.01314146004411
609.2,611,4266,4179,1578420,752220,2025-08-25,2025-09-19,645.31,-87,-826200,308081023,-281827335,0.244163042785014,95.0436986182041,-1.09834888729361
641.3,660,360,402,928440,751740,2025-08-25,2025-10-17,645.31,42,-176700,273584119,-124151124,0.274774721116031,98.1552913164525,-0.235054673158273
618.49,620,4418,4892,1700930,738692,2025-08-25,2025-09-12,645.31,474,-962238,54744117,-73987580,1.34935412329328,81.9885979711756,-1.3026240977295
634.85,636,5596,6398,3005052,735770,2025-08-25,2025-08-29,645.31,802,-2269282,32399846,-85165082,2.27090585554018,67.4933300608898,-3.08422740802153
547.3,550,2736,2724,1028736,735480,2025-08-25,2025-11-21,645.31,-12,-293256,116293910,-42898419,0.632432085222691,95.5392169718947,-0.398727361722956
636.08,641,1432,1478,1394768,727176,2025-08-25,2025-09-12,645.31,46,-667592,54744117,-73987580,1.32831807297212,83.3169160441477,-0.918061102126583
637.35,639,3526,4406,2380050,726990,2025-08-25,2025-08-29,645.31,880,-1653060,32399846,-85165082,2.24380696130469,69.7371370221945,-2.27384145586597
633.09,637,1848,1858,1550472,726478,2025-08-25,2025-09-12,645.31,10,-823994,54744117,-73987580,1.32704305012354,84.6439590942713,-1.13423118112317
636.41,645,367,841,541325,722419,2025-08-25,2025-09-26,645.31,474,181094,18921943,-7892956,3.81789016064576,55.0401615732592,0.250677238555464
627.64,629,6339,5288,2903262,719168,2025-08-25,2025-09-05,645.31,-1051,-2184094,34008892,-59743455,2.11464695762508,73.056984626256,-3.03697328023494
638.54,648,278,759,437294,718014,2025-08-25,2025-09-19,645.31,481,280720,308081023,-281827335,0.233060119382946,95.276758737587,0.390967307044152
639.32,649,204,737,311508,713416,2025-08-25,2025-09-19,645.31,533,401908,308081023,-281827335,0.231567654850328,95.5083263924374,0.563357143658118
625.33,629,1572,1943,1139700,713081,2025-08-25,2025-09-19,645.31,371,-426619,308081023,-281827335,0.231458917221266,95.7397853096586,-0.598275651714181
631.03,636,1216,1419,1163712,705243,2025-08-25,2025-09-19,645.31,203,-458469,308081023,-281827335,0.228914781291154,95.9687000909498,-0.650086565907071
624.91,626,6333,6398,2438205,697382,2025-08-25,2025-09-05,645.31,65,-1740823,34008892,-59743455,2.05058724053698,75.107571866793,-2.49622588480919
552.09,555,2368,2364,956672,687924,2025-08-25,2025-11-21,645.31,-4,-268748,116293910,-42898419,0.591539144225179,96.1307561161199,-0.390665247905291
424.94,425,114319,114303,1028871,685818,2025-08-25,2025-09-19,645.31,-16,-343053,308081023,-281827335,0.222609621755248,96.191309712705,-0.500209968242304
590.09,591,6177,7362,1155099,669942,2025-08-25,2025-09-19,645.31,1185,-485157,308081023,-281827335,0.217456431907525,96.4087661446126,-0.724177615375659
463.46,465,4333,4333,823270,667282,2025-08-25,2025-12-19,645.31,0,-155988,332103998,-83576231,0.200925614873206,96.2018451822432,-0.233766233766234
638.99,643,1439,1649,1492243,661249,2025-08-25,2025-09-05,645.31,210,-830994,34008892,-59743455,1.94434149751189,77.0519133643048,-1.25670360182019
638.34,644,820,1167,924960,660522,2025-08-25,2025-09-12,645.31,347,-264438,54744117,-73987580,1.20656252433481,85.8505216186061,-0.400346998283176
609.58,610,15442,15602,2347184,655284,2025-08-25,2025-09-05,645.31,160,-1691900,34008892,-59743455,1.92680196696793,78.9787153312728,-2.58193394009315
544.67,545,19970,19845,1098350,654885,2025-08-25,2025-09-19,645.31,-125,-443465,308081023,-281827335,0.212569081218612,96.6213352258312,-0.677164693037709
519.76,520,27266,27234,1036108,653616,2025-08-25,2025-09-19,645.31,-32,-382492,308081023,-281827335,0.212157176587926,96.8334924024191,-0.585193752906906
469.55,470,14507,14523,884927,653535,2025-08-25,2025-10-17,645.31,16,-231392,273584119,-124151124,0.238878997212554,98.394170313665,-0.35406213898261
635.28,638,1591,2386,1221888,648992,2025-08-25,2025-09-05,645.31,795,-572896,34008892,-59743455,1.90830092318209,80.8870162544549,-0.88274739904344
632.32,636,1940,1746,1563640,642528,2025-08-25,2025-09-12,645.31,-194,-921112,54744117,-73987580,1.1736932390379,87.024214857644,-1.43357487922705
643.57,670,136,241,478176,636963,2025-08-25,2025-10-17,645.31,105,158787,273584119,-124151124,0.232821628071182,98.6269919417362,0.24928763523156
639.64,644,1266,1452,1363482,633072,2025-08-25,2025-09-05,645.31,186,-730410,34008892,-59743455,1.86148963629865,82.7485058907535,-1.15375502312533
635.71,637,3133,4843,1835938,624747,2025-08-25,2025-08-29,645.31,1710,-1211191,32399846,-85165082,1.92824064657591,71.6653776687704,-1.93869038186658
631.31,632,7123,8952,2884815,617688,2025-08-25,2025-08-29,645.31,1829,-2267127,32399846,-85165082,1.90645350598271,73.5718311747531,-3.67034328010258
601.71,603,4121,4533,1145638,584757,2025-08-25,2025-09-19,645.31,412,-560881,308081023,-281827335,0.189806238081727,97.0232986405008,-0.959169364368447
633.67,636,2412,2477,1649808,577141,2025-08-25,2025-09-05,645.31,65,-1072667,34008892,-59743455,1.69702970623095,84.4455355969845,-1.85858741624664
438.79,440,4658,4733,689384,572693,2025-08-25,2025-12-19,645.31,75,-116691,332103998,-83576231,0.172443874042131,96.3742890562853,-0.203758383636608
389.24,390,7463,7452,746300,566352,2025-08-25,2025-12-19,645.31,-11,-179948,332103998,-83576231,0.17053453237862,96.5448235886639,-0.317731728677572
629.46,634,1157,1243,1025102,564322,2025-08-25,2025-09-19,645.31,86,-460780,308081023,-281827335,0.183173242708948,97.2064718832098,-0.816519646584751
259.8,260,27776,27747,694400,554940,2025-08-25,2025-12-19,645.31,-29,-139460,332103998,-83576231,0.167098259383195,96.7119218480471,-0.251306447543879
638.9,641,1499,2633,1187208,552930,2025-08-25,2025-08-29,645.31,1134,-634278,32399846,-85165082,1.70658218560668,75.2784133603598,-1.14712169714069
492.9,495,2593,2589,684552,543690,2025-08-25,2025-12-19,645.31,-4,-140862,332103998,-83576231,0.163710766288336,96.8756326143355,-0.259085140429289
640.05,670,35,181,127365,542095,2025-08-25,2025-12-19,645.31,146,414730,332103998,-83576231,0.163230495045109,97.0388631093806,0.7650504062941
631.46,638,816,825,941664,539550,2025-08-25,2025-09-26,645.31,9,-402114,18921943,-7892956,2.85145135465211,57.8916129279113,-0.74527661940506
628.65,633,1092,1234,916188,536790,2025-08-25,2025-09-19,645.31,142,-379398,308081023,-281827335,0.174236632549743,97.3807085157595,-0.706790364947186
604.67,605,16984,16064,1970144,530112,2025-08-25,2025-09-05,645.31,-920,-1440032,34008892,-59743455,1.5587452834394,86.0042808804239,-2.71646746347942
632.2,633,3776,6522,1623680,521760,2025-08-25,2025-08-29,645.31,2746,-1101920,32399846,-85165082,1.61037802463629,76.8887913849961,-2.11192885617909
629.1,632,1584,1779,1064448,515910,2025-08-25,2025-09-12,645.31,195,-548538,54744117,-73987580,0.942402632962369,87.9666174906063,-1.06324358899808
644.2,680,142,144,539458,515520,2025-08-25,2025-11-21,645.31,2,-23938,116293910,-42898419,0.443290624590746,96.5740467407107,-0.0464346679081316
627,631,1125,1260,892125,504000,2025-08-25,2025-09-19,645.31,135,-388125,308081023,-281827335,0.163593328499172,97.5443018442587,-0.770089285714286
614.87,615,38241,37461,3785859,486993,2025-08-25,2025-08-29,645.31,-780,-3298866,32399846,-85165082,1.50307195904573,78.3918633440418,-6.77394952288842
639.58,646,480,749,603840,480858,2025-08-25,2025-09-12,645.31,269,-122982,54744117,-73987580,0.878373835128257,88.8449913257346,-0.255755337334515
641.22,649,531,616,809775,479248,2025-08-25,2025-09-12,645.31,85,-330527,54744117,-73987580,0.875432879847162,89.7204242055818,-0.689678412846793
489.85,490,30560,30925,764000,463875,2025-08-25,2025-09-19,645.31,365,-300125,308081023,-281827335,0.150569157257051,97.6948710015157,-0.646995419024522
625.31,630,927,978,784242,458682,2025-08-25,2025-09-26,645.31,51,-325560,18921943,-7892956,2.42407452553895,60.3156874534502,-0.709772783758683
344.51,345,9178,9166,559858,449134,2025-08-25,2025-12-19,645.31,-12,-110724,332103998,-83576231,0.135238962103672,97.1741020714843,-0.246527762315924
509.8,510,22447,22439,740751,448780,2025-08-25,2025-09-19,645.31,-8,-291971,308081023,-281827335,0.145669472150513,97.8405404736662,-0.65058826150898
641.86,648,689,728,945308,446992,2025-08-25,2025-09-05,645.31,39,-498316,34008892,-59743455,1.31433861473641,87.3186194951603,-1.11482084690554
274.76,275,18541,18545,574771,445080,2025-08-25,2025-12-19,645.31,4,-129691,332103998,-83576231,0.134018260147534,97.3081203316318,-0.291388065066954
624.83,627,4861,2010,2537442,436170,2025-08-25,2025-09-12,645.31,-2851,-2101272,54744117,-73987580,0.79674314593475,90.5171673515165,-4.81755278905014
626.61,627,12562,10886,3441988,424554,2025-08-25,2025-08-29,645.31,-1676,-3017434,32399846,-85165082,1.31035808009705,79.7022214241389,-7.10730319346891
615.6,619,1244,1244,741424,422960,2025-08-25,2025-09-26,645.31,0,-318464,18921943,-7892956,2.23528841620546,62.5509758696557,-0.752941176470588
612.16,615,1377,1450,710532,411800,2025-08-25,2025-09-26,645.31,73,-298732,18921943,-7892956,2.17630927225603,64.7272851419117,-0.725429820301117
599.93,600,62253,58605,2116602,410235,2025-08-25,2025-08-29,645.31,-3648,-1706367,32399846,-85165082,1.26616342559159,80.9683848497305,-4.1594866357088
359.39,360,6713,6713,496762,409493,2025-08-25,2025-12-19,645.31,0,-87269,332103998,-83576231,0.123302640879379,97.4314229725112,-0.213114754098361
642.74,647,494,954,607126,406404,2025-08-25,2025-08-29,645.31,460,-200722,32399846,-85165082,1.2543392953164,82.2227241450469,-0.493897697857304
524.18,525,4876,4885,570492,400570,2025-08-25,2025-10-17,645.31,9,-169922,273584119,-124151124,0.146415662379877,98.7734076041161,-0.424200514267169
639.16,650,37,366,66193,396744,2025-08-25,2025-09-26,645.31,329,330551,18921943,-7892956,2.09674027661958,66.8240254185313,0.83315941765975
599.37,600,9606,6276,1508142,395388,2025-08-25,2025-09-12,645.31,-3330,-1112754,54744117,-73987580,0.722247469988419,91.2394148215049,-2.81433427418131
635.77,644,429,473,585585,389279,2025-08-25,2025-09-26,645.31,44,-196306,18921943,-7892956,2.05728872558172,68.881314144113,-0.504280991268473
633.09,634,3344,4271,1571680,388661,2025-08-25,2025-08-29,645.31,927,-1183019,32399846,-85165082,1.19957668934599,83.4223008343929,-3.04383254301306
428.9,430,3521,3520,482377,387200,2025-08-25,2025-12-19,645.31,-1,-95177,332103998,-83576231,0.116589984562607,97.5480129570738,-0.245808367768595
349.47,350,7241,7288,485147,386264,2025-08-25,2025-12-19,645.31,47,-98882.9999999999,332103998,-83576231,0.116308145137115,97.6643211022109,-0.255998488080691
597.88,599,3169,3339,747884,373968,2025-08-25,2025-09-19,645.31,170,-373916,308081023,-281827335,0.121386249746386,97.9619267234126,-0.999860950669576
636.53,638,2262,2534,1438632,372498,2025-08-25,2025-08-29,645.31,272,-1066134,32399846,-85165082,1.1496906497642,84.5719914841571,-2.86212006507418
640.35,651,49,344,81291,366360,2025-08-25,2025-09-19,645.31,295,285069,308081023,-281827335,0.118916769501898,98.0808434929145,0.778111693416312
484.53,485,7612,7593,525228,356871,2025-08-25,2025-10-17,645.31,-19,-168357,273584119,-124151124,0.13044287852103,98.9038504826371,-0.471758702724514
542.44,545,1382,1393,478172,356608,2025-08-25,2025-11-21,645.31,11,-121564,116293910,-42898419,0.306643744285492,96.8806904849962,-0.34088971643934
622.66,626,1122,1044,729300,348696,2025-08-25,2025-09-19,645.31,-78,-380604,308081023,-281827335,0.113183212845927,98.1940267057605,-1.09150664188864
429.94,430,60027,58060,660297,348360,2025-08-25,2025-09-19,645.31,-1967,-311937,308081023,-281827335,0.113074150626928,98.3071008563874,-0.895444367895281
532.77,535,1544,1555,458568,346765,2025-08-25,2025-11-21,645.31,11,-111803,116293910,-42898419,0.298179844499166,97.1788703294953,-0.322417198967601
239.85,240,22964,23063,436316,345945,2025-08-25,2025-12-19,645.31,99,-90371,332103998,-83576231,0.104167670995638,97.7684887732065,-0.261229386174103
514.28,515,4709,4718,485027,339696,2025-08-25,2025-10-17,645.31,9,-145331,273584119,-124151124,0.124165101849351,99.0280155844865,-0.427826645000236
643.5,680,20,93,89000,339450,2025-08-25,2025-12-19,645.31,73,250450,332103998,-83576231,0.102211958315539,97.8707007315221,0.737811165120047
642.42,652,235,352,400910,337216,2025-08-25,2025-09-12,645.31,117,-63694,54744117,-73987580,0.615985823645671,91.8554006451506,-0.188881903587018
638.51,649,11,319,16643,334631,2025-08-25,2025-09-26,645.31,308,317988,18921943,-7892956,1.76848117553256,70.6497953196456,0.950264619834982
449.91,450,35475,37127,496650,334143,2025-08-25,2025-09-19,645.31,1652,-162507,308081023,-281827335,0.108459455485514,98.4155603118729,-0.486339680915058
633.41,655,152,154,420128,332486,2025-08-25,2025-12-19,645.31,2,-87642,332103998,-83576231,0.100115024812198,97.9708157563343,-0.263596061187539
599.72,600,11802,11872,1050378,332416,2025-08-25,2025-09-05,645.31,70,-717962,34008892,-59743455,0.977438488734064,88.2960579838943,-2.15982985175202
527.97,530,1610,1628,444360,330484,2025-08-25,2025-11-21,645.31,18,-113876,116293910,-42898419,0.28417997124699,97.4630503007423,-0.344573413538931
582.28,583,1642,4580,221670,329760,2025-08-25,2025-09-19,645.31,2938,108090,308081023,-281827335,0.107036777789458,98.5225970896624,0.32778384279476
607.65,610,1476,1396,656820,328060,2025-08-25,2025-09-26,645.31,-80,-328760,18921943,-7892956,1.73375429785408,72.3835496174996,-1.00213375602024
634.7,642.5,419,420,526264,327600,2025-08-25,2025-09-26,645.31,1,-198664,18921943,-7892956,1.73132325787051,74.1148728753702,-0.606422466422466
626.96,632,622,639,572240,322056,2025-08-25,2025-09-26,645.31,17,-250184,18921943,-7892956,1.70202394119885,75.816896816569,-0.776833842561542
299.68,300,9750,9755,380250,312160,2025-08-25,2025-12-19,645.31,5,-68090,332103998,-83576231,0.0939946528436553,98.0648104091779,-0.218125320348539
374.34,375,4675,4675,355300,308550,2025-08-25,2025-12-19,645.31,0,-46750,332103998,-83576231,0.0929076439483273,98.1577180531263,-0.151515151515152
489.47,490,5896,5817,448096,308301,2025-08-25,2025-10-17,645.31,-79,-139795,273584119,-124151124,0.112689655059985,99.1407052395465,-0.453436738771525
449.69,450,9681,9862,464688,305722,2025-08-25,2025-10-17,645.31,181,-158966,273584119,-124151124,0.11174698338393,99.2524522229304,-0.519969122274485
638.09,665,131,112,377018,301392,2025-08-25,2025-12-19,645.31,-19,-75626,332103998,-83576231,0.0907522950085051,98.2484703481347,-0.250922386791952
628.13,631,1009,1037,643742,297619,2025-08-25,2025-09-12,645.31,28,-346123,54744117,-73987580,0.543654763853438,92.399055409004,-1.16297346607575
630.32,632,1699,1771,931052,297528,2025-08-25,2025-09-05,645.31,72,-633524,34008892,-59743455,0.874853553006079,89.1709115369004,-2.12929203301874
219.86,220,21222,21222,318330,297108,2025-08-25,2025-12-19,645.31,0,-21221.9999999999,332103998,-83576231,0.0894623376379829,98.3379326857727,-0.0714285714285712
630.86,634,665,923,478135,289822,2025-08-25,2025-09-12,645.31,258,-188313,54744117,-73987580,0.529412137563567,92.9284675465676,-0.649753986929909
614.47,615,5309,5458,1088345,289274,2025-08-25,2025-09-05,645.31,149,-799071,34008892,-59743455,0.850583429768897,90.0214949666693,-2.76233259815953
627.58,628,3730,6638,1100350,278796,2025-08-25,2025-08-29,645.31,2908,-821554,32399846,-85165082,0.860485571443766,85.4324770556008,-2.94679263691014
514.78,515,12656,12655,480928,278410,2025-08-25,2025-09-19,645.31,-1,-202518,308081023,-281827335,0.0903690844989177,98.6129661741613,-0.727409216622966
634.81,639,682,653,620620,273607,2025-08-25,2025-09-12,645.31,-29,-347013,54744117,-73987580,0.499792516518259,93.4282600630859,-1.26828991948305
623.63,627,898,804,616926,270948,2025-08-25,2025-09-19,645.31,-94,-345978,308081023,-281827335,0.0879469943853049,98.7009131685466,-1.276916603924
598.32,600,1374,1582,446550,265776,2025-08-25,2025-09-26,645.31,208,-180774,18921943,-7892956,1.40459148407751,77.2214883006465,-0.680174282102222
394.18,395,3246,3222,331092,264204,2025-08-25,2025-12-19,645.31,-24,-66888,332103998,-83576231,0.0795545978341399,98.4174872836069,-0.253168006540401
504.81,505,13879,13865,430249,263435,2025-08-25,2025-09-19,645.31,-14,-166814,308081023,-281827335,0.0855083501848798,98.7864215187315,-0.633226412587545
640,665,103,104,333823,260000,2025-08-25,2025-11-21,645.31,1,-73823,116293910,-42898419,0.223571466468021,97.6866217672104,-0.283934615384615
289.65,290,7422,7422,259770,259770,2025-08-25,2025-12-19,645.31,0,0,332103998,-83576231,0.0782194738890195,98.4957067574959,0
429.31,430,3732,3762,328416,259578,2025-08-25,2025-11-21,645.31,30,-68838,116293910,-42898419,0.223208592780138,97.9098303599905,-0.265191965420799
620.12,624,263,663,179366,257244,2025-08-25,2025-09-26,645.31,400,77878,18921943,-7892956,1.35950097725165,78.5809892778982,0.302739811229805
630.38,631,3181,4090,1157884,253580,2025-08-25,2025-08-29,645.31,909,-904304,32399846,-85165082,0.782658041028961,86.2151350966298,-3.56614874990141
639.91,647,245,354,325605,250986,2025-08-25,2025-09-12,645.31,109,-74619,54744117,-73987580,0.458471181478733,93.8867312445646,-0.297303435251369
249.82,250,13904,13901,319792,250218,2025-08-25,2025-12-19,645.31,-3,-69574,332103998,-83576231,0.0753432664186114,98.5710500239145,-0.278053537315461
614.76,616,1062,1999,338778,247876,2025-08-25,2025-09-12,645.31,937,-90902,54744117,-73987580,0.452790205749414,94.339521450314,-0.366723684422857
640.78,648,325,340,456300,245480,2025-08-25,2025-09-12,645.31,15,-210820,54744117,-73987580,0.44841347975345,94.7879349300675,-0.85880723480528
518.18,520,1314,1327,317988,241514,2025-08-25,2025-11-21,645.31,13,-76474,116293910,-42898419,0.207675535202144,98.1175058951926,-0.316644169696167
414.04,415,2884,2505,331660,240480,2025-08-25,2025-12-19,645.31,-379,-91180,332103998,-83576231,0.0724110523957017,98.6434610763102,-0.379158349966733
384.28,385,3329,3338,306268,240336,2025-08-25,2025-12-19,645.31,9,-65932,332103998,-83576231,0.0723676924840875,98.7158287687943,-0.274332601025231
149.96,150,44826,59269,224130,237076,2025-08-25,2025-12-19,645.31,14443,12946,332103998,-83576231,0.0713860722628217,98.7872148410571,0.0546069614807066
509.33,510,3431,3394,336238,227398,2025-08-25,2025-10-17,645.31,-37,-108840,273584119,-124151124,0.0831181286513199,99.3355703515817,-0.478632177943518
449.16,450,2498,2626,274780,220584,2025-08-25,2025-11-21,645.31,128,-54196,116293910,-42898419,0.189678032151469,98.3071839273441,-0.245693250643746
324.49,325,4325,4325,220575,220575,2025-08-25,2025-12-19,645.31,0,0,332103998,-83576231,0.0664174479465315,98.8536322890037,0
369.2,370,2741,2741,219280,219280,2025-08-25,2025-12-19,645.31,0,0,332103998,-83576231,0.0660275098525011,98.9196597988562,0
630.13,636,395,372,416725,218364,2025-08-25,2025-09-26,645.31,-23,-198361,18921943,-7892956,1.15402524994394,79.7350145278421,-0.908396072612702
643.61,649,147,403,204624,217217,2025-08-25,2025-08-29,645.31,256,12593,32399846,-85165082,0.670426026099013,86.8855611227288,0.0579742837807354
642.86,665,80,97,244800,214758,2025-08-25,2025-10-17,645.31,17,-30042,273584119,-124151124,0.0784979774355982,99.4140683290173,-0.139887687536669
379.3,380,3070,3067,276300,214690,2025-08-25,2025-12-19,645.31,-3,-61610,332103998,-83576231,0.0646454126697987,98.9843052115259,-0.286971912990824
630.69,637,338,338,368082,213278,2025-08-25,2025-09-26,645.31,0,-154804,18921943,-7892956,1.12714640351681,80.8621609313589,-0.725832012678289
508.4,510,1304,1330,284272,212800,2025-08-25,2025-11-21,645.31,26,-71472,116293910,-42898419,0.182984646401518,98.4901685737456,-0.335864661654135
642.63,653,204,205,239292,212585,2025-08-25,2025-09-12,645.31,1,-26707,54744117,-73987580,0.388324831323885,95.1762597613913,-0.12562974810076
329.48,330,4087,4087,212524,212524,2025-08-25,2025-12-19,645.31,0,0,332103998,-83576231,0.0639932073326019,99.0482984188586,0
399.96,400,52877,52888,264385,211552,2025-08-25,2025-09-19,645.31,11,-52833.0000000001,308081023,-281827335,0.0686676504576525,98.8550891691891,-0.249740016638935
644.17,652,208,267,330512,209061,2025-08-25,2025-08-29,645.31,59,-121451,32399846,-85165082,0.64525306694359,87.5308141896724,-0.580935707759936
626.72,628,1704,1631,741240,208768,2025-08-25,2025-09-05,645.31,-73,-532472,34008892,-59743455,0.613862986186083,90.6353579528554,-2.55054414469651
620.22,621,2329,2640,689384,205920,2025-08-25,2025-09-05,645.31,311,-483464,34008892,-59743455,0.605488705718493,91.2408466585739,-2.3478243978244
586.23,587,2619,2618,421659,201586,2025-08-25,2025-09-19,645.31,-1,-220073,308081023,-281827335,0.0654327871405439,98.9205219563297,-1.09170775748316
621.11,625,552,515,399096,200335,2025-08-25,2025-09-26,645.31,-37,-198761,18921943,-7892956,1.05874433719624,81.9209052685551,-0.992143160206654
469.88,470,16398,16398,278766,196776,2025-08-25,2025-09-19,645.31,0,-81990.0000000001,308081023,-281827335,0.0638715095411768,98.9843934658708,-0.416666666666667
494.83,495,11380,11530,318640,196010,2025-08-25,2025-09-19,645.31,150,-122630,308081023,-281827335,0.063622873649053,99.0480163395199,-0.625631345339524
622.75,623,11643,7821,2235456,195525,2025-08-25,2025-08-29,645.31,-3822,-2039931,32399846,-85165082,0.60347509059148,88.1342892802639,-10.4330955120829
493.37,495,1185,1185,208560,193155,2025-08-25,2025-11-21,645.31,0,-15405,116293910,-42898419,0.166092102329348,98.656260676075,-0.0797546012269939
609.9,610,15929,19315,1083172,193150,2025-08-25,2025-08-29,645.31,3386,-890022,32399846,-85165082,0.596144808836437,88.7304340891003,-4.60793165933213
354.46,355,3529,3548,247030,191592,2025-08-25,2025-12-19,645.31,19,-55438,332103998,-83576231,0.0576903624026833,99.1059887812612,-0.289354461564157
478.87,480,1553,1660,226738,187580,2025-08-25,2025-11-21,645.31,107,-39158,116293910,-42898419,0.16129821415412,98.8175588902291,-0.208753598464655
641.47,647,342,339,471960,187467,2025-08-25,2025-09-05,645.31,-3,-284493,34008892,-59743455,0.551229366719739,91.7920760252936,-1.51756309110403
404.11,405,2103,2102,227124,187078,2025-08-25,2025-12-19,645.31,-1,-40046,332103998,-83576231,0.0563311496177773,99.162319930879,-0.214060445375726
364.21,365,2350,2350,185650,185650,2025-08-25,2025-12-19,645.31,0,0,332103998,-83576231,0.0559011638276032,99.2182210947066,0
587.17,588,2194,2191,357622,181853,2025-08-25,2025-09-19,645.31,-3,-175769,308081023,-281827335,0.0590276539038888,99.1070439934238,-0.966544406746108
643.74,652,208,216,330512,178416,2025-08-25,2025-09-05,645.31,8,-152096,34008892,-59743455,0.524615738730918,92.3166917640245,-0.85247959824231
644.9,660,5,118,11325,178180,2025-08-25,2025-08-29,645.31,113,166855,32399846,-85165082,0.549940885521493,89.2803749746218,0.936440677966102
607.56,608,3432,4005,494208,176220,2025-08-25,2025-09-05,645.31,573,-317988,34008892,-59743455,0.518158603932172,92.8348503679567,-1.80449438202247
622.81,627,391,413,302634,173047,2025-08-25,2025-09-26,645.31,22,-129587,18921943,-7892956,0.914530817474717,82.8354360860299,-0.748854357486694
633.61,641,159,234,200340,172926,2025-08-25,2025-09-26,645.31,75,-27414,18921943,-7892956,0.913891348261645,83.7493274342915,-0.158530238367857
579.05,580,1811,1814,318736,172330,2025-08-25,2025-09-26,645.31,3,-146406,18921943,-7892956,0.910741566022052,84.6600690003136,-0.84956768989729
159.95,160,29482,34457,206374,172285,2025-08-25,2025-12-19,645.31,4975,-34089,332103998,-83576231,0.0518768220309109,99.2700979167375,-0.197864004411295
628.53,629,2738,3571,865208,167837,2025-08-25,2025-08-29,645.31,833,-697371,32399846,-85165082,0.518017894282584,89.7983928689044,-4.15504924420718
629.4,631,1001,1043,513513,166880,2025-08-25,2025-09-05,645.31,42,-346633,34008892,-59743455,0.490695198185228,93.3255455661419,-2.07713926174497
539.98,540,83222,83205,665776,166410,2025-08-25,2025-08-29,645.31,-17,-499366,32399846,-85165082,0.513613552360712,90.3120064212651,-3.00081725857821
637.35,680,39,39,166335,166335,2025-08-25,2025-10-17,645.31,0,0,273584119,-124151124,0.0607984851635339,99.4748668141808,0
583.29,584,2662,2339,388652,166069,2025-08-25,2025-09-19,645.31,-323,-222583,308081023,-281827335,0.0539043263304147,99.1609483197542,-1.34030433133216
634.43,642,214,219,276488,165783,2025-08-25,2025-09-26,645.31,5,-110705,18921943,-7892956,0.87614152521229,85.5362105255258,-0.667770519293293
585.19,586,2044,2044,308644,165564,2025-08-25,2025-09-19,645.31,0,-143080,308081023,-281827335,0.053740408411978,99.2146887281662,-0.864197530864198
589.95,590,28937,33034,636614,165170,2025-08-25,2025-08-29,645.31,4097,-471444,32399846,-85165082,0.509786373675974,90.8217927949411,-2.85429557425683
610.91,612,1576,1512,430248,164808,2025-08-25,2025-09-12,645.31,-64,-265440,54744117,-73987580,0.301051526687333,95.4773112880787,-1.61060142711519
642.39,649,202,248,294920,163928,2025-08-25,2025-09-05,645.31,46,-130992,34008892,-59743455,0.482015115341011,93.807560681483,-0.799082524034942
644.4,655,116,154,228056,163240,2025-08-25,2025-09-05,645.31,38,-64816,34008892,-59743455,0.479992115003335,94.2875527964863,-0.397059544229356
619.36,623,436,447,294736,162708,2025-08-25,2025-09-26,645.31,11,-132028,18921943,-7892956,0.859890551409018,86.3961010769349,-0.811441355065516
581.3,582,2416,2312,318912,161840,2025-08-25,2025-09-19,645.31,-104,-157072,308081023,-281827335,0.0525316354847342,99.2672203636509,-0.970538803756797
622.01,623,1479,1628,491028,161172,2025-08-25,2025-09-05,645.31,149,-329856,34008892,-59743455,0.473911352360436,94.7614641488467,-2.04660859206314
643.3,651,204,209,339660,160930,2025-08-25,2025-09-05,645.31,5,-178730,34008892,-59743455,0.473199773753288,95.2346639226,-1.11060709625303
484.86,485,11205,11354,313740,158956,2025-08-25,2025-09-19,645.31,149,-154784,308081023,-281827335,0.0515955181049889,99.3188158817559,-0.973753743174211
199.91,200,17551,17581,193061,158229,2025-08-25,2025-12-19,645.31,30,-34832,332103998,-83576231,0.04764441288057,99.3177423296181,-0.22013663740528
499.99,500,155609,155543,622436,155543,2025-08-25,2025-08-29,645.31,-66,-466893,32399846,-85165082,0.480073269484059,91.3018660644251,-3.00169727985187
409.08,410,1687,1688,194005,155296,2025-08-25,2025-12-19,645.31,1,-38709,332103998,-83576231,0.0467612557919282,99.36450358541,-0.249259478672986
631.06,637.5,257,239,287326,153916,2025-08-25,2025-09-26,645.31,-18,-133410,18921943,-7892956,0.813425978505484,87.2095270554403,-0.866771485745472
643.71,675,38,49,149644,153321,2025-08-25,2025-11-21,645.31,11,3677,116293910,-42898419,0.131839233885936,98.949398124115,0.0239823637988273
464.89,465,13867,13867,235739,152537,2025-08-25,2025-09-19,645.31,0,-83202,308081023,-281827335,0.0495119752961869,99.3683278570521,-0.545454545454546
617.83,618,7237,8969,911862,152473,2025-08-25,2025-08-29,645.31,1732,-759389,32399846,-85165082,0.470597915804908,91.77246398023,-4.9804817902186
603.04,605,704,765,268928,149940,2025-08-25,2025-09-26,645.31,61,-118988,18921943,-7892956,0.792413337256116,88.0019403926965,-0.793570761637989
626.54,629,666,609,386946,149814,2025-08-25,2025-09-12,645.31,-57,-237132,54744117,-73987580,0.27366228228688,95.7509735703656,-1.58284272497897
488.73,490,1346,1156,215360,146812,2025-08-25,2025-11-21,645.31,-190,-68548,116293910,-42898419,0.126242208211935,99.075640332327,-0.466910061847805
644.57,655,58,139,111418,144977,2025-08-25,2025-08-29,645.31,81,33559,32399846,-85165082,0.447462003368781,92.2199259835988,0.231478096525656
618.34,619,1622,2181,420098,143946,2025-08-25,2025-09-05,645.31,559,-276152,34008892,-59743455,0.423259893324369,95.6579238159244,-1.91844163783641
588.78,590,1152,1152,276480,140544,2025-08-25,2025-09-26,645.31,0,-135936,18921943,-7892956,0.742756703156753,88.7446970958532,-0.967213114754098
374.82,375,7608,7608,144552,136944,2025-08-25,2025-10-17,645.31,0,-7608,273584119,-124151124,0.0500555370321038,99.5249223512129,-0.0555555555555556
625.61,628,493,570,266220,136230,2025-08-25,2025-09-12,645.31,77,-129990,54744117,-73987580,0.248848657107758,95.9998222274733,-0.954195111208984
409.8,410,6568,6768,210176,135360,2025-08-25,2025-10-17,645.31,200,-74816,273584119,-124151124,0.0494765560569691,99.5743989072699,-0.552718676122932
399.83,400,7149,7958,200172,135286,2025-08-25,2025-10-17,645.31,809,-64886,273584119,-124151124,0.0494495077033327,99.6238484149733,-0.479620951170114
632.1,639,182,196,206752,135240,2025-08-25,2025-09-26,645.31,14,-71512,18921943,-7892956,0.714725755172183,89.4594228510254,-0.528778467908903
214.89,215,10688,12130,160320,133430,2025-08-25,2025-12-19,645.31,1442,-26890,332103998,-83576231,0.0401771736575119,99.4046807590675,-0.201528891553624
623.06,624,1461,1404,490896,131976,2025-08-25,2025-09-05,645.31,-57,-358920,34008892,-59743455,0.388063215937761,96.0459870318621,-2.71958537915985
604.91,605,16068,14643,739128,131787,2025-08-25,2025-08-29,645.31,-1425,-607341,32399846,-85165082,0.406751933327091,92.6266779169259,-4.60850463247513
419.38,420,2085,2091,166800,129642,2025-08-25,2025-11-21,645.31,6,-37158,116293910,-42898419,0.111477892522489,99.1871182248494,-0.286620076826954
309.51,310,2592,2592,127008,127008,2025-08-25,2025-12-19,645.31,0,0,332103998,-83576231,0.0382434420437179,99.4429242011113,0
439.71,440,4314,4355,181188,126295,2025-08-25,2025-10-17,645.31,41,-54893,273584119,-124151124,0.0461631327365168,99.6700115477098,-0.434641118017341
628.49,634,221,229,218348,126179,2025-08-25,2025-09-26,645.31,8,-92169,18921943,-7892956,0.666839552365209,90.1262624033906,-0.730462279777142
569.7,570,3936,4121,236160,123630,2025-08-25,2025-09-12,645.31,185,-112530,54744117,-73987580,0.225832485342672,96.225654712816,-0.910215966998301
637.65,647,37,131,59200,122485,2025-08-25,2025-09-26,645.31,94,63285,18921943,-7892956,0.647317244323165,90.7735796477138,0.516675511287096
594.75,595,4850,4876,339500,121900,2025-08-25,2025-09-05,645.31,26,-217600,34008892,-59743455,0.358435670294698,96.4044227021568,-1.7850697292863
369.64,370,2898,3382,139104,121752,2025-08-25,2025-11-21,645.31,484,-17352,116293910,-42898419,0.10469335840544,99.2918115832549,-0.142519219396807
594.46,595,2452,2248,316308,121392,2025-08-25,2025-09-12,645.31,-204,-194916,54744117,-73987580,0.221744374833921,96.4473990876499,-1.6056741795176
635.14,643,154,153,208516,120258,2025-08-25,2025-09-26,645.31,-1,-88258,18921943,-7892956,0.635547839880926,91.4091274875947,-0.733905436644547
620.21,622,730,650,346750,116350,2025-08-25,2025-09-12,645.31,-80,-230400,54744117,-73987580,0.212534252767288,96.6599333404172,-1.98023205844435
642.37,670,42,42,152040,116046,2025-08-25,2025-11-21,645.31,0,-35994,116293910,-42898419,0.0997868246067227,99.3915984078616,-0.310170104958379
577.36,578,1814,1810,226750,115840,2025-08-25,2025-09-19,645.31,-4,-110910,308081023,-281827335,0.0376004983598097,99.4059283554119,-0.957441298342541
621.2,623,705,643,315840,115740,2025-08-25,2025-09-12,645.31,-62,-200100,54744117,-73987580,0.21141997778501,96.8713533182022,-1.72887506480041
164.93,165,16435,16435,115045,115045,2025-08-25,2025-12-19,645.31,0,0,332103998,-83576231,0.0346412571642694,99.4775654582755,0
169.94,170,17176,19109,137408,114654,2025-08-25,2025-12-19,645.31,1933,-22754,332103998,-83576231,0.0345235229598169,99.5120889812353,-0.198457969194271
641.1,652,3,104,5070,113360,2025-08-25,2025-09-19,645.31,101,108290,308081023,-281827335,0.0367955153148138,99.4427238707267,0.955275229357798
607.14,608,870,1317,193140,113262,2025-08-25,2025-09-12,645.31,447,-79878,54744117,-73987580,0.206893464004543,97.0782467822067,-0.705249774858293
625.67,626,1572,3393,386712,111969,2025-08-25,2025-08-29,645.31,1821,-274743,32399846,-85165082,0.345584975928589,92.9722628928545,-2.45374166063821
574.18,575,1360,1358,212160,111356,2025-08-25,2025-09-26,645.31,-2,-100804,18921943,-7892956,0.588501931329145,91.9976294189238,-0.905240849168433
615.44,616,539,1988,117502,111328,2025-08-25,2025-09-05,645.31,1449,-6173.99999999999,34008892,-59743455,0.327349682547729,96.7317723847046,-0.0554577464788731
621.17,622,1211,1335,375410,110805,2025-08-25,2025-09-05,645.31,124,-264605,34008892,-59743455,0.325811849442199,97.0575842341468,-2.38802400613691
644.92,675,20,36,76200,108288,2025-08-25,2025-10-17,645.31,16,32088,273584119,-124151124,0.0395812448455753,99.7095927925553,0.296320921985816
394.5,395,2126,2163,131812,108150,2025-08-25,2025-11-21,645.31,37,-23662,116293910,-42898419,0.0929971311481401,99.4845955390097,-0.218788719371244
644.41,665,41,51,117711,105009,2025-08-25,2025-09-19,645.31,10,-12702,308081023,-281827335,0.034084864746765,99.4768087354735,-0.120961060480531
621.77,622,3016,4546,539864,104558,2025-08-25,2025-08-29,645.31,1530,-435306,32399846,-85165082,0.322711410418432,93.2949743032729,-4.163296926108
610.89,611,10046,9424,673082,103664,2025-08-25,2025-08-29,645.31,-622,-569418,32399846,-85165082,0.319952138044113,93.614926441317,-5.49291943201111
459.9,460,9989,10018,199780,100180,2025-08-25,2025-09-19,645.31,29,-99600,308081023,-281827335,0.0325174199385854,99.5093261554121,-0.994210421241765
621.93,626,209,242,154242,98494,2025-08-25,2025-09-26,645.31,33,-55748,18921943,-7892956,0.520527939440469,92.5181573583643,-0.566004020549475
454.91,455,10921,10761,174736,96849,2025-08-25,2025-09-19,645.31,-160,-77887,308081023,-281827335,0.0314362108567784,99.5407623662688,-0.804210678478869
613.08,616,319,330,173217,96360,2025-08-25,2025-09-26,645.31,11,-76857,18921943,-7892956,0.509250027864475,93.0274073862288,-0.797602739726027
580.32,581,2108,1406,305660,95608,2025-08-25,2025-09-19,645.31,-702,-210052,308081023,-281827335,0.031033394744343,99.5717957610132,-2.19701280227596
269.75,270,3795,3795,117645,94875,2025-08-25,2025-12-19,645.31,0,-22770,332103998,-83576231,0.0285678584333092,99.5406568396687,-0.24
589.79,590,4457,4485,249592,94185,2025-08-25,2025-09-05,645.31,28,-155407,34008892,-59743455,0.27694227733147,97.3345265114782,-1.65001858045336
623.93,626,427,451,218197,93357,2025-08-25,2025-09-12,645.31,24,-124840,54744117,-73987580,0.170533392656603,97.2487801748634,-1.33723234465546
616.51,618,571,618,198137,92082,2025-08-25,2025-09-12,645.31,47,-106055,54744117,-73987580,0.168204375275612,97.416984550139,-1.15174518364067
626.15,631,159,188,142941,91180,2025-08-25,2025-09-26,645.31,29,-51761,18921943,-7892956,0.481874403701565,93.5092817899304,-0.567679315639395
627.71,633,166,172,160356,90988,2025-08-25,2025-09-26,645.31,6,-69368,18921943,-7892956,0.480859708751897,93.9901414986823,-0.762386248736097
339.54,340,1954,1954,115286,89884,2025-08-25,2025-12-19,645.31,0,-25402,332103998,-83576231,0.0270650159411812,99.5677218556098,-0.282608695652174
643.68,655,61,79,119743,89428,2025-08-25,2025-09-12,645.31,18,-30315,54744117,-73987580,0.163356365762553,97.5803409159015,-0.338987789059355
644.15,653,0,101,0,89385,2025-08-25,2025-08-29,645.31,101,89385,32399846,-85165082,0.275880940915583,93.8908073822326,1
579.62,580,2227,2351,169252,89338,2025-08-25,2025-09-12,645.31,124,-79914,54744117,-73987580,0.16319196453566,97.7435328804372,-0.894512973202892
619.34,621,424,532,170448,88312,2025-08-25,2025-09-12,645.31,108,-82136,54744117,-73987580,0.161317790549074,97.9048506709863,-0.930066129178367
294.54,295,1919,1919,88274,88274,2025-08-25,2025-12-19,645.31,0,0,332103998,-83576231,0.0265802280404947,99.5943020836503,0
324.93,325,11895,12425,118950,86975,2025-08-25,2025-10-17,645.31,530,-31975,273584119,-124151124,0.0317909534800154,99.7413837460354,-0.36763437769474
641.55,675,30,26,124500,86970,2025-08-25,2025-12-19,645.31,-4,-37530,332103998,-83576231,0.0261875799519884,99.6204896636023,-0.431528113142463
194.93,195,12307,12227,135377,85589,2025-08-25,2025-12-19,645.31,-80,-49788,332103998,-83576231,0.0257717463551884,99.6462614099575,-0.58171026650621
588.15,589,1044,989,176436,84065,2025-08-25,2025-09-19,645.31,-55,-92371,308081023,-281827335,0.0272866530957994,99.599082414109,-1.09880449652055
645.49,657,0,72,0,82872,2025-08-25,2025-08-29,645.31,72,82872,32399846,-85165082,0.255778993517438,94.1465863757501,1
575.39,576,1246,1337,155750,81557,2025-08-25,2025-09-19,645.31,91,-74193,308081023,-281827335,0.0264725815325535,99.6255549956415,-0.909707321259978
174.94,175,8571,13468,77139,80808,2025-08-25,2025-12-19,645.31,4897,3669,332103998,-83576231,0.0243321370674978,99.670593547025,0.0454039204039204
611.87,613,693,697,194733,78761,2025-08-25,2025-09-12,645.31,4,-115972,54744117,-73987580,0.143871167015079,98.0487218380013,-1.47245464125646
584.8,585,4035,3908,189645,78160,2025-08-25,2025-09-05,645.31,-127,-111485,34008892,-59743455,0.229822247663935,97.5643487591422,-1.42636898669396
179.93,180,11201,11143,100809,78001,2025-08-25,2025-12-19,645.31,-58,-22808,332103998,-83576231,0.0234869199015183,99.6940804669265,-0.292406507608876
589.53,590,1361,1656,149710,77832,2025-08-25,2025-09-12,645.31,295,-71878,54744117,-73987580,0.142174181017478,98.1908960190188,-0.923501901531504
597.93,598,10958,11114,328740,77798,2025-08-25,2025-08-29,645.31,156,-250942,32399846,-85165082,0.240118425254244,94.3867048010043,-3.22555849764775
459.99,460,76712,77130,153424,77130,2025-08-25,2025-08-29,645.31,418,-76294,32399846,-85165082,0.238056687059562,94.6247614880639,-0.989161156489044
624.42,629,168,168,138768,76944,2025-08-25,2025-09-26,645.31,0,-61824,18921943,-7892956,0.406639001079329,94.3967804997616,-0.803493449781659
605.78,608,149,341,59600,75702,2025-08-25,2025-09-26,645.31,192,16102,18921943,-7892956,0.400075193123666,94.7968556928853,0.21270243850889
645.4,670,27,30,95661,73800,2025-08-25,2025-09-19,645.31,3,-21861,308081023,-281827335,0.0239547373873788,99.6495097330289,-0.296219512195122
444.92,445,9378,9212,112536,73696,2025-08-25,2025-09-19,645.31,-166,-38840,308081023,-281827335,0.0239209800338789,99.6734307130628,-0.527029960920538
641.8,651,80,80,140160,73600,2025-08-25,2025-09-12,645.31,0,-66560,54744117,-73987580,0.134443669992887,98.3253396890117,-0.904347826086956
204.88,205,6002,6002,72024,72024,2025-08-25,2025-12-19,645.31,0,0,332103998,-83576231,0.021687182459032,99.7157676493855,0
617.5,619,440,477,163680,71550,2025-08-25,2025-09-12,645.31,37,-92130,54744117,-73987580,0.130698975380313,98.456038664392,-1.28763102725367
464.48,465,1368,1368,77976,71136,2025-08-25,2025-10-17,645.31,0,-6839.99999999999,273584119,-124151124,0.0260015092469603,99.7673852552823,-0.096153846153846
594.94,595,11507,11702,310689,70212,2025-08-25,2025-08-29,645.31,195,-240477,32399846,-85165082,0.216704733720031,94.8414662217839,-3.42501281832166
483.8,485,383,582,60514,69840,2025-08-25,2025-11-21,645.31,199,9326,116293910,-42898419,0.0600547354543329,99.5446502744641,0.133533791523482
224.88,225,5826,5776,93216,69312,2025-08-25,2025-12-19,645.31,-50,-23904,332103998,-83576231,0.020870570790298,99.7366382201758,-0.344875346260388
209.88,210,5757,5762,80598,69144,2025-08-25,2025-12-19,645.31,5,-11454,332103998,-83576231,0.0208199842267482,99.7574582044026,-0.165654286706005
615.59,617,610,489,199470,68949,2025-08-25,2025-09-12,645.31,-121,-130521,54744117,-73987580,0.125947779923092,98.5819864443151,-1.89300787538616
439.93,440,10073,9780,110803,68460,2025-08-25,2025-09-19,645.31,-293,-42343,308081023,-281827335,0.0222214271211375,99.6956521401839,-0.618507157464213
184.93,185,6261,9699,62610,67893,2025-08-25,2025-12-19,645.31,3438,5283,332103998,-83576231,0.0204432949945999,99.7779014993972,0.0778136184879148
189.92,190,8480,8475,84800,67800,2025-08-25,2025-12-19,645.31,-5,-17000,332103998,-83576231,0.020415291718349,99.7983167911156,-0.250737463126844
319.6,320,1695,1695,83055,67800,2025-08-25,2025-12-19,645.31,0,-15255,332103998,-83576231,0.020415291718349,99.8187320828339,-0.225
608.55,609,709,1504,99260,67680,2025-08-25,2025-09-05,645.31,795,-31580,34008892,-59743455,0.19900677740398,97.7633555365462,-0.46660756501182
644.4,651,67,102,106597,67320,2025-08-25,2025-08-29,645.31,35,-39277,32399846,-85165082,0.207778765368206,95.0492449871521,-0.583437314319667
564.7,565,1052,2239,53652,67170,2025-08-25,2025-09-12,645.31,1187,13518,54744117,-73987580,0.122698115671498,98.7046845599866,0.201250558284949
574.82,575,3742,3723,134712,67014,2025-08-25,2025-09-05,645.31,-19,-67698,34008892,-59743455,0.19704846603059,97.9604040025767,-1.01020682245501
384.85,385,4226,4428,114102,66420,2025-08-25,2025-10-17,645.31,202,-47682,273584119,-124151124,0.0242777249800819,99.7916629802624,-0.717886178861789
579.83,580,3766,3864,161938,65688,2025-08-25,2025-09-05,645.31,98,-96250,34008892,-59743455,0.193149485728615,98.1535534883054,-1.4652600170503
578.33,579,994,974,127232,65258,2025-08-25,2025-09-19,645.31,-20,-61974,308081023,-281827335,0.0211820901412678,99.7168342303252,-0.949676667994728
615.87,616,4133,5015,454630,65195,2025-08-25,2025-08-29,645.31,882,-389435,32399846,-85165082,0.201220092218957,95.2504650793711,-5.97338752971854
304.67,305,1920,1945,88320,64185,2025-08-25,2025-12-19,645.31,25,-24135,332103998,-83576231,0.0193267772705344,99.8380588601044,-0.376022435148399
645.9,710,0,10,0,64100,2025-08-25,2025-12-19,645.31,10,64100,332103998,-83576231,0.0193011828782621,99.8573600429827,1
473.92,475,632,593,87216,64044,2025-08-25,2025-11-21,645.31,-39,-23172,116293910,-42898419,0.0550708115326073,99.5997210859967,-0.361813753044782
611.21,614,222,228,111000,63612,2025-08-25,2025-09-26,645.31,6,-47388,18921943,-7892956,0.336181120511778,95.133036813397,-0.744953782305226
645,656,2,57,4048,62700,2025-08-25,2025-08-29,645.31,55,58652,32399846,-85165082,0.193519438333133,95.4439845177042,0.935438596491228
234.85,235,4115,4115,69955,61725,2025-08-25,2025-12-19,645.31,0,-8230,332103998,-83576231,0.0185860454471253,99.8759460884298,-0.133333333333333
616.41,617,1014,1042,235248,61478,2025-08-25,2025-09-05,645.31,28,-173770,34008892,-59743455,0.180770370290217,98.3343238585956,-2.82653957513257
613.91,617,162,196,82620,60564,2025-08-25,2025-09-26,645.31,34,-22056,18921943,-7892956,0.320072838185804,95.4531096515828,-0.364176738656628
622.17,624,564,325,262260,59475,2025-08-25,2025-09-12,645.31,-239,-202785,54744117,-73987580,0.108641810772105,98.8133263707587,-3.40958385876419
646,700,10,11,55250,59400,2025-08-25,2025-12-19,645.31,1,4150,332103998,-83576231,0.0178859635408545,99.8938320519707,0.0698653198653199
569.24,570,791,781,106785,59356,2025-08-25,2025-09-26,645.31,-10,-47429,18921943,-7892956,0.313688715794144,95.766798367377,-0.799059909697419
583.9,585,328,533,66912,58630,2025-08-25,2025-09-26,645.31,205,-8281.99999999999,18921943,-7892956,0.309851900515713,96.0766502678927,-0.141258741258741
409.96,410,14657,14638,117256,58552,2025-08-25,2025-09-19,645.31,-19,-58704,308081023,-281827335,0.0190053900204038,99.7358396203456,-1.00259598305779
645.04,660,21,39,51051,58344,2025-08-25,2025-09-05,645.31,18,7293.00000000001,34008892,-59743455,0.171555133286906,98.5058789918825,0.125
623.73,624,2422,2154,513464,58158,2025-08-25,2025-08-29,645.31,-268,-455306,32399846,-85165082,0.179500853183068,95.6234853708873,-7.82877678049452
557.97,558,19010,19119,209110,57357,2025-08-25,2025-08-29,645.31,109,-151753,32399846,-85165082,0.177028619210104,95.8005139900974,-2.64576250501247
641,660,15,30,32895,57000,2025-08-25,2025-09-26,645.31,15,24105,18921943,-7892956,0.301237563182597,96.3778878310753,0.422894736842105
454.09,455,612,616,74052,56056,2025-08-25,2025-11-21,645.31,4,-17996,116293910,-42898419,0.0482020081705052,99.6479230941672,-0.321036106750392
623.36,628,114,119,90060,55216,2025-08-25,2025-09-26,645.31,5,-34844,18921943,-7892956,0.291809355941935,96.6696971870172,-0.631048971312663
608.03,609,559,557,127452,54029,2025-08-25,2025-09-12,645.31,-2,-73423,54744117,-73987580,0.0986937098647513,98.9120200806235,-1.35895537581669
334.56,335,1229,1219,74969,53636,2025-08-25,2025-12-19,645.31,-10,-21333,332103998,-83576231,0.0161503626342975,99.909982414605,-0.397736594824372
584.54,585,989,1160,89010,53360,2025-08-25,2025-09-12,645.31,171,-35650,54744117,-73987580,0.0974716607448432,99.0094917413683,-0.668103448275862
459.64,460,1427,1447,81339,52092,2025-08-25,2025-10-17,645.31,20,-29247,273584119,-124151124,0.0190405788868176,99.8107035591492,-0.561448974890578
579.95,580,10415,10219,166640,51095,2025-08-25,2025-08-29,645.31,-196,-115545,32399846,-85165082,0.157701366852176,95.9582153569495,-2.26137586848028
612.53,613,910,1072,164710,50384,2025-08-25,2025-09-05,645.31,162,-114326,34008892,-59743455,0.148149489845185,98.6540284817277,-2.26909336297237
615.82,622.5,75,75,50100,50100,2025-08-25,2025-09-26,645.31,0,0,18921943,-7892956,0.264771963428914,96.9344691504461,0
607.9,608,4864,5007,282112,50070,2025-08-25,2025-08-29,645.31,143,-232042,32399846,-85165082,0.15453777156842,96.112753128518,-4.63435190732974
424.75,425,1892,1990,70004,49750,2025-08-25,2025-10-17,645.31,98,-20254,273584119,-124151124,0.0181845350460565,99.8288880941953,-0.407115577889447
612.77,614,406,404,115304,49692,2025-08-25,2025-09-12,645.31,-2,-65612,54744117,-73987580,0.0907713974087846,99.1002631387771,-1.32037350076471
611.54,612,857,1077,147404,49542,2025-08-25,2025-09-05,645.31,220,-97862,34008892,-59743455,0.145673666757506,98.7997021484852,-1.9753340599895
434.93,435,7114,7033,71140,49231,2025-08-25,2025-09-19,645.31,-81,-21909,308081023,-281827335,0.0159798872129816,99.7518195075586,-0.445024476447767
409.44,410,867,867,65025,48552,2025-08-25,2025-11-21,645.31,0,-16473,116293910,-42898419,0.0417493916921359,99.6896724858593,-0.339285714285714
584.95,585,9364,9565,177916,47825,2025-08-25,2025-08-29,645.31,201,-130091,32399846,-85165082,0.14760872628839,96.2603618548064,-2.72014636696289
374.62,375,1244,1254,64688,47652,2025-08-25,2025-11-21,645.31,10,-17036,116293910,-42898419,0.0409754904620543,99.7306479763214,-0.357508604046
610.03,611,452,488,115712,47336,2025-08-25,2025-09-12,645.31,36,-68376,54744117,-73987580,0.0864677386247731,99.1867308774019,-1.44448200101403
618.32,622,114,126,75354,46368,2025-08-25,2025-09-26,645.31,12,-28986,18921943,-7892956,0.245048830344748,97.1795179807909,-0.625129399585922
576.37,577,763,729,96138,45927,2025-08-25,2025-09-19,645.31,-34,-50211,308081023,-281827335,0.0149074420594871,99.7667269496181,-1.09327846364883
613.85,614,2015,3048,189410,45720,2025-08-25,2025-08-29,645.31,1033,-143690,32399846,-85165082,0.141111781827605,96.401473636634,-3.1428258967629
574.66,575,652,1339,41728,45526,2025-08-25,2025-09-12,645.31,687,3798.00000000001,54744117,-73987580,0.0831614472839155,99.2698923246858,0.0834248561261698
314.64,315,1259,1259,57914,45324,2025-08-25,2025-12-19,645.31,0,-12590,332103998,-83576231,0.0136475321805671,99.9236299467855,-0.277777777777778
414.78,415,2051,2048,63581,45056,2025-08-25,2025-10-17,645.31,-3,-18525,273584119,-124151124,0.0164687921816105,99.8453568863769,-0.411155007102273
414.96,415,11170,11144,89360,44576,2025-08-25,2025-09-19,645.31,-26,-44784,308081023,-281827335,0.0144689210539268,99.781195870672,-1.00466618808327
644.66,685,3,11,14526,44374,2025-08-25,2025-12-19,645.31,8,29848,332103998,-83576231,0.0133614772081124,99.9369914239936,0.67264614413846
494.45,495,820,805,65600,44275,2025-08-25,2025-10-17,645.31,-15,-21325,273584119,-124151124,0.0161833223952594,99.8615402087721,-0.481648785996612
503.45,505,276,283,56028,43865,2025-08-25,2025-11-21,645.31,7,-12163,116293910,-42898419,0.037719086063922,99.7683670623853,-0.277282571526274
574.97,575,14716,14610,220740,43830,2025-08-25,2025-08-29,645.31,-106,-176910,32399846,-85165082,0.135278420767802,96.5367520574018,-4.0362765229295
620.8,621,2459,2155,398358,43100,2025-08-25,2025-08-29,645.31,-304,-355258,32399846,-85165082,0.133025323638884,96.6697773810407,-8.24264501160093
474.57,475,999,989,64935,42527,2025-08-25,2025-10-17,645.31,-10,-22408,273584119,-124151124,0.0155443964201738,99.8770846051923,-0.526912314529593
394.96,395,2097,10245,10485,40980,2025-08-25,2025-09-19,645.31,8148,30495,308081023,-281827335,0.0133016956386827,99.7944975663107,0.744143484626647
611.89,612,3576,3703,286080,40733,2025-08-25,2025-08-29,645.31,127,-245347,32399846,-85165082,0.125719733359226,96.7954971143999,-6.02329806299561
643,657,1,29,2368,40600,2025-08-25,2025-09-19,645.31,28,38232,308081023,-281827335,0.0131783514624333,99.8076759177731,0.941674876847291
569.97,570,13073,13507,183022,40521,2025-08-25,2025-08-29,645.31,434,-142501,32399846,-85165082,0.125065409261513,96.9205625236614,-3.51671972557439
609.42,612,41,157,19639,40506,2025-08-25,2025-09-26,645.31,116,20867,18921943,-7892956,0.214068925162707,97.3935869059536,0.515158248160766
468.98,470,253,394,31878,40188,2025-08-25,2025-11-21,645.31,141,8310,116293910,-42898419,0.0345572695939108,99.8029243319792,0.206778142729173
627.32,632.5,75,76,71100,39368,2025-08-25,2025-09-26,645.31,1,-31732,18921943,-7892956,0.208054743638114,97.6016416495917,-0.806035358666938
610.51,611,723,801,122187,39249,2025-08-25,2025-09-05,645.31,78,-82938,34008892,-59743455,0.115408052693984,98.9151102011792,-2.11312390124589
349.86,350,2652,2652,37128,37128,2025-08-25,2025-10-17,645.31,0,0,273584119,-124151124,0.0135709631595977,99.8906555683519,0
279.76,280,1547,1545,51051,37080,2025-08-25,2025-12-19,645.31,-2,-13971,332103998,-83576231,0.0111651772406546,99.9481566012343,-0.376779935275081
637.36,690,7,7,36848,36848,2025-08-25,2025-09-19,645.31,0,0,308081023,-281827335,0.0119604900169395,99.8196364077901,0
364.88,365,1017,3044,17289,36528,2025-08-25,2025-10-17,645.31,2027,19239,273584119,-124151124,0.0133516521841679,99.9040072205361,0.52669185282523
617.33,618,490,542,113680,36314,2025-08-25,2025-09-05,645.31,52,-77366,34008892,-59743455,0.106777956776716,99.0218881579559,-2.13047309577573
592.95,593,7208,7250,187408,36250,2025-08-25,2025-08-29,645.31,42,-151158,32399846,-85165082,0.111883247840129,97.0324457715015,-4.16987586206897
549.78,550,1685,1645,65715,36190,2025-08-25,2025-09-12,645.31,-40,-29525,54744117,-73987580,0.0661075600141655,99.3359998846999,-0.815833103067146
606.78,609,81,162,35316,35964,2025-08-25,2025-09-26,645.31,81,648.000000000007,18921943,-7892956,0.19006504775963,97.7917066973513,0.0180180180180182
284.74,285,1339,1339,44187,34814,2025-08-25,2025-12-19,645.31,0,-9373,332103998,-83576231,0.0104828608537257,99.958639462088,-0.269230769230769
618.8,619,1763,1737,248583,34740,2025-08-25,2025-08-29,645.31,-26,-213843,32399846,-85165082,0.107222731861133,97.1396685033626,-6.15552677029361
544.78,545,1568,1567,56448,34474,2025-08-25,2025-09-12,645.31,-1,-21974,54744117,-73987580,0.0629729766213966,99.3989728613213,-0.637407901607008
444.69,445,880,1078,40480,33418,2025-08-25,2025-10-17,645.31,198,-7062,273584119,-124151124,0.0122148902948566,99.9162221108309,-0.211323238973009
642.65,656,2,25,3046,33375,2025-08-25,2025-09-19,645.31,23,30329,308081023,-281827335,0.0108331891640077,99.8304695969541,0.908734082397004
339.88,340,2759,2764,38626,33168,2025-08-25,2025-10-17,645.31,5,-5458.00000000001,273584119,-124151124,0.0121235107217609,99.9283456215527,-0.164556198745779
569.84,570,2143,2042,72862,32672,2025-08-25,2025-09-05,645.31,-101,-40190,34008892,-59743455,0.0960689927798883,99.1179571507358,-1.23010528893242
644.84,665,16,16,47040,32256,2025-08-25,2025-09-05,645.31,0,-14784,34008892,-59743455,0.0948457832733863,99.2128029340092,-0.458333333333333
614.92,618,105,103,59325,31724,2025-08-25,2025-09-26,645.31,-2,-27601,18921943,-7892956,0.167657200954469,97.9593638983058,-0.870035304501324
399.49,400,618,617,40788,31467,2025-08-25,2025-11-21,645.31,-1,-9321,116293910,-42898419,0.02705816667442,99.8299824986536,-0.296215082467347
641.9,655,20,24,44080,31440,2025-08-25,2025-09-26,645.31,4,-12640,18921943,-7892956,0.166156298008085,98.1255201963139,-0.402035623409669
539.81,540,1441,1653,53317,31407,2025-08-25,2025-09-12,645.31,212,-21910,54744117,-73987580,0.0573705481449267,99.4563434094663,-0.697615181329003
637.36,700,5,5,31320,31320,2025-08-25,2025-09-19,645.31,0,0,308081023,-281827335,0.0101661568424486,99.8406357537965,0
608.9,609,2806,3105,171166,31050,2025-08-25,2025-08-29,645.31,299,-140116,32399846,-85165082,0.0958337888396136,97.2355022922023,-4.51259259259259
644.29,670,0,12,0,30852,2025-08-25,2025-09-26,645.31,12,30852,18921943,-7892956,0.163048794724728,98.2885689910386,1
149.99,150,30173,30173,30173,30173,2025-08-25,2025-09-19,645.31,0,0,308081023,-281827335,0.00979385218413794,99.8504296059807,0
444.2,445,345,376,35535,30080,2025-08-25,2025-11-21,645.31,31,-5455,116293910,-42898419,0.0258654988898387,99.8558479975435,-0.181349734042553
616.83,617,1686,1699,195576,28883,2025-08-25,2025-08-29,645.31,13,-166693,32399846,-85165082,0.0891454854445913,97.3246477776468,-5.77131876882595
389.84,390,1760,1765,42240,28240,2025-08-25,2025-10-17,645.31,5,-14000,273584119,-124151124,0.0103222365768972,99.9386678581296,-0.495750708215297
229.86,230,1999,1999,31984,27986,2025-08-25,2025-12-19,645.31,0,-3998,332103998,-83576231,0.00842687837801941,99.967066340466,-0.142857142857143
644.65,660,15,18,38190,27630,2025-08-25,2025-09-12,645.31,3,-10560,54744117,-73987580,0.0504711766562972,99.5068145861226,-0.382193268186754
389.96,390,6317,6883,37902,27532,2025-08-25,2025-09-19,645.31,566,-10370,308081023,-281827335,0.00893661015920478,99.8593662161398,-0.376652622403022
554.76,555,838,1135,35196,27240,2025-08-25,2025-09-12,645.31,297,-7956,54744117,-73987580,0.0497587713397588,99.5565733574623,-0.292070484581498
384.57,385,622,624,36076,26832,2025-08-25,2025-11-21,645.31,2,-9244,116293910,-42898419,0.0230725753394997,99.878920572883,-0.344514013118664
605.92,606,3299,3330,174847,26640,2025-08-25,2025-08-29,645.31,31,-148207,32399846,-85165082,0.0822226130334076,97.4068703906803,-5.56332582582583
612.86,613,1693,1840,147291,25760,2025-08-25,2025-08-29,645.31,147,-121531,32399846,-85165082,0.0795065507410128,97.4863769414213,-4.71781832298137
613.5,614,442,514,82654,25700,2025-08-25,2025-09-05,645.31,72,-56954,34008892,-59743455,0.0755684719161095,99.2883714059253,-2.21610894941634
637.36,700,4,4,25056,25056,2025-08-25,2025-10-17,645.31,0,0,273584119,-124151124,0.0091584263339496,99.9478262844635,0
564.34,565,367,378,42939,24948,2025-08-25,2025-09-26,645.31,11,-17991,18921943,-7892956,0.131846925022446,98.4204159160611,-0.721139971139971
559.87,560,1879,1912,50733,24856,2025-08-25,2025-09-05,645.31,33,-25877,34008892,-59743455,0.0730867680134948,99.3614581739388,-1.04107660122305
605.66,606,562,730,66316,24820,2025-08-25,2025-09-05,645.31,168,-41496,34008892,-59743455,0.0729809133446629,99.4344390872834,-1.67187751813054
504.89,505,2256,2252,45120,24772,2025-08-25,2025-09-12,645.31,-4,-20348,54744117,-73987580,0.0452505243622799,99.6018238818246,-0.821411270789601
549.97,550,7938,8049,71442,24147,2025-08-25,2025-08-29,645.31,111,-47295,32399846,-85165082,0.07452813201643,97.5609050734377,-1.95862840104361
635.45,659,10,10,23550,23550,2025-08-25,2025-09-12,645.31,0,0,54744117,-73987580,0.0430183210371262,99.6448422028617,0
469.99,470,20273,23248,40546,23248,2025-08-25,2025-08-29,645.31,2975,-17298,32399846,-85165082,0.0717534274699948,97.6326585009077,-0.74406400550585
419.95,420,4643,4617,41787,23085,2025-08-25,2025-09-19,645.31,-26,-18702,308081023,-281827335,0.00749315870714958,99.866859374847,-0.810136452241715
610.3,613,80,84,38240,22680,2025-08-25,2025-09-26,645.31,4,-15560,18921943,-7892956,0.119860840929497,98.5402767569906,-0.686067019400353
559.37,560,371,357,40068,22491,2025-08-25,2025-09-26,645.31,-14,-17577,18921943,-7892956,0.118862000588417,98.659138757579,-0.781512605042017
359.89,360,1941,2024,32997,22264,2025-08-25,2025-10-17,645.31,83,-10733,273584119,-124151124,0.00813789926161613,99.9559641837252,-0.482078692058929
369.96,370,5548,5548,22192,22192,2025-08-25,2025-09-19,645.31,0,0,308081023,-281827335,0.00720329989296355,99.8740626747399,0
644.85,654,13,24,24466,21960,2025-08-25,2025-08-29,645.31,11,-2506,32399846,-85165082,0.0677780999329441,97.7004366008406,-0.114116575591985
641.9,654,0,18,0,21780,2025-08-25,2025-09-19,645.31,18,21780,308081023,-281827335,0.00706956883871422,99.8811322435787,1
254.77,255,931,931,21413,21413,2025-08-25,2025-12-19,645.31,0,0,332103998,-83576231,0.00644767907912991,99.9735140195452,0
644.7,654,21,23,38787,21390,2025-08-25,2025-09-05,645.31,2,-17397,34008892,-59743455,0.0628953157309565,99.4973344030144,-0.813323983169705
551.83,552,1237,1237,21029,21029,2025-08-25,2025-08-29,645.31,0,0,32399846,-85165082,0.0649046294849673,97.7653412303256,0
154.95,155,4120,4120,20600,20600,2025-08-25,2025-12-19,645.31,0,0,332103998,-83576231,0.00620287624480811,99.97971689579,0
559.74,560,753,783,35391,20358,2025-08-25,2025-09-12,645.31,30,-15033,54744117,-73987580,0.0371875575233043,99.682029760385,-0.738432066018273
564.83,565,1101,1188,35232,20196,2025-08-25,2025-09-05,645.31,87,-15036,34008892,-59743455,0.0593844692146983,99.5567188722291,-0.744503862150921
299.99,300,20144,20146,20144,20146,2025-08-25,2025-09-19,645.31,2,2,308081023,-281827335,0.00653918888084191,99.8876714324595,9.92752903802243e-05
617.6,621,63,59,38304,20060,2025-08-25,2025-09-26,645.31,-4,-18244,18921943,-7892956,0.106014482762156,98.7651532403411,-0.909471585244267
580.94,581,3214,3329,57852,19974,2025-08-25,2025-08-29,645.31,115,-37878,32399846,-85165082,0.0616484411685167,97.8269896714941,-1.89636527485731
623.28,627.5,46,47,37950,19834,2025-08-25,2025-09-26,645.31,1,-18116,18921943,-7892956,0.104820102248485,98.8699733425896,-0.913381062821418
590.91,591,2206,2187,63974,19683,2025-08-25,2025-08-29,645.31,-19,-44291,32399846,-85165082,0.0607502887513725,97.8877399602455,-2.25021592236956
606.91,607,1728,2184,91584,19656,2025-08-25,2025-08-29,645.31,456,-71928,32399846,-85165082,0.0606669550219467,97.9484069152674,-3.65934065934066
458.86,460,170,170,21930,19380,2025-08-25,2025-11-21,645.31,0,-2550,116293910,-42898419,0.016664673154424,99.8955852460374,-0.131578947368421
591.95,592,3806,3866,91344,19330,2025-08-25,2025-08-29,645.31,60,-72014,32399846,-85165082,0.0596607773999914,98.0080676926674,-3.72550439730988
603.9,604,1708,1920,78568,19200,2025-08-25,2025-08-29,645.31,212,-59368,32399846,-85165082,0.0592595409249785,98.0673272335924,-3.09208333333333
519.98,520,9543,9531,57258,19062,2025-08-25,2025-08-29,645.31,-12,-38196,32399846,-85165082,0.0588336129745802,98.126160846567,-2.00377714825307
602.92,603,2375,2368,106875,18944,2025-08-25,2025-08-29,645.31,-7,-87931,32399846,-85165082,0.0584694137126454,98.1846302602796,-4.64162795608108
244.84,245,1154,1167,21926,18672,2025-08-25,2025-12-19,645.31,13,-3254,332103998,-83576231,0.00562233520597364,99.985339230996,-0.174271636675236
254.99,255,18622,18622,18622,18622,2025-08-25,2025-09-19,645.31,0,0,308081023,-281827335,0.00604451381609441,99.8937159462756,0
582.94,583,3014,3097,63294,18582,2025-08-25,2025-08-29,645.31,83,-44712,32399846,-85165082,0.0573521244514557,98.2419823847311,-2.40619954794963
581.87,582,1417,1412,28340,18356,2025-08-25,2025-08-29,645.31,-5,-9984,32399846,-85165082,0.056654590271818,98.2986369750029,-0.543909348441927
586.9,587,1788,1813,39336,18130,2025-08-25,2025-08-29,645.31,25,-21206,32399846,-85165082,0.0559570560921802,98.3545940310951,-1.16966354109211
514.85,515,978,1207,22494,18105,2025-08-25,2025-09-12,645.31,229,-4389,54744117,-73987580,0.0330720468100709,99.7151018071951,-0.242419221209611
364.98,365,8921,8921,35684,17842,2025-08-25,2025-09-19,645.31,0,-17842,308081023,-281827335,0.00579133366484569,99.8995072799405,-1
588.94,589,2883,2933,72075,17598,2025-08-25,2025-08-29,645.31,50,-54477,32399846,-85165082,0.0543150729790506,98.4089091040742,-3.09563586771224
544.97,545,5859,5859,46872,17577,2025-08-25,2025-08-29,645.31,0,-29295,32399846,-85165082,0.0542502578561639,98.4631593619303,-1.66666666666667
608.51,611,70,70,32060,17430,2025-08-25,2025-09-26,645.31,0,-14630,18921943,-7892956,0.0921152758995205,98.9620886184891,-0.839357429718876
644.44,730,2,2,18650,17112,2025-08-25,2025-08-29,645.31,0,-1538,32399846,-85165082,0.0528150658493871,98.5159744277797,-0.0898784478728378
645.19,730,2,2,18532,16962,2025-08-25,2025-10-17,645.31,0,-1570,273584119,-124151124,0.00619992127540122,99.9621641050006,-0.0925598396415517
596.91,597,1876,1870,56280,16830,2025-08-25,2025-08-29,645.31,-6,-39450,32399846,-85165082,0.0519446913420514,98.5679191191218,-2.34402852049911
489.99,490,16358,16356,49074,16356,2025-08-25,2025-08-29,645.31,-2,-32718,32399846,-85165082,0.050481721425466,98.6184008405472,-2.00036683785767
645.8,700,1,3,5600,16260,2025-08-25,2025-11-21,645.31,2,10660,116293910,-42898419,0.0139818155568077,99.9095670615942,0.65559655596556
639.54,651,18,14,29124,16044,2025-08-25,2025-09-26,645.31,-4,-13080,18921943,-7892956,0.0847904467316068,99.0468790652207,-0.815258040388931
638,648,22,16,32186,16000,2025-08-25,2025-09-26,645.31,-6,-16186,18921943,-7892956,0.0845579124723079,99.1314369776931,-1.011625
593.88,594,1330,1310,35910,15720,2025-08-25,2025-08-29,645.31,-20,-20190,32399846,-85165082,0.0485187491323261,98.6669195896796,-1.28435114503817
642.81,654,9,14,16902,15666,2025-08-25,2025-09-12,645.31,5,-1236,54744117,-73987580,0.0286167735612577,99.7437185807564,-0.0788969743393336
539.57,540,287,362,18942,15566,2025-08-25,2025-09-26,645.31,75,-3376,18921943,-7892956,0.0822642790964966,99.2137012567895,-0.216882950019273
479.99,480,15410,15411,30820,15411,2025-08-25,2025-08-29,645.31,1,-15409,32399846,-85165082,0.0475650408955648,98.7144846305751,-0.999870222568295
369.88,370,1117,1264,21223,15168,2025-08-25,2025-10-17,645.31,147,-6055,273584119,-124151124,0.00554418145886604,99.9677082864594,-0.399195675105485
329.93,330,2162,2162,23782,15134,2025-08-25,2025-10-17,645.31,0,-8648,273584119,-124151124,0.00553175383692502,99.9732400402964,-0.571428571428571
509.88,510,1271,1256,29233,15072,2025-08-25,2025-09-12,645.31,-15,-14161,54744117,-73987580,0.0275317254637608,99.7712503062201,-0.939556794055202
606.61,607,313,378,41003,14742,2025-08-25,2025-09-05,645.31,65,-26261,34008892,-59743455,0.0433474868866648,99.6000663591157,-1.78137294803961
644.75,657,7,12,15169,14700,2025-08-25,2025-09-12,645.31,5,-469,54744117,-73987580,0.0268522003926011,99.7981025066127,-0.0319047619047619
499.88,500,1222,1222,23218,14664,2025-08-25,2025-09-12,645.31,0,-8554,54744117,-73987580,0.0267864399018437,99.8248889465146,-0.583333333333334
539.89,540,1275,1327,25500,14597,2025-08-25,2025-09-05,645.31,52,-10903,34008892,-59743455,0.0429211278038697,99.6429874869196,-0.746934301568816
224.99,225,14411,14411,14411,14411,2025-08-25,2025-09-19,645.31,0,0,308081023,-281827335,0.00467766558928883,99.9041849455297,0
354.98,355,7186,7184,21558,14368,2025-08-25,2025-09-19,645.31,-2,-7190,308081023,-281827335,0.0046637082219764,99.9088486537517,-0.500417594654788
598.92,599,1732,1775,65816,14200,2025-08-25,2025-08-29,645.31,43,-51616,32399846,-85165082,0.0438273688090987,98.7583119993842,-3.63492957746479
319.98,320,7030,7030,14060,14060,2025-08-25,2025-09-19,645.31,0,0,308081023,-281827335,0.0045637345212269,99.9134123882729,0
568.9,569,1361,1366,24498,13660,2025-08-25,2025-08-29,645.31,5,-10838,32399846,-85165082,0.0421606942205836,98.8004726936048,-0.793411420204978
334.98,335,6784,6783,20352,13566,2025-08-25,2025-09-19,645.31,-1,-6786,308081023,-281827335,0.00440338709210272,99.9178157753651,-0.500221141088014
534.82,535,753,749,24096,13482,2025-08-25,2025-09-12,645.31,-4,-10614,54744117,-73987580,0.0246273037886427,99.8495162503032,-0.78727191811304
645.1,690,4,3,20480,13470,2025-08-25,2025-12-19,645.31,-1,-7010,332103998,-83576231,0.00405595839891093,99.9893951893949,-0.520415738678545
264.79,265,618,628,16068,13188,2025-08-25,2025-12-19,645.31,10,-2880,332103998,-83576231,0.00397104523866647,99.9933662346335,-0.218380345768881
404.47,405,247,248,17537,13144,2025-08-25,2025-11-21,645.31,1,-4393,116293910,-42898419,0.0113023975202141,99.9208694591144,-0.334220937309799
449.99,450,12505,13087,25010,13087,2025-08-25,2025-08-29,645.31,582,-11923,32399846,-85165082,0.0403921672961038,98.8408648609009,-0.911056773897761
570.83,571,769,769,13073,13073,2025-08-25,2025-08-29,645.31,0,0,32399846,-85165082,0.0403489572141794,98.8812138181151,0
419.77,420,584,566,20440,13018,2025-08-25,2025-10-17,645.31,-18,-7422,273584119,-124151124,0.00475831713024249,99.9779983574266,-0.570133661084652
463.88,465,112,112,12544,12544,2025-08-25,2025-11-21,645.31,0,0,116293910,-42898419,0.0107864633668263,99.9316559224813,0
643.32,659,0,8,0,12544,2025-08-25,2025-08-29,645.31,8,12544,32399846,-85165082,0.0387162334043193,98.9199300515194,1
234.99,235,12369,12369,12369,12369,2025-08-25,2025-09-19,645.31,0,0,308081023,-281827335,0.00401485293691718,99.921830628302,0
434.26,435,167,166,15698,12284,2025-08-25,2025-11-21,645.31,-1,-3414,116293910,-42898419,0.0105628919003583,99.9422188143816,-0.277922500814067
199.99,200,12267,12267,12267,12267,2025-08-25,2025-09-19,645.31,0,0,308081023,-281827335,0.00398174476329235,99.9258123730653,0
394.84,395,668,766,16700,12256,2025-08-25,2025-10-17,645.31,98,-4444,273584119,-124151124,0.00447979219144661,99.982478149618,-0.362597911227154
434.72,435,438,436,17958,12208,2025-08-25,2025-10-17,645.31,-2,-5750,273584119,-124151124,0.00446224731341222,99.9869403969315,-0.471002621231979
559.97,560,3934,4062,43274,12186,2025-08-25,2025-08-29,645.31,128,-31088,32399846,-85165082,0.0376112898808223,98.9575413414002,-2.55112424093222
644.9,657,3,10,6708,12100,2025-08-25,2025-09-05,645.31,7,5392,34008892,-59743455,0.0355789303573901,99.678566417277,0.445619834710744
629.41,750,1,1,12059,12059,2025-08-25,2025-12-19,645.31,0,0,332103998,-83576231,0.00363109148719131,99.9969973261207,0
601.93,602,1695,1696,67800,11872,2025-08-25,2025-08-29,645.31,1,-55928,32399846,-85165082,0.036642149471945,98.9941834908721,-4.71091644204852
379.98,380,5704,5917,28520,11834,2025-08-25,2025-09-19,645.31,213,-16686,308081023,-281827335,0.00384119732035556,99.9296535703856,-1.41000507013689
549.9,550,1161,1168,25542,11680,2025-08-25,2025-09-05,645.31,7,-13862,34008892,-59743455,0.0343439592210179,99.712910376498,-1.18681506849315
344.98,345,6214,5801,18642,11602,2025-08-25,2025-09-19,645.31,-413,-7040,308081023,-281827335,0.00376589245485594,99.9334194628405,-0.606791932425444
546.97,547,3146,3668,28314,11004,2025-08-25,2025-08-29,645.31,522,-17310,32399846,-85165082,0.0339631243926283,99.0281466152648,-1.57306434023991
424.35,425,163,169,14018,10985,2025-08-25,2025-11-21,645.31,6,-3033,116293910,-42898419,0.00944589445827387,99.9516647088399,-0.276103777878926
379.6,380,180,273,9900,10920,2025-08-25,2025-11-21,645.31,93,1020,116293910,-42898419,0.00939000159165686,99.9610547104315,0.0934065934065932
640.06,652,9,9,11259,10746,2025-08-25,2025-09-26,645.31,0,-513,18921943,-7892956,0.0567912079642138,99.2704924647538,-0.0477386934673367
641.3,695,2,2,10740,10740,2025-08-25,2025-11-21,645.31,0,0,116293910,-42898419,0.00923522134564054,99.9702899317772,0
439.24,440,125,140,12500,10640,2025-08-25,2025-11-21,645.31,15,-1860,116293910,-42898419,0.00914923232007592,99.9794391640972,-0.174812030075188
644,665,5,5,13200,10500,2025-08-25,2025-09-26,645.31,0,-2700,18921943,-7892956,0.0554911300599521,99.3259835948137,-0.257142857142857
645.11,750,0,1,0,10489,2025-08-25,2025-09-26,645.31,1,10489,18921943,-7892956,0.0554329964951274,99.3814165913088,1
369.99,370,10470,10470,10470,10470,2025-08-25,2025-08-29,645.31,0,0,32399846,-85165082,0.0323149684106523,99.0604615836754,0
644.49,656,2,9,2648,10359,2025-08-25,2025-09-12,645.31,7,7711,54744117,-73987580,0.0189225812154391,99.8684388315186,0.744376870354281
249.99,250,10315,10316,10315,10316,2025-08-25,2025-09-19,645.31,1,1,308081023,-281827335,0.00334846979523305,99.9367679326357,9.69367972082202e-05
600.93,601,1374,1470,57708,10290,2025-08-25,2025-08-29,645.31,96,-47418,32399846,-85165082,0.0317594102144807,99.0922209938899,-4.60816326530612
519.67,520,135,311,6615,10263,2025-08-25,2025-09-26,645.31,176,3648,18921943,-7892956,0.054238615981456,99.4356552072903,0.355451622332651
554.97,555,3397,3397,30573,10191,2025-08-25,2025-08-29,645.31,0,-20382,32399846,-85165082,0.0314538532065862,99.1236748470965,-2
554.87,555,772,775,17756,10075,2025-08-25,2025-09-05,645.31,3,-7681,34008892,-59743455,0.0296246052355954,99.7425349817336,-0.762382133995037
555.97,556,2107,3357,25284,10071,2025-08-25,2025-08-29,645.31,1250,-15213,32399846,-85165082,0.0310834810758051,99.1547583281723,-1.51057491808162
645.14,695,1,2,5604,9972,2025-08-25,2025-12-19,645.31,1,4368,332103998,-83576231,0.00300267387928284,100,0.438026474127557
549.47,550,114,188,9690,9964,2025-08-25,2025-09-26,645.31,74,274,18921943,-7892956,0.0526584399921298,99.4883136472824,0.0274989963869932
339.98,340,5002,4960,10004,9920,2025-08-25,2025-09-19,645.31,-42,-84,308081023,-281827335,0.00321993217998371,99.9399878648157,-0.00846774193548387
204.99,205,9799,9799,9799,9799,2025-08-25,2025-09-19,645.31,0,0,308081023,-281827335,0.0031806567975464,99.9431685216132,0
474.99,475,9741,9735,19482,9735,2025-08-25,2025-08-29,645.31,-6,-9747,32399846,-85165082,0.030046439109618,99.1848047672819,-1.00123266563945
379.86,380,610,691,13420,9674,2025-08-25,2025-10-17,645.31,81,-3746,273584119,-124151124,0.00353602396051359,99.990476420892,-0.38722348563159
384.97,385,2760,3159,11040,9477,2025-08-25,2025-09-19,645.31,399,-1563,308081023,-281827335,0.00307613883767193,99.9462446604509,-0.164925609370054
314.99,315,9247,9249,9247,9249,2025-08-25,2025-08-29,645.31,2,2,32399846,-85165082,0.0285464319799545,99.2133511992619,0.000216239593469564
499.95,500,359,1832,3590,9160,2025-08-25,2025-09-05,645.31,1473,5570,34008892,-59743455,0.0269341324027845,99.7694691141364,0.608078602620087
524.85,525,595,603,15470,9045,2025-08-25,2025-09-12,645.31,8,-6425,54744117,-73987580,0.0165223233027943,99.8849611548214,-0.710337202874517
344.91,345,980,990,13720,8910,2025-08-25,2025-10-17,645.31,10,-4810,273584119,-124151124,0.00325676798513294,99.9937331888771,-0.539842873176207
359.97,360,2196,2933,6588,8799,2025-08-25,2025-09-19,645.31,737,2211,308081023,-281827335,0.00285606686004805,99.9491007273109,0.25127855438118
219.99,220,8767,8767,8767,8767,2025-08-25,2025-09-19,645.31,0,0,308081023,-281827335,0.0028456799820481,99.951946407293,0
519.92,520,1085,1083,16275,8664,2025-08-25,2025-09-05,645.31,-2,-7611,34008892,-59743455,0.0254756902988783,99.7949448044353,-0.878462603878116
404.96,405,2034,2162,12204,8648,2025-08-25,2025-09-19,645.31,128,-3556,308081023,-281827335,0.0028070537794858,99.9547534610725,-0.411193339500463
464.99,465,5676,8581,11352,8581,2025-08-25,2025-08-29,645.31,2905,-2771,32399846,-85165082,0.0264846937852729,99.2398358930472,-0.322922736277823
154.99,155,8569,8569,8569,8569,2025-08-25,2025-09-19,645.31,0,0,308081023,-281827335,0.00278141117442342,99.9575348722469,0
552.9,553,854,854,8540,8540,2025-08-25,2025-08-29,645.31,0,0,32399846,-85165082,0.0263581499739227,99.2661940430211,0
534.6,535,159,213,10335,8520,2025-08-25,2025-09-26,645.31,54,-1815,18921943,-7892956,0.045027088391504,99.5333407356739,-0.213028169014085
556.96,557,868,2096,10416,8384,2025-08-25,2025-08-29,645.31,1228,-2032,32399846,-85165082,0.0258766662039073,99.292070709225,-0.24236641221374
529.92,530,1033,1038,16528,8304,2025-08-25,2025-09-05,645.31,5,-8224,34008892,-59743455,0.0244171436105593,99.8193619480458,-0.990366088631985
585.94,586,1344,1383,34944,8298,2025-08-25,2025-08-29,645.31,39,-26646,32399846,-85165082,0.0256112328435141,99.3176819420685,-3.21113521330441
269.99,270,8283,8283,8283,8283,2025-08-25,2025-09-19,645.31,0,0,308081023,-281827335,0.00268857845229889,99.9602234506992,0
544.88,545,693,668,14553,8016,2025-08-25,2025-09-05,645.31,-25,-6537,34008892,-59743455,0.023570306259904,99.8429322543057,-0.815494011976048
645.63,685,0,2,0,7874,2025-08-25,2025-11-21,645.31,2,7874,116293910,-42898419,0.00677077587295844,99.9862099399702,1
379.99,380,7786,7786,7786,7786,2025-08-25,2025-08-29,645.31,0,0,32399846,-85165082,0.024030978418848,99.3417129204873,0
309.98,310,3874,3874,7748,7748,2025-08-25,2025-09-19,645.31,0,0,308081023,-281827335,0.00251492283573727,99.9627383735349,0
524.98,525,3829,3757,22974,7514,2025-08-25,2025-08-29,645.31,-72,-15460,32399846,-85165082,0.0231914682557442,99.3649043887431,-2.05749268033005
595.94,596,1241,1243,35989,7458,2025-08-25,2025-08-29,645.31,2,-28531,32399846,-85165082,0.0230186279280463,99.3879230166711,-3.82555644945026
499.75,500,296,296,11248,7400,2025-08-25,2025-09-26,645.31,0,-3848,18921943,-7892956,0.0391080345184424,99.5724487701924,-0.52
575.95,576,1443,1432,24531,7160,2025-08-25,2025-08-29,645.31,-11,-17371,32399846,-85165082,0.0220988704699399,99.4100218871411,-2.42611731843575
194.99,195,6991,6991,6991,6991,2025-08-25,2025-09-19,645.31,0,0,308081023,-281827335,0.00226920825305102,99.965007581788,0
583.92,584,865,865,18165,6920,2025-08-25,2025-08-29,645.31,0,-11245,32399846,-85165082,0.0213581262083777,99.4313800133495,-1.625
394.99,395,6898,6899,6898,6899,2025-08-25,2025-08-29,645.31,1,0.999999999999091,32399846,-85165082,0.021293311085491,99.4526733244349,0.000144948543267008
214.99,215,6836,6836,6836,6836,2025-08-25,2025-09-19,645.31,0,0,308081023,-281827335,0.00221889681273877,99.9672264786007,0
566.97,567,2275,2274,27300,6822,2025-08-25,2025-08-29,645.31,-1,-20478,32399846,-85165082,0.0210556556349064,99.4737289800699,-3.00175901495163
509.71,510,133,231,6118,6699,2025-08-25,2025-09-26,645.31,98,580.999999999999,18921943,-7892956,0.0354033409782494,99.6078521111706,0.0867293625914314
354.89,355,606,606,9696,6666,2025-08-25,2025-10-17,645.31,0,-3030,273584119,-124151124,0.00243654493702538,99.9961697338141,-0.454545454545455
635.75,700,1,1,6425,6425,2025-08-25,2025-08-29,645.31,0,0,32399846,-85165082,0.0198303411689056,99.4935593212388,0
534.98,535,2759,3171,19313,6342,2025-08-25,2025-08-29,645.31,412,-12971,32399846,-85165082,0.019574167111782,99.5131334883505,-2.04525386313466
329.98,330,3153,3160,6306,6320,2025-08-25,2025-09-19,645.31,7,14,308081023,-281827335,0.00205140840498962,99.9692778870057,0.00221518987341772
374.98,375,3146,3146,12584,6292,2025-08-25,2025-09-19,645.31,0,-6292,308081023,-281827335,0.00204231988673966,99.9713202068925,-1
389.54,390,133,135,8113,6210,2025-08-25,2025-11-21,645.31,2,-1903,116293910,-42898419,0.00533991848756311,99.9915498584578,-0.306441223832528
561.95,562,1229,1228,17206,6140,2025-08-25,2025-08-29,645.31,-1,-11066,32399846,-85165082,0.0189507073583004,99.5320841957088,-1.80228013029316
644.4,675,0,2,0,6120,2025-08-25,2025-08-29,645.31,2,6120,32399846,-85165082,0.0188889786698369,99.5509731743787,1
553.95,554,1219,1219,12190,6095,2025-08-25,2025-08-29,645.31,0,-6095,32399846,-85165082,0.0188118178092575,99.5697849921879,-1
645.52,675,4,2,16172,5896,2025-08-25,2025-09-19,645.31,-2,-10276,308081023,-281827335,0.00191378227149032,99.9732339891639,-1.74287652645862
504.73,505,197,217,8077,5859,2025-08-25,2025-09-26,645.31,20,-2218,18921943,-7892956,0.0309640505734533,99.6388161617441,-0.378562894691927
565.96,566,1457,1461,18941,5844,2025-08-25,2025-08-29,645.31,4,-13097,32399846,-85165082,0.0180371227690403,99.587822114957,-2.24110198494182
349.99,350,5766,5766,17298,5766,2025-08-25,2025-09-19,645.31,0,-11532,308081023,-281827335,0.00187158557961553,99.9751055747436,-2
545.98,546,2062,2868,16496,5736,2025-08-25,2025-08-29,645.31,806,-10760,32399846,-85165082,0.0177037878513373,99.6055259028083,-1.87587168758717
509.99,510,5636,5636,28180,5636,2025-08-25,2025-08-29,645.31,0,-22544,32399846,-85165082,0.0173951444090197,99.6229210472173,-4
529.57,530,94,128,5640,5504,2025-08-25,2025-09-26,645.31,34,-136,18921943,-7892956,0.0290879218904739,99.6679040836345,-0.0247093023255814
640.4,695,1,1,5460,5460,2025-08-25,2025-10-17,645.31,0,0,273584119,-124151124,0.00199572987641143,99.9981654636905,0
524.65,525,51,155,3009,5425,2025-08-25,2025-09-26,645.31,104,2416,18921943,-7892956,0.0286704171976419,99.6965745008322,0.445345622119816
576.94,577,897,895,16146,5370,2025-08-25,2025-08-29,645.31,-2,-10776,32399846,-85165082,0.0165741528524549,99.6394952000698,-2.00670391061453
289.99,290,5367,5367,5367,5367,2025-08-25,2025-09-19,645.31,0,0,308081023,-281827335,0.00174207419455368,99.9768476489381,0
259.99,260,5344,5344,5344,5344,2025-08-25,2025-09-19,645.31,0,0,308081023,-281827335,0.00173460862599122,99.9785822575641,0
587.96,588,1315,1315,32875,5260,2025-08-25,2025-08-29,645.31,0,-27615,32399846,-85165082,0.0162346450659056,99.6557298451357,-5.25
519.85,520,348,348,9744,5220,2025-08-25,2025-09-12,645.31,0,-4524,54744117,-73987580,0.00953527115982161,99.8944964259813,-0.866666666666667
544.53,545,109,111,9047,5217,2025-08-25,2025-09-26,645.31,2,-3830,18921943,-7892956,0.0275711643355019,99.7241456651677,-0.734138393712862
643.07,695,0,1,0,5193,2025-08-25,2025-09-12,645.31,1,5193,54744117,-73987580,0.00948595079175357,99.903982376773,1
184.99,185,5144,5144,5144,5144,2025-08-25,2025-09-19,645.31,0,0,308081023,-281827335,0.00166969063849155,99.9802519482026,0
514.94,515,339,849,4746,5094,2025-08-25,2025-09-05,645.31,510,347.999999999999,34008892,-59743455,0.0149784356397145,99.8579106899454,0.0683156654888102
494.89,495,457,457,7769,5027,2025-08-25,2025-09-12,645.31,0,-2742,54744117,-73987580,0.00918272186215004,99.9131650986352,-0.545454545454546
573.96,574,1255,1255,18825,5020,2025-08-25,2025-08-29,645.31,0,-13805,32399846,-85165082,0.0154939008043433,99.67122374594,-2.75
334.93,335,767,717,9204,5019,2025-08-25,2025-10-17,645.31,-50,-4185,273584119,-124151124,0.00183453630947051,100,-0.833831440526001
439.83,440,291,291,4947,4947,2025-08-25,2025-09-26,645.31,0,0,18921943,-7892956,0.0261442495625317,99.7502899147302,0
640.7,690,1,1,4930,4930,2025-08-25,2025-11-21,645.31,0,0,116293910,-42898419,0.00423925896033593,99.9957891174181,0
550.97,551,1630,1637,17930,4911,2025-08-25,2025-08-29,645.31,7,-13019,32399846,-85165082,0.0151574794522171,99.6863812253923,-2.6509875789045
414.41,415,47,83,3666,4897,2025-08-25,2025-11-21,645.31,36,1231,116293910,-42898419,0.0042108825818996,100,0.251378394935675
547.98,548,2387,2387,21483,4774,2025-08-25,2025-08-29,645.31,0,-16709,32399846,-85165082,0.014734637936242,99.7011158633285,-3.5
439.99,440,4741,4741,4741,4741,2025-08-25,2025-08-29,645.31,0,0,32399846,-85165082,0.0146327856002772,99.7157486489288,0
558.96,559,949,1183,12337,4732,2025-08-25,2025-08-29,645.31,234,-7605,32399846,-85165082,0.0146050076904687,99.7303536566192,-1.60714285714286
554.43,555,87,83,8352,4731,2025-08-25,2025-09-26,645.31,-4,-3621,18921943,-7892956,0.0250027177441555,99.7752926324744,-0.765377298668358
564.98,565,2433,2362,34062,4724,2025-08-25,2025-08-29,645.31,-71,-29338,32399846,-85165082,0.0145803162150832,99.7449339728343,-6.21041490262489
514.7,515,158,157,7742,4710,2025-08-25,2025-09-26,645.31,-1,-3032,18921943,-7892956,0.0248917354840357,99.8001843679584,-0.643736730360934
454.95,455,641,940,6410,4700,2025-08-25,2025-09-12,645.31,299,-1710,54744117,-73987580,0.00858539740443708,99.9217504960396,-0.363829787234043
474.96,475,1142,1138,7994,4552,2025-08-25,2025-09-05,645.31,-4,-3442,34008892,-59743455,0.0133847347923008,99.8712954247377,-0.756151142355009
179.99,180,4526,4526,4526,4526,2025-08-25,2025-09-19,645.31,0,0,308081023,-281827335,0.00146909405711757,99.9817210422597,0
567.97,568,1487,1486,22305,4458,2025-08-25,2025-08-29,645.31,-1,-17847,32399846,-85165082,0.0137593246585184,99.7586932974929,-4.00336473755047
384.99,385,4437,4437,4437,4437,2025-08-25,2025-08-29,645.31,0,0,32399846,-85165082,0.0136945095356317,99.7723878070285,0
560.96,561,949,1074,10439,4296,2025-08-25,2025-08-29,645.31,125,-6143,32399846,-85165082,0.0132593222819639,99.7856471293104,-1.42993482309125
164.99,165,4215,4215,4215,4215,2025-08-25,2025-09-19,645.31,0,0,308081023,-281827335,0.00136814658655558,99.9830891888463,0
529.83,530,243,247,7047,4199,2025-08-25,2025-09-12,645.31,4,-2848,54744117,-73987580,0.00767023057473007,99.9294207266143,-0.678256727792332
639.25,653,3,3,4152,4125,2025-08-25,2025-09-26,645.31,0,-27,18921943,-7892956,0.0218000868092669,99.8219844547677,-0.00654545454545455
534.92,535,515,515,8755,4120,2025-08-25,2025-09-05,645.31,0,-4635,34008892,-59743455,0.0121144787663179,99.8834099035041,-1.125
449.87,450,299,314,5980,4082,2025-08-25,2025-09-26,645.31,15,-1898,18921943,-7892956,0.0215728374194976,99.8435572921872,-0.464968152866242
524.91,525,452,452,6780,4068,2025-08-25,2025-09-05,645.31,0,-2712,34008892,-59743455,0.0119615775780052,99.8953714810821,-0.666666666666667
509.94,510,433,674,4763,4044,2025-08-25,2025-09-05,645.31,241,-719,34008892,-59743455,0.0118910077987839,99.9072624888809,-0.177794263105836
189.99,190,4025,4025,4025,4025,2025-08-25,2025-09-19,645.31,0,0,308081023,-281827335,0.00130647449843089,99.9843956633447,0
644.62,658,9,3,20196,4014,2025-08-25,2025-09-12,645.31,-6,-16182,54744117,-73987580,0.00733229471944903,99.9367530213338,-4.03139013452915
294.99,295,3995,3992,7990,3992,2025-08-25,2025-09-19,645.31,-3,-3998,308081023,-281827335,0.00129576303049344,99.9856914263752,-1.00150300601202
529.99,530,3721,3990,29768,3990,2025-08-25,2025-08-29,645.31,269,-25778,32399846,-85165082,0.0123148733484721,99.7979620026589,-6.46065162907268
264.99,265,3919,3919,3919,3919,2025-08-25,2025-09-19,645.31,0,0,308081023,-281827335,0.00127206796505606,99.9869634943403,0
644.98,658,2,3,4298,3906,2025-08-25,2025-09-05,645.31,1,-392,34008892,-59743455,0.0114852315682616,99.9187477204491,-0.100358422939068
304.99,305,2880,3882,5760,3882,2025-08-25,2025-09-19,645.31,1002,-1878,308081023,-281827335,0.00126005813736862,99.9882235524776,-0.483771251931994
494.99,495,3863,3881,15452,3881,2025-08-25,2025-08-29,645.31,18,-11571,32399846,-85165082,0.0119784519963459,99.8099404546553,-2.98144808039165
229.99,230,3807,3807,3807,3807,2025-08-25,2025-09-19,645.31,0,0,308081023,-281827335,0.00123571389205625,99.9894592663697,0
578.94,579,640,631,11520,3786,2025-08-25,2025-08-29,645.31,-9,-7734,32399846,-85165082,0.0116852407261442,99.8216256953814,-2.04278922345483
274.99,275,4039,3771,4039,3771,2025-08-25,2025-09-19,645.31,-268,-268,308081023,-281827335,0.00122402865430631,99.990683295024,-0.0710686820472023
244.99,245,3721,3721,3721,3721,2025-08-25,2025-09-19,645.31,0,0,308081023,-281827335,0.00120779915743139,99.9918910941814,0
645.65,664,0,2,0,3670,2025-08-25,2025-09-12,645.31,2,3670,54744117,-73987580,0.00670391669665619,99.9434569380304,1
645.98,658,3,3,6672,3606,2025-08-25,2025-08-29,645.31,0,-3066,32399846,-85165082,0.0111296825299725,99.8327553779114,-0.850249584026622
563.96,564,863,856,11219,3424,2025-08-25,2025-08-29,645.31,-7,-7795,32399846,-85165082,0.0105679514649545,99.8433233293763,-2.27657710280374
489.79,490,164,163,5412,3423,2025-08-25,2025-09-26,645.31,-1,-1989,18921943,-7892956,0.0180901083995444,99.8616474005867,-0.581069237510956
489.91,490,369,370,6642,3330,2025-08-25,2025-09-12,645.31,1,-3312,54744117,-73987580,0.00608284539505861,99.9495397834255,-0.994594594594595
644.95,656,1,3,2040,3315,2025-08-25,2025-09-05,645.31,2,1275,34008892,-59743455,0.00974745075493786,99.928495171204,0.384615384615385
479.92,480,201,411,2412,3288,2025-08-25,2025-09-12,645.31,210,876.000000000001,54744117,-73987580,0.00600612482250833,99.955545908248,0.266423357664234
577.97,578,1094,1093,21880,3279,2025-08-25,2025-08-29,645.31,-1,-18601,32399846,-85165082,0.010120418473594,99.8534437478499,-5.67276608722171
572.96,573,826,818,12390,3272,2025-08-25,2025-08-29,645.31,-8,-9118,32399846,-85165082,0.0100988134326317,99.8635425612826,-2.78667481662592
479.81,480,157,171,4710,3249,2025-08-25,2025-09-26,645.31,14,-1461,18921943,-7892956,0.017170541101408,99.8788179416881,-0.449676823638043
284.99,285,3374,3219,3374,3219,2025-08-25,2025-09-19,645.31,-155,-155,308081023,-281827335,0.00104485500880721,99.9929359491902,-0.0481515998757378
642.1,658,12,2,25440,3180,2025-08-25,2025-09-26,645.31,-10,-22260,18921943,-7892956,0.0168058851038712,99.895623826792,-7
571.97,572,1056,1056,19008,3168,2025-08-25,2025-08-29,645.31,0,-15840,32399846,-85165082,0.00977782425262145,99.8733203855352,-5
514.98,515,1543,1544,7715,3088,2025-08-25,2025-08-29,645.31,1,-4627,32399846,-85165082,0.00953090949876737,99.8828512950339,-1.49838082901554
639.72,670,1,1,3028,3028,2025-08-25,2025-09-05,645.31,0,0,34008892,-59743455,0.00890355381175017,99.9373987250158,0
562.97,563,968,999,15488,2997,2025-08-25,2025-08-29,645.31,31,-12491,32399846,-85165082,0.00925004396625836,99.8921013390002,-4.16783450116783
640.1,670,1,1,2990,2990,2025-08-25,2025-08-29,645.31,0,0,32399846,-85165082,0.00922843892529613,99.9013297779255,0
159.99,160,2911,2911,2911,2911,2025-08-25,2025-09-19,645.31,0,0,308081023,-281827335,0.000944881308057718,99.9938808304983,0
643.53,658,1,2,2142,2894,2025-08-25,2025-09-19,645.31,1,752,308081023,-281827335,0.000939363279120246,99.9948201937774,0.25984796129924
324.99,325,2791,2789,8373,2789,2025-08-25,2025-09-19,645.31,-2,-5584,308081023,-281827335,0.000905281335682919,99.9957254751131,-2.0021513087128
642.37,656,0,2,0,2726,2025-08-25,2025-09-26,645.31,2,2726,18921943,-7892956,0.0144065543374695,99.9100303811295,1
399.97,400,867,887,4335,2661,2025-08-25,2025-09-12,645.31,20,-1674,54744117,-73987580,0.00486079627515044,99.9604067045232,-0.629086809470124
641.17,654,0,2,0,2566,2025-08-25,2025-09-26,645.31,2,2566,18921943,-7892956,0.0135609752127464,99.9235913563422,1
449.95,450,513,513,4617,2565,2025-08-25,2025-09-12,645.31,0,-2052,54744117,-73987580,0.00468543496646407,99.9650921394896,-0.8
639.5,665,1,1,2797,2550,2025-08-25,2025-09-12,645.31,0,-247,54744117,-73987580,0.00465803476198182,99.9697501742516,-0.0968627450980392
169.99,170,2525,2525,2525,2525,2025-08-25,2025-09-19,645.31,0,0,308081023,-281827335,0.000819589592183352,99.9965450647053,0
319.99,320,2495,2496,2495,2496,2025-08-25,2025-08-29,645.31,1,1,32399846,-85165082,0.0077037403202472,99.9090335182457,0.000400641025641026
474.82,475,134,136,4020,2448,2025-08-25,2025-09-26,645.31,2,-1572,18921943,-7892956,0.0129373606082631,99.9365287169505,-0.642156862745098
469.93,470,109,326,1526,2282,2025-08-25,2025-09-12,645.31,217,756,54744117,-73987580,0.00416848444189903,99.9739186586935,0.331288343558282
279.99,280,2282,2248,2282,2248,2025-08-25,2025-09-19,645.31,-34,-34,308081023,-281827335,0.000729678179496307,99.9972747428848,-0.0151245551601423
399.99,400,2224,2223,2224,2223,2025-08-25,2025-08-29,645.31,-1,-1,32399846,-85165082,0.00686114372272016,99.9158946619685,-0.000449842555105713
209.99,210,2169,2169,2169,2169,2025-08-25,2025-09-19,645.31,0,0,308081023,-281827335,0.000704035574433937,99.9979787784592,0
504.99,505,2137,2159,10685,2159,2025-08-25,2025-08-29,645.31,22,-8526,32399846,-85165082,0.0066636119196369,99.9225582738881,-3.94905048633627
454.96,455,525,525,2100,2100,2025-08-25,2025-09-05,645.31,0,0,34008892,-59743455,0.00617485568186109,99.9435735806977,0
444.99,445,1844,2009,1844,2009,2025-08-25,2025-08-29,645.31,165,165,32399846,-85165082,0.00620064675616051,99.9287589206443,0.082130413140866
394.99,395,34,2005,34,2005,2025-08-25,2025-09-05,645.31,1971,1971,34008892,-59743455,0.00589551697244356,99.9494690976701,0.983042394014963
419.99,420,1998,1997,1998,1997,2025-08-25,2025-08-29,645.31,-1,-1,32399846,-85165082,0.0061636095430824,99.9349225301873,-0.000500751126690035
449.96,450,482,482,1928,1928,2025-08-25,2025-09-05,645.31,0,0,34008892,-59743455,0.00566910559744199,99.9551382032676,0
414.99,415,1927,1927,1927,1927,2025-08-25,2025-08-29,645.31,0,0,32399846,-85165082,0.00594755913346008,99.9408700893208,0
174.99,175,1917,1917,1917,1917,2025-08-25,2025-09-19,645.31,0,0,308081023,-281827335,0.000622238910184351,99.9986010173694,0
459.86,460,115,135,2645,1890,2025-08-25,2025-09-26,645.31,20,-755,18921943,-7892956,0.00998840341079138,99.9465171203613,-0.3994708994709
364.99,365,1865,1865,1865,1865,2025-08-25,2025-08-29,645.31,0,0,32399846,-85165082,0.00575620019922317,99.94662628952,0
464.96,465,253,466,1518,1864,2025-08-25,2025-09-05,645.31,213,346,34008892,-59743455,0.0054809195195186,99.9606191227871,0.185622317596567
359.97,360,605,605,1815,1815,2025-08-25,2025-08-29,645.31,0,0,32399846,-85165082,0.00560187847806437,99.9522281679981,0
239.99,240,1805,1805,1805,1805,2025-08-25,2025-09-19,645.31,0,0,308081023,-281827335,0.000585884837184535,99.9991869022066,0
374.99,375,1788,1788,1788,1788,2025-08-25,2025-08-29,645.31,0,0,32399846,-85165082,0.00551854474863862,99.9577467127467,0
414.95,415,356,356,1780,1780,2025-08-25,2025-09-12,645.31,0,0,54744117,-73987580,0.00325149093189319,99.9771701496254,0
409.92,410,216,217,2592,1736,2025-08-25,2025-09-26,645.31,1,-856,18921943,-7892956,0.00917453350324541,99.9556916538645,-0.493087557603687
459.97,460,556,556,3892,1668,2025-08-25,2025-09-05,645.31,0,-2224,34008892,-59743455,0.00490459965587823,99.965523722443,-1.33333333333333
439.95,440,30,328,240,1640,2025-08-25,2025-09-12,645.31,298,1400,54744117,-73987580,0.0029957556900589,99.9801659053155,0.853658536585366
389.99,390,610,1582,1220,1582,2025-08-25,2025-09-05,645.31,972,362,34008892,-59743455,0.00465172461366868,99.9701754470566,0.228824273072061
454.99,455,1525,1536,3050,1536,2025-08-25,2025-08-29,645.31,11,-1514,32399846,-85165082,0.00474076327399828,99.9624874760207,-0.985677083333333
429.99,430,1485,1485,1485,1485,2025-08-25,2025-08-29,645.31,0,0,32399846,-85165082,0.0045833551184163,99.9670708311391,0
464.89,465,135,135,1485,1485,2025-08-25,2025-09-12,645.31,0,0,54744117,-73987580,0.00271262024374235,99.9828785255592,0
389.98,390,726,726,2904,1452,2025-08-25,2025-09-12,645.31,0,-1452,54744117,-73987580,0.00265233979388141,99.9855308653531,-1
409.95,410,287,287,1435,1435,2025-08-25,2025-09-12,645.31,0,0,54744117,-73987580,0.00262128622880154,99.9881521515819,0
459.94,460,351,231,4212,1386,2025-08-25,2025-09-12,645.31,-120,-2826,54744117,-73987580,0.00253177889415953,99.990683930476,-2.03896103896104
314.99,315,1384,1384,1384,1384,2025-08-25,2025-09-19,645.31,0,0,308081023,-281827335,0.000449232473497727,99.9996361346801,0
484.99,485,1230,1326,3690,1326,2025-08-25,2025-08-29,645.31,96,-2364,32399846,-85165082,0.00409261204513133,99.9711634431843,-1.78280542986425
548.99,549,1300,1300,11700,1300,2025-08-25,2025-08-29,645.31,0,-10400,32399846,-85165082,0.00401236475012875,99.9751758079344,-8
384.95,385,235,235,2115,1175,2025-08-25,2025-09-26,645.31,0,-940,18921943,-7892956,0.00620972169718511,99.9619013755617,-0.8
399.99,400,373,1166,746,1166,2025-08-25,2025-09-05,645.31,793,420,34008892,-59743455,0.00342851510716668,99.9736039621638,0.360205831903945
469.97,470,163,375,978,1125,2025-08-25,2025-09-05,645.31,212,147,34008892,-59743455,0.00330795840099701,99.9769119205648,0.130666666666667
641.79,653,0,1,0,1121,2025-08-25,2025-09-19,645.31,1,1121,308081023,-281827335,0.000363865319935659,100,1
389.99,390,1060,1060,1060,1060,2025-08-25,2025-08-29,645.31,0,0,32399846,-85165082,0.00327162048856652,99.978447428423,0
642.69,653,1,1,1757,1031,2025-08-25,2025-09-05,645.31,0,-726,34008892,-59743455,0.00303156009904704,99.9799434806638,-0.704170708050437
494.76,495,36,42,1440,1008,2025-08-25,2025-09-26,645.31,6,-432,18921943,-7892956,0.0053271484857554,99.9672285240475,-0.428571428571429
374.95,375,190,195,1140,975,2025-08-25,2025-09-26,645.31,5,-165,18921943,-7892956,0.00515274779128127,99.9723812718388,-0.169230769230769
329.99,330,957,957,957,957,2025-08-25,2025-08-29,645.31,0,0,32399846,-85165082,0.0029537177429794,99.981401146166,0
484.86,485,68,68,952,952,2025-08-25,2025-09-12,645.31,0,0,54744117,-73987580,0.00173899964447321,99.9924229301205,0
489.96,490,235,234,2115,936,2025-08-25,2025-09-05,645.31,-1,-1179,34008892,-59743455,0.00275222138962951,99.9826957020534,-1.25961538461538
344.99,345,932,932,932,932,2025-08-25,2025-08-29,645.31,0,0,32399846,-85165082,0.0028765568824,99.9842777030484,0
484.97,485,307,307,2149,921,2025-08-25,2025-09-05,645.31,0,-1228,34008892,-59743455,0.00270811527761622,99.9854038173311,-1.33333333333333
399.91,400,101,101,909,909,2025-08-25,2025-09-26,645.31,0,0,18921943,-7892956,0.004803946402333,99.9771852182411,0
419.95,420,173,173,865,865,2025-08-25,2025-09-12,645.31,0,0,54744117,-73987580,0.00158007845847619,99.994003008579,0
434.95,435,159,164,954,820,2025-08-25,2025-09-12,645.31,5,-134,54744117,-73987580,0.00149787784502945,99.995500886424,-0.163414634146341
379.96,380,200,200,800,800,2025-08-25,2025-09-12,645.31,0,0,54744117,-73987580,0.00146134423905312,99.9969622306631,0
404.9,405,75,80,825,800,2025-08-25,2025-09-26,645.31,5,-25,18921943,-7892956,0.0042278956236154,99.9814131138647,-0.03125
424.99,425,783,797,783,797,2025-08-25,2025-08-29,645.31,14,14,32399846,-85165082,0.00245988823527124,99.9867375912836,0.0175658720200753
404.99,405,758,758,758,758,2025-08-25,2025-08-29,645.31,0,0,32399846,-85165082,0.00233951729276738,99.9890771085764,0
339.99,340,757,757,757,757,2025-08-25,2025-08-29,645.31,0,0,32399846,-85165082,0.0023364308583442,99.9914135394347,0
434.99,435,756,756,756,756,2025-08-25,2025-08-29,645.31,0,0,32399846,-85165082,0.00233334442392103,99.9937468838587,0
414.98,415,343,341,1029,682,2025-08-25,2025-09-05,645.31,-2,-347,34008892,-59743455,0.00200535789287108,99.987409175224,-0.508797653958944
349.99,350,681,681,681,681,2025-08-25,2025-08-29,645.31,0,0,32399846,-85165082,0.00210186184218283,99.9958487457008,0
444.95,445,133,133,665,665,2025-08-25,2025-09-05,645.31,0,0,34008892,-59743455,0.00195537096592268,99.9893645461899,0
474.88,475,55,55,660,660,2025-08-25,2025-09-12,645.31,0,0,54744117,-73987580,0.00120560899721882,99.9981678396603,0
419.89,420,52,57,676,627,2025-08-25,2025-09-26,645.31,5,-49,18921943,-7892956,0.00331361319500857,99.9847267270597,-0.0781499202551834
384.98,385,200,300,1000,600,2025-08-25,2025-09-12,645.31,100,-400,54744117,-73987580,0.00109600817928984,99.9992638478396,-0.666666666666667
414.9,415,55,60,770,600,2025-08-25,2025-09-26,645.31,5,-170,18921943,-7892956,0.00317092171771155,99.9878976487774,-0.283333333333334
504.95,505,113,116,1130,580,2025-08-25,2025-09-05,645.31,3,-550,34008892,-59743455,0.00170543633118068,99.991069982521,-0.948275862068965
479.98,480,184,271,1472,542,2025-08-25,2025-09-05,645.31,87,-930,34008892,-59743455,0.00159370084741367,99.9926636833685,-1.71586715867159
464.76,465,20,20,480,480,2025-08-25,2025-09-26,645.31,0,0,18921943,-7892956,0.00253673737416924,99.9904343861516,0
484.8,485,21,23,672,460,2025-08-25,2025-09-26,645.31,2,-212,18921943,-7892956,0.00243103998357885,99.9928654261352,-0.460869565217391
409.99,410,448,448,448,448,2025-08-25,2025-08-29,645.31,0,0,32399846,-85165082,0.00138272262158283,99.9972314683224,0
324.99,325,412,412,412,412,2025-08-25,2025-08-29,645.31,0,0,32399846,-85165082,0.0012716109823485,99.9985030793048,0
374.99,375,387,386,774,386,2025-08-25,2025-09-05,645.31,-1,-388,34008892,-59743455,0.00113499728247542,99.9937986806509,-1.00518134715026
494.95,495,61,71,732,355,2025-08-25,2025-09-05,645.31,10,-377,34008892,-59743455,0.00104384465098128,99.9948425253019,-1.06197183098592
429.98,430,185,174,740,348,2025-08-25,2025-09-05,645.31,-11,-392,34008892,-59743455,0.00102326179870841,99.9958657871006,-1.1264367816092
419.98,420,128,156,512,312,2025-08-25,2025-09-05,645.31,28,-200,34008892,-59743455,0.000917407129876504,99.9967831942305,-0.641025641025641
469.74,470,12,12,312,312,2025-08-25,2025-09-26,645.31,0,0,18921943,-7892956,0.00164887929321,99.9945143054284,0
394.89,395,27,27,297,297,2025-08-25,2025-09-26,645.31,0,0,18921943,-7892956,0.00156960625026722,99.9960839116786,0
354.99,355,257,257,257,257,2025-08-25,2025-08-29,645.31,0,0,32399846,-85165082,0.000793213646756222,99.9992962929515,0
424.85,425,17,17,255,255,2025-08-25,2025-09-26,645.31,0,0,18921943,-7892956,0.00134764173002741,99.9974315534087,0
384.99,385,229,229,229,229,2025-08-25,2025-09-05,645.31,0,0,34008892,-59743455,0.000673353310069614,99.9974565475406,0
334.99,335,228,228,228,228,2025-08-25,2025-08-29,645.31,0,0,32399846,-85165082,0.000703707048484119,100,0
389.9,390,20,20,200,200,2025-08-25,2025-09-26,645.31,0,0,18921943,-7892956,0.00105697390590385,99.9984885273146,0
439.99,440,196,197,588,197,2025-08-25,2025-09-05,645.31,1,-391,34008892,-59743455,0.000579260271107921,99.9980358078117,-1.98477157360406
404.99,405,164,185,492,185,2025-08-25,2025-09-05,645.31,21,-307,34008892,-59743455,0.000543975381497286,99.9985797831932,-1.65945945945946
379.99,380,170,170,170,170,2025-08-25,2025-09-05,645.31,0,0,34008892,-59743455,0.000499869269483993,99.9990796524627,0
434.97,435,45,52,135,156,2025-08-25,2025-09-05,645.31,7,21,34008892,-59743455,0.000458703564938252,99.9995383560276,0.134615384615385
374.98,375,73,76,219,152,2025-08-25,2025-09-12,645.31,3,-67,54744117,-73987580,0.000277655405420093,99.999541503245,-0.440789473684211
429.95,430,20,20,120,100,2025-08-25,2025-09-12,645.31,0,-20,54744117,-73987580,0.00018266802988164,99.9997241712749,-0.2
409.99,410,91,89,182,89,2025-08-25,2025-09-05,645.31,-2,-93,34008892,-59743455,0.000261696264612208,99.9998000522922,-1.04494382022472
424.95,425,7,17,35,85,2025-08-25,2025-09-12,645.31,10,50,54744117,-73987580,0.000155267825399394,99.9998794391003,0.588235294117647
454.73,455,3,3,81,81,2025-08-25,2025-09-26,645.31,0,0,18921943,-7892956,0.000428074431891059,99.9989166017465,0
379.95,380,15,15,105,75,2025-08-25,2025-09-26,645.31,0,-30,18921943,-7892956,0.000396365214713944,99.9993129669612,-0.4
424.98,425,35,34,105,68,2025-08-25,2025-09-05,645.31,-1,-37,34008892,-59743455,0.000199947707793597,100,-0.544117647058824
429.87,430,4,4,52,52,2025-08-25,2025-09-26,645.31,0,0,18921943,-7892956,0.000274813215535001,99.9995877801767,0
434.9,435,204,4,4284,40,2025-08-25,2025-09-26,645.31,-200,-4244,18921943,-7892956,0.00021139478118077,99.9997991749579,-106.1
444.81,445,2,2,38,38,2025-08-25,2025-09-26,645.31,0,0,18921943,-7892956,0.000200825042121731,100,0
404.97,405,2,12,10,36,2025-08-25,2025-09-12,645.31,10,26,54744117,-73987580,6.57604907573904e-05,99.999945199591,0.722222222222222
394.95,395,3,3,15,15,2025-08-25,2025-09-12,645.31,0,0,54744117,-73987580,2.7400204482246e-05,99.9999725997955,0
444.95,445,2,3,14,15,2025-08-25,2025-09-12,645.31,1,1,54744117,-73987580,2.7400204482246e-05,100,0.0666666666666667
661,661,0,0,0,0,2025-08-25,2025-08-29,645.31,0,0,32399846,-85165082,0,100,
662,662,0,0,0,0,2025-08-25,2025-08-29,645.31,0,0,32399846,-85165082,0,100,
663,663,0,0,0,0,2025-08-25,2025-08-29,645.31,0,0,32399846,-85165082,0,100,
664,664,0,0,0,0,2025-08-25,2025-08-29,645.31,0,0,32399846,-85165082,0,100,
644.32,665,0,0,0,0,2025-08-25,2025-08-29,645.31,0,0,32399846,-85165082,0,100,
644.7,666,0,0,0,0,2025-08-25,2025-08-29,645.31,0,0,32399846,-85165082,0,100,
667,667,0,0,0,0,2025-08-25,2025-08-29,645.31,0,0,32399846,-85165082,0,100,
668,668,0,0,0,0,2025-08-25,2025-08-29,645.31,0,0,32399846,-85165082,0,100,
669,669,0,0,0,0,2025-08-25,2025-08-29,645.31,0,0,32399846,-85165082,0,100,
644.89,680,0,0,0,0,2025-08-25,2025-08-29,645.31,0,0,32399846,-85165082,0,100,
638.85,685,0,0,0,0,2025-08-25,2025-08-29,645.31,0,0,32399846,-85165082,0,100,
633.84,690,0,0,0,0,2025-08-25,2025-08-29,645.31,0,0,32399846,-85165082,0,100,
580.97,695,0,0,0,0,2025-08-25,2025-08-29,645.31,0,0,32399846,-85165082,0,100,
635.73,705,0,0,0,0,2025-08-25,2025-08-29,645.31,0,0,32399846,-85165082,0,100,
710,710,0,0,0,0,2025-08-25,2025-08-29,645.31,0,0,32399846,-85165082,0,100,
715,715,0,0,0,0,2025-08-25,2025-08-29,645.31,0,0,32399846,-85165082,0,100,
635.17,720,0,0,0,0,2025-08-25,2025-08-29,645.31,0,0,32399846,-85165082,0,100,
631.88,725,0,0,0,0,2025-08-25,2025-08-29,645.31,0,0,32399846,-85165082,0,100,
638.78,735,0,0,0,0,2025-08-25,2025-08-29,645.31,0,0,32399846,-85165082,0,100,
635.52,659,0,0,0,0,2025-08-25,2025-09-05,645.31,0,0,34008892,-59743455,0,100,
645.59,661,0,0,0,0,2025-08-25,2025-09-05,645.31,0,0,34008892,-59743455,0,100,
662,662,0,0,0,0,2025-08-25,2025-09-05,645.31,0,0,34008892,-59743455,0,100,
663,663,0,0,0,0,2025-08-25,2025-09-05,645.31,0,0,34008892,-59743455,0,100,
664,664,0,0,0,0,2025-08-25,2025-09-05,645.31,0,0,34008892,-59743455,0,100,
666,666,0,0,0,0,2025-08-25,2025-09-05,645.31,0,0,34008892,-59743455,0,100,
667,667,0,0,0,0,2025-08-25,2025-09-05,645.31,0,0,34008892,-59743455,0,100,
668,668,0,0,0,0,2025-08-25,2025-09-05,645.31,0,0,34008892,-59743455,0,100,
669,669,0,0,0,0,2025-08-25,2025-09-05,645.31,0,0,34008892,-59743455,0,100,
644.24,675,0,0,0,0,2025-08-25,2025-09-05,645.31,0,0,34008892,-59743455,0,100,
642.64,680,0,0,0,0,2025-08-25,2025-09-05,645.31,0,0,34008892,-59743455,0,100,
637.75,685,0,0,0,0,2025-08-25,2025-09-05,645.31,0,0,34008892,-59743455,0,100,
637.6,690,0,0,0,0,2025-08-25,2025-09-05,645.31,0,0,34008892,-59743455,0,100,
695,695,0,0,0,0,2025-08-25,2025-09-05,645.31,0,0,34008892,-59743455,0,100,
643.5,700,0,0,0,0,2025-08-25,2025-09-05,645.31,0,0,34008892,-59743455,0,100,
705,705,0,0,0,0,2025-08-25,2025-09-05,645.31,0,0,34008892,-59743455,0,100,
710,710,0,0,0,0,2025-08-25,2025-09-05,645.31,0,0,34008892,-59743455,0,100,
715,715,0,0,0,0,2025-08-25,2025-09-05,645.31,0,0,34008892,-59743455,0,100,
720,720,0,0,0,0,2025-08-25,2025-09-05,645.31,0,0,34008892,-59743455,0,100,
632.48,725,0,0,0,0,2025-08-25,2025-09-05,645.31,0,0,34008892,-59743455,0,100,
635.69,730,0,0,0,0,2025-08-25,2025-09-05,645.31,0,0,34008892,-59743455,0,100,
635.71,735,0,0,0,0,2025-08-25,2025-09-05,645.31,0,0,34008892,-59743455,0,100,
661,661,0,0,0,0,2025-08-25,2025-09-12,645.31,0,0,54744117,-73987580,0,100,
662,662,0,0,0,0,2025-08-25,2025-09-12,645.31,0,0,54744117,-73987580,0,100,
663,663,0,0,0,0,2025-08-25,2025-09-12,645.31,0,0,54744117,-73987580,0,100,
666,666,0,0,0,0,2025-08-25,2025-09-12,645.31,0,0,54744117,-73987580,0,100,
667,667,0,0,0,0,2025-08-25,2025-09-12,645.31,0,0,54744117,-73987580,0,100,
668,668,0,0,0,0,2025-08-25,2025-09-12,645.31,0,0,54744117,-73987580,0,100,
669,669,0,0,0,0,2025-08-25,2025-09-12,645.31,0,0,54744117,-73987580,0,100,
639.82,670,0,0,0,0,2025-08-25,2025-09-12,645.31,0,0,54744117,-73987580,0,100,
644.22,675,0,0,0,0,2025-08-25,2025-09-12,645.31,0,0,54744117,-73987580,0,100,
641.93,680,0,0,0,0,2025-08-25,2025-09-12,645.31,0,0,54744117,-73987580,0,100,
685,685,0,0,0,0,2025-08-25,2025-09-12,645.31,0,0,54744117,-73987580,0,100,
690,690,0,0,0,0,2025-08-25,2025-09-12,645.31,0,0,54744117,-73987580,0,100,
643.49,700,0,0,0,0,2025-08-25,2025-09-12,645.31,0,0,54744117,-73987580,0,100,
705,705,0,0,0,0,2025-08-25,2025-09-12,645.31,0,0,54744117,-73987580,0,100,
710,710,0,0,0,0,2025-08-25,2025-09-12,645.31,0,0,54744117,-73987580,0,100,
644.49,715,0,0,0,0,2025-08-25,2025-09-12,645.31,0,0,54744117,-73987580,0,100,
720,720,0,0,0,0,2025-08-25,2025-09-12,645.31,0,0,54744117,-73987580,0,100,
725,725,0,0,0,0,2025-08-25,2025-09-12,645.31,0,0,54744117,-73987580,0,100,
730,730,0,0,0,0,2025-08-25,2025-09-12,645.31,0,0,54744117,-73987580,0,100,
735,735,0,0,0,0,2025-08-25,2025-09-12,645.31,0,0,54744117,-73987580,0,100,
740,740,0,0,0,0,2025-08-25,2025-09-12,645.31,0,0,54744117,-73987580,0,100,
643.94,745,0,0,0,0,2025-08-25,2025-09-12,645.31,0,0,54744117,-73987580,0,100,
642.42,750,0,0,0,0,2025-08-25,2025-09-12,645.31,0,0,54744117,-73987580,0,100,
641.5,680,0,0,0,0,2025-08-25,2025-09-19,645.31,0,0,308081023,-281827335,0,100,
633.3,685,0,0,0,0,2025-08-25,2025-09-19,645.31,0,0,308081023,-281827335,0,100,
627.64,695,0,0,0,0,2025-08-25,2025-09-19,645.31,0,0,308081023,-281827335,0,100,
639.05,705,0,0,0,0,2025-08-25,2025-09-19,645.31,0,0,308081023,-281827335,0,100,
710,710,0,0,0,0,2025-08-25,2025-09-19,645.31,0,0,308081023,-281827335,0,100,
715,715,0,0,0,0,2025-08-25,2025-09-19,645.31,0,0,308081023,-281827335,0,100,
593.69,720,0,0,0,0,2025-08-25,2025-09-19,645.31,0,0,308081023,-281827335,0,100,
553.12,725,0,0,0,0,2025-08-25,2025-09-19,645.31,0,0,308081023,-281827335,0,100,
593.85,730,0,0,0,0,2025-08-25,2025-09-19,645.31,0,0,308081023,-281827335,0,100,
611,735,0,0,0,0,2025-08-25,2025-09-19,645.31,0,0,308081023,-281827335,0,100,
740,740,0,0,0,0,2025-08-25,2025-09-19,645.31,0,0,308081023,-281827335,0,100,
745,745,0,0,0,0,2025-08-25,2025-09-19,645.31,0,0,308081023,-281827335,0,100,
594.66,750,0,0,0,0,2025-08-25,2025-09-19,645.31,0,0,308081023,-281827335,0,100,
594.64,755,0,0,0,0,2025-08-25,2025-09-19,645.31,0,0,308081023,-281827335,0,100,
633.19,760,0,0,0,0,2025-08-25,2025-09-19,645.31,0,0,308081023,-281827335,0,100,
765,765,0,0,0,0,2025-08-25,2025-09-19,645.31,0,0,308081023,-281827335,0,100,
770,770,0,0,0,0,2025-08-25,2025-09-19,645.31,0,0,308081023,-281827335,0,100,
775,775,0,0,0,0,2025-08-25,2025-09-19,645.31,0,0,308081023,-281827335,0,100,
633.18,780,0,0,0,0,2025-08-25,2025-09-19,645.31,0,0,308081023,-281827335,0,100,
785,785,0,0,0,0,2025-08-25,2025-09-19,645.31,0,0,308081023,-281827335,0,100,
790,790,0,0,0,0,2025-08-25,2025-09-19,645.31,0,0,308081023,-281827335,0,100,
795,795,0,0,0,0,2025-08-25,2025-09-19,645.31,0,0,308081023,-281827335,0,100,
594.64,800,0,0,0,0,2025-08-25,2025-09-19,645.31,0,0,308081023,-281827335,0,100,
594.62,805,0,0,0,0,2025-08-25,2025-09-19,645.31,0,0,308081023,-281827335,0,100,
810,810,0,0,0,0,2025-08-25,2025-09-19,645.31,0,0,308081023,-281827335,0,100,
815,815,0,0,0,0,2025-08-25,2025-09-19,645.31,0,0,308081023,-281827335,0,100,
820,820,0,0,0,0,2025-08-25,2025-09-19,645.31,0,0,308081023,-281827335,0,100,
633.88,825,0,0,0,0,2025-08-25,2025-09-19,645.31,0,0,308081023,-281827335,0,100,
622.75,830,0,0,0,0,2025-08-25,2025-09-19,645.31,0,0,308081023,-281827335,0,100,
657,657,0,0,0,0,2025-08-25,2025-09-26,645.31,0,0,18921943,-7892956,0,100,
645.23,675,0,0,0,0,2025-08-25,2025-09-26,645.31,0,0,18921943,-7892956,0,100,
644.7,680,0,0,0,0,2025-08-25,2025-09-26,645.31,0,0,18921943,-7892956,0,100,
685,685,0,0,0,0,2025-08-25,2025-09-26,645.31,0,0,18921943,-7892956,0,100,
690,690,0,0,0,0,2025-08-25,2025-09-26,645.31,0,0,18921943,-7892956,0,100,
695,695,0,0,0,0,2025-08-25,2025-09-26,645.31,0,0,18921943,-7892956,0,100,
700,700,0,0,0,0,2025-08-25,2025-09-26,645.31,0,0,18921943,-7892956,0,100,
705,705,0,0,0,0,2025-08-25,2025-09-26,645.31,0,0,18921943,-7892956,0,100,
710,710,0,0,0,0,2025-08-25,2025-09-26,645.31,0,0,18921943,-7892956,0,100,
715,715,0,0,0,0,2025-08-25,2025-09-26,645.31,0,0,18921943,-7892956,0,100,
720,720,0,0,0,0,2025-08-25,2025-09-26,645.31,0,0,18921943,-7892956,0,100,
725,725,0,0,0,0,2025-08-25,2025-09-26,645.31,0,0,18921943,-7892956,0,100,
730,730,0,0,0,0,2025-08-25,2025-09-26,645.31,0,0,18921943,-7892956,0,100,
735,735,0,0,0,0,2025-08-25,2025-09-26,645.31,0,0,18921943,-7892956,0,100,
740,740,0,0,0,0,2025-08-25,2025-09-26,645.31,0,0,18921943,-7892956,0,100,
745,745,0,0,0,0,2025-08-25,2025-09-26,645.31,0,0,18921943,-7892956,0,100,
645.14,685,0,0,0,0,2025-08-25,2025-10-17,645.31,0,0,273584119,-124151124,0,100,
638,690,0,0,0,0,2025-08-25,2025-10-17,645.31,0,0,273584119,-124151124,0,100,
632.45,705,0,0,0,0,2025-08-25,2025-10-17,645.31,0,0,273584119,-124151124,0,100,
635.42,710,0,0,0,0,2025-08-25,2025-10-17,645.31,0,0,273584119,-124151124,0,100,
715,715,0,0,0,0,2025-08-25,2025-10-17,645.31,0,0,273584119,-124151124,0,100,
635.49,720,0,0,0,0,2025-08-25,2025-10-17,645.31,0,0,273584119,-124151124,0,100,
631.47,725,0,0,0,0,2025-08-25,2025-10-17,645.31,0,0,273584119,-124151124,0,100,
645.17,735,0,0,0,0,2025-08-25,2025-10-17,645.31,0,0,273584119,-124151124,0,100,
740,740,0,0,0,0,2025-08-25,2025-10-17,645.31,0,0,273584119,-124151124,0,100,
745,745,0,0,0,0,2025-08-25,2025-10-17,645.31,0,0,273584119,-124151124,0,100,
705,705,0,0,0,0,2025-08-25,2025-11-21,645.31,0,0,116293910,-42898419,0,100,
710,710,0,0,0,0,2025-08-25,2025-11-21,645.31,0,0,116293910,-42898419,0,100,
715,715,0,0,0,0,2025-08-25,2025-11-21,645.31,0,0,116293910,-42898419,0,100,
720,720,0,0,0,0,2025-08-25,2025-11-21,645.31,0,0,116293910,-42898419,0,100,
725,725,0,0,0,0,2025-08-25,2025-11-21,645.31,0,0,116293910,-42898419,0,100,
643.51,730,0,0,0,0,2025-08-25,2025-11-21,645.31,0,0,116293910,-42898419,0,100,
642.17,735,0,0,0,0,2025-08-25,2025-11-21,645.31,0,0,116293910,-42898419,0,100,
740,740,0,0,0,0,2025-08-25,2025-11-21,645.31,0,0,116293910,-42898419,0,100,
745,745,0,0,0,0,2025-08-25,2025-11-21,645.31,0,0,116293910,-42898419,0,100,
750,750,0,0,0,0,2025-08-25,2025-11-21,645.31,0,0,116293910,-42898419,0,100,
755,755,0,0,0,0,2025-08-25,2025-11-21,645.31,0,0,116293910,-42898419,0,100,
760,760,0,0,0,0,2025-08-25,2025-11-21,645.31,0,0,116293910,-42898419,0,100,
765,765,0,0,0,0,2025-08-25,2025-11-21,645.31,0,0,116293910,-42898419,0,100,
770,770,0,0,0,0,2025-08-25,2025-11-21,645.31,0,0,116293910,-42898419,0,100,
775,775,0,0,0,0,2025-08-25,2025-11-21,645.31,0,0,116293910,-42898419,0,100,
780,780,0,0,0,0,2025-08-25,2025-11-21,645.31,0,0,116293910,-42898419,0,100,
785,785,0,0,0,0,2025-08-25,2025-11-21,645.31,0,0,116293910,-42898419,0,100,
790,790,0,0,0,0,2025-08-25,2025-11-21,645.31,0,0,116293910,-42898419,0,100,
795,795,0,0,0,0,2025-08-25,2025-11-21,645.31,0,0,116293910,-42898419,0,100,
800,800,0,0,0,0,2025-08-25,2025-11-21,645.31,0,0,116293910,-42898419,0,100,
537.36,705,0,0,0,0,2025-08-25,2025-12-19,645.31,0,0,332103998,-83576231,0,100,
599.77,715,0,0,0,0,2025-08-25,2025-12-19,645.31,0,0,332103998,-83576231,0,100,
641.25,720,0,0,0,0,2025-08-25,2025-12-19,645.31,0,0,332103998,-83576231,0,100,
626.5,725,0,0,0,0,2025-08-25,2025-12-19,645.31,0,0,332103998,-83576231,0,100,
730,730,0,0,0,0,2025-08-25,2025-12-19,645.31,0,0,332103998,-83576231,0,100,
735,735,0,0,0,0,2025-08-25,2025-12-19,645.31,0,0,332103998,-83576231,0,100,
557.52,740,0,0,0,0,2025-08-25,2025-12-19,645.31,0,0,332103998,-83576231,0,100,
625.55,745,0,0,0,0,2025-08-25,2025-12-19,645.31,0,0,332103998,-83576231,0,100,
629.39,755,0,0,0,0,2025-08-25,2025-12-19,645.31,0,0,332103998,-83576231,0,100,
760,760,0,0,0,0,2025-08-25,2025-12-19,645.31,0,0,332103998,-83576231,0,100,
556.84,765,0,0,0,0,2025-08-25,2025-12-19,645.31,0,0,332103998,-83576231,0,100,
770,770,0,0,0,0,2025-08-25,2025-12-19,645.31,0,0,332103998,-83576231,0,100,
775,775,0,0,0,0,2025-08-25,2025-12-19,645.31,0,0,332103998,-83576231,0,100,
602,780,0,0,0,0,2025-08-25,2025-12-19,645.31,0,0,332103998,-83576231,0,100,
785,785,0,0,0,0,2025-08-25,2025-12-19,645.31,0,0,332103998,-83576231,0,100,
790,790,0,0,0,0,2025-08-25,2025-12-19,645.31,0,0,332103998,-83576231,0,100,
795,795,0,0,0,0,2025-08-25,2025-12-19,645.31,0,0,332103998,-83576231,0,100,
593.9,800,0,0,0,0,2025-08-25,2025-12-19,645.31,0,0,332103998,-83576231,0,100,
805,805,0,0,0,0,2025-08-25,2025-12-19,645.31,0,0,332103998,-83576231,0,100,
810,810,0,0,0,0,2025-08-25,2025-12-19,645.31,0,0,332103998,-83576231,0,100,
815,815,0,0,0,0,2025-08-25,2025-12-19,645.31,0,0,332103998,-83576231,0,100,
820,820,0,0,0,0,2025-08-25,2025-12-19,645.31,0,0,332103998,-83576231,0,100,
516.96,825,0,0,0,0,2025-08-25,2025-12-19,645.31,0,0,332103998,-83576231,0,100,
830,830,0,0,0,0,2025-08-25,2025-12-19,645.31,0,0,332103998,-83576231,0,100,
835,835,0,0,0,0,2025-08-25,2025-12-19,645.31,0,0,332103998,-83576231,0,100,
593.89,840,0,0,0,0,2025-08-25,2025-12-19,645.31,0,0,332103998,-83576231,0,100,
