Watch,strike,open_interest.yt,open_interest.td,OI_Dollar.yt,OI_Dollar.td,Date.td,expiry,stkClose,diff_oi,diff_oi_d,totalOI,totalOIdiff,OI_pct,cum_sep_OI,pct
435.42,440,88535,116264,34617185,53248912,2023-09-13,2023-10-20,445.99,27729,18631727,497615928,97292139,10.7008053809725,10.7008053809725,0.34989873595915
427.44,430,132366,133991,29120520,34301696,2023-09-13,2023-10-20,445.99,1625,5181176,497615928,97292139,6.89320700361505,17.5940123845875,0.151047225186766
437.88,450,26784,28211,29623104,34191732,2023-09-13,2023-12-15,445.99,1427,4568628,481634514,35662575,7.09910336699832,7.09910336699832,0.133617916752506
442.92,450,45593,45240,25440894,32029920,2023-09-13,2023-09-29,445.99,-353,6589026,181598301,29583870,17.6377861596844,17.6377861596844,0.205714719237513
423.88,430,46507,46791,25997413,28636092,2023-09-13,2023-12-15,445.99,284,2638679,481634514,35662575,5.94560629847221,13.0447096654705,0.0921452200949767
438.77,445,46274,45488,24525220,28339024,2023-09-13,2023-10-20,445.99,-786,3813804,497615928,97292139,5.69495918547045,23.2889715700579,0.134577817499996
443.5,460,16530,16530,26530650,27274500,2023-09-13,2023-12-15,445.99,0,743850,481634514,35662575,5.66290396705249,18.707613632523,0.0272727272727273
443.97,465,12753,12755,23656815,26823765,2023-09-13,2023-11-17,445.99,2,3166950,390070868,38675143,6.87663888809046,6.87663888809046,0.11806508146787
441.53,450,31191,31231,22644666,26452657,2023-09-13,2023-10-20,445.99,40,3807991,497615928,97292139,5.31587827309258,28.6048498431505,0.143954953182964
431.6,435,78123,74917,22811916,25471780,2023-09-13,2023-10-20,445.99,-3206,2659864,497615928,97292139,5.11876299908149,33.723612842232,0.104423954666694
440.51,448,8021,33759,5133440,25285491,2023-09-13,2023-10-20,445.99,25738,20152051,497615928,97292139,5.08132669740427,38.8049395396363,0.796980806107344
444.45,450,47183,41912,18259821,23261160,2023-09-13,2023-09-15,445.99,-5271,5001339,204169288,52571163,11.393074946708,11.393074946708,0.215008150926265
439.67,450,19995,21047,18515370,21741551,2023-09-13,2023-11-17,445.99,1052,3226181,390070868,38675143,5.5737438459516,12.4503827340421,0.148387803611619
444.29,460,13231,13226,17848619,20778046,2023-09-13,2023-10-20,445.99,-5,2929427,497615928,97292139,4.17551867431382,42.9804582139501,0.140986645231222
427.78,435,27841,27814,18375060,20081708,2023-09-13,2023-12-15,445.99,-27,1706648,481634514,35662575,4.16949105935544,22.8771046918785,0.0849852014579638
397.49,400,77390,78153,18186650,19616403,2023-09-13,2023-12-15,445.99,763,1429753,481634514,35662575,4.0728814961961,26.9499861880746,0.0728855845793949
418.5,420,121923,129393,15728067,19408950,2023-09-13,2023-10-20,445.99,7470,3680883,497615928,97292139,3.90038760977924,46.8808458237294,0.189648744522501
440.64,445,58944,44406,20335680,19361016,2023-09-13,2023-09-29,445.99,-14538,-974664,181598301,29583870,10.661452168542,28.2992383282264,-0.0503415729835666
443.29,460,10925,10932,16136225,18267372,2023-09-13,2023-11-17,445.99,7,2131147,390070868,38675143,4.68309056086701,17.1334732949091,0.116664126618761
436.74,445,22544,21733,16637472,17951458,2023-09-13,2023-11-17,445.99,-811,1313986,390070868,38675143,4.60210168783996,21.735574982749,0.0731966172329846
419.79,425,32964,33105,15987540,17247705,2023-09-13,2023-12-15,445.99,141,1260165,481634514,35662575,3.58107745575725,30.5310636438318,0.0730627640025151
437.29,440,45707,62648,9872712,16977608,2023-09-13,2023-09-29,445.99,16941,7104896,181598301,29583870,9.34899055030256,37.648228878529,0.418486279103629
420.54,424,29814,48621,9272154,16822866,2023-09-13,2023-11-17,445.99,18807,7550712,390070868,38675143,4.31277169870578,26.0483466814548,0.448836244668417
444.87,455,16550,16573,13173800,16788449,2023-09-13,2023-09-15,445.99,23,3614649,204169288,52571163,8.2228082217733,19.6158831684812,0.215305714065665
419.09,424,33832,33879,15867208,16634589,2023-09-13,2023-12-15,445.99,47,767381,481634514,35662575,3.45377843914234,33.9848420829741,0.0461316477371338
423.06,427,43540,41811,15282540,16473534,2023-09-13,2023-11-17,445.99,-1729,1190994,390070868,38675143,4.22321566449305,30.2715623459479,0.0722974196065034
441.78,455,11931,11826,14018925,15633972,2023-09-13,2023-11-17,445.99,-105,1615047,390070868,38675143,4.00798246743205,34.2795448133799,0.103303690194661
415.54,420,34693,34866,14501674,15550236,2023-09-13,2023-12-15,445.99,173,1048562,481634514,35662575,3.22863822005912,37.2134803030333,0.0674306164871066
444.87,460,10067,10219,12785090,15461347,2023-09-13,2023-09-15,445.99,152,2676257,204169288,52571163,7.57280742439578,27.188690592877,0.173093392186334
427.04,434,22047,22097,14065986,15379512,2023-09-13,2023-12-15,445.99,50,1313526,481634514,35662575,3.19319142481554,40.4066717278488,0.0854075213829933
433.36,440,29761,22648,17737556,15038272,2023-09-13,2023-11-17,445.99,-7113,-2699284,390070868,38675143,3.85526662811436,38.1348114414943,-0.179494292961319
406.67,410,44959,44987,13847372,14980671,2023-09-13,2023-12-15,445.99,28,1133299,481634514,35662575,3.11038153715039,43.5170532649992,0.0756507502234046
443.04,455,12384,12341,12210624,14759836,2023-09-13,2023-10-20,445.99,-43,2549212,497615928,97292139,2.96611003978956,49.8469558635189,0.172712759139058
444.65,452,18578,18470,10032120,13575450,2023-09-13,2023-09-15,445.99,-108,3543330,204169288,52571163,6.64911463079599,33.837805223673,0.261010132260809
441.49,454,9513,10584,10626021,13240584,2023-09-13,2023-11-17,445.99,1071,2614563,390070868,38675143,3.3944047316038,41.5292161730981,0.197465836854326
444.83,454,14353,14360,9903570,13168120,2023-09-13,2023-09-15,445.99,7,3264550,204169288,52571163,6.44960862086172,40.2874138445347,0.247913141739292
442.71,445,61035,57043,8605935,13062847,2023-09-13,2023-09-15,445.99,-3992,4456912,204169288,52571163,6.3980469971566,46.6854608416913,0.341189941212662
444.42,456,11151,11145,9846333,12905910,2023-09-13,2023-09-15,445.99,-6,3059577,204169288,52571163,6.32118088201395,53.0066417237053,0.237067901449801
431.51,440,15057,14929,11789631,12674721,2023-09-13,2023-12-15,445.99,-128,885090,481634514,35662575,2.63160563281393,46.1486588978131,0.0698311229099244
444.88,458,9319,9656,10800721,12668672,2023-09-13,2023-09-15,445.99,337,1867951,204169288,52571163,6.20498416980325,59.2116258935085,0.147446472684745
440.45,452,9199,10812,9272592,12487860,2023-09-13,2023-11-17,445.99,1613,3215268,390070868,38675143,3.20143364307842,44.7306498161765,0.257471496317223
398.51,400,83124,83501,11637360,12441649,2023-09-13,2023-11-17,445.99,377,804289,390070868,38675143,3.18958682143882,47.9202366376153,0.0646448875064712
425.62,430,24189,27284,9554655,11950392,2023-09-13,2023-11-17,445.99,3095,2395737,390070868,38675143,3.06364637309957,50.9838830107149,0.200473507479922
436.58,448,9704,9551,9946600,10907242,2023-09-13,2023-12-15,445.99,-153,960642,481634514,35662575,2.26463047870361,48.4132893765167,0.0880737770373115
434.88,445,10718,10688,9860560,10816256,2023-09-13,2023-12-15,445.99,-30,955696,481634514,35662575,2.2457393906783,50.659028767195,0.0883573761567774
422.27,426,47198,28575,15905726,10658475,2023-09-13,2023-11-17,445.99,-18623,-5247251,390070868,38675143,2.73244578726141,53.7163287979763,-0.492307858300554
413.84,415,90059,91164,9186018,10575024,2023-09-13,2023-10-20,445.99,1105,1389006,497615928,97292139,2.12513776287322,51.9720936263921,0.131347787012115
443.6,458,7318,7314,8957232,10532160,2023-09-13,2023-10-20,445.99,-4,1574928,497615928,97292139,2.11652389069025,54.0886175170824,0.149535138091332
418.8,422,32778,32784,9407286,10490880,2023-09-13,2023-11-17,445.99,6,1083594,390070868,38675143,2.68948051767865,56.4058093156549,0.103289142569546
424.65,429,23548,23518,9089528,10230330,2023-09-13,2023-11-17,445.99,-30,1140802,390070868,38675143,2.6226849629796,59.0284942786345,0.111511749865351
436.11,444,12341,12454,8762110,9826206,2023-09-13,2023-11-17,445.99,113,1064096,390070868,38675143,2.51908225045917,61.5475765290937,0.108291643794156
433.3,435,69525,57190,9524925,9722300,2023-09-13,2023-09-29,445.99,-12335,197374.999999998,181598301,29583870,5.35373951543743,43.0019683939664,0.0203012661612991
429.63,435,18473,18049,8959405,9692313,2023-09-13,2023-11-17,445.99,-424,732908.000000002,390070868,38675143,2.48475694934491,64.0323334784386,0.075617450653936
444.09,449,18217,19475,5829440,9562225,2023-09-13,2023-09-15,445.99,1258,3732785,204169288,52571163,4.68347864346767,63.8951045369762,0.390367827571512
409.08,410,99498,99240,8158836,9130080,2023-09-13,2023-10-20,445.99,-258,971244,497615928,97292139,1.83476442096524,55.9233819380476,0.106378476420798
423.05,425,48045,46655,8071560,9097725,2023-09-13,2023-10-20,445.99,-1390,1026165,497615928,97292139,1.82826241848111,57.7516443565287,0.112793583011138
423.92,426,43474,43508,7738372,9049664,2023-09-13,2023-10-20,445.99,34,1311292,497615928,97292139,1.81860416654509,59.5702485230738,0.144899523341419
388,390,44982,45222,8231706,9044400,2023-09-13,2023-12-15,445.99,240,812694,481634514,35662575,1.87785545618103,52.5368842233761,0.0898560435186414
443.86,464,4434,4444,8131956,8950216,2023-09-13,2023-11-17,445.99,10,818260,390070868,38675143,2.29451023756022,66.3268437159988,0.0914234919023183
444.64,465,4389,4382,7847532,8921752,2023-09-13,2023-10-20,445.99,-7,1074220,497615928,97292139,1.79289920157057,61.3631477246444,0.120404602145408
425.68,428,38124,38137,7624800,8847784,2023-09-13,2023-10-20,445.99,13,1222984,497615928,97292139,1.7780347256087,63.1411824502531,0.138224893374431
402.09,405,27898,29071,7532460,8459661,2023-09-13,2023-12-15,445.99,1173,927200.999999999,481634514,35662575,1.75644825154702,54.2933324749231,0.109602618828343
421.41,425,23244,23428,7554300,8410652,2023-09-13,2023-11-17,445.99,184,856351.999999998,390070868,38675143,2.15618562932518,68.483029345324,0.101817552313423
442.71,454,7065,7062,6528060,7972998,2023-09-13,2023-10-20,445.99,-3,1444938,497615928,97292139,1.60223930774177,64.7434217579949,0.181228942989826
439.89,454,5573,5569,7144586,7857859,2023-09-13,2023-12-15,445.99,-4,713273,481634514,35662575,1.63149831907603,55.9248307939991,0.0907719265514945
428.89,430,70262,70658,6323580,7843038,2023-09-13,2023-09-29,445.99,396,1519458,181598301,29583870,4.31889393062108,47.3208623245875,0.193733346695502
439.24,440,119747,102455,5508362,7786580,2023-09-13,2023-09-15,445.99,-17292,2278218,204169288,52571163,3.81378613614012,67.7088906731163,0.292582622923029
444,448,18596,19435,4927940,7774000,2023-09-13,2023-09-15,445.99,839,2846060,204169288,52571163,3.80762458259638,71.5165152557127,0.366099819912529
432.89,442,8461,8323,7048013,7582253,2023-09-13,2023-12-15,445.99,-138,534240,481634514,35662575,1.57427526051424,57.4991060545134,0.0704592685050209
432.64,439,11596,11482,6632912,7302552,2023-09-13,2023-11-17,445.99,-114,669640,390070868,38675143,1.87210904455444,70.3551383898784,0.0916994497266161
415.68,417,55020,55052,6382320,7266864,2023-09-13,2023-10-20,445.99,32,884544,497615928,97292139,1.46033589182057,66.2037576498154,0.121722933028608
378.45,380,39302,46658,5777394,7231990,2023-09-13,2023-12-15,445.99,7356,1454596,481634514,35662575,1.50155144404788,59.0006574985613,0.201133574576292
443.45,456,5524,5524,5805724,6932620,2023-09-13,2023-10-20,445.99,0,1126896,497615928,97292139,1.39316682001385,67.5969244698293,0.162549800796813
373.59,375,50837,48948,6710484,6901668,2023-09-13,2023-12-15,445.99,-1889,191183.999999999,481634514,35662575,1.43296790395715,60.4336254025184,0.0277011296399652
442.83,458,4514,4532,6206750,6875044,2023-09-13,2023-11-17,445.99,18,668294,390070868,38675143,1.7625115239316,72.11764991381,0.0972057778830215
443.22,446,25004,23871,4350696,6636138,2023-09-13,2023-09-15,445.99,-1133,2285442,204169288,52571163,3.25031157477514,74.7668268304879,0.344393380607817
442.4,452,6606,6713,5430132,6444480,2023-09-13,2023-10-20,445.99,107,1014348,497615928,97292139,1.29507108542555,68.8919955552548,0.157397959183673
422.16,424,34748,34807,5663924,6404488,2023-09-13,2023-10-20,445.99,59,740564,497615928,97292139,1.28703436518616,70.179029920441,0.115632038033329
426.59,429,26650,26369,5489900,6354929,2023-09-13,2023-10-20,445.99,-281,865029,497615928,97292139,1.2770750778701,71.4561049983111,0.136119380720068
432.38,436,17329,17376,5302674,6290112,2023-09-13,2023-10-20,445.99,47,987438,497615928,97292139,1.26404957037468,72.7201545686858,0.156982578370624
427.17,432,13273,13005,5707390,6281415,2023-09-13,2023-11-17,445.99,-268,574025.000000001,390070868,38675143,1.61032661377829,73.7279765275883,0.091384664124246
447.84,468,3103,3103,6255648,6255648,2023-09-13,2023-12-15,445.99,0,0,481634514,35662575,1.29883715102693,61.7324625535453,0
446.25,475,2157,2157,6201375,6201375,2023-09-13,2023-12-15,445.99,0,0,481634514,35662575,1.28756864795616,63.0200312015015,0
443.61,447,16860,18183,3641760,6164037,2023-09-13,2023-09-15,445.99,1323,2522277,204169288,52571163,3.01908140072468,77.7859082312125,0.409192384795873
417.03,420,19726,20498,5247116,6087906,2023-09-13,2023-11-17,445.99,772,840790.000000001,390070868,38675143,1.56071793600336,75.2886944635917,0.138108242801384
411.15,415,15631,15586,5549005,6000610,2023-09-13,2023-12-15,445.99,-45,451605,481634514,35662575,1.24588455054116,64.2659157520427,0.0752598485820608
441.75,451,6610,6484,5122750,5997700,2023-09-13,2023-10-20,445.99,-126,874950,497615928,97292139,1.20528698189098,73.9254415505767,0.145880921019724
438.14,444,9599,9613,4809099,5633218,2023-09-13,2023-10-20,445.99,14,824119,497615928,97292139,1.1320413361045,75.0574828866812,0.146296308788334
445.18,467,2581,2581,5631742,5631742,2023-09-13,2023-12-15,445.99,0,0,481634514,35662575,1.16929784645791,65.4352135985005,0
444,455,4693,5032,4153305,5535200,2023-09-13,2023-09-29,445.99,339,1381895,181598301,29583870,3.04804613783253,50.36890846242,0.249655838994074
445.89,462,3401,3402,5611650,5480622,2023-09-13,2023-10-20,445.99,1,-131028,497615928,97292139,1.10137591897983,76.1588588056611,-0.0239075053889869
444.97,500,995,995,5475485,5475485,2023-09-13,2023-12-15,445.99,0,0,481634514,35662575,1.1368547811339,66.5720683796345,0
417.51,419,36421,36396,4589046,5423004,2023-09-13,2023-10-20,445.99,-25,833958,497615928,97292139,1.08979710954911,77.2486559152102,0.153781557232855
438.72,442,16140,16451,4147980,5395928,2023-09-13,2023-09-29,445.99,311,1247948,181598301,29583870,2.97135379036393,53.340262252784,0.231275880627021
439.47,453,3760,3749,4594720,5072397,2023-09-13,2023-12-15,445.99,-11,477677,481634514,35662575,1.05316310450293,67.6252314841374,0.0941718481420125
437.28,446,4935,5801,3829560,5058472,2023-09-13,2023-11-17,445.99,866,1228912,390070868,38675143,1.29680845584193,76.5855029194336,0.242941346714976
432.43,434,31747,31821,3936628,4995897,2023-09-13,2023-09-29,445.99,74,1059269,181598301,29583870,2.75107034178695,56.0913325945709,0.212027790004478
444.57,451,7703,7767,3589598,4994181,2023-09-13,2023-09-15,445.99,64,1404583,204169288,52571163,2.44609806348544,80.232006294698,0.281243911664395
438.91,452,3799,3800,4657574,4974200,2023-09-13,2023-12-15,445.99,1,316626,481634514,35662575,1.03277482310996,68.6580063072473,0.0636536528486993
434.76,442,6349,6840,4209387,4952160,2023-09-13,2023-11-17,445.99,491,742773,390070868,38675143,1.26955392116081,77.8550568405944,0.149989701463604
368.76,370,39230,39349,4668370,4879276,2023-09-13,2023-12-15,445.99,119,210906,481634514,35662575,1.01306610265061,69.6710724098979,0.0432248554908556
428.78,434,9096,9287,4284216,4847814,2023-09-13,2023-11-17,445.99,191,563598,390070868,38675143,1.24280339745854,79.097860238053,0.116258173271499
407.86,410,22244,22189,4293092,4748446,2023-09-13,2023-11-17,445.99,-55,455354,390070868,38675143,1.2173290521147,80.3151892901677,0.0958953729283222
433.46,443,4762,4976,4114368,4747104,2023-09-13,2023-12-15,445.99,214,632735.999999999,481634514,35662575,0.985623717157446,70.6566961270554,0.133288843050415
439.88,447,6074,6648,3656548,4733376,2023-09-13,2023-10-20,445.99,574,1076828,497615928,97292139,0.951210709637896,78.1998666248481,0.227496822563853
421.25,423,26909,26994,4063259,4723950,2023-09-13,2023-10-20,445.99,85,660691,497615928,97292139,0.949316477667089,79.1491831025152,0.139859863038347
444.75,460,3054,3055,3924390,4658875,2023-09-13,2023-09-29,445.99,1,734485,181598301,29583870,2.56548380372788,58.6568163982988,0.157652866840171
442.78,456,3472,3483,4617760,4604526,2023-09-13,2023-11-17,445.99,11,-13234.0000000009,390070868,38675143,1.18043319246286,81.4956224826305,-0.00287412862909253
399.39,400,75363,74284,4144965,4531324,2023-09-13,2023-10-20,445.99,-1079,386359,497615928,97292139,0.91060670389152,80.0597898064067,0.085264042032748
439.4,446,6479,6754,3628240,4457640,2023-09-13,2023-10-20,445.99,275,829400,497615928,97292139,0.895799300057775,80.9555891064645,0.186062580199388
436.83,442,9018,8407,3949884,4346419,2023-09-13,2023-10-20,445.99,-611,396535.000000001,497615928,97292139,0.873448528359808,81.8290376348243,0.091232575598441
444.6,465,2075,2079,4042100,4241160,2023-09-13,2023-12-15,445.99,4,199060,481634514,35662575,0.880576428125332,71.5372725551807,0.0469352724254685
444.34,457,3316,3317,3810084,4199322,2023-09-13,2023-09-29,445.99,1,389238,181598301,29583870,2.31242361678263,60.9692400150814,0.0926906772093208
441.47,445,11539,11889,3011679,4196817,2023-09-13,2023-09-22,445.99,350,1185138,40008818,10432511,10.4897300390129,10.4897300390129,0.282389725356145
444.8,464,2168,2168,4492096,4162560,2023-09-13,2023-10-20,445.99,0,-329536,497615928,97292139,0.83650055510281,82.6655381899271,-0.0791666666666667
443.52,462,2234,2244,3712908,4146912,2023-09-13,2023-11-17,445.99,10,434004.000000001,390070868,38675143,1.06311758713547,82.558740069766,0.104657152117045
436.14,447,4000,3797,3972000,4123542,2023-09-13,2023-12-15,445.99,-203,151542,481634514,35662575,0.856155836041268,72.393428391222,0.0367504441569893
440.89,444,11354,13132,2543296,4084052,2023-09-13,2023-09-22,445.99,1778,1540756,40008818,10432511,10.2078796729261,20.697609711939,0.377261601958055
424.78,427,18172,18290,3361820,4060380,2023-09-13,2023-10-20,445.99,118,698560,497615928,97292139,0.815966646469564,83.4815048363966,0.172043010752688
442.14,444,20789,21811,2349157,4056846,2023-09-13,2023-09-15,445.99,1022,1707689,204169288,52571163,1.98700110077281,82.2190073954708,0.420940060332584
439.39,443,11248,11085,3216928,4001685,2023-09-13,2023-09-29,445.99,-163,784757,181598301,29583870,2.20359165144392,63.1728316665253,0.196106640077867
424.25,425,52954,53008,3336102,3975600,2023-09-13,2023-09-29,445.99,54,639498.000000001,181598301,29583870,2.18922753027298,65.3620591967983,0.160855719891337
444.48,456,3426,3426,3251274,3946752,2023-09-13,2023-09-29,445.99,0,695478,181598301,29583870,2.17334191909648,67.5354011158948,0.176215277777778
433.88,438,9235,9424,3241485,3882688,2023-09-13,2023-10-20,445.99,189,641203,497615928,97292139,0.780257982417315,84.261762818814,0.165144096048923
431.16,437,6732,6642,3534300,3878928,2023-09-13,2023-11-17,445.99,-90,344628,390070868,38675143,0.994416224899933,83.5531562946659,0.0888461966811449
443.81,453,4187,4208,3014640,3867152,2023-09-13,2023-09-29,445.99,21,852512,181598301,29583870,2.12950890988787,69.6649100257827,0.220449571157275
422.14,428,2099,6597,1110371,3865842,2023-09-13,2023-12-15,445.99,4498,2755471,481634514,35662575,0.802650534301203,73.1960789255232,0.712773827797411
392.78,395,17342,17259,3607136,3831498,2023-09-13,2023-12-15,445.99,-83,224362,481634514,35662575,0.795519816090256,73.9915987416135,0.0585572535859344
349.19,350,47107,47099,3627239,3815019,2023-09-13,2023-12-15,445.99,-8,187780,481634514,35662575,0.792098342022059,74.7836970836355,0.0492212489636356
428.02,433,7592,7641,3378440,3805218,2023-09-13,2023-11-17,445.99,49,426778,390070868,38675143,0.975519658648284,84.5286759533142,0.112155992113987
420.5,426,6923,6799,3440731,3739450,2023-09-13,2023-12-15,445.99,-124,298719,481634514,35662575,0.776408228916917,75.5601053125524,0.0798831378946102
439.59,451,3276,3271,3754296,3732211,2023-09-13,2023-12-15,445.99,-5,-22085.0000000005,481634514,35662575,0.774905222012391,76.3350105345648,-0.00591740391955344
430.79,434,11935,11614,3353735,3728094,2023-09-13,2023-10-20,445.99,-321,374359,497615928,97292139,0.749191050813792,85.0109538696277,0.100415654755486
389.57,390,60343,86547,2353377,3721521,2023-09-13,2023-10-20,445.99,26204,1368144,497615928,97292139,0.747870152580807,85.7588240222086,0.367630331791759
431.74,438,5951,5913,3308756,3701538,2023-09-13,2023-11-17,445.99,-38,392782,390070868,38675143,0.94893987315146,85.4776158264657,0.106113188625917
442.77,453,3406,3439,2963220,3518097,2023-09-13,2023-10-20,445.99,33,554877.000000001,497615928,97292139,0.706990432187291,86.4658144543959,0.15772077915987
430,438,4465,4368,3232660,3494400,2023-09-13,2023-12-15,445.99,-97,261740,481634514,35662575,0.725529400079497,77.0605399346443,0.0749027014652015
429.1,437,4370,4374,3063370,3455460,2023-09-13,2023-12-15,445.99,4,392090,481634514,35662575,0.717444431318309,77.7779843659626,0.113469697232785
441.51,443,23624,23183,2102536,3454267,2023-09-13,2023-09-15,445.99,-441,1351731,204169288,52571163,1.69186415539638,83.9108715508671,0.391322095252046
438.47,448,3044,3615,2575224,3445095,2023-09-13,2023-11-17,445.99,571,869871,390070868,38675143,0.883197204052675,86.3608130305184,0.252495504478106
405.01,408,11369,11444,3933674,3421756,2023-09-13,2023-12-15,445.99,75,-511918,481634514,35662575,0.710446593949868,78.4884309599125,-0.149606810070619
445.93,462,1666,2107,2922164,3385949,2023-09-13,2023-09-15,445.99,441,463785,204169288,52571163,1.65840270746303,85.5692742583302,0.136973415724809
426.83,433,5455,5345,3387555,3297865,2023-09-13,2023-12-15,445.99,-110,-89690.0000000005,481634514,35662575,0.684723561982936,79.1731545218954,-0.0271963831145303
443.27,451,4220,4221,2532000,3262833,2023-09-13,2023-09-29,445.99,1,730833,181598301,29583870,1.79673101677311,71.4616410425558,0.223987252795347
434.71,439,7657,7526,2794805,3228654,2023-09-13,2023-10-20,445.99,-131,433849,497615928,97292139,0.648824488592335,87.1146389429882,0.134374572190145
434.1,444,3508,3220,3122120,3187800,2023-09-13,2023-12-15,445.99,-288,65680,481634514,35662575,0.661871171466753,79.8350256933622,0.0206035510383336
414.77,416,25455,25743,2749140,3166389,2023-09-13,2023-10-20,445.99,288,417249,497615928,97292139,0.636311826417261,87.7509507694054,0.1317743966392
440.5,455,2191,2177,2903075,3156650,2023-09-13,2023-12-15,445.99,-14,253575,481634514,35662575,0.655403611710435,80.4904293050726,0.0803304135713494
443.6,459,2018,2018,3107720,3107720,2023-09-13,2023-12-15,445.99,0,0,481634514,35662575,0.645244456048264,81.1356737611209,0
359,360,31020,30871,2946900,3087100,2023-09-13,2023-12-15,445.99,-149,140200,481634514,35662575,0.640963201403793,81.7766369625247,0.0454147905801561
444.72,453,3786,3680,2347320,3047040,2023-09-13,2023-09-15,445.99,-106,699720,204169288,52571163,1.49240859379399,87.0616828521242,0.229639256458727
430.4,436,5819,5342,2996785,2991520,2023-09-13,2023-11-17,445.99,-477,-5265.00000000047,390070868,38675143,0.766917051595865,87.1277300821142,-0.00175997486227753
374.72,375,36074,106722,973998,2988216,2023-09-13,2023-10-20,445.99,70648,2014218,497615928,97292139,0.600506501471955,88.3514572708774,0.674053682866299
425.39,432,4207,4511,2625168,2981771,2023-09-13,2023-12-15,445.99,304,356603.000000001,481634514,35662575,0.61909412912215,82.3957310916468,0.119594361874202
432.14,441,3255,3349,2613765,2967214,2023-09-13,2023-12-15,445.99,94,353449,481634514,35662575,0.616071712834101,83.0118028044809,0.119118135732711
412.53,415,11794,11948,2653650,2951156,2023-09-13,2023-11-17,445.99,154,297506,390070868,38675143,0.756569188345539,87.8842992704598,0.100809987679404
441.19,446,5378,6130,2043640,2948530,2023-09-13,2023-09-29,445.99,752,904890,181598301,29583870,1.62365505831467,73.0852961008705,0.306895300370015
419.48,420,57847,56670,2603115,2946840,2023-09-13,2023-09-29,445.99,-1177,343725,181598301,29583870,1.6227244328679,74.7080205337384,0.116641894368205
445.38,459,2151,2151,3357711,2929662,2023-09-13,2023-09-29,445.99,0,-428049,181598301,29583870,1.61326509326759,76.321285627006,-0.146108663729809
440.01,444,6857,7215,2139384,2878785,2023-09-13,2023-09-29,445.99,358,739401,181598301,29583870,1.58524886199238,77.9065344889983,0.256844814739552
441.05,449,3608,3621,2442616,2878695,2023-09-13,2023-10-20,445.99,13,436079,497615928,97292139,0.578497358709949,88.9299546295874,0.151484961067428
384.62,385,75028,75080,2625980,2853040,2023-09-13,2023-10-20,445.99,52,227060,497615928,97292139,0.573341776149898,89.5032964057373,0.0795852844684968
429.97,433,8742,9322,2281662,2824566,2023-09-13,2023-10-20,445.99,580,542904,497615928,97292139,0.567619692430746,90.070916098168,0.19220793566162
404.26,405,38197,38029,2597396,2814146,2023-09-13,2023-10-20,445.99,-168,216750,497615928,97292139,0.565525708011501,90.6364418061795,0.0770215902088945
437.2,449,2477,2378,2647913,2806040,2023-09-13,2023-12-15,445.99,-99,158127,481634514,35662575,0.58260774891228,83.5944105533932,0.0563523684623172
442.04,448,5255,4653,2417300,2773188,2023-09-13,2023-09-29,445.99,-602,355888.000000001,181598301,29583870,1.52710019021599,79.4336346792143,0.128331725075978
430.67,439,3443,3324,2578807,2768892,2023-09-13,2023-12-15,445.99,-119,190085,481634514,35662575,0.574894846510107,84.1693053999033,0.068650203763816
441.68,458,1634,1644,2861134,2683008,2023-09-13,2023-12-15,445.99,10,-178126,481634514,35662575,0.557063067951148,84.7263684678545,-0.0663904095701543
399.32,402,1013,9807,254263,2628276,2023-09-13,2023-12-15,445.99,8794,2374013,481634514,35662575,0.545699264401139,85.2720677322556,0.903258637981704
440.81,442,19702,22073,1418544,2626687,2023-09-13,2023-09-15,445.99,2371,1208143,204169288,52571163,1.28652405350995,88.3482069056341,0.459949358260044
426.42,431,5950,5684,2445450,2603272,2023-09-13,2023-11-17,445.99,-266,157822,390070868,38675143,0.667384368729633,88.5516836391894,0.0606244756598617
446.05,465,1369,1369,2408071,2594255,2023-09-13,2023-09-29,445.99,0,186184,181598301,29583870,1.42856788070941,80.8622025599237,0.0717678100263852
390.87,393,12159,12158,2407482,2589654,2023-09-13,2023-12-15,445.99,-1,182172,481634514,35662575,0.537680320808571,85.8097480530642,0.0703460771207272
405.08,407,13372,13401,2286612,2572992,2023-09-13,2023-11-17,445.99,29,286380,390070868,38675143,0.659621676746186,89.2113053159356,0.111302328184464
435.48,446,2565,2431,2457270,2557412,2023-09-13,2023-12-15,445.99,-134,100142,481634514,35662575,0.530986033114728,86.3407340861789,0.0391575545903437
374.64,375,25,70321,875,2531556,2023-09-13,2023-10-27,445.99,70296,2530681,12636806,8295984,20.0331950969256,20.0331950969256,0.999654362771355
444.2,454,2553,2575,2093460,2523500,2023-09-13,2023-09-29,445.99,22,430040.000000001,181598301,29583870,1.38960551178284,82.2518080717066,0.170414107390529
411.93,413,23518,23476,2163656,2511932,2023-09-13,2023-10-20,445.99,-42,348276,497615928,97292139,0.504793327274685,91.1412351334542,0.138648657686593
437.42,443,4535,4430,2131450,2471940,2023-09-13,2023-10-20,445.99,-105,340490,497615928,97292139,0.496756607035296,91.6379917404895,0.137742016391984
438.12,440,10641,12597,1479099,2368236,2023-09-13,2023-09-22,445.99,1956,889137,40008818,10432511,5.91928509360111,26.6168948055401,0.375442734592329
416.42,421,5222,5150,2208906,2358700,2023-09-13,2023-12-15,445.99,-72,149794,481634514,35662575,0.489728192527332,86.8304622787062,0.063507016576928
435.75,438,10283,10445,1840657,2350125,2023-09-13,2023-09-29,445.99,162,509468,181598301,29583870,1.29413380359764,83.5459418753042,0.216783362587096
416.61,418,16927,16841,2031240,2340899,2023-09-13,2023-10-20,445.99,-86,309659,497615928,97292139,0.470422843860416,92.1084145843499,0.132282084788793
443.53,450,3252,3601,1596732,2329847,2023-09-13,2023-09-22,445.99,349,733115,40008818,10432511,5.82333374607568,32.4402285516158,0.314662293275052
444.89,461,1458,1445,2079108,2327895,2023-09-13,2023-09-29,445.99,-13,248787,181598301,29583870,1.28189249964404,84.8278343749483,0.106872088302952
363.9,365,20967,20988,2306370,2308680,2023-09-13,2023-12-15,445.99,21,2310.00000000047,481634514,35662575,0.479342724180269,87.3098050028865,0.00100057175528894
433.15,437,5876,5966,1921452,2296910,2023-09-13,2023-10-20,445.99,90,375458,497615928,97292139,0.461582893705123,92.569997478055,0.163462216630168
424.54,431,3422,3539,1995026,2286194,2023-09-13,2023-12-15,445.99,117,291168,481634514,35662575,0.474674038829369,87.7844790417159,0.127359270473109
429.14,432,7895,7959,1926380,2276274,2023-09-13,2023-10-20,445.99,64,349894,497615928,97292139,0.457435920338949,93.027433398394,0.153713480890262
403.25,405,12844,12860,2055040,2250500,2023-09-13,2023-11-17,445.99,16,195460,390070868,38675143,0.576946443485752,89.7882517594213,0.0868518107087313
419.38,421,13806,13766,1863810,2230092,2023-09-13,2023-10-20,445.99,-40,366282,497615928,97292139,0.448155268856265,93.4755886672502,0.164245241900334
441.41,457,1418,1412,2526876,2201308,2023-09-13,2023-12-15,445.99,-6,-325568,481634514,35662575,0.457049471334191,88.2415285130501,-0.147897522745568
369.76,370,91197,91183,2188728,2188392,2023-09-13,2023-10-20,445.99,-14,-336,497615928,97292139,0.439775312015334,93.9153639792656,-0.000153537391838391
417.92,421,6337,7070,1761686,2177560,2023-09-13,2023-11-17,445.99,733,415874,390070868,38675143,0.558247277261423,90.3464990366827,0.190981649185327
439.95,445,2727,4309,1134432,2176045,2023-09-13,2023-10-06,445.99,1582,1041613,35655626,8296590,6.10294992436818,6.10294992436818,0.4786725458343
444.7,470,861,857,1997520,2168210,2023-09-13,2023-12-15,445.99,-4,170690,481634514,35662575,0.450177455513498,88.6917059685636,0.0787239243431217
379.15,380,25452,25455,2061612,2163675,2023-09-13,2023-11-17,445.99,3,102063,390070868,38675143,0.554687667677864,90.9011867043606,0.047171132448265
436.11,441,4411,4324,1812921,2114436,2023-09-13,2023-10-20,445.99,-87,301514.999999999,497615928,97292139,0.424913247551835,94.3402772268174,0.142598309903917
383.27,385,11990,12036,1966360,2082228,2023-09-13,2023-12-15,445.99,46,115868,481634514,35662575,0.43232532957553,89.1240312981391,0.0556461636285749
423.3,424,29209,29204,1694122,2044280,2023-09-13,2023-09-29,445.99,-5,350158,181598301,29583870,1.12571537770059,85.9535497526488,0.171286712192068
440.04,441,20296,21083,1136576,2023968,2023-09-13,2023-09-15,445.99,787,887392,204169288,52571163,0.991318537585339,89.3395254432195,0.43844171449351
374.8,375,100517,100544,1909823,2010880,2023-09-13,2023-10-13,445.99,27,101057,22195764,5051124,9.05974671563457,9.05974671563457,0.0502551121896882
394.49,395,39493,39273,1856171,2002923,2023-09-13,2023-10-20,445.99,-220,146752,497615928,97292139,0.402503796060162,94.7427810228776,0.0732689174771072
389.44,390,261,35408,13572,1982848,2023-09-13,2023-10-27,445.99,35147,1969276,12636806,8295984,15.6910535779373,35.7242486748629,0.993155299851527
441.26,456,1349,1341,2421455,1976634,2023-09-13,2023-12-15,445.99,-8,-444821,481634514,35662575,0.410401236320037,89.5344325344591,-0.225039638091827
444.7,470,768,778,1910016,1968340,2023-09-13,2023-11-17,445.99,10,58324.0000000002,390070868,38675143,0.504610869838144,91.4057975741988,0.0296310596746498
435.67,437,14044,14566,1334180,1937278,2023-09-13,2023-09-22,445.99,522,603098,40008818,10432511,4.84212755298095,37.2823561045967,0.311312057433161
445.71,458,1574,1575,2257116,1935675,2023-09-13,2023-09-29,445.99,1,-321441,181598301,29583870,1.06591030276214,87.019460055411,-0.166061451431671
443.55,452,2183,2234,1482257,1887730,2023-09-13,2023-09-29,445.99,51,405473,181598301,29583870,1.03950862403718,88.0589686794482,0.214793958881832
379.69,380,58974,59198,1769220,1835138,2023-09-13,2023-10-20,445.99,224,65918,497615928,97292139,0.368786024871776,95.1115670477493,0.0359199144696475
442.51,449,3203,2806,1623921,1821094,2023-09-13,2023-09-29,445.99,-397,197173,181598301,29583870,1.00281444813738,89.0617831275855,0.108271731168188
434.74,435,71120,69467,1209040,1806142,2023-09-13,2023-09-15,445.99,-1653,597102,204169288,52571163,0.884629621669641,90.2241550648891,0.330595268810536
400.5,402,12157,12029,1799236,1804350,2023-09-13,2023-11-17,445.99,-128,5114,390070868,38675143,0.462569791292386,91.8683673654911,0.0028342616454679
441.6,448,3122,2782,1651538,1780480,2023-09-13,2023-10-06,445.99,-340,128942,35655626,8296590,4.99354575909002,11.0964956834582,0.0724197969086988
442.92,448,3666,3495,1404078,1775460,2023-09-13,2023-09-22,445.99,-171,371382,40008818,10432511,4.43767171527037,41.7200278198671,0.209175087019702
388.87,390,16142,15663,1662626,1769919,2023-09-13,2023-11-17,445.99,-479,107293,390070868,38675143,0.453742933707113,92.3221102991982,0.0606202882730789
429.45,430,31643,31988,1360649,1759340,2023-09-13,2023-09-22,445.99,345,398691,40008818,10432511,4.39738059744729,46.1174084173144,0.226613957506792
405.19,406,21714,21720,1519980,1759320,2023-09-13,2023-10-20,445.99,6,239340,497615928,97292139,0.353549776244301,95.4651168239936,0.136041197735489
384.03,385,17885,17913,1609650,1737561,2023-09-13,2023-11-17,445.99,28,127911,390070868,38675143,0.445447518013573,92.7675578172118,0.0736152572485225
445.05,475,573,573,1607265,1716135,2023-09-13,2023-11-17,445.99,0,108870,390070868,38675143,0.439954669980635,93.2075124871925,0.0634390651085141
428.39,436,2217,2213,1518645,1684093,2023-09-13,2023-12-15,445.99,-4,165448,481634514,35662575,0.349662026089767,89.8840945605489,0.0982416054220283
416.1,419,5785,5700,1527240,1653000,2023-09-13,2023-11-17,445.99,-85,125760,390070868,38675143,0.423769149558741,93.6312816367512,0.0760798548094372
441.75,447,2835,3138,1185030,1647450,2023-09-13,2023-09-29,445.99,303,462420,181598301,29583870,0.907194610813016,89.9689777383986,0.280688336520077
420.34,422,9944,9896,1471712,1642736,2023-09-13,2023-10-20,445.99,-48,171024,497615928,97292139,0.330121265732475,95.7952380897261,0.104109242142377
354.52,355,33930,33947,1594710,1629456,2023-09-13,2023-11-17,445.99,17,34746.0000000002,390070868,38675143,0.417733323268837,94.04901496002,0.0213236810321974
319.53,320,34597,34603,1556865,1626341,2023-09-13,2023-12-15,445.99,6,69476,481634514,35662575,0.337671191064185,90.2217657516131,0.0427192083333077
403.01,406,5432,5433,1537256,1624467,2023-09-13,2023-12-15,445.99,1,87211.0000000002,481634514,35662575,0.337282099347224,90.5590478509603,0.0536859166729766
442,450,1452,1976,978648,1580800,2023-09-13,2023-10-13,445.99,524,602152,22195764,5051124,7.12207969052113,16.1818264061557,0.380915991902834
389.69,390,50262,50357,1457598,1561067,2023-09-13,2023-10-13,445.99,95,103469,22195764,5051124,7.03317533922238,23.2150017453781,0.066280947582647
438.66,443,3208,3587,1119592,1556758,2023-09-13,2023-10-06,445.99,379,437166,35655626,8296590,4.36609358646515,15.4625892699233,0.280818213235455
444.57,466,703,703,1506529,1506529,2023-09-13,2023-10-20,445.99,0,0,497615928,97292139,0.302749352508668,96.0979874422348,0
428.29,431,5351,5523,1230730,1496733,2023-09-13,2023-10-20,445.99,172,266003,497615928,97292139,0.300780766004741,96.3987682082395,0.177722412748299
439.33,445,1829,2627,866946,1489509,2023-09-13,2023-10-13,445.99,798,622563,22195764,5051124,6.71078048946637,29.9257822348445,0.417965248951164
442.49,450,1773,1968,1104579,1477968,2023-09-13,2023-10-06,445.99,195,373389,35655626,8296590,4.14511864130502,19.6077079112284,0.252636728264753
429.89,430,139321,134337,1253889,1477707,2023-09-13,2023-09-15,445.99,-4984,223818,204169288,52571163,0.723765564583837,90.9479206294729,0.151463043756306
446.19,463,872,872,1465832,1465832,2023-09-13,2023-12-15,445.99,0,0,481634514,35662575,0.30434529864278,90.8633931496031,0
441.09,447,1364,2459,665632,1453269,2023-09-13,2023-10-06,445.99,1095,787637,35655626,8296590,4.07584766566712,23.6835555768955,0.541976055362084
396.5,399,5784,5783,1341888,1445750,2023-09-13,2023-12-15,445.99,-1,103862,481634514,35662575,0.30017574695654,91.1635688965596,0.071839529655888
435.69,436,46271,46440,925420,1439640,2023-09-13,2023-09-15,445.99,169,514220,204169288,52571163,0.705120742743639,91.6530413722166,0.357186518851935
393.73,395,11263,11295,1351560,1434465,2023-09-13,2023-11-17,445.99,32,82905,390070868,38675143,0.367744714532232,94.4167596745523,0.0577950664533467
438.41,439,24304,24277,899248,1432343,2023-09-13,2023-09-15,445.99,-27,533095,204169288,52571163,0.70154674781449,92.3545881200311,0.372183897292757
445.67,465,619,737,1109248,1424621,2023-09-13,2023-09-15,445.99,118,315373,204169288,52571163,0.697764592292647,93.0523527123237,0.221373263485516
444.81,470,542,557,1235218,1403083,2023-09-13,2023-10-20,445.99,15,167865,497615928,97292139,0.28196103079723,96.6807292390367,0.119640106821906
444.4,453,1624,1630,1096200,1401800,2023-09-13,2023-09-22,445.99,6,305600,40008818,10432511,3.50372760324986,49.6211360205643,0.218005421600799
359.8,360,34725,69654,659775,1393080,2023-09-13,2023-10-20,445.99,34929,733305,497615928,97292139,0.279950845946394,96.9606800849832,0.52639116202946
411.61,414,5753,5693,1288672,1360627,2023-09-13,2023-11-17,445.99,-60,71955,390070868,38675143,0.348815333730588,94.7655750082829,0.0528837072908299
423.87,425,7722,11853,718146,1339389,2023-09-13,2023-10-06,445.99,4131,621243,35655626,8296590,3.75645907885617,27.4400146557517,0.463825669764348
443.15,461,749,749,1336965,1336965,2023-09-13,2023-10-20,445.99,0,0,497615928,97292139,0.268674076686709,97.2293541616698,0
423.96,428,3437,3285,1278564,1327140,2023-09-13,2023-11-17,445.99,-152,48575.9999999998,390070868,38675143,0.340230483451535,95.1058054917344,0.03660201636602
442.09,449,1727,1892,1010295,1307372,2023-09-13,2023-10-06,445.99,165,297077,35655626,8296590,3.66666399294182,31.1066786486935,0.227232187931209
339.32,340,19095,19167,1241175,1303356,2023-09-13,2023-12-15,445.99,72,62181.0000000002,481634514,35662575,0.270611005256986,91.4341799018166,0.0477083774502133
441.45,449,1619,1708,1028065,1289540,2023-09-13,2023-10-13,445.99,89,261475,22195764,5051124,5.80984732041663,35.7356295552611,0.202766102641252
423.38,429,2088,2289,1133784,1286418,2023-09-13,2023-12-15,445.99,201,152634,481634514,35662575,0.267094230709554,91.7012741325262,0.118650392018768
440.55,446,1820,2357,820820,1284565,2023-09-13,2023-10-06,445.99,537,463745,35655626,8296590,3.60269933277851,34.709377981472,0.361013261298572
441.99,446,2733,3177,819900,1273977,2023-09-13,2023-09-22,445.99,444,454077,40008818,10432511,3.18424053417424,52.8053765547385,0.356424802017619
430.69,432,9396,9398,995976,1231138,2023-09-13,2023-09-29,445.99,2,235162,181598301,29583870,0.677945769988234,90.6469235083868,0.191011893061541
391.92,394,5848,5914,1204688,1230112,2023-09-13,2023-12-15,445.99,66,25424,481634514,35662575,0.255403623337509,91.9566777558637,0.0206680367316147
299.68,300,38388,38434,1190028,1229888,2023-09-13,2023-12-15,445.99,46,39860,481634514,35662575,0.255357115042632,92.2120348709063,0.0324094551699017
439.57,442,4642,5038,826276,1224234,2023-09-13,2023-09-22,445.99,396,397958,40008818,10432511,3.0599104427429,55.8652869974814,0.325066939817061
354.1,355,13505,13514,1161430,1216260,2023-09-13,2023-12-15,445.99,9,54830,481634514,35662575,0.252527583602532,92.4645624545088,0.0450808215348692
410.58,414,3683,3496,1263269,1195632,2023-09-13,2023-12-15,445.99,-187,-67637,481634514,35662575,0.24824466794753,92.7128071224564,-0.0565700817642887
444.31,456,1013,1022,1008948,1194718,2023-09-13,2023-10-06,445.99,9,185770,35655626,8296590,3.35071385368469,38.0600918351567,0.155492760634727
401.28,404,4322,4322,1318210,1175584,2023-09-13,2023-12-15,445.99,0,-142626,481634514,35662575,0.244082175556048,92.9568892980124,-0.121323529411765
407.02,409,5868,5872,1109052,1162656,2023-09-13,2023-11-17,445.99,4,53604.0000000002,390070868,38675143,0.298062761251886,95.4038682529863,0.0461047807778055
406.02,408,5844,5868,1063608,1161864,2023-09-13,2023-11-17,445.99,24,98256,390070868,38675143,0.297859721223785,95.7017279742101,0.084567556960195
434.95,437,5700,5542,940500,1136110,2023-09-13,2023-09-29,445.99,-158,195610,181598301,29583870,0.625617086582765,91.2725405949696,0.172175229511227
441.25,447.5,1406,1808,703000,1130000,2023-09-13,2023-10-06,445.99,402,427000,35655626,8296590,3.16920533101845,41.2292971661751,0.37787610619469
428.39,430,6768,6997,900144,1126517,2023-09-13,2023-10-06,445.99,229,226373,35655626,8296590,3.15943688662204,44.3887340527972,0.200949475240942
445.75,500,205,206,1152715,1117550,2023-09-13,2023-10-20,445.99,1,-35165,497615928,97292139,0.224580833754984,97.4539349954248,-0.0314661536396582
419.67,423,3753,3347,1133406,1114551,2023-09-13,2023-11-17,445.99,-406,-18855,390070868,38675143,0.285730386817813,95.9874583610279,-0.0169171262687845
443.75,454,1047,1064,892044,1090600,2023-09-13,2023-10-06,445.99,17,198556,35655626,8296590,3.05870383540595,47.4474378882031,0.182061250687695
436.55,438,7135,7263,756310,1053135,2023-09-13,2023-09-22,445.99,128,296825,40008818,10432511,2.63225721889609,58.4975442163775,0.281848955736919
413.68,418,2492,2426,961912,1048032,2023-09-13,2023-12-15,445.99,-66,86120.0000000002,481634514,35662575,0.217599023644722,93.1744883216571,0.0821730634179111
444.5,463,567,565,1003590,1045250,2023-09-13,2023-10-20,445.99,-2,41660,497615928,97292139,0.21005155606675,97.6639865514916,0.0398564936618034
410.61,413,4361,4372,941976,1044908,2023-09-13,2023-11-17,445.99,11,102932,390070868,38675143,0.267876451619555,96.2553348126474,0.098508194022823
443.04,451,1314,1300,864612,1034800,2023-09-13,2023-10-06,445.99,-14,170188,35655626,8296590,2.90220679339636,50.3496446815995,0.16446463084654
437.97,441,3288,3412,775968,1033836,2023-09-13,2023-09-29,445.99,124,257868,181598301,29583870,0.569298277741046,91.8418388727106,0.249428342599793
437.52,438,21171,21395,635130,1026960,2023-09-13,2023-09-15,445.99,224,391830,204169288,52571163,0.502994358289578,93.5553470706133,0.381543584949755
443.19,453,889,1034,698754,1014354,2023-09-13,2023-10-06,445.99,145,315600,35655626,8296590,2.84486380915034,53.1945084907498,0.311133982810735
377.5,379,6730,6732,1016230,1009800,2023-09-13,2023-12-15,445.99,2,-6429.99999999988,481634514,35662575,0.209661054315555,93.3841493759727,-0.00636759754406802
415.14,418,3499,3526,867752,1008436,2023-09-13,2023-11-17,445.99,27,140684,390070868,38675143,0.258526355780048,96.5138611684275,0.139507117952949
374.86,375,71295,71315,926835,998410,2023-09-13,2023-10-06,445.99,20,71575,35655626,8296590,2.80014716331162,55.9946556540614,0.0716889854869242
434.11,436,4683,5271,693084,996219,2023-09-13,2023-09-29,445.99,588,303135,181598301,29583870,0.548583876894311,92.3904227496049,0.304285503488691
407.59,411,2882,2916,933768,994356,2023-09-13,2023-12-15,445.99,34,60588.0000000001,481634514,35662575,0.206454473484847,93.5906038494575,0.0609318996415772
413.07,417,2528,2530,993504,994290,2023-09-13,2023-12-15,445.99,2,785.999999999884,481634514,35662575,0.206440770147963,93.7970446196055,0.000790513833991978
445.74,466,485,489,909375,990714,2023-09-13,2023-12-15,445.99,4,81339.0000000001,481634514,35662575,0.205698298440464,94.002742918046,0.0821013935404164
412.88,414,8801,8807,871299,986384,2023-09-13,2023-10-20,445.99,6,115085,497615928,97292139,0.198221950805401,97.862208502297,0.116673628120489
400.22,403,3483,3479,929961,967162,2023-09-13,2023-12-15,445.99,-4,37200.9999999999,481634514,35662575,0.200808283436266,94.2035512014822,0.0384640835764845
432.82,433,54546,53105,709098,955890,2023-09-13,2023-09-15,445.99,-1441,246792,204169288,52571163,0.468185009294836,94.0235320799081,0.258180334557324
427.06,428,10405,10139,832400,953066,2023-09-13,2023-09-29,445.99,-266,120666,181598301,29583870,0.524820989376988,92.9152437389819,0.126608230699658
440.23,443,3384,3323,697104,920471,2023-09-13,2023-09-22,445.99,-61,223367,40008818,10432511,2.30067031722857,60.7982145336061,0.242665982958725
434.02,435,8436,9379,641136,919142,2023-09-13,2023-09-22,445.99,943,278006,40008818,10432511,2.29734854951226,63.0955630831183,0.30246251395323
427.98,429,9010,9009,756840,918918,2023-09-13,2023-09-29,445.99,-1,162078,181598301,29583870,0.506016848692874,93.4212605876748,0.176379176379176
435.95,440,2443,2261,818405,915705,2023-09-13,2023-10-13,445.99,-182,97299.9999999999,22195764,5051124,4.12558450342146,39.8612140586826,0.106256927722356
359.74,360,29,35105,696,912730,2023-09-13,2023-10-27,445.99,35076,912034,12636806,8295984,7.22279031584405,42.947038990707,0.999237452477732
413.34,416,3394,3424,787408,910784,2023-09-13,2023-11-17,445.99,30,123376,390070868,38675143,0.233491930497101,96.7473530989246,0.135461316843511
438.88,441,3793,4271,587915,905452,2023-09-13,2023-09-22,445.99,478,317537,40008818,10432511,2.2631310927506,65.3586941758689,0.350694459783622
414.27,417,3123,3288,768258,897624,2023-09-13,2023-11-17,445.99,165,129366,390070868,38675143,0.230118184575629,96.9774712835002,0.144120478062084
445.46,464,483,483,895482,895482,2023-09-13,2023-12-15,445.99,0,0,481634514,35662575,0.18592562907566,94.3894768305579,0
402.35,403,13116,13262,813192,862030,2023-09-13,2023-10-20,445.99,146,48838.0000000001,497615928,97292139,0.173231995098035,98.035440497395,0.0566546407897638
443.42,461,485,486,812375,854388,2023-09-13,2023-12-15,445.99,1,42012.9999999999,481634514,35662575,0.177393433228915,94.5668702637868,0.0491732093615546
412.01,416,2132,2131,773916,850269,2023-09-13,2023-12-15,445.99,-1,76353,481634514,35662575,0.176538220431603,94.7434084842184,0.0897986401950442
379.39,381,5247,5272,787050,848792,2023-09-13,2023-12-15,445.99,25,61742,481634514,35662575,0.176231556362259,94.9196400405807,0.0727410248918463
403.27,404,11457,11471,733248,837383,2023-09-13,2023-10-20,445.99,14,104135,497615928,97292139,0.16827897840119,98.2037194757962,0.124357671459774
444.3,455,735,775,632835,829250,2023-09-13,2023-09-22,445.99,40,196415,40008818,10432511,2.07266808032169,67.4313622561906,0.236858607175158
417.22,422,1726,1726,776700,825028,2023-09-13,2023-12-15,445.99,0,48328.0000000001,481634514,35662575,0.17129752457898,95.0909375651596,0.0585774058577407
354.82,355,45522,45523,773874,819414,2023-09-13,2023-10-20,445.99,1,45539.9999999999,497615928,97292139,0.16466796054808,98.3683874363443,0.0555763020890537
436.59,440,2609,2366,730520,806806,2023-09-13,2023-10-06,445.99,-243,76286,35655626,8296590,2.26277334185635,58.2574289959178,0.0945530895903104
421.41,427,1410,1419,723330,793221,2023-09-13,2023-12-15,445.99,9,69891,481634514,35662575,0.164693554332778,95.2556311194924,0.088110375292636
442.51,447,1613,1752,543581,786648,2023-09-13,2023-09-22,445.99,139,243067,40008818,10432511,1.96618655417413,69.3975488103648,0.308990806561512
432.64,435,3425,3324,654175,784464,2023-09-13,2023-10-06,445.99,-101,130289,35655626,8296590,2.20011282370978,60.4575418196276,0.166086652797324
443.8,455,678,700,627150,784000,2023-09-13,2023-10-06,445.99,22,156850,35655626,8296590,2.19881148629953,62.6563533059271,0.200063775510204
387.07,389,4022,4021,760158,776053,2023-09-13,2023-12-15,445.99,-1,15895,481634514,35662575,0.16112902573257,95.416760145225,0.0204818485335409
359.87,360,58799,59268,823186,770484,2023-09-13,2023-10-13,445.99,469,-52702,22195764,5051124,3.47131101231749,43.332525071,-0.0684011608287778
409.72,412,3421,3369,694463,768132,2023-09-13,2023-11-17,445.99,-52,73669.0000000001,390070868,38675143,0.196921139981159,97.1743924234814,0.0959066931204534
438,442,2300,1918,768200,767200,2023-09-13,2023-10-06,445.99,-382,-1000,35655626,8296590,2.15169409730739,64.8080474032345,-0.00130344108446298
389.79,390,36190,36237,687610,760977,2023-09-13,2023-10-06,445.99,47,73367,35655626,8296590,2.13424103113489,66.9422884343694,0.0964115866839602
414.68,419,1753,1759,760802,759888,2023-09-13,2023-12-15,445.99,6,-914,481634514,35662575,0.157772746327727,95.5745328915527,-0.00120280883498621
444.34,460,504,484,655200,757944,2023-09-13,2023-09-22,445.99,-20,102744,40008818,10432511,1.89444237017949,71.2919911805443,0.135556188847725
419.16,420,8978,8991,628460,755244,2023-09-13,2023-10-06,445.99,13,126784,35655626,8296590,2.11816222214132,69.0604506565107,0.167871575278983
324.49,325,14777,14778,724073,753678,2023-09-13,2023-12-15,445.99,1,29605,481634514,35662575,0.156483386902792,95.7310162784555,0.0392807007767243
408.77,411,3316,3341,649936,745043,2023-09-13,2023-11-17,445.99,25,95107,390070868,38675143,0.191001959161944,97.3653943826433,0.127653034791281
422.95,424,6959,7080,619351,743400,2023-09-13,2023-10-06,445.99,121,124049,35655626,8296590,2.08494446290187,71.1453951194126,0.166867097121334
433.52,436,3145,2991,635290,741768,2023-09-13,2023-10-06,445.99,-154,106478,35655626,8296590,2.08036734511406,73.2257624645266,0.143546230088114
443.3,449,1447,1295,627998,738150,2023-09-13,2023-09-22,445.99,-152,110152,40008818,10432511,1.84496827674339,73.1369594572876,0.149227121858701
439.35,444,1560,1587,592800,737955,2023-09-13,2023-10-06,445.99,27,145155,35655626,8296590,2.06967338057674,75.2954358451034,0.196698985710511
445.75,457,629,629,707625,707625,2023-09-13,2023-10-20,445.99,0,0,497615928,97292139,0.142203044593862,98.5105904809382,0
414.63,415,19159,18933,632247,700521,2023-09-13,2023-09-29,445.99,-226,68274,181598301,29583870,0.385753058339461,93.8070136460142,0.0974617463288038
446.2,480,210,206,682500,696280,2023-09-13,2023-10-20,445.99,-4,13779.9999999999,497615928,97292139,0.139923173841815,98.65051365478,0.0197908887229274
334.38,335,11207,11200,672420,694400,2023-09-13,2023-12-15,445.99,-7,21980,481634514,35662575,0.144175714118362,95.8751919925739,0.0316532258064516
437.31,439,3691,4096,461375,692224,2023-09-13,2023-09-22,445.99,405,230849,40008818,10432511,1.73017858213157,74.8671380394192,0.333488870654586
408.64,412,1984,2058,658688,691488,2023-09-13,2023-12-15,445.99,74,32800,481634514,35662575,0.143571106284962,96.0187630988588,0.0474339395622194
424.67,425,20774,20903,560898,689799,2023-09-13,2023-09-22,445.99,129,128901,40008818,10432511,1.72411741831513,76.5912554577343,0.186867478787299
437.27,441,2374,1845,716948,688185,2023-09-13,2023-10-06,445.99,-529,-28763,35655626,8296590,1.93008811568755,77.2255239607909,-0.0417954474450911
424.93,425,98655,98260,591930,687820,2023-09-13,2023-09-15,445.99,-395,95890.0000000001,204169288,52571163,0.336887103216033,94.3604191831242,0.139411473932134
421.4,422,11340,11425,578340,685500,2023-09-13,2023-09-29,445.99,85,107160,181598301,29583870,0.377481505182144,94.1844951511964,0.156323851203501
395.63,397,4957,4951,624582,678287,2023-09-13,2023-11-17,445.99,-6,53705.0000000001,390070868,38675143,0.173888145884301,97.5392825285276,0.0791773983579224
444.73,459,468,467,596232,666409,2023-09-13,2023-10-20,445.99,-1,70177,497615928,97292139,0.133920351520581,98.7844340063005,0.105306200846627
374.25,375,9185,8851,661320,663825,2023-09-13,2023-11-17,445.99,-334,2505,390070868,38675143,0.170180614462088,97.7094631429897,0.00377358490566038
434.67,437.5,2327,2327,537537,658541,2023-09-13,2023-10-06,445.99,0,121004,35655626,8296590,1.84694836096834,79.0724723217593,0.183745583038869
427.91,428,72906,71741,510342,645669,2023-09-13,2023-09-15,445.99,-1165,135327,204169288,52571163,0.316241980527453,94.6766611636516,0.209591911645131
436.62,437,18152,16887,453800,641706,2023-09-13,2023-09-15,445.99,-1265,187906,204169288,52571163,0.314300944224285,94.9909621078759,0.292822569837278
444.35,452,865,828,528515,633420,2023-09-13,2023-09-22,445.99,-37,104905,40008818,10432511,1.58320098334322,78.1744564410776,0.165616810331218
405.7,409,1882,1885,574010,622050,2023-09-13,2023-12-15,445.99,3,48040,481634514,35662575,0.129153950125759,96.1479170489846,0.077228518607829
407.14,408,6974,7175,536998,617050,2023-09-13,2023-10-20,445.99,201,80052,497615928,97292139,0.124001255844045,98.9084352621446,0.129733408961997
430.87,431,47880,47336,478800,615368,2023-09-13,2023-09-15,445.99,-544,136568,204169288,52571163,0.301400864952813,95.2923629728287,0.221928992082786
444,456,486,510,638604,612000,2023-09-13,2023-10-13,445.99,24,-26604,22195764,5051124,2.75728287613799,46.089807947138,-0.0434705882352941
443.78,472,216,216,609552,609552,2023-09-13,2023-10-20,445.99,0,0,497615928,97292139,0.122494471278259,99.0309297334228,0
369.94,370,100618,100595,603708,603570,2023-09-13,2023-09-29,445.99,-23,-138,181598301,29583870,0.332365444322081,94.5168605955184,-0.000228639594413241
445.45,480,172,172,594260,594260,2023-09-13,2023-12-15,445.99,0,0,481634514,35662575,0.123384014792594,96.2713010637772,0
364.4,365,9858,9882,552048,592920,2023-09-13,2023-11-17,445.99,24,40872,390070868,38675143,0.152003148309963,97.8614662912997,0.0689334142886055
443.5,454,593,564,530142,592200,2023-09-13,2023-10-13,445.99,-29,62058,22195764,5051124,2.66807666543941,48.7578846125774,0.104792299898683
397.56,399,4082,4076,542906,586944,2023-09-13,2023-11-17,445.99,-6,44038,390070868,38675143,0.150471119007021,98.0119374103067,0.0750293043288627
439.9,442.5,2079,2252,392931,585520,2023-09-13,2023-09-22,445.99,173,192589,40008818,10432511,1.46347737641237,79.6379338174899,0.328919592840552
294.72,295,20808,20813,603432,582764,2023-09-13,2023-12-15,445.99,5,-20668,481634514,35662575,0.120997142659091,96.3922982064363,-0.0354654714429855
439.39,447,361,765,241148,582165,2023-09-13,2023-10-27,445.99,404,341017,12636806,8295984,4.6068998764403,47.5539388671473,0.585773792653286
381.34,383,3507,3503,550599,581498,2023-09-13,2023-12-15,445.99,-4,30899,481634514,35662575,0.12073428774251,96.5130324941788,0.0531368981492628
380.38,382,3521,3520,538713,570240,2023-09-13,2023-12-15,445.99,-1,31527,481634514,35662575,0.118396830672313,96.6314293248511,0.0552872474747475
427.86,430,2588,2647,463252,566458,2023-09-13,2023-10-13,445.99,59,103206,22195764,5051124,2.5520995808029,51.3099841933803,0.18219532604359
440.94,448,571,792,332322,559152,2023-09-13,2023-10-13,445.99,221,226830,22195764,5051124,2.51918339012795,53.8291675835083,0.405667868486565
384.9,385,55719,55714,612909,557140,2023-09-13,2023-09-29,445.99,-5,-55769,181598301,29583870,0.306798024503544,94.823658620022,-0.100098718454966
431.85,432,36823,36973,441876,554595,2023-09-13,2023-09-15,445.99,150,112719,204169288,52571163,0.271634879776825,95.5639978526055,0.203245611662565
443.79,455,494,494,474240,553774,2023-09-13,2023-10-13,445.99,0,79534.0000000002,22195764,5051124,2.49495354158568,56.324121125094,0.143621766280107
409.33,413,1488,1501,495504,550867,2023-09-13,2023-12-15,445.99,13,55363,481634514,35662575,0.114374486044412,96.7458038108955,0.100501572974965
438.66,444,995,1031,445760,550554,2023-09-13,2023-10-13,445.99,36,104794,22195764,5051124,2.48044626893672,58.8045673940307,0.190342818324815
434.87,436,5311,4830,446124,545790,2023-09-13,2023-09-22,445.99,-481,99666,40008818,10432511,1.36417426778267,81.0021080852726,0.182608695652174
364.78,365,24739,24736,519519,544192,2023-09-13,2023-10-20,445.99,-3,24673.0000000001,497615928,97292139,0.109359843481537,99.1402895769044,0.0453387774902977
437.64,442.5,1118,1118,449436,543348,2023-09-13,2023-10-13,445.99,0,93912.0000000001,22195764,5051124,2.44798061467945,61.2525480087101,0.17283950617284
401.41,403,3252,3413,487800,542667,2023-09-13,2023-11-17,445.99,161,54867,390070868,38675143,0.139120104708768,98.1510575150155,0.101106203251718
432.22,433,7053,6878,416127,536484,2023-09-13,2023-09-22,445.99,-175,120357,40008818,10432511,1.34091439542153,82.3430224806941,0.22434406245107
329.44,330,9735,9579,525690,536424,2023-09-13,2023-12-15,445.99,-156,10734.0000000001,481634514,35662575,0.111375739156434,96.857179550052,0.0200102903673216
435.8,439,1608,1660,408432,531200,2023-09-13,2023-10-06,445.99,52,122768,35655626,8296590,1.48980696622743,80.5622792879867,0.231114457831325
419.95,420,107230,106131,428920,530655,2023-09-13,2023-09-15,445.99,-1099,101735,204169288,52571163,0.259909316037777,95.8239071686433,0.191715898276658
444.97,470,209,209,539011,523127,2023-09-13,2023-09-15,445.99,0,-15883.9999999999,204169288,52571163,0.256222179704129,96.0801293483475,-0.0303635637235317
426.04,427,5389,5426,382619,520896,2023-09-13,2023-09-29,445.99,37,138277,181598301,29583870,0.286839687999063,95.1104983080211,0.265459899864848
384.22,386,3269,2919,617841,519582,2023-09-13,2023-12-15,445.99,-350,-98259,481634514,35662575,0.107878896735378,96.9650584467873,-0.18911163204268
433.79,434,26895,24737,376530,519477,2023-09-13,2023-09-15,445.99,-2158,142947,204169288,52571163,0.254434447555109,96.3345637959026,0.275174839309536
418.23,423,1045,1089,477565,519453,2023-09-13,2023-12-15,445.99,44,41887.9999999999,481634514,35662575,0.107852112940561,97.0729105597279,0.0806386718336403
433.61,437,441,1510,126126,511890,2023-09-13,2023-10-13,445.99,1069,385764,22195764,5051124,2.30625086840895,63.5587988771191,0.753607220301237
369.37,370,8063,8057,507969,507591,2023-09-13,2023-11-17,445.99,-6,-377.999999999942,390070868,38675143,0.130127892555155,98.2811854075706,-0.000744694054859014
399.97,400,169434,169163,508302,507489,2023-09-13,2023-09-15,445.99,-271,-813,204169288,52571163,0.248562849472248,96.5831266453748,-0.00160200516661445
443.37,452.5,509,555,377678,506715,2023-09-13,2023-10-06,445.99,46,129037,35655626,8296590,1.42113617637789,81.9834154643646,0.254653996822672
395.55,398,2064,2064,516000,505680,2023-09-13,2023-12-15,445.99,0,-10320,481634514,35662575,0.104992475684581,97.1779030354125,-0.0204081632653061
442.5,462,258,258,503100,503100,2023-09-13,2023-12-15,445.99,0,0,481634514,35662575,0.104456799788231,97.2823598352007,0
438.25,442.5,1005,1181,333660,501925,2023-09-13,2023-10-06,445.99,176,168265,35655626,8296590,1.40770211130215,83.3911175756668,0.335239328584948
443.88,451,695,702,382250,499824,2023-09-13,2023-09-22,445.99,7,117574,40008818,10432511,1.24928459521099,83.5923070759051,0.235230801242037
409.7,410,18548,16418,463700,492540,2023-09-13,2023-09-29,445.99,-2130,28839.9999999999,181598301,29583870,0.271225004467415,95.3817233124885,0.0585536200105574
449.9,474,204,204,491640,491640,2023-09-13,2023-10-20,445.99,0,0,497615928,97292139,0.0987990882799877,99.2390886651844,0
357.08,358,5303,5303,487876,487876,2023-09-13,2023-12-15,445.99,0,0,481634514,35662575,0.101295896747134,97.3836557319478,0
444.85,457,398,398,388448,483570,2023-09-13,2023-09-15,445.99,0,95122,204169288,52571163,0.236847571315427,96.8199742166902,0.196707818930041
358.04,359,5007,5006,465651,480576,2023-09-13,2023-12-15,445.99,-1,14925,481634514,35662575,0.0997802246373066,97.4834359565851,0.0310564822213344
436.45,439,1818,1875,356328,478125,2023-09-13,2023-09-29,445.99,57,121797,181598301,29583870,0.263287154872666,95.6450104673612,0.254738823529412
431.54,433,3382,3265,399076,476690,2023-09-13,2023-09-29,445.99,-117,77614,181598301,29583870,0.262496949241832,95.907507416603,0.162818603285154
440.5,447,640,733,349440,476450,2023-09-13,2023-10-13,445.99,93,127010,22195764,5051124,2.14658076198684,65.7053796391059,0.266575716234652
314.59,315,11511,11491,471951,471131,2023-09-13,2023-12-15,445.99,-20,-820,481634514,35662575,0.0978191940787698,97.5812551506639,-0.00174049255939431
349.84,350,29851,29181,447765,466896,2023-09-13,2023-10-20,445.99,-670,19131.0000000001,497615928,97292139,0.0938265786379732,99.3329152438223,0.0409748637812276
442.34,451,340,538,252280,465908,2023-09-13,2023-10-13,445.99,198,213628,22195764,5051124,2.09908521283611,67.804464851942,0.458519707753462
442.85,453,430,459,405060,465885,2023-09-13,2023-10-27,445.99,29,60825.0000000001,12636806,8295984,3.68673065013422,51.2406695172815,0.130557970314563
404.78,405,20530,20524,451660,451528,2023-09-13,2023-09-29,445.99,-6,-132.000000000058,181598301,29583870,0.248641092737977,96.156148509341,-0.000292340674332618
426.92,427,56460,56422,395220,451376,2023-09-13,2023-09-15,445.99,-38,56156,204169288,52571163,0.221079283971446,97.0410535006617,0.124410690865265
430.14,432,2203,2358,337059,438588,2023-09-13,2023-10-06,445.99,155,101529,35655626,8296590,1.23006675019533,84.6211843258621,0.231490601658048
443.26,452,499,499,436126,436126,2023-09-13,2023-10-13,445.99,0,0,22195764,5051124,1.96490645692575,69.7693713088678,0
359.47,360,8057,8082,410907,428346,2023-09-13,2023-11-17,445.99,25,17439,390070868,38675143,0.109812353379848,98.3909977609505,0.0407124147301481
446.28,480,127,127,442468,428244,2023-09-13,2023-11-17,445.99,0,-14224.0000000001,390070868,38675143,0.10978620428532,98.5007839652358,-0.0332147093712931
429.76,431,3231,3423,313407,424452,2023-09-13,2023-09-29,445.99,192,111045,181598301,29583870,0.233731261615713,96.3898797709567,0.261619688445336
402.3,404,2265,2494,351075,423980,2023-09-13,2023-11-17,445.99,229,72905,390070868,38675143,0.108693069588575,98.6094770348244,0.171953865748384
398.41,401,1635,1630,395670,422170,2023-09-13,2023-12-15,445.99,-5,26500,481634514,35662575,0.0876536020007902,97.6689087526647,0.0627709216666272
439.96,448,244,520,169580,418080,2023-09-13,2023-10-27,445.99,276,248500,12636806,8295984,3.30843094370524,54.5491004609868,0.594383849980865
344.29,345,5857,5857,415847,415847,2023-09-13,2023-12-15,445.99,0,0,481634514,35662575,0.0863407808021001,97.7552495334668,0
427.55,428,8960,9240,340480,415800,2023-09-13,2023-09-22,445.99,280,75320,40008818,10432511,1.0392708927317,84.6315779686368,0.181144781144781
430.95,433,1741,2026,295970,415330,2023-09-13,2023-10-06,445.99,285,119360,35655626,8296590,1.1648372125061,85.7860215383682,0.287385934076517
434.23,437,1408,1498,309760,414946,2023-09-13,2023-10-06,445.99,90,105186,35655626,8296590,1.16376024361485,86.949781781983,0.253493225624539
348.19,349,754,5111,58058,413991,2023-09-13,2023-12-15,445.99,4357,355933,481634514,35662575,0.0859554263588344,97.8412049598256,0.85976023633364
438.01,443,667,819,272136,408681,2023-09-13,2023-10-13,445.99,152,136545,22195764,5051124,1.84125673709632,71.6106280459641,0.334111446335895
440.7,447.5,508,598,290576,406640,2023-09-13,2023-10-13,445.99,90,116064,22195764,5051124,1.83206128881169,73.4426893347758,0.28542199488491
432.07,435,1059,1377,264750,403461,2023-09-13,2023-10-13,445.99,318,138711,22195764,5051124,1.81773873609397,75.2604280708697,0.343802746733885
309.62,310,10487,10495,388019,398810,2023-09-13,2023-12-15,445.99,8,10791,481634514,35662575,0.082803451249343,97.924008411075,0.0270579975426895
404.25,406,2248,2275,370920,398125,2023-09-13,2023-11-17,445.99,27,27205,390070868,38675143,0.102064786853039,98.7115418216774,0.0683328100470958
431.05,435,912,1007,312816,397765,2023-09-13,2023-10-27,445.99,95,84948.9999999999,12636806,8295984,3.147670384431,57.6967708454178,0.213565798901361
445.36,457,339,340,374256,395760,2023-09-13,2023-10-13,445.99,1,21504.0000000001,22195764,5051124,1.78304292656923,77.043470997439,0.0543359611885994
444.41,462,213,224,319500,394016,2023-09-13,2023-09-29,445.99,11,74516,181598301,29583870,0.216971192918815,96.6068509638755,0.189119223584829
410.13,411,4363,4525,370855,393675,2023-09-13,2023-10-20,445.99,162,22820,497615928,97292139,0.0791122184497278,99.4120274622721,0.0579665968120912
349.58,350,9286,9314,380726,391188,2023-09-13,2023-11-17,445.99,28,10461.9999999999,390070868,38675143,0.100286392061455,98.8118282137389,0.0267441741566713
419.95,422,1813,1843,331779,377815,2023-09-13,2023-10-27,445.99,30,46036,12636806,8295984,2.98979821325104,60.6865690586688,0.121847994388788
389.03,391,1909,1908,381800,375876,2023-09-13,2023-12-15,445.99,-1,-5924,481634514,35662575,0.0780417493086885,98.0020501603837,-0.0157605167661676
346.25,347,4980,4980,373500,373500,2023-09-13,2023-12-15,445.99,0,0,481634514,35662575,0.0775484291808871,98.0795985895645,0
443.98,452.5,436,435,304764,370620,2023-09-13,2023-09-22,445.99,-1,65856,40008818,10432511,0.92634578707124,85.5579237557081,0.177691435972155
442.5,447.5,612,738,223380,369000,2023-09-13,2023-09-22,445.99,126,145620,40008818,10432511,0.922296679696961,86.480220435405,0.394634146341464
439.94,446,579,607,298185,367842,2023-09-13,2023-10-13,445.99,28,69656.9999999999,22195764,5051124,1.65726216948423,78.7007331669232,0.189366630237982
425.2,426,4438,4597,301784,367760,2023-09-13,2023-09-29,445.99,159,65976.0000000001,181598301,29583870,0.202512907871313,96.8093638717468,0.179399608440287
433.12,434,3251,4137,217817,364056,2023-09-13,2023-09-22,445.99,886,146239,40008818,10432511,0.909939403858419,87.3901598392634,0.401693695475421
432.89,436,979,1154,259435,358894,2023-09-13,2023-10-13,445.99,175,99459,22195764,5051124,1.61694817083116,80.3176813377544,0.277126393865598
442.08,452.5,94,333,85258,346986,2023-09-13,2023-10-27,445.99,239,261728,12636806,8295984,2.74583625007775,63.4324053087465,0.754289798435672
434.85,440,612,660,269892,339900,2023-09-13,2023-10-27,445.99,48,70008.0000000001,12636806,8295984,2.68976195408872,66.1221672628353,0.205966460723742
431.81,434,1585,1534,277375,335946,2023-09-13,2023-10-06,445.99,-51,58571,35655626,8296590,0.942196331092322,87.8919781130754,0.174346472349723
414.96,415,82355,83289,329420,333156,2023-09-13,2023-09-15,445.99,934,3736,204169288,52571163,0.163176353928413,97.2042298545901,0.0112139658298215
376.52,378,1542,2182,251346,322936,2023-09-13,2023-12-15,445.99,640,71590,481634514,35662575,0.0670500121176947,98.1466486016822,0.221684792033096
379.96,380,79939,79949,399695,319796,2023-09-13,2023-09-22,445.99,10,-79899,40008818,10432511,0.799313791274714,88.1894736305381,-0.249843650327084
396.75,398,2545,2543,328305,317875,2023-09-13,2023-11-17,445.99,-2,-10430,390070868,38675143,0.0814916021875287,98.8933198159264,-0.0328116397955171
393.77,396,1410,1411,321480,314653,2023-09-13,2023-12-15,445.99,1,-6827,481634514,35662575,0.0653302433388318,98.2119788450211,-0.0216969169211798
444.1,458,226,226,250408,314140,2023-09-13,2023-09-22,445.99,0,63732,40008818,10432511,0.785176907750686,88.9746505382888,0.202877697841727
420.68,422,2366,2368,264992,312576,2023-09-13,2023-10-13,445.99,2,47584,22195764,5051124,1.40826871289495,81.7259500506493,0.152231777231777
407.75,408,12212,12210,305300,305250,2023-09-13,2023-09-29,445.99,-2,-50,181598301,29583870,0.168090779659882,96.9774546514067,-0.000163800163800164
444.48,457,231,242,235389,302984,2023-09-13,2023-09-22,445.99,11,67595,40008818,10432511,0.757293054746081,89.7319435930349,0.223097589311647
445.99,457,271,275,288886,302775,2023-09-13,2023-10-06,445.99,4,13889,35655626,8296590,0.849164729291248,88.7411428423666,0.0458723474527289
409.96,410,75717,75625,302868,302500,2023-09-13,2023-09-15,445.99,-92,-368,204169288,52571163,0.148161363035169,97.3523912176253,-0.00121652892561983
441.73,476,88,88,301576,301576,2023-09-13,2023-12-15,445.99,0,0,481634514,35662575,0.0626151139990769,98.2745939590201,0
394.75,395,11960,12033,275080,300825,2023-09-13,2023-10-06,445.99,73,25745,35655626,8296590,0.843695746640376,89.584838589007,0.085581318042051
385.18,387,1738,1650,349338,300300,2023-09-13,2023-12-15,445.99,-88,-49037.9999999999,481634514,35662575,0.0623501828193318,98.3369441418395,-0.163296703296703
389.95,392,1464,1464,286944,300120,2023-09-13,2023-12-15,445.99,0,13176,481634514,35662575,0.0623128100823771,98.3992569519219,0.0439024390243902
274.8,275,14535,14885,290700,297700,2023-09-13,2023-12-15,445.99,350,7000,481634514,35662575,0.0618103543966536,98.4610673063185,0.0235136042996305
446.91,459,246,246,297414,297414,2023-09-13,2023-09-15,445.99,0,0,204169288,52571163,0.145670292977659,97.4980615106029,0
409.88,410,24777,24742,297324,296904,2023-09-13,2023-09-22,445.99,-35,-420,40008818,10432511,0.742096404847551,90.4740399978825,-0.00141459865815213
359.92,360,36895,36890,368950,295120,2023-09-13,2023-10-06,445.99,-5,-73830,35655626,8296590,0.827695466628464,90.4125340556354,-0.250169422607753
390.81,392,2479,2479,272690,295001,2023-09-13,2023-11-17,445.99,0,22311,390070868,38675143,0.0756275395577606,98.9689473554841,0.0756302521008403
418.52,419,6407,6140,275501,294720,2023-09-13,2023-09-29,445.99,-267,19219,181598301,29583870,0.162292267260804,97.1397469186675,0.0652110477741585
344.62,345,7746,7750,286602,294500,2023-09-13,2023-11-17,445.99,4,7898,390070868,38675143,0.0754991013581665,99.0444464568423,0.0268183361629881
400.33,401,4453,4385,262727,293795,2023-09-13,2023-10-20,445.99,-68,31068,497615928,97292139,0.0590405136710174,99.4710679759431,0.105747204683538
370.76,372,2347,2347,291028,291028,2023-09-13,2023-12-15,445.99,0,0,481634514,35662575,0.0604250716135347,98.521492377932,0
399.82,400,14988,16045,239808,288810,2023-09-13,2023-09-29,445.99,1057,49002,181598301,29583870,0.159037831526849,97.2987847501943,0.169668640282539
438.22,445,446,423,267600,286794,2023-09-13,2023-10-27,445.99,-23,19194,12636806,8295984,2.26951335646049,68.3916806192957,0.0669260863197975
435.1,438,971,987,235953,286230,2023-09-13,2023-10-06,445.99,16,50277,35655626,8296590,0.802762514953461,91.2152965705889,0.175652447332565
369.96,370,71346,71347,285384,285388,2023-09-13,2023-09-22,445.99,1,4,40008818,10432511,0.713312750204218,91.1873527480867,1.40160062791708e-05
394.94,395,45864,47546,275184,285276,2023-09-13,2023-09-22,445.99,1682,10092.0000000001,40008818,10432511,0.713032811916613,91.9003855600033,0.0353762671938756
430.55,432.5,586,1460,90830,284700,2023-09-13,2023-10-06,445.99,874,193870,35655626,8296590,0.798471467027392,92.0137680376163,0.680962416578855
436.26,442,45,493,22185,282982,2023-09-13,2023-10-27,445.99,448,260797,12636806,8295984,2.23934750600745,70.6310281253032,0.921602787456446
410.97,412,2360,2742,214760,282426,2023-09-13,2023-10-20,445.99,382,67666,497615928,97292139,0.0567558199222273,99.5278237958653,0.239588423162174
399.71,400,9706,9720,271768,281880,2023-09-13,2023-10-06,445.99,14,10112,35655626,8296590,0.790562476732283,92.8043305143486,0.0358734213140343
436.14,437.5,2518,2054,254318,279344,2023-09-13,2023-09-22,445.99,-464,25026,40008818,10432511,0.698206080469561,92.5985916404729,0.0895884644023141
339.66,340,8151,8151,277134,277134,2023-09-13,2023-11-17,445.99,0,0,390070868,38675143,0.0710470898329172,99.1154935466752,0
440.89,450,257,302,200460,275122,2023-09-13,2023-10-27,445.99,45,74662,12636806,8295984,2.17714824458016,72.8081763698834,0.271377788762803
433.64,438,620,630,251100,274680,2023-09-13,2023-10-27,445.99,10,23580,12636806,8295984,2.17365052529888,74.9818268951822,0.0858453473132372
434.48,438,459,773,135405,272096,2023-09-13,2023-10-13,445.99,314,136691,22195764,5051124,1.22589157102229,82.9518416216716,0.502363136540045
421.05,422,2846,2843,227680,270085,2023-09-13,2023-10-06,445.99,-3,42405,35655626,8296590,0.757482143210724,93.5618126575593,0.157006127700539
435.97,466,88,88,264264,264264,2023-09-13,2023-09-29,445.99,0,0,181598301,29583870,0.14552118524501,97.4443059354394,0
417.95,418,52519,52247,262595,261235,2023-09-13,2023-09-15,445.99,-272,-1359.99999999997,204169288,52571163,0.127950193958653,97.6260117045616,-0.00520604053821261
423.44,425,1643,1670,215233,260520,2023-09-13,2023-10-13,445.99,27,45287,22195764,5051124,1.17373747531286,84.1255790969845,0.17383310302472
369.74,371,2030,2030,243600,255780,2023-09-13,2023-12-15,445.99,0,12180,481634514,35662575,0.0531066592125497,98.5745990371446,0.0476190476190477
304.64,305,7061,7085,233013,255060,2023-09-13,2023-12-15,445.99,24,22047,481634514,35662575,0.0529571682647311,98.6275562054093,0.0864384850623383
359.98,361,2347,2487,328580,253674,2023-09-13,2023-12-15,445.99,140,-74906,481634514,35662575,0.0526693981901804,98.6802256035995,-0.295284499002657
429.59,432,310,1041,61690,250881,2023-09-13,2023-10-13,445.99,731,189191,22195764,5051124,1.13031027001368,85.2558893669981,0.754106528593237
443.4,463,128,128,250880,250880,2023-09-13,2023-09-29,445.99,0,0,181598301,29583870,0.138151072239382,97.5824570076787,0
382.3,384,1553,1466,248480,249220,2023-09-13,2023-12-15,445.99,-87,739.999999999942,481634514,35662575,0.0517446305768693,98.7319702341764,0.00296926410400426
403.87,407,761,786,215363,246018,2023-09-13,2023-12-15,445.99,25,30655,481634514,35662575,0.0510798111117095,98.7830500452881,0.124604703720866
442.73,452,28,264,26600,244728,2023-09-13,2023-10-27,445.99,236,218128,12636806,8295984,1.93662860694387,76.9184555021261,0.891307901016639
386.14,388,1299,1300,226026,241800,2023-09-13,2023-12-15,445.99,1,15774,481634514,35662575,0.0502040433090723,98.8332540885972,0.0652357320099257
394.78,396,1966,1966,239852,239852,2023-09-13,2023-11-17,445.99,0,0,390070868,38675143,0.0614893394192155,99.1769828860944,0
426.57,427,5691,5548,193494,238564,2023-09-13,2023-09-22,445.99,-143,45070,40008818,10432511,0.596278550393566,93.1948701908664,0.188922050267433
314.79,315,10592,11277,222432,236817,2023-09-13,2023-11-17,445.99,685,14385,390070868,38675143,0.0607112756751678,99.2376941617696,0.060743105435843
430.45,433,716,927,158952,236385,2023-09-13,2023-10-13,445.99,211,77433,22195764,5051124,1.0650005109083,86.3208898779064,0.32757154641792
415.07,416,2226,2540,182532,236220,2023-09-13,2023-10-13,445.99,314,53688,22195764,5051124,1.06425712581914,87.3851470037256,0.227279654559309
428.49,429,4984,4604,194376,234804,2023-09-13,2023-09-22,445.99,-380,40428,40008818,10432511,0.586880622166843,93.7817508130333,0.172177646036694
389.93,391,2191,2191,234437,234437,2023-09-13,2023-11-17,445.99,0,0,390070868,38675143,0.0601011301361782,99.2977952919058,0
444.72,470,91,92,207116,232576,2023-09-13,2023-09-29,445.99,1,25460,181598301,29583870,0.128071682785182,97.7105286904639,0.109469592735278
431.3,432,3041,3311,164214,231770,2023-09-13,2023-09-22,445.99,270,67556,40008818,10432511,0.579297293911557,94.3610481069448,0.291478621046727
416.56,417,5322,5261,196914,231484,2023-09-13,2023-09-29,445.99,-61,34570,181598301,29583870,0.127470355573426,97.8379990460373,0.149340775172366
417.51,418,4505,4700,175695,230300,2023-09-13,2023-09-29,445.99,195,54605,181598301,29583870,0.126818367094745,97.9648174131321,0.237103777681285
324.74,325,8811,8823,229086,229398,2023-09-13,2023-11-17,445.99,12,312,390070868,38675143,0.0588093135937545,99.3566046054995,0.00136008160489629
365.89,367,2064,2064,229104,229104,2023-09-13,2023-12-15,445.99,0,0,481634514,35662575,0.0475680195958714,98.880822108193,0
395.5,396,3832,4570,183936,228500,2023-09-13,2023-10-20,445.99,738,44564,497615928,97292139,0.0459189481571418,99.5737427440225,0.195028446389497
444.6,500,14,41,76412,227140,2023-09-13,2023-11-17,445.99,27,150728,390070868,38675143,0.0582304444227299,99.4148350499223,0.663590736990402
361.99,363,2232,2232,225432,225432,2023-09-13,2023-12-15,445.99,0,0,481634514,35662575,0.0468056157619967,98.927627723955,0
352.18,353,2739,2739,314985,224598,2023-09-13,2023-12-15,445.99,0,-90387,481634514,35662575,0.0466324554141068,98.9742601793691,-0.402439024390244
239.9,240,22338,22348,223380,223480,2023-09-13,2023-12-15,445.99,10,100,481634514,35662575,0.0464003291923552,99.0206605085615,0.000447467334884553
436.57,441,452,498,160912,220614,2023-09-13,2023-10-13,445.99,46,59702,22195764,5051124,0.993946412477624,88.3790934162032,0.270617458547508
334.68,335,6867,6867,212877,219744,2023-09-13,2023-11-17,445.99,0,6867,390070868,38675143,0.0563343787057689,99.471169428628,0.03125
441.24,451,172,224,141728,218624,2023-09-13,2023-10-27,445.99,52,76896,12636806,8295984,1.73005742115531,78.6485129232814,0.351727166276347
430.39,431,3428,3583,164544,218563,2023-09-13,2023-09-22,445.99,155,54019,40008818,10432511,0.546287071015195,94.90733517796,0.247155282458605
374.98,375,107662,107654,107662,215308,2023-09-13,2023-09-15,445.99,-8,107646,204169288,52571163,0.10545562562769,97.7314673301893,0.499962843925911
446.19,459,14,168,17290,215208,2023-09-13,2023-10-06,445.99,154,197918,35655626,8296590,0.60357375298922,94.1653864105485,0.919659120478793
399.5,401,1426,1426,201066,213900,2023-09-13,2023-11-17,445.99,0,12834,390070868,38675143,0.0548361894075104,99.5260056180356,0.06
419.78,420,10227,9680,204540,212960,2023-09-13,2023-09-22,445.99,-547,8420,40008818,10432511,0.532282658287981,95.439617836248,0.0395379413974455
354.95,355,42189,42188,210945,210940,2023-09-13,2023-09-29,445.99,-1,-5.0000000000291,181598301,29583870,0.116157474402803,98.0809748875349,-2.37034227743866e-05
443.51,453,191,221,181641,209729,2023-09-13,2023-10-13,445.99,30,28088,22195764,5051124,0.944905523414288,89.3239989396175,0.133925208244926
420.44,421,3764,3741,180672,209496,2023-09-13,2023-09-29,445.99,-23,28824,181598301,29583870,0.115362312778466,98.1963372003134,0.13758735250315
389.87,390,16163,16100,177793,209300,2023-09-13,2023-09-29,445.99,-63,31507,181598301,29583870,0.115254382253279,98.3115915825666,0.150535117056856
442.85,452,224,223,163968,204045,2023-09-13,2023-10-06,445.99,-1,40077,35655626,8296590,0.57226593076784,94.7376523413164,0.196412556053812
409.54,410,4426,4435,181466,204010,2023-09-13,2023-10-06,445.99,9,22544,35655626,8296590,0.572167769540773,95.3098201108571,0.110504387039851
389.98,390,99938,99866,199876,199732,2023-09-13,2023-09-15,445.99,-72,-144,204169288,52571163,0.0978266623528608,97.8292939925421,-0.00072096609456672
436.47,442.5,120,329,61200,198387,2023-09-13,2023-10-27,445.99,209,137187,12636806,8295984,1.56991410646013,80.2184270297415,0.691512044640022
391.84,393,1709,1710,208498,198360,2023-09-13,2023-11-17,445.99,1,-10138,390070868,38675143,0.050852297947049,99.5768579159826,-0.0511090945755193
433.92,439,358,390,151792,198120,2023-09-13,2023-10-27,445.99,32,46328,12636806,8295984,1.56780123078569,81.7862282605272,0.233838077932566
437.28,442,414,419,158976,197768,2023-09-13,2023-10-13,445.99,5,38792,22195764,5051124,0.891016862496826,90.2150158021143,0.196149023097771
289.74,290,7578,7579,204606,197054,2023-09-13,2023-12-15,445.99,1,-7552.00000000003,481634514,35662575,0.0409135961547806,99.0615741047163,-0.0383245201822852
408.09,409,2164,2145,170956,195195,2023-09-13,2023-10-20,445.99,-19,24239,497615928,97292139,0.039226035385266,99.6129687794077,0.124178385716847
425.91,426,21545,21614,150815,194526,2023-09-13,2023-09-15,445.99,69,43711,204169288,52571163,0.0952768175397663,97.9245708100819,0.224705180798454
444.14,454,191,196,149171,193256,2023-09-13,2023-09-22,445.99,5,44085,40008818,10432511,0.483033515261561,95.9226513515096,0.228117108912531
422.36,423,3034,3019,166870,193216,2023-09-13,2023-09-29,445.99,-15,26346,181598301,29583870,0.106397471196606,98.4179890537632,0.136355167273932
329.72,330,6647,6847,192763,191716,2023-09-13,2023-11-17,445.99,200,-1047,390070868,38675143,0.049149017711315,99.6260069336939,-0.00546120302948111
199.95,200,37393,37393,149572,186965,2023-09-13,2023-12-15,445.99,0,37393,481634514,35662575,0.0388188542484727,99.1003929589647,0.2
420.94,421,31434,30975,157170,185850,2023-09-13,2023-09-15,445.99,-459,28680,204169288,52571163,0.0910274027110287,98.0155982127929,0.154317998385795
366.87,368,1630,1633,184190,184529,2023-09-13,2023-12-15,445.99,3,338.999999999971,481634514,35662575,0.0383130765416865,99.1387060355064,0.00183710961420682
443.58,477,55,55,183810,183810,2023-09-13,2023-12-15,445.99,0,0,481634514,35662575,0.0381637932201844,99.1768698287266,0
392.77,394,1479,1480,173043,182040,2023-09-13,2023-11-17,445.99,1,8997.00000000003,390070868,38675143,0.0466684428225489,99.6726753765165,0.0494232036914965
384.95,385,35984,35988,215904,179940,2023-09-13,2023-09-22,445.99,4,-35964,40008818,10432511,0.449750852424583,96.3724022039342,-0.199866622207402
397.41,398,3019,3020,156988,178180,2023-09-13,2023-10-20,445.99,1,21192,497615928,97292139,0.0358067316526894,99.6487755110604,0.11893590750926
394.86,395,12076,12272,169064,171808,2023-09-13,2023-09-29,445.99,196,2744.00000000003,181598301,29583870,0.0946088146496481,98.5125978684129,0.0159713168187746
428.75,431,527,762,98022,171450,2023-09-13,2023-10-13,445.99,235,73428,22195764,5051124,0.772444688094539,90.9874604902089,0.42827646544182
394.75,397,754,755,165126,169875,2023-09-13,2023-12-15,445.99,1,4749,481634514,35662575,0.0352705205009457,99.2121403492276,0.0279558498896247
425.71,427,1282,1315,138456,169635,2023-09-13,2023-10-06,445.99,33,31179,35655626,8296590,0.475759421528597,95.7855795323857,0.183800512865859
426.97,430,239,556,62379,168468,2023-09-13,2023-10-27,445.99,317,106089,12636806,8295984,1.33315333004242,83.1193815905697,0.629727900847639
446.16,469,73,73,166732,166732,2023-09-13,2023-12-15,445.99,0,0,481634514,35662575,0.0346179509884543,99.246758300216,0
364.92,366,1543,1543,166644,166644,2023-09-13,2023-12-15,445.99,0,0,481634514,35662575,0.0345996798726098,99.2813579800886,0
379.91,380,18453,18460,166077,166140,2023-09-13,2023-09-29,445.99,7,63,181598301,29583870,0.0914876400743419,98.6040855084872,0.00037919826652221
309.81,310,8650,8669,164350,164711,2023-09-13,2023-11-17,445.99,19,361,390070868,38675143,0.0422259167531578,99.7149012932696,0.00219171761448841
443.84,452.5,138,188,112884,162808,2023-09-13,2023-10-13,445.99,50,49924,22195764,5051124,0.733509330879532,91.7209698210884,0.30664340818633
428.9,429,17385,16279,139080,162790,2023-09-13,2023-09-15,445.99,-1106,23710,204169288,52571163,0.0797328538462651,98.0953310666392,0.145647767061859
433.93,437.5,434,447,121954,159579,2023-09-13,2023-10-13,445.99,13,37625,22195764,5051124,0.71896150995298,92.4399313310414,0.235776637276835
421.94,422,30927,26575,154635,159450,2023-09-13,2023-09-15,445.99,-4352,4815,204169288,52571163,0.0780969564825049,98.1734280231217,0.0301975540921919
402.8,403,7932,7942,166572,158840,2023-09-13,2023-09-29,445.99,10,-7732,181598301,29583870,0.0874677786770703,98.6915532871643,-0.048677914882901
284.77,285,6898,6898,158654,158654,2023-09-13,2023-12-15,445.99,0,0,481634514,35662575,0.0329407456044564,99.3142987256931,0
418.15,420,765,851,124695,157435,2023-09-13,2023-10-27,445.99,86,32740,12636806,8295984,1.24584487567507,84.3652264662447,0.207958840156255
374.64,376,1157,1153,152724,156808,2023-09-13,2023-12-15,445.99,-4,4084.00000000003,481634514,35662575,0.0325574674243549,99.3468561931174,0.0260445895617572
444.7,510,24,24,156720,156720,2023-09-13,2023-12-15,445.99,0,0,481634514,35662575,0.0325391963085104,99.3793953894259,0
435.17,439,237,407,76551,155881,2023-09-13,2023-10-13,445.99,170,79330,22195764,5051124,0.702300673227558,93.1422320042689,0.508913850950404
319.76,320,6487,6485,149201,155640,2023-09-13,2023-11-17,445.99,-2,6439,390070868,38675143,0.0399004418858575,99.7548017351555,0.0413711128244667
374.92,375,18915,18915,151320,151320,2023-09-13,2023-09-29,445.99,0,0,181598301,29583870,0.0833267707719358,98.7748800579362,0
375.62,377,1136,1089,153360,150282,2023-09-13,2023-12-15,445.99,-47,-3078,481634514,35662575,0.0312024980834326,99.4105978875094,-0.0204814947897952
431.27,434,312,549,72384,149877,2023-09-13,2023-10-13,445.99,237,77493,22195764,5051124,0.675250466710675,93.8174824709796,0.51704397606037
401.32,402,2181,2189,130860,148852,2023-09-13,2023-10-20,445.99,8,17992,497615928,97292139,0.0299130296327653,99.6786885406932,0.120871738371
372.67,374,982,1105,133552,146965,2023-09-13,2023-12-15,445.99,123,13413,481634514,35662575,0.0305138015918851,99.4411116891013,0.0912666281087332
416.95,417,29157,29152,145785,145760,2023-09-13,2023-09-15,445.99,-5,-25,204169288,52571163,0.0713917364496075,98.2448197595713,-0.000171514818880351
353.12,354,1627,1627,138295,143176,2023-09-13,2023-12-15,445.99,0,4881,481634514,35662575,0.0297271054789898,99.4708387945803,0.0340909090909091
445.63,490,32,32,141984,141984,2023-09-13,2023-09-15,445.99,0,0,204169288,52571163,0.0695422908072246,98.3143620503785,0
415.59,416,3422,3435,126614,140835,2023-09-13,2023-09-29,445.99,13,14221,181598301,29583870,0.0775530383403752,98.8524330962766,0.100976319806866
409.31,410,1706,2027,105772,139863,2023-09-13,2023-10-13,445.99,321,34091,22195764,5051124,0.630133749845241,94.4476162208248,0.243745665401143
418.83,420,1370,1188,139740,138996,2023-09-13,2023-10-13,445.99,-182,-744.000000000029,22195764,5051124,0.626227599104045,95.0738438199289,-0.0053526720193389
411.68,412,4305,4311,120540,137952,2023-09-13,2023-09-29,445.99,6,17412,181598301,29583870,0.0759654684214254,98.928398564698,0.126217814892136
447.19,490,32,32,136992,136992,2023-09-13,2023-12-15,445.99,0,0,481634514,35662575,0.0284431443382814,99.4992819389185,0
404.63,405,3698,3696,122034,136752,2023-09-13,2023-10-06,445.99,-2,14718,35655626,8296590,0.38353554639596,96.1691150787817,0.107625482625483
445,472,36,50,98532,135000,2023-09-13,2023-12-15,445.99,14,36468,481634514,35662575,0.0280295527159833,99.5273114916345,0.270133333333333
384.99,385,134637,134634,269274,134634,2023-09-13,2023-09-15,445.99,-3,-134640,204169288,52571163,0.0659423370276924,98.3803043874062,-1.00004456526583
438.85,446,109,188,67035,134420,2023-09-13,2023-10-27,445.99,79,67385,12636806,8295984,1.06371815789528,85.42894462414,0.501301889599762
399.55,400,322,2943,13524,132435,2023-09-13,2023-10-13,445.99,2621,118911,22195764,5051124,0.596667904740742,95.6705117246696,0.897881979839166
329.9,330,13225,13242,132250,132420,2023-09-13,2023-10-20,445.99,17,170,497615928,97292139,0.0266108845294036,99.7052994252226,0.00128379398882344
426.6,428,926,936,109268,131040,2023-09-13,2023-10-06,445.99,10,21772,35655626,8296590,0.367515634138635,96.5366307129203,0.166147741147741
449.76,482,39,39,125736,125736,2023-09-13,2023-11-17,445.99,0,0,390070868,38675143,0.0322341426430235,99.7870358777985,0
444.96,464,66,66,125664,125664,2023-09-13,2023-09-15,445.99,0,0,204169288,52571163,0.0615489240477735,98.441853311454,0
356.06,357,1312,1314,116768,123516,2023-09-13,2023-12-15,445.99,2,6747.99999999999,481634514,35662575,0.025645172098277,99.5529566637328,0.0546325982059003
359.99,360,122667,122667,122667,122667,2023-09-13,2023-09-15,445.99,0,0,204169288,52571163,0.0600810245270582,98.501934335981,0
427.73,431,281,372,77837,121644,2023-09-13,2023-10-27,445.99,91,43807,12636806,8295984,0.962616661203788,86.3915612853438,0.360124625957713
404.97,405,40414,40405,161656,121215,2023-09-13,2023-09-15,445.99,-9,-40441,204169288,52571163,0.0593698499844893,98.5613041859655,-0.333630326279751
429.29,431,591,706,83922,120726,2023-09-13,2023-10-06,445.99,115,36804,35655626,8296590,0.338588922825251,96.8752196357456,0.304855623477958
437.43,444,75,183,41325,120231,2023-09-13,2023-10-27,445.99,108,78906,12636806,8295984,0.951435038252546,87.3429963235963,0.656286648202211
406.76,407,4964,4963,114172,119112,2023-09-13,2023-09-29,445.99,-1,4939.99999999999,181598301,29583870,0.0655909220207958,98.9939894867188,0.0414735710927529
269.83,270,6952,6952,118184,118184,2023-09-13,2023-12-15,445.99,0,0,481634514,35662575,0.0245381085791539,99.5774947723119,0
406.16,407,1333,1363,97309,114492,2023-09-13,2023-10-20,445.99,30,17183,497615928,97292139,0.023008105962396,99.728307531185,0.150080354959298
324.91,325,12560,12704,113040,114336,2023-09-13,2023-10-20,445.99,144,1296,497615928,97292139,0.0229767564835666,99.7512842876685,0.0113350125944584
381.98,382,56952,56952,113904,113904,2023-09-13,2023-09-15,445.99,0,0,204169288,52571163,0.055788998000522,98.6170931839661,0
446.43,458,98,98,113386,113386,2023-09-13,2023-10-06,445.99,0,0,35655626,8296590,0.318003111206069,97.1932227469516,0
423.93,424,15861,15918,79305,111426,2023-09-13,2023-09-15,445.99,57,32121,204169288,52571163,0.0545752992977083,98.6716684832638,0.288272037047009
219.94,220,18557,18557,111342,111342,2023-09-13,2023-12-15,445.99,0,0,481634514,35662575,0.0231175293222445,99.6006123016342,0
444.91,464,52,58,106808,110722,2023-09-13,2023-09-29,445.99,6,3914,181598301,29583870,0.0609708347436577,99.0549603214625,0.0353497949820271
412.96,413,27832,27547,139160,110188,2023-09-13,2023-09-15,445.99,-285,-28972,204169288,52571163,0.0539689397359313,98.7256374229997,-0.262932442734236
351.13,352,1250,1251,101250,108837,2023-09-13,2023-12-15,445.99,1,7586.99999999997,481634514,35662575,0.0225974253996257,99.6232097270338,0.0697097494418256
364.97,365,35742,36138,107226,108414,2023-09-13,2023-09-22,445.99,396,1187.99999999999,40008818,10432511,0.270975263503161,96.6433774674373,0.0109579943549725
432.47,437,233,239,88074,108267,2023-09-13,2023-10-27,445.99,6,20193,12636806,8295984,0.856759215896802,88.1997555394931,0.186511125273629
446.34,460,79,79,107914,107914,2023-09-13,2023-10-13,445.99,0,0,22195764,5051124,0.486191869763978,96.1567035944336,0
404.04,405,196,1113,17052,106848,2023-09-13,2023-10-27,445.99,917,89796,12636806,8295984,0.845530112593325,89.0452856520865,0.840408805031447
444.24,456,77,90,79310,105840,2023-09-13,2023-09-22,445.99,13,26530,40008818,10432511,0.26454168178625,96.9079191492236,0.250661375661376
422.64,425,253,447,53636,105492,2023-09-13,2023-10-27,445.99,194,51856,12636806,8295984,0.83479955298831,89.8800852050748,0.491563341296022
339.88,340,8771,8776,105252,105312,2023-09-13,2023-10-20,445.99,5,59.9999999999855,497615928,97292139,0.0211633097082053,99.7724475973768,0.000569735642661667
360.99,362,1039,1037,103900,104737,2023-09-13,2023-12-15,445.99,-2,837.000000000015,481634514,35662575,0.0217461575023255,99.6449558845361,0.00799144523902742
279.9,280,10136,10142,101360,101420,2023-09-13,2023-11-17,445.99,6,60,390070868,38675143,0.0260004035984559,99.813036281397,0.000591599290080852
369.99,370,101138,101159,101138,101159,2023-09-13,2023-09-15,445.99,21,21,204169288,52571163,0.0495466291678502,98.7751840521675,0.000207593985705671
414.12,415,888,1138,69264,100144,2023-09-13,2023-10-13,445.99,250,30880,22195764,5051124,0.45118519011105,96.6078887845447,0.308355967406934
367.84,369,831,860,102213,99760,2023-09-13,2023-12-15,445.99,29,-2453.00000000001,481634514,35662575,0.0207128013255296,99.6656686858617,-0.0245890136327187
264.84,265,6115,6125,103955,98000,2023-09-13,2023-12-15,445.99,10,-5955.00000000001,481634514,35662575,0.0203473790086397,99.6860160648703,-0.0607653061224491
411.48,412,1859,1878,85514,97656,2023-09-13,2023-10-06,445.99,19,12142,35655626,8296590,0.273886651155697,97.4671093981073,0.12433439829606
279.79,280,4592,4591,96432,96411,2023-09-13,2023-12-15,445.99,-1,-21,481634514,35662575,0.0200174607918568,99.7060335256622,-0.000217817468961011
447,460,73,73,94900,94900,2023-09-13,2023-10-06,445.99,0,0,35655626,8296590,0.266157155675797,97.7332665537831,0
444.7,475,31,31,93930,93930,2023-09-13,2023-10-20,445.99,0,0,497615928,97292139,0.0188760035028461,99.7913236008796,0
413.65,414,2154,2645,68928,92575,2023-09-13,2023-09-29,445.99,491,23647,181598301,29583870,0.0509778998427964,99.1059382213053,0.255436132865244
413.53,415,266,625,34580,91875,2023-09-13,2023-10-27,445.99,359,57295,12636806,8295984,0.727042893591941,90.6071280986667,0.623619047619048
443.61,468,37,37,90243,90243,2023-09-13,2023-11-17,445.99,0,0,390070868,38675143,0.0231350268382514,99.8361713082352,0
299.95,300,18038,18038,90190,90190,2023-09-13,2023-10-20,445.99,0,0,497615928,97292139,0.0181244198437314,99.8094480207233,0
422.93,423,13768,12802,82608,89614,2023-09-13,2023-09-15,445.99,-966,7006.00000000001,204169288,52571163,0.0438920078910203,98.8190760600586,0.0781797486999801
443.85,491,19,19,89585,89585,2023-09-13,2023-12-15,445.99,0,0,481634514,35662575,0.0186002035560101,99.7246337292182,0
309.94,310,14849,14849,89094,89094,2023-09-13,2023-10-20,445.99,0,0,497615928,97292139,0.0179041696591352,99.8273521903825,0
431.72,436,173,206,61242,88168,2023-09-13,2023-10-27,445.99,33,26926,12636806,8295984,0.697707949303012,91.3048360479697,0.305394247345976
426.1,428,431,450,68529,85500,2023-09-13,2023-10-13,445.99,19,16971,22195764,5051124,0.385208637107513,96.9930974216522,0.198491228070175
440.43,449,85,99,62730,84843,2023-09-13,2023-10-27,445.99,14,22113,12636806,8295984,0.671395920773018,91.9762319687427,0.260634348148934
424.79,426,644,698,66332,84458,2023-09-13,2023-10-06,445.99,54,18126,35655626,8296590,0.236871454731997,97.9701380085151,0.214615548556679
364.91,365,9359,9379,112308,84411,2023-09-13,2023-10-06,445.99,20,-27897,35655626,8296590,0.236739638227078,98.2068776467422,-0.330490102000924
371.41,373,508,508,80772,80772,2023-09-13,2023-12-15,445.99,0,0,481634514,35662575,0.0167703928294474,99.7414041220476,0
394.98,395,40401,40324,121203,80648,2023-09-13,2023-09-15,445.99,-77,-40555,204169288,52571163,0.0395005540696209,98.8585766141282,-0.502864299176669
209.95,210,15936,15936,79680,79680,2023-09-13,2023-12-15,445.99,0,0,481634514,35662575,0.0165436648919226,99.7579477869395,0
445.5,457.5,66,66,79200,79200,2023-09-13,2023-09-22,445.99,0,0,40008818,10432511,0.197956360520323,97.1058755097439,0
425.25,427,439,451,65850,78925,2023-09-13,2023-10-13,445.99,12,13075,22195764,5051124,0.355585867645736,97.3486832892979,0.165663604687995
441.94,469,29,29,78474,78474,2023-09-13,2023-09-22,445.99,0,0,40008818,10432511,0.196141760548887,97.3020172702928,0
349.96,350,19506,19534,97530,78136,2023-09-13,2023-09-29,445.99,28,-19394,181598301,29583870,0.0430268342653712,99.1489650555707,-0.248208252278079
416.95,418,389,733,35010,76965,2023-09-13,2023-10-13,445.99,344,41955,22195764,5051124,0.346755353859412,97.6954386431573,0.545117910738648
414.36,415,1181,1201,63774,76864,2023-09-13,2023-10-06,445.99,20,13090,35655626,8296590,0.215573273064958,98.4224509198072,0.170300791007494
379.99,380,76249,76268,76249,76268,2023-09-13,2023-09-15,445.99,19,19,204169288,52571163,0.0373552754907976,98.895931889619,0.000249121518854565
399.2,400,249,946,18177,75680,2023-09-13,2023-10-27,445.99,697,57503,12636806,8295984,0.598885509518782,92.5751174782615,0.759817653276956
435.42,441,123,135,57933,75330,2023-09-13,2023-10-27,445.99,12,17397,12636806,8295984,0.596115822305098,93.1712333005666,0.230943847072879
304.95,305,15022,15062,90132,75310,2023-09-13,2023-10-20,445.99,40,-14822,497615928,97292139,0.0151341618630825,99.8424863522455,-0.196813172221485
449.46,485,21,21,74634,74634,2023-09-13,2023-10-20,445.99,0,0,497615928,97292139,0.0149983141214885,99.857484666367,0
412.67,413,2209,2209,68479,72897,2023-09-13,2023-09-29,445.99,0,4418,181598301,29583870,0.0401418953803979,99.1891069509511,0.0606060606060606
350.17,351,876,877,80592,72791,2023-09-13,2023-12-15,445.99,1,-7801,481634514,35662575,0.0151133271981418,99.7730611141377,-0.107169842425575
354.98,355,36142,36150,108426,72300,2023-09-13,2023-09-22,445.99,8,-36126,40008818,10432511,0.180710162444689,97.4827274327374,-0.499668049792531
299.84,300,4497,4501,76449,72016,2023-09-13,2023-11-17,445.99,4,-4433,390070868,38675143,0.018462286191544,99.8546335944268,-0.0615557653854699
433.1,437.5,157,162,61073,71280,2023-09-13,2023-10-27,445.99,5,10207,12636806,8295984,0.56406658454676,93.7352998851134,0.143195847362514
445.54,500,16,13,84016,70798,2023-09-13,2023-09-15,445.99,-3,-13218,204169288,52571163,0.0346761262154179,98.9306080158344,-0.186700189270883
446.36,480,21,21,70644,70644,2023-09-13,2023-09-15,445.99,0,0,204169288,52571163,0.0346006986124181,98.9652087144468,0
314.94,315,11685,11679,81795,70074,2023-09-13,2023-10-20,445.99,-6,-11721,497615928,97292139,0.0140819447403219,99.8715666111074,-0.167266033050775
424.4,427,227,269,51529,69940,2023-09-13,2023-10-27,445.99,42,18411,12636806,8295984,0.553462639214371,94.2887625243278,0.26323991993137
405.9,406,6817,6808,61353,68080,2023-09-13,2023-09-22,445.99,-9,6727,40008818,10432511,0.170162487679591,97.652889920417,0.098810223266745
189.95,190,13524,13524,67620,67620,2023-09-13,2023-12-15,445.99,0,0,481634514,35662575,0.0140396915159614,99.7871008056537,0
436.82,443,32,109,16800,67362,2023-09-13,2023-10-27,445.99,77,50562,12636806,8295984,0.533061914537582,94.8218244388653,0.750601229179656
304.83,305,3914,3937,70452,66929,2023-09-13,2023-11-17,445.99,23,-3522.99999999999,390070868,38675143,0.0171581641928717,99.8717917586196,-0.0526378699816221
411.96,412,16425,16433,65700,65732,2023-09-13,2023-09-15,445.99,8,32,204169288,52571163,0.0321948519505049,98.9974035663973,0.000486825290573845
384.83,385,3831,3840,65127,65280,2023-09-13,2023-10-06,445.99,9,153,35655626,8296590,0.183084711512287,98.6055356313194,0.00234375
344.86,345,4630,4635,64820,64890,2023-09-13,2023-10-20,445.99,5,70,497615928,97292139,0.0130401774438378,99.8846067885512,0.00107874865156419
420.77,421,2721,2813,57141,64699,2023-09-13,2023-09-22,445.99,92,7558,40008818,10432511,0.16171185062253,97.8146017710396,0.116817879719934
444.55,463,35,35,64575,64575,2023-09-13,2023-09-22,445.99,0,0,40008818,10432511,0.161401918946968,97.9760036899865,0
428.65,432,321,191,92769,63985,2023-09-13,2023-10-27,445.99,-130,-28784,12636806,8295984,0.506338389621555,95.3281628284869,-0.449855434867547
427,429,216,315,35856,63000,2023-09-13,2023-10-13,445.99,99,27144,22195764,5051124,0.283837943131852,97.9792765862892,0.430857142857143
407.96,408,15479,15477,61916,61908,2023-09-13,2023-09-15,445.99,-2,-7.99999999999272,204169288,52571163,0.0303218964058884,99.0277254628032,-0.000129224009820907
445.63,466,30,30,61110,61110,2023-09-13,2023-09-15,445.99,0,0,204169288,52571163,0.0299310442812535,99.0576565070845,0
359.94,360,10055,10055,50275,60330,2023-09-13,2023-09-29,445.99,0,10055,181598301,29583870,0.0332216764516976,99.2223286274027,0.166666666666667
408.97,409,20079,20069,80316,60207,2023-09-13,2023-09-15,445.99,-10,-20109,204169288,52571163,0.0294887642454824,99.0871452713299,-0.333997707907719
149.98,150,29931,29972,29931,59944,2023-09-13,2023-12-15,445.99,41,30013,481634514,35662575,0.0124459519111623,99.7995467575648,0.500683971706927
425.61,426,1602,1531,48060,59709,2023-09-13,2023-09-22,445.99,-71,11649,40008818,10432511,0.149239600130151,98.1252432901167,0.195096216650756
415.95,416,11935,11935,59675,59675,2023-09-13,2023-09-15,445.99,0,0,204169288,52571163,0.0292281961623925,99.1163734674923,0
446.28,470,25,25,69675,59300,2023-09-13,2023-10-27,445.99,0,-10375,12636806,8295984,0.46926414791839,95.7974269764053,-0.17495784148398
395.85,396,3950,3952,55300,59280,2023-09-13,2023-09-29,445.99,2,3979.99999999999,181598301,29583870,0.0326434772096243,99.2549721046124,0.0671390013495276
274.92,275,7391,7394,81301,59152,2023-09-13,2023-11-17,445.99,3,-22149,390070868,38675143,0.0151644239169381,99.8869561825366,-0.374442115228564
364.95,365,11897,11812,59485,59060,2023-09-13,2023-09-29,445.99,-85,-425,181598301,29583870,0.0325223307017614,99.2874944353141,-0.00719607179139858
249.88,250,4920,4920,59040,59040,2023-09-13,2023-12-15,445.99,0,0,481634514,35662575,0.0122582577211234,99.8118050152859,0
413.96,414,14549,14597,58196,58388,2023-09-13,2023-09-15,445.99,48,192,204169288,52571163,0.0285978369087519,99.1449713044011,0.00328834692060012
259.85,260,3849,3848,57735,57720,2023-09-13,2023-12-15,445.99,-1,-15.0000000000073,481634514,35662575,0.011984190983456,99.8237892062694,-0.000259875259875386
404.45,405,1254,1031,62700,56705,2023-09-13,2023-10-13,445.99,-223,-5994.99999999999,22195764,5051124,0.25547667563955,98.2347532619287,-0.105722599418041
414.85,415,3756,3737,52584,56055,2023-09-13,2023-09-22,445.99,-19,3470.99999999999,40008818,10432511,0.140106613497055,98.2653499036137,0.0619213272678618
334.89,335,5002,5003,55022,55033,2023-09-13,2023-10-20,445.99,1,11.0000000000073,497615928,97292139,0.0110593324898555,99.8956661210411,0.000199880071956958
446.31,472,21,21,55146,53949,2023-09-13,2023-11-17,445.99,0,-1197,390070868,38675143,0.0138305637323318,99.9007867462689,-0.0221876216426625
413.4,414,734,897,38902,53820,2023-09-13,2023-10-06,445.99,163,14918,35655626,8296590,0.150943921164082,98.7564795524835,0.27718320327016
424.37,426,154,328,21714,53464,2023-09-13,2023-10-13,445.99,174,31750,22195764,5051124,0.240874790342878,98.4756280522716,0.593857549004938
423.7,424,1976,1779,51376,53370,2023-09-13,2023-09-22,445.99,-197,1993.99999999999,40008818,10432511,0.133395592941536,98.3987454965553,0.0373618137530447
399.92,400,6651,6630,53208,53040,2023-09-13,2023-09-22,445.99,-21,-168.000000000007,40008818,10432511,0.132570774772701,98.531316271328,-0.00316742081447978
446.86,462,35,35,52990,52990,2023-09-13,2023-10-06,445.99,0,0,35655626,8296590,0.148616097779352,98.9050956502629,0
444.87,466,26,25,50778,52825,2023-09-13,2023-11-17,445.99,-1,2047,390070868,38675143,0.0135424109651788,99.9143291572341,0.0387505915759584
429.46,433,135,149,41445,52746,2023-09-13,2023-10-27,445.99,14,11301,12636806,8295984,0.417399776494155,96.2148267528994,0.214253213513821
408.79,410,226,434,23730,52514,2023-09-13,2023-10-27,445.99,208,28784,12636806,8295984,0.415563869541085,96.6303906224405,0.54812050119968
427.53,429,319,355,39875,52185,2023-09-13,2023-10-06,445.99,36,12310,35655626,8296590,0.146358389556812,99.0514540398197,0.235891539714477
376.98,377,26003,26003,52006,52006,2023-09-13,2023-09-15,445.99,0,0,204169288,52571163,0.0254719994909323,99.170443303892,0
407.57,408,1205,1205,53020,51815,2023-09-13,2023-10-06,445.99,0,-1205.00000000001,35655626,8296590,0.14532068515639,99.1967747249761,-0.0232558139534885
445.76,510,8,8,51392,51392,2023-09-13,2023-09-15,445.99,0,0,204169288,52571163,0.0251712686581931,99.1956145725502,0
234.92,235,6234,6234,56106,49872,2023-09-13,2023-12-15,445.99,0,-6233.99999999999,481634514,35662575,0.0103547396522335,99.8341439459216,-0.125
418.95,419,9893,9868,49465,49340,2023-09-13,2023-09-15,445.99,-25,-125,204169288,52571163,0.0241662203377033,99.2197807928879,-0.00253344142683421
254.86,255,3522,3522,49308,49308,2023-09-13,2023-12-15,445.99,0,0,481634514,35662575,0.0102376384097756,99.8443815843314,0
445.63,462,30,30,49110,49110,2023-09-13,2023-09-22,445.99,0,0,40008818,10432511,0.122747940216579,98.6540642115446,0
284.89,285,4136,4436,49632,48796,2023-09-13,2023-11-17,445.99,300,-836,390070868,38675143,0.0125095217313178,99.9268386789654,-0.0171325518485122
444,525,6,6,48600,48600,2023-09-13,2023-12-15,445.99,0,0,481634514,35662575,0.010090638977754,99.8544722233092,0
430.09,434,58,124,19082,48484,2023-09-13,2023-10-27,445.99,66,29402,12636806,8295984,0.383672899623528,97.014063522064,0.606426862470093
345.27,346,649,650,46728,47450,2023-09-13,2023-12-15,445.99,1,722,481634514,35662575,0.0098518687138771,99.864324092023,0.0152160168598525
362.81,364,398,398,47362,47362,2023-09-13,2023-12-15,445.99,0,0,481634514,35662575,0.0098335975980326,99.8741576896211,0
392.97,393,15762,15762,47286,47286,2023-09-13,2023-09-15,445.99,0,0,204169288,52571163,0.0231601924379537,99.2429409853259,0
445.73,493,10,10,46690,47270,2023-09-13,2023-09-15,445.99,0,580.000000000007,204169288,52571163,0.0231523558038759,99.2660933411297,0.0122699386503069
422.48,424,297,305,37422,46360,2023-09-13,2023-10-13,445.99,8,8938,22195764,5051124,0.208868683231629,98.6844967355032,0.192795513373598
366.9,367,4608,4608,46080,46080,2023-09-13,2023-09-29,445.99,0,0,181598301,29583870,0.0253746867378456,99.312869122052,0
406.96,407,11465,11458,34395,45832,2023-09-13,2023-09-15,445.99,-7,11437,204169288,52571163,0.0224480383161252,99.2885413794459,0.249541804852505
319.92,320,5651,5655,39557,45240,2023-09-13,2023-10-20,445.99,4,5682.99999999999,497615928,97292139,0.0090913488605212,99.9047574699016,0.125618921308576
405.96,406,11284,11282,45136,45128,2023-09-13,2023-09-15,445.99,-2,-8,204169288,52571163,0.0221032264166979,99.3106446058626,-0.000177273533061514
294.96,295,11304,11276,45216,45104,2023-09-13,2023-10-20,445.99,-28,-112,497615928,97292139,0.0090640185456443,99.9138214884472,-0.00248315005321036
425.2,428,149,161,35313,45080,2023-09-13,2023-10-27,445.99,12,9766.99999999999,12636806,8295984,0.356735713122446,97.3707992351865,0.216659272404614
445.61,468,20,20,50880,44780,2023-09-13,2023-10-20,445.99,0,-6100,497615928,97292139,0.00899890808961405,99.9228203965368,-0.136221527467619
446.3,460,32,32,43840,43840,2023-09-13,2023-10-27,445.99,0,0,12636806,8295984,0.346923106993967,97.7177223421805,0
443.14,454,39,40,42315,43440,2023-09-13,2023-10-27,445.99,1,1125,12636806,8295984,0.343757750178328,98.0614800923588,0.0258977900552486
387.89,388,3920,3939,43120,43329,2023-09-13,2023-09-29,445.99,19,209,181598301,29583870,0.0238598047236136,99.3367289267756,0.00482355927900482
224.93,225,6156,6156,43092,43092,2023-09-13,2023-12-15,445.99,0,0,481634514,35662575,0.00894703322694187,99.883104722848,0
378.83,379,2522,2522,42874,42874,2023-09-13,2023-09-29,445.99,0,0,181598301,29583870,0.0236092517187151,99.3603381784943,0
447.4,486,11,11,42460,42460,2023-09-13,2023-11-17,445.99,0,0,390070868,38675143,0.0108852015065119,99.9377238804719,0
299.99,300,42414,42414,42414,42414,2023-09-13,2023-09-15,445.99,0,0,204169288,52571163,0.0207739373612353,99.3314185432238,0
410.7,411,1428,1410,41412,42300,2023-09-13,2023-09-29,445.99,-18,888.000000000007,181598301,29583870,0.0232931694663817,99.3836313479607,0.0209929078014186
347.25,348,564,564,42300,42300,2023-09-13,2023-12-15,445.99,0,0,481634514,35662575,0.00878259318434144,99.8918873160324,0
355.12,356,474,474,41712,41712,2023-09-13,2023-12-15,445.99,0,0,481634514,35662575,0.0086605089102896,99.9005478249426,0
417.79,418,1970,1976,33490,41496,2023-09-13,2023-09-22,445.99,6,8006,40008818,10432511,0.103717135557466,98.757781347102,0.192934258723732
421.75,422,1673,1645,36806,41125,2023-09-13,2023-09-22,445.99,-28,4319,40008818,10432511,0.102789839979776,98.8605711870818,0.105021276595745
264.97,265,13573,13574,40719,40722,2023-09-13,2023-10-20,445.99,1,3,497615928,97292139,0.00818341972365483,99.9310038162605,7.36702519522617e-05
349.99,350,40281,40281,40281,40281,2023-09-13,2023-09-15,445.99,0,0,204169288,52571163,0.0197292160807261,99.3511477593045,0
405.79,406,1905,1901,40005,39921,2023-09-13,2023-09-29,445.99,-4,-84,181598301,29583870,0.0219831351836271,99.4056144831443,-0.00210415570752236
417.23,418,511,515,31682,39655,2023-09-13,2023-10-06,445.99,4,7973,35655626,8296590,0.111216670266847,99.3079913952429,0.201059135039718
400.97,401,13103,13103,39309,39309,2023-09-13,2023-09-15,445.99,0,0,204169288,52571163,0.0192531405604941,99.370400899865,0
401.97,402,13055,13060,39165,39180,2023-09-13,2023-09-15,445.99,5,15,204169288,52571163,0.0191899576982411,99.3895908575633,0.000382848392036753
422.72,423,1500,1370,37500,38360,2023-09-13,2023-09-22,445.99,-130,860,40008818,10432511,0.0958788635045404,98.9564500505863,0.0224191866527633
397.85,398,2536,2536,40576,38040,2023-09-13,2023-09-29,445.99,0,-2536,181598301,29583870,0.0209473325413986,99.4265618156857,-0.0666666666666667
415.3,416,227,541,12939,37870,2023-09-13,2023-10-06,445.99,314,24931,35655626,8296590,0.106210447686432,99.4142018429294,0.658331132822815
444.88,468,16,16,36992,36992,2023-09-13,2023-09-15,445.99,0,0,204169288,52571163,0.0181182979880892,99.4077091555513,0
451.6,479,13,13,35620,35620,2023-09-13,2023-12-15,445.99,0,0,481634514,35662575,0.0073956493906913,99.9079434743333,0
423.54,426,44,143,9768,35178,2023-09-13,2023-10-27,445.99,99,25410,12636806,8295984,0.278377305151317,98.3398573975101,0.722326454033771
444.83,480,10,10,34700,35170,2023-09-13,2023-10-06,445.99,0,470.000000000007,35655626,8296590,0.0986380101698397,99.5128398530992,0.0133636622121128
179.97,180,11665,11665,58325,34995,2023-09-13,2023-12-15,445.99,0,-23330,481634514,35662575,0.00726588294293212,99.9152093572763,-0.666666666666667
426.13,429,46,119,11914,34153,2023-09-13,2023-10-27,445.99,73,22239,12636806,8295984,0.270266078311244,98.6101234758213,0.651158024185284
412.89,413,3280,3079,45920,33869,2023-09-13,2023-09-22,445.99,-201,-12051,40008818,10432511,0.0846538380613994,99.0411038886477,-0.35581209956007
294.85,295,2251,2251,33765,33765,2023-09-13,2023-11-17,445.99,0,0,390070868,38675143,0.0086561193798251,99.9463799998517,0
439.61,447.5,19,41,13091,32349,2023-09-13,2023-10-27,445.99,22,19258,12636806,8295984,0.255990319072715,98.8661137948941,0.595319793502118
400.92,401,4025,4025,32200,32200,2023-09-13,2023-09-22,445.99,0,0,40008818,10432511,0.0804822576862931,99.1215861463341,0
448,471,14,14,32200,32200,2023-09-13,2023-12-15,445.99,0,0,481634514,35662575,0.00668556738855306,99.9218949246648,0
249.98,250,15891,15889,31782,31778,2023-09-13,2023-10-20,445.99,-2,-3.99999999999636,497615928,97292139,0.00638604960410351,99.9373898658646,-0.000125873245641524
445.75,477,0,10,0,31250,2023-09-13,2023-09-15,445.99,10,31250,204169288,52571163,0.0153059259333852,99.4230150814847,1
444.37,600,2,2,31126,31126,2023-09-13,2023-10-20,445.99,0,0,497615928,97292139,0.0062550248592525,99.9436448907238,0
445.73,497,5,6,25380,30762,2023-09-13,2023-09-15,445.99,1,5382,204169288,52571163,0.0150669085940095,99.4380819900788,0.174956114686951
391.97,392,10159,10159,30477,30477,2023-09-13,2023-09-15,445.99,0,0,204169288,52571163,0.014927318549497,99.4530093086282,0
446.82,462,20,20,30360,30360,2023-09-13,2023-10-13,445.99,0,0,22195764,5051124,0.136782856404492,98.8212795919077,0
445.83,476,0,10,0,30170,2023-09-13,2023-09-15,445.99,10,30170,204169288,52571163,0.0147769531331274,99.4677862617614,1
445.98,458,25,25,30050,30050,2023-09-13,2023-10-13,445.99,0,0,22195764,5051124,0.135386193509717,98.9566657854174,0
445.2,475,10,10,29800,29800,2023-09-13,2023-09-15,445.99,0,0,204169288,52571163,0.0145957309700762,99.4823819927315,0
391.89,392,2491,2663,32383,29293,2023-09-13,2023-09-29,445.99,172,-3090,181598301,29583870,0.0161306575219556,99.4426924732077,-0.105485952275288
445.5,482,8,8,29200,29200,2023-09-13,2023-10-20,445.99,0,0,497615928,97292139,0.00586797937062818,99.9495128700945,0
289.87,290,2213,2220,28769,28860,2023-09-13,2023-11-17,445.99,7,91.0000000000036,390070868,38675143,0.00739865556942848,99.9537786554212,0.00315315315315328
416.28,418,103,167,15759,28724,2023-09-13,2023-10-27,445.99,64,12965,12636806,8295984,0.227304272930992,99.0934180678251,0.451364712435594
396.86,397,2046,2046,57288,28644,2023-09-13,2023-09-29,445.99,0,-28644,181598301,29583870,0.0157732753237598,99.4584657485314,-1
184.96,185,7109,7109,28436,28436,2023-09-13,2023-12-15,445.99,0,0,481634514,35662575,0.00590406193356816,99.9277989865984,0
375.93,376,4053,4053,32424,28371,2023-09-13,2023-09-29,445.99,0,-4053,181598301,29583870,0.0156229435208207,99.4740886920523,-0.142857142857143
442.97,720,1,1,27703,27703,2023-09-13,2023-12-15,445.99,0,0,481634514,35662575,0.00575187184363619,99.933550858442,0
361.94,362,4596,4617,50556,27702,2023-09-13,2023-09-29,445.99,21,-22854,181598301,29583870,0.0152545480037283,99.489343240056,-0.824994585228503
405.61,406,713,707,24955,27573,2023-09-13,2023-10-06,445.99,-6,2618,35655626,8296590,0.0773314146833378,99.5901712677825,0.094947956334095
434.71,469,8,8,27432,27432,2023-09-13,2023-09-29,445.99,0,0,181598301,29583870,0.0151058681986237,99.5044491082546,0
408.72,409,970,968,24250,27104,2023-09-13,2023-09-29,445.99,-2,2854,181598301,29583870,0.0149252497687189,99.5193743580233,0.105298110979929
443.49,466,12,12,27012,27012,2023-09-13,2023-10-06,445.99,0,0,35655626,8296590,0.0757580304437791,99.6659292982263,0
410.96,411,6747,6746,26988,26984,2023-09-13,2023-09-15,445.99,-1,-3.99999999999636,204169288,52571163,0.013216483372367,99.4955984761038,-0.00014823599169865
382.9,383,2653,2654,26530,26540,2023-09-13,2023-09-29,445.99,1,10.0000000000036,181598301,29583870,0.0146146741758338,99.5339890321991,0.000376789751318901
244.9,245,2635,2640,28985,26400,2023-09-13,2023-12-15,445.99,5,-2585,481634514,35662575,0.00548133475334785,99.9390321931954,-0.0979166666666668
446.82,467,7,13,15330,26234,2023-09-13,2023-09-15,445.99,6,10904,204169288,52571163,0.0128491411499657,99.5084476172538,0.415643820995655
393.86,394,1868,1868,26152,26152,2023-09-13,2023-09-29,445.99,0,0,181598301,29583870,0.0144010157892391,99.5483900479884,0
229.93,230,3708,3708,29664,25956,2023-09-13,2023-12-15,445.99,0,-3708,481634514,35662575,0.00538914866885972,99.9444213418642,-0.142857142857143
319.99,320,25913,25913,25913,25913,2023-09-13,2023-09-15,445.99,0,0,204169288,52571163,0.012691918678778,99.5211395359326,0
289.97,290,8625,8625,25875,25875,2023-09-13,2023-10-20,445.99,0,0,497615928,97292139,0.00519979336352754,99.954712663458,0
446.57,470,11,11,25773,25773,2023-09-13,2023-09-22,445.99,0,0,40008818,10432511,0.0644182989859885,99.18600444532,0
376.92,377,3192,3192,25536,25536,2023-09-13,2023-09-29,445.99,0,0,181598301,29583870,0.0140618055672228,99.5624518535556,0
339.99,340,25509,25492,25509,25492,2023-09-13,2023-09-15,445.99,-17,-17,204169288,52571163,0.0124857172446034,99.5336252531772,-0.000666875882629845
443.03,466,11,11,25267,25267,2023-09-13,2023-10-13,445.99,0,0,22195764,5051124,0.113837036652579,99.07050282207,0
164.97,165,8396,8396,25188,25188,2023-09-13,2023-12-15,445.99,0,0,481634514,35662575,0.00522969165785324,99.9496510335221,0
447.02,472,10,10,24980,24980,2023-09-13,2023-09-15,445.99,0,0,204169288,52571163,0.0122349449541108,99.5458601981313,0
445.69,468,10,11,22000,24541,2023-09-13,2023-10-06,445.99,1,2541,35655626,8296590,0.0688278478128529,99.7347571460392,0.103541012998655
445.75,461,16,16,24432,24400,2023-09-13,2023-09-15,445.99,0,-32,204169288,52571163,0.0119508669687872,99.5578110651001,-0.00131147540983607
421.76,424,42,108,8358,24192,2023-09-13,2023-10-27,445.99,66,15834,12636806,8295984,0.191440780209809,99.2848588480349,0.654513888888889
329.99,330,24130,24130,24130,24130,2023-09-13,2023-09-15,445.99,0,0,204169288,52571163,0.0118186237687227,99.5696296888688,0
314.99,315,24015,24015,24015,24015,2023-09-13,2023-09-15,445.99,0,0,204169288,52571163,0.0117622979612879,99.5813919868301,0
444.93,565,2,2,24014,24014,2023-09-13,2023-10-20,445.99,0,0,497615928,97292139,0.00482581015774881,99.9595384736157,0
443.46,470,9,9,23886,23886,2023-09-13,2023-10-13,445.99,0,0,22195764,5051124,0.107615128724562,99.1781179507946,0
402.97,403,7957,7956,31828,23868,2023-09-13,2023-09-15,445.99,-1,-7960.00000000001,204169288,52571163,0.0116902988856972,99.5930822857158,-0.333500921736216
388.89,389,1957,2155,25441,23705,2023-09-13,2023-09-29,445.99,198,-1736,181598301,29583870,0.0130535362222359,99.5755053897778,-0.0732334950432398
401.81,402,1238,1238,22284,23522,2023-09-13,2023-09-29,445.99,0,1238,181598301,29583870,0.0129527643543317,99.5884581541322,0.0526315789473684
444.41,461,14,14,16422,23226,2023-09-13,2023-09-22,445.99,0,6804,40008818,10432511,0.0580522023919827,99.244056647712,0.292947558770344
418.79,419,1243,1104,22374,23184,2023-09-13,2023-09-22,445.99,-139,810.000000000004,40008818,10432511,0.057947225534131,99.3020038732461,0.0349378881987579
445.76,492,4,5,18276,23120,2023-09-13,2023-09-15,445.99,1,4844,204169288,52571163,0.0113239362425557,99.6044062219583,0.209515570934256
386.9,387,2301,2301,23010,23010,2023-09-13,2023-09-29,445.99,0,0,181598301,29583870,0.0126708233905779,99.6011289775228,0
381.91,382,2492,2492,24920,22428,2023-09-13,2023-09-29,445.99,0,-2492,181598301,29583870,0.0123503358106858,99.6134793133334,-0.111111111111111
413.86,414,1604,1597,22456,22358,2023-09-13,2023-09-22,445.99,-7,-98.0000000000036,40008818,10432511,0.0558826806630478,99.3578865539092,-0.00438321853475282
360.94,361,3600,3600,21600,21600,2023-09-13,2023-09-29,445.99,0,0,181598301,29583870,0.0118943844083651,99.6253736977418,0
387.98,388,10775,10769,32325,21538,2023-09-13,2023-09-15,445.99,-6,-10787,204169288,52571163,0.010549089048104,99.6149553110064,-0.500835732194261
367.93,368,3021,3018,18126,21126,2023-09-13,2023-09-29,445.99,-3,3000,181598301,29583870,0.0116333687505149,99.6370070664923,0.142005112184039
403.82,404,1167,1163,23340,20934,2023-09-13,2023-09-29,445.99,-4,-2406,181598301,29583870,0.0115276408891072,99.6485347073814,-0.114932645457151
279.97,280,6964,6944,20892,20832,2023-09-13,2023-10-20,445.99,-20,-60,497615928,97292139,0.00418636117290844,99.9637248347886,-0.00288018433179724
269.93,270,2959,2963,26631,20741,2023-09-13,2023-11-17,445.99,4,-5890,390070868,38675143,0.00531723891772405,99.9590958943389,-0.283978593124729
446.31,498,4,4,20676,20676,2023-09-13,2023-09-15,445.99,0,0,204169288,52571163,0.0101268903871575,99.6250822013936,0
447.16,473,8,8,20672,20672,2023-09-13,2023-12-15,445.99,0,0,481634514,35662575,0.0042920512129245,99.953943084735,0
204.95,205,4081,4081,20405,20405,2023-09-13,2023-12-15,445.99,0,0,481634514,35662575,0.00423661498644177,99.9581796997214,0
309.99,310,20112,20112,20112,20112,2023-09-13,2023-09-15,445.99,0,0,204169288,52571163,0.00985064903591181,99.6349328504295,0
345.94,346,3299,3299,19794,19794,2023-09-13,2023-09-29,445.99,0,0,181598301,29583870,0.0108998817119991,99.6594345890934,0
393.97,394,6615,6595,19845,19785,2023-09-13,2023-09-15,445.99,-20,-60,204169288,52571163,0.00969048782694486,99.6446233382564,-0.00303260045489007
394.63,395,443,528,15062,19536,2023-09-13,2023-10-13,445.99,85,4474,22195764,5051124,0.0880167945559342,99.2661347453505,0.229013104013104
392.87,393,1488,1488,19344,19344,2023-09-13,2023-09-29,445.99,0,0,181598301,29583870,0.0106520820368248,99.6700866711303,0
149.99,150,19254,19254,19254,19254,2023-09-13,2023-09-15,445.99,0,0,204169288,52571163,0.00943040953348478,99.6540537477899,0
385.89,386,1738,1736,19118,19096,2023-09-13,2023-09-29,445.99,-2,-22,181598301,29583870,0.0105155168825065,99.6806021880128,-0.00115207373271889
385.98,386,9537,9537,19074,19074,2023-09-13,2023-09-15,445.99,0,0,204169288,52571163,0.00934224740010848,99.66339599519,0
394.34,395,276,286,17112,18876,2023-09-13,2023-10-27,445.99,10,1764,12636806,8295984,0.149373188129975,99.4342320361648,0.0934520025429118
444.6,459,13,13,20072,18720,2023-09-13,2023-09-22,445.99,0,-1352,40008818,10432511,0.0467896852138946,99.4046762391231,-0.0722222222222222
349.98,350,9249,9276,18498,18552,2023-09-13,2023-09-22,445.99,27,54,40008818,10432511,0.0463697777824879,99.4510460169056,0.00291073738680466
354.99,355,18524,18524,18524,18524,2023-09-13,2023-09-15,445.99,0,0,204169288,52571163,0.0090728631036809,99.6724688582937,0
443.47,455,11,16,11264,18448,2023-09-13,2023-10-27,445.99,5,7184,12636806,8295984,0.145986256337242,99.5802182925021,0.389418907198612
249.99,250,18308,18308,18308,18308,2023-09-13,2023-09-15,445.99,0,0,204169288,52571163,0.00896706854362934,99.6814359268373,0
380.92,381,2259,2283,20331,18264,2023-09-13,2023-09-29,445.99,24,-2067,181598301,29583870,0.0100573628164065,99.6906595508292,-0.113173455978975
416.82,417,1085,991,17360,17838,2023-09-13,2023-09-22,445.99,-94,478,40008818,10432511,0.0445851711990092,99.4956311881046,0.0267967260903689
370.87,371,1358,1358,17654,17654,2023-09-13,2023-09-29,445.99,0,0,181598301,29583870,0.00972145659005918,99.7003810074192,0
442.75,478,5,5,17625,17625,2023-09-13,2023-10-20,445.99,0,0,497615928,97292139,0.00354188823312746,99.9672667230218,0
339.97,340,5704,5829,22816,17487,2023-09-13,2023-09-29,445.99,125,-5329,181598301,29583870,0.00962949537727228,99.7100105027965,-0.304740664493624
446.59,461,12,12,17292,17292,2023-09-13,2023-10-13,445.99,0,0,22195764,5051124,0.0779067573434282,99.3440415026939,0
390.98,391,8599,8610,17198,17220,2023-09-13,2023-09-15,445.99,11,22,204169288,52571163,0.00843417742633261,99.6898701042637,0.00127758420441347
373.93,374,2446,2458,19568,17206,2023-09-13,2023-09-29,445.99,12,-2362,181598301,29583870,0.00947475824677457,99.7194852610433,-0.137277693827735
444.11,530,2,2,17178,17178,2023-09-13,2023-09-29,445.99,0,0,181598301,29583870,0.00945933960031928,99.7289446006436,0
384.74,385,249,658,6225,17108,2023-09-13,2023-10-13,445.99,409,10883,22195764,5051124,0.0770777703349162,99.4211192730289,0.63613514145429
344.99,345,17090,17090,187990,17090,2023-09-13,2023-09-15,445.99,0,-170900,204169288,52571163,0.00837050477444972,99.6982406090381,-10
438.87,495,3,3,16839,16839,2023-09-13,2023-11-17,445.99,0,0,390070868,38675143,0.00431690787018732,99.9634128022091,0
451.36,485,5,5,16820,16820,2023-09-13,2023-12-15,445.99,0,0,481634514,35662575,0.00349227464209511,99.9616719743636,0
384.52,385,325,350,14625,16800,2023-09-13,2023-10-27,445.99,25,2175,12636806,8295984,0.132944986256812,99.7131632787589,0.129464285714286
393.93,394,394,2392,2364,16744,2023-09-13,2023-09-22,445.99,1998,14380,40008818,10432511,0.0418507739968724,99.5374819621015,0.858815097945533
364.99,365,16641,16641,16641,16641,2023-09-13,2023-09-15,445.99,0,0,204169288,52571163,0.00815058923063884,99.7063911982688,0
444.82,500,3,3,16554,16554,2023-09-13,2023-10-13,445.99,0,0,22195764,5051124,0.0745817985810265,99.4957010716099,0
396.98,397,8182,8182,24546,16364,2023-09-13,2023-09-15,445.99,0,-8182,204169288,52571163,0.00801491750316531,99.7144061157719,-0.5
209.97,210,5399,5412,16197,16236,2023-09-13,2023-11-17,445.99,13,38.9999999999982,390070868,38675143,0.00416232057606517,99.9675751227851,0.0024020694752401
449.1,530,2,2,16180,16180,2023-09-13,2023-09-15,445.99,0,0,204169288,52571163,0.00792479621126954,99.7223309119832,0
382.98,383,8086,8086,16172,16172,2023-09-13,2023-09-15,445.99,0,0,204169288,52571163,0.0079208778942306,99.7302517898774,0
388.98,389,7818,8033,23454,16066,2023-09-13,2023-09-15,445.99,215,-7388,204169288,52571163,0.00786896019346455,99.7381207500709,-0.459853105938006
329.98,330,7962,7962,15924,15924,2023-09-13,2023-09-29,445.99,0,0,181598301,29583870,0.0087688045055003,99.7377134051491,0
415.83,416,960,930,15360,15810,2023-09-13,2023-09-22,445.99,-30,450.000000000002,40008818,10432511,0.0395162886341706,99.5769982507356,0.0284629981024669
214.93,215,2232,2232,15624,15624,2023-09-13,2023-12-15,445.99,0,0,481634514,35662575,0.00324395356766313,99.9649159279312,0
397.97,398,5164,5164,15492,15492,2023-09-13,2023-09-15,445.99,0,0,204169288,52571163,0.00758782094592013,99.7457085710168,0
304.99,305,15267,15267,15267,15267,2023-09-13,2023-09-15,445.99,0,0,204169288,52571163,0.00747761827919976,99.753186189296,0
372.98,373,7552,7552,15104,15104,2023-09-13,2023-09-15,445.99,0,0,204169288,52571163,0.00739778256953122,99.7605839718656,0
449.27,468,8,8,14984,14984,2023-09-13,2023-09-29,445.99,0,0,181598301,29583870,0.00825117851735849,99.7459645836665,0
440.16,590,1,1,14984,14984,2023-09-13,2023-12-15,445.99,0,0,481634514,35662575,0.00311107272515773,99.9680270006564,0
194.95,195,2996,2996,14980,14980,2023-09-13,2023-12-15,445.99,0,0,481634514,35662575,0.00311024221989207,99.9711372428763,0
444.42,461,9,9,12924,14922,2023-09-13,2023-10-06,445.99,0,1998,35655626,8296590,0.0418503380083693,99.7766074840476,0.133896260554885
269.97,270,4963,4965,14889,14895,2023-09-13,2023-10-20,445.99,2,6,497615928,97292139,0.00299327235361325,99.9702599953754,0.00040281973816717
403.5,404,49,297,2450,14850,2023-09-13,2023-10-13,445.99,248,12400,22195764,5051124,0.0669046580239365,99.5626057296338,0.835016835016835
379.85,380,959,988,14385,14820,2023-09-13,2023-10-06,445.99,29,434.999999999998,35655626,8296590,0.0415642681466313,99.8181717521942,0.0293522267206477
199.99,200,14758,14758,14758,14758,2023-09-13,2023-09-15,445.99,0,0,204169288,52571163,0.00722831535759678,99.7678122872231,0
452.7,600,1,1,14730,14730,2023-09-13,2023-12-15,445.99,0,0,481634514,35662575,0.0030583356407884,99.9741955785171,0
403.98,404,7300,7306,29200,14612,2023-09-13,2023-09-15,445.99,6,-14588,204169288,52571163,0.007156806071636,99.7749690932948,-0.998357514371749
361.98,362,7137,7137,14274,14274,2023-09-13,2023-09-15,445.99,0,0,204169288,52571163,0.00699125717674051,99.7819603504715,0
356.92,357,1779,1779,14232,14232,2023-09-13,2023-09-29,445.99,0,0,181598301,29583870,0.00783707772684503,99.7538016613933,0
358.9,359,1411,1411,14110,14110,2023-09-13,2023-09-29,445.99,0,0,181598301,29583870,0.00776989648157556,99.7615715578749,0
450,520,2,2,14000,14000,2023-09-13,2023-12-15,445.99,0,0,481634514,35662575,0.00290676842980568,99.9771023469468,0
358.97,359,4573,4573,13719,13719,2023-09-13,2023-09-15,445.99,0,0,204169288,52571163,0.00671942393216359,99.7886797744037,0
154.98,155,6769,6769,13538,13538,2023-09-13,2023-12-15,445.99,0,0,481634514,35662575,0.00281084507162209,99.9799131920185,0
398.97,399,4477,4462,13431,13386,2023-09-13,2023-09-15,445.99,-15,-45.0000000000018,204169288,52571163,0.00655632398541743,99.7952360983891,-0.00336172120125518
383.9,384,1318,1318,13180,13180,2023-09-13,2023-09-29,445.99,0,0,181598301,29583870,0.00725777715288206,99.7688293350278,0
340.97,341,4373,4373,13119,13119,2023-09-13,2023-09-29,445.99,0,0,181598301,29583870,0.00722418653024733,99.776053521558,0
344.96,345,3263,3263,13052,13052,2023-09-13,2023-09-29,445.99,0,0,181598301,29583870,0.0071872919119436,99.78324081347,0
324.99,325,12986,12963,12986,12963,2023-09-13,2023-09-15,445.99,-23,-23.0000000000018,204169288,52571163,0.00634914297198313,99.8015852413611,-0.00177428064491258
214.97,215,4303,4303,12909,12909,2023-09-13,2023-11-17,445.99,0,0,390070868,38675143,0.00330939863983895,99.970884521425,0
383.98,384,6392,6392,12784,12784,2023-09-13,2023-09-15,445.99,0,0,204169288,52571163,0.0062614706282367,99.8078467119893,0
249.95,250,2485,2485,14910,12425,2023-09-13,2023-11-17,445.99,0,-2485,390070868,38675143,0.00318531862266628,99.9740698400476,-0.2
372.93,373,1760,1760,12320,12320,2023-09-13,2023-09-29,445.99,0,0,181598301,29583870,0.00678420444032679,99.7900250179103,0
443.54,464,6,6,12276,12276,2023-09-13,2023-09-22,445.99,0,0,40008818,10432511,0.0306832358806501,99.6076814866163,0
234.99,235,12179,12178,24358,12178,2023-09-13,2023-10-20,445.99,-1,-12180,497615928,97292139,0.00244726893066815,99.9727072643061,-1.00016423057973
334.99,335,12099,12114,12099,12114,2023-09-13,2023-09-15,445.99,15,15,204169288,52571163,0.00593331157622492,99.8137800235656,0.00123823675086677
444.5,484,3,3,11850,11850,2023-09-13,2023-10-20,445.99,0,0,497615928,97292139,0.0023813546418474,99.9750886189479,0
451.5,570,1,1,11850,11850,2023-09-13,2023-12-15,445.99,0,0,481634514,35662575,0.00246037184951409,99.982373563868,0
443.4,467,5,5,11800,11800,2023-09-13,2023-09-29,445.99,0,0,181598301,29583870,0.00649785814901429,99.7965228760593,0
390.89,391,1065,1065,22365,11715,2023-09-13,2023-09-29,445.99,0,-10650,181598301,29583870,0.00645105154370359,99.802973927603,-0.909090909090909
446.16,459,9,9,11556,11556,2023-09-13,2023-10-13,445.99,0,0,22195764,5051124,0.0520639884258997,99.6146697180597,0
447.21,504,2,2,11358,11358,2023-09-13,2023-09-29,445.99,0,0,181598301,29583870,0.00625446380139867,99.8092283914044,0
445.7,502,2,2,11260,11260,2023-09-13,2023-09-15,445.99,0,0,204169288,52571163,0.00551503123231737,99.8192950547979,0
411.86,412,803,802,10439,11228,2023-09-13,2023-09-22,445.99,-1,789.000000000002,40008818,10432511,0.0280638133323509,99.6357452999486,0.0702707516921982
264.92,265,1399,1399,11192,11192,2023-09-13,2023-11-17,445.99,0,0,390070868,38675143,0.00286922221528217,99.9769390622629,0
407.89,408,998,998,9980,10978,2023-09-13,2023-09-22,445.99,0,997.999999999998,40008818,10432511,0.0274389510832337,99.6631842510319,0.0909090909090907
284.97,285,3629,3629,10887,10887,2023-09-13,2023-10-20,445.99,0,0,497615928,97292139,0.00218783189753524,99.9772764508455,0
369.89,370,941,987,10351,10857,2023-09-13,2023-10-06,445.99,46,506,35655626,8296590,0.0304496126361658,99.8486213648303,0.0466058763931104
349.81,350,554,569,10526,10811,2023-09-13,2023-10-27,445.99,15,285,12636806,8295984,0.0855516813346664,99.7987149600936,0.0263620386643234
169.98,170,5405,5405,16215,10810,2023-09-13,2023-12-15,445.99,0,-5405,481634514,35662575,0.00224444048044281,99.9846180043484,-0.5
446.12,500,2,2,10776,10776,2023-09-13,2023-09-22,445.99,0,0,40008818,10432511,0.026934062385947,99.6901183134178,0
159.98,160,5342,5342,10684,10684,2023-09-13,2023-12-15,445.99,0,0,481634514,35662575,0.00221827956457456,99.986836283913,0
395.98,396,5337,5334,16011,10668,2023-09-13,2023-09-15,445.99,-3,-5343,204169288,52571163,0.00522507577143532,99.8245201305693,-0.500843644544432
219.97,220,3556,3556,7112,10668,2023-09-13,2023-11-17,445.99,0,3556,390070868,38675143,0.00273488765123572,99.9796739499141,0.333333333333333
449.22,555,1,1,10578,10578,2023-09-13,2023-09-15,445.99,0,0,204169288,52571163,0.00518099470474717,99.829701125274,0
406.9,407,1051,1051,10510,10510,2023-09-13,2023-09-22,445.99,0,0,40008818,10432511,0.0262692089528863,99.7163875223707,0
334.95,335,2095,2095,10475,10475,2023-09-13,2023-09-29,445.99,0,0,181598301,29583870,0.00576822577211226,99.8149966171765,0
450.31,555,1,1,10469,10469,2023-09-13,2023-12-15,445.99,0,0,481634514,35662575,0.0021736399065454,99.9890099238196,0
435.56,540,1,1,10444,10444,2023-09-13,2023-12-15,445.99,0,0,481634514,35662575,0.00216844924863503,99.9911783730682,0
375.98,376,5166,5166,10332,10332,2023-09-13,2023-09-15,445.99,0,0,204169288,52571163,0.00506050645579956,99.8347616317299,0
445.7,480,2,3,6540,10290,2023-09-13,2023-09-29,445.99,1,3750,181598301,29583870,0.00566635257231839,99.8206629697488,0.364431486880466
294.98,295,5136,5136,10272,10272,2023-09-13,2023-09-29,445.99,0,0,181598301,29583870,0.00565644058531142,99.8263194103341,0
274.97,275,3427,3410,10281,10230,2023-09-13,2023-10-20,445.99,-17,-51,497615928,97292139,0.00205580236169611,99.9793322532071,-0.00498533724340176
377.92,378,1278,1278,10224,10224,2023-09-13,2023-09-29,445.99,0,0,181598301,29583870,0.0056300086199595,99.8319494189541,0
357.92,358,1277,1277,10216,10216,2023-09-13,2023-09-29,445.99,0,0,181598301,29583870,0.00562560329240085,99.8375750222465,0
348.99,349,10173,10173,10173,10173,2023-09-13,2023-09-15,445.99,0,0,204169288,52571163,0.0049826299046505,99.8397442616345,0
229.96,230,2537,2537,10148,10148,2023-09-13,2023-11-17,445.99,0,0,390070868,38675143,0.00260157854187665,99.982275528456,0
368.94,369,1680,1681,13440,10086,2023-09-13,2023-09-29,445.99,1,-3354,181598301,29583870,0.00555401671957272,99.8431290389661,-0.332540154669839
449.99,550,1,1,10001,10001,2023-09-13,2023-09-29,445.99,0,0,181598301,29583870,0.00550721011426203,99.8486362490803,0
365.94,366,1652,1651,9912,9906,2023-09-13,2023-09-29,445.99,-1,-5.99999999999818,181598301,29583870,0.00545489684950301,99.8540911459298,-0.000605693519079162
324.98,325,4642,4843,9284,9686,2023-09-13,2023-09-29,445.99,201,402,181598301,29583870,0.00533375034164004,99.8594248962715,0.0415032004955606
299.98,300,4825,4825,9650,9650,2023-09-13,2023-09-29,445.99,0,0,181598301,29583870,0.00531392636762609,99.8647388226391,0
445.09,469,4,4,9564,9564,2023-09-13,2023-09-15,445.99,0,0,204169288,52571163,0.00468434802006069,99.8444286096546,0
400.85,401,631,635,11358,9525,2023-09-13,2023-09-29,445.99,4,-1833,181598301,29583870,0.00524509312452213,99.8699839157636,-0.19244094488189
444.92,492,2,2,9416,9416,2023-09-13,2023-12-15,445.99,0,0,481634514,35662575,0.00195500939536073,99.9931333824635,0
319.98,320,4596,4596,9192,9192,2023-09-13,2023-09-29,445.99,0,0,181598301,29583870,0.00506172136489317,99.8750456371285,0
254.98,255,4487,4487,8974,8974,2023-09-13,2023-10-20,445.99,0,0,497615928,97292139,0.00180339886548005,99.9811356520726,0
449.16,494,2,2,8968,8968,2023-09-13,2023-09-15,445.99,0,0,204169288,52571163,0.00439243340065916,99.8488210430552,0
355.95,356,1649,1787,8245,8935,2023-09-13,2023-09-29,445.99,138,690,181598301,29583870,0.00492020021707142,99.8799658373456,0.0772243984331282
446.34,491,0,2,0,8932,2023-09-13,2023-09-22,445.99,2,8932,40008818,10432511,0.0223250784364587,99.7387126008072,1
149.99,150,8915,8915,8915,8915,2023-09-13,2023-10-20,445.99,0,0,497615928,97292139,0.00179154233182021,99.9829271944044,0
451.4,540,1,1,8860,8860,2023-09-13,2023-09-29,445.99,0,0,181598301,29583870,0.00487890027120904,99.8848447376168,0
289.99,290,8827,8827,8827,8827,2023-09-13,2023-09-15,445.99,0,0,204169288,52571163,0.00432337306284773,99.8531444161181,0
350.91,351,973,973,8757,8757,2023-09-13,2023-09-29,445.99,0,0,181598301,29583870,0.00482218167889137,99.8896669192957,0
244.99,245,8734,8734,8734,8734,2023-09-13,2023-09-15,445.99,0,0,204169288,52571163,0.00427782262726997,99.8574222387453,0
234.96,235,2137,2137,8548,8548,2023-09-13,2023-11-17,445.99,0,0,390070868,38675143,0.00219139666692566,99.984466925123,0
174.98,175,4274,4269,12822,8538,2023-09-13,2023-12-15,445.99,-5,-4284,481634514,35662575,0.00177271348954863,99.9949060959531,-0.501756851721715
354.88,355,608,710,6688,8520,2023-09-13,2023-10-13,445.99,102,1832,22195764,5051124,0.0383857027854504,99.6530554208452,0.215023474178404
411.24,412,33,110,2277,8360,2023-09-13,2023-10-13,445.99,77,6083,22195764,5051124,0.037664844517179,99.6907202653624,0.727631578947368
269.99,270,8347,8347,8347,8347,2023-09-13,2023-09-15,445.99,0,0,204169288,52571163,0.00408827404051093,99.8615105127858,0
352.94,353,1388,1388,8328,8328,2023-09-13,2023-09-29,445.99,0,0,181598301,29583870,0.00458594598855856,99.8942528652842,0
441.79,525,1,1,8321,8321,2023-09-13,2023-09-29,445.99,0,0,181598301,29583870,0.00458209132694474,99.8988349566112,0
444.6,465,2,4,4402,8160,2023-09-13,2023-10-06,445.99,2,3758,35655626,8296590,0.0228855889390359,99.8715069537694,0.460539215686274
448.8,530,1,1,8120,8120,2023-09-13,2023-11-17,445.99,0,0,390070868,38675143,0.00208167301537627,99.9865485981383,0
342.97,343,2699,2699,8097,8097,2023-09-13,2023-09-29,445.99,0,0,181598301,29583870,0.00445874215530243,99.9032936987665,0
444.6,525,1,1,7466,8040,2023-09-13,2023-10-20,445.99,0,574.000000000001,497615928,97292139,0.00161570390889899,99.9845428983133,0.0713930348258708
350.99,351,7969,7969,7969,7969,2023-09-13,2023-09-15,445.99,0,0,204169288,52571163,0.0039031335604207,99.8654136463463,0
377.98,378,3951,3951,7902,7902,2023-09-13,2023-09-15,445.99,0,0,204169288,52571163,0.00387031765521953,99.8692839640015,0
445.67,485,1,2,3938,7866,2023-09-13,2023-09-15,445.99,1,3928,204169288,52571163,0.00385268522854427,99.87313664923,0.499364352911264
169.98,170,3883,3883,7766,7766,2023-09-13,2023-10-20,445.99,0,0,497615928,97292139,0.00156064136274995,99.9861035396761,0
389.95,390,1531,1547,9186,7735,2023-09-13,2023-09-22,445.99,16,-1451,40008818,10432511,0.0193332379876856,99.7580458387948,-0.187588881706529
448.71,474,3,3,7587,7587,2023-09-13,2023-09-29,445.99,0,0,181598301,29583870,0.00417790252343826,99.9074716012899,0
444.71,520,0,1,0,7529,2023-09-13,2023-10-13,445.99,1,7529,22195764,5051124,0.0339208868863446,99.7246411522487,1
224.96,225,1861,1861,7444,7444,2023-09-13,2023-11-17,445.99,0,0,390070868,38675143,0.00190837117320948,99.9884569693115,0
386.98,387,3651,3648,7302,7296,2023-09-13,2023-09-15,445.99,-3,-5.99999999999909,204169288,52571163,0.00357350513951932,99.8767101543696,-0.000822368421052507
443.32,515,1,1,7168,7168,2023-09-13,2023-12-15,445.99,0,0,481634514,35662575,0.00148826543606051,99.9963943613892,0
294.99,295,7133,7133,7133,7133,2023-09-13,2023-09-15,445.99,0,0,204169288,52571163,0.00349366942985078,99.8802038237994,0
444.16,515,1,1,7084,7084,2023-09-13,2023-11-17,445.99,0,0,390070868,38675143,0.00181608025134551,99.9902730495629,0
444.62,515,1,1,7038,7038,2023-09-13,2023-10-20,445.99,0,0,497615928,97292139,0.00141434379487949,99.987517883471,0
214.99,215,7014,7014,7014,7014,2023-09-13,2023-09-15,445.99,0,0,204169288,52571163,0.00343538446389645,99.8836392082633,0
328.95,329,1366,1366,6830,6830,2023-09-13,2023-09-29,445.99,0,0,181598301,29583870,0.00376104840320064,99.9112326496931,0
404.92,405,1118,847,10062,6776,2023-09-13,2023-09-22,445.99,-271,-3286,40008818,10432511,0.0169362664000721,99.7749821051949,-0.484946871310507
444.52,478,2,2,6696,6696,2023-09-13,2023-11-17,445.99,0,0,390070868,38675143,0.00171661114666989,99.9919896607096,0
408.9,409,662,662,6620,6620,2023-09-13,2023-09-22,445.99,0,0,40008818,10432511,0.016546352356623,99.7915284575515,0
371.99,372,6544,6608,13088,6608,2023-09-13,2023-09-15,445.99,64,-6480,204169288,52571163,0.00323652987416991,99.8868757381375,-0.980629539951574
335.96,336,1650,1650,6600,6600,2023-09-13,2023-09-29,445.99,0,0,181598301,29583870,0.00363439523588935,99.914867044929,0
397.82,398,359,359,6462,6462,2023-09-13,2023-09-22,445.99,0,0,40008818,10432511,0.0161514394151809,99.8076798969667,0
447.1,510,1,1,6290,6290,2023-09-13,2023-09-29,445.99,0,0,181598301,29583870,0.00346368879299152,99.918330733722,0
239.98,240,3067,3067,6134,6134,2023-09-13,2023-10-20,445.99,0,0,497615928,97292139,0.00123267758422717,99.9887505610552,0
345.99,346,6105,6105,6105,6105,2023-09-13,2023-09-15,445.99,0,0,204169288,52571163,0.00299016569034614,99.8898659038278,0
449.9,510,1,1,6010,6010,2023-09-13,2023-11-17,445.99,0,0,390070868,38675143,0.00154074566778466,99.9935304063773,0
327.96,328,1487,1487,5948,5948,2023-09-13,2023-09-29,445.99,0,0,181598301,29583870,0.00327536103985907,99.9216060947619,0
445.69,505,1,1,5931,5931,2023-09-13,2023-09-15,445.99,0,0,204169288,52571163,0.00290494229474905,99.8927708461226,0
169.99,170,5919,5919,5919,5919,2023-09-13,2023-09-15,445.99,0,0,204169288,52571163,0.00289906481919063,99.8956699109418,0
371.94,372,982,982,5892,5892,2023-09-13,2023-09-29,445.99,0,0,181598301,29583870,0.00324452374694849,99.9248506185088,0
436.22,495,1,1,5878,5878,2023-09-13,2023-10-20,445.99,0,0,497615928,97292139,0.00118123228563536,99.9899317933408,0
259.99,260,5852,5852,5852,5852,2023-09-13,2023-09-15,445.99,0,0,204169288,52571163,0.00286624891398945,99.8985361598557,0
259.99,260,5824,5824,17472,5824,2023-09-13,2023-10-20,445.99,0,-11648,497615928,97292139,0.00117038054296365,99.9911021738838,-2
449.61,469,3,3,5817,5817,2023-09-13,2023-10-13,445.99,0,0,22195764,5051124,0.026207703415841,99.7508488556645,0
447.09,505,1,1,5791,5791,2023-09-13,2023-09-29,445.99,0,0,181598301,29583870,0.00318890648652049,99.9280395249954,0
174.99,175,5624,5624,5624,5624,2023-09-13,2023-09-15,445.99,0,0,204169288,52571163,0.00275457687837948,99.9012907367341,0
351.99,352,5610,5610,5610,5610,2023-09-13,2023-09-15,445.99,0,0,204169288,52571163,0.00274771982356132,99.9040384565577,0
199.99,200,5599,5599,5599,5599,2023-09-13,2023-10-20,445.99,0,0,497615928,97292139,0.00112516494849819,99.9922273388323,0
259.93,260,792,792,5544,5544,2023-09-13,2023-11-17,445.99,0,0,390070868,38675143,0.00142128019670518,99.994951686574,0
447.08,502,1,1,5492,5492,2023-09-13,2023-09-29,445.99,0,0,181598301,29583870,0.0030242573690158,99.9310637823644,0
346.99,347,5483,5483,5483,5483,2023-09-13,2023-09-15,445.99,0,0,204169288,52571163,0.00268551654056804,99.9067239730983,0
373.98,374,2737,2737,5474,5474,2023-09-13,2023-09-15,445.99,0,0,204169288,52571163,0.00268110843389923,99.9094050815322,0
446.77,465,3,3,5469,5469,2023-09-13,2023-10-13,445.99,0,0,22195764,5051124,0.0246398366823507,99.7754886923469,0
435.68,490,1,1,5432,5432,2023-09-13,2023-10-20,445.99,0,0,497615928,97292139,0.00109160492949494,99.9933189437618,0
446.88,474,2,2,5424,5424,2023-09-13,2023-09-15,445.99,0,0,204169288,52571163,0.00265661895240581,99.9120617004846,0
444.49,458,0,4,0,5404,2023-09-13,2023-10-27,445.99,4,5404,12636806,8295984,0.0427639705792745,99.8414789306728,1
378.98,379,2701,2701,5402,5402,2023-09-13,2023-09-15,445.99,0,0,204169288,52571163,0.00264584358054871,99.9147075440651,0
445.09,463,3,3,5373,5373,2023-09-13,2023-09-15,445.99,0,0,204169288,52571163,0.00263163968128252,99.9173391837464,0
336.96,337,1339,1339,5356,5356,2023-09-13,2023-09-29,445.99,0,0,181598301,29583870,0.00294936680051869,99.9340131491649,0
353.99,354,5342,5342,5342,5342,2023-09-13,2023-09-15,445.99,0,0,204169288,52571163,0.00261645620275661,99.9199556399491,0
445.61,499,1,1,5339,5339,2023-09-13,2023-09-15,445.99,0,0,204169288,52571163,0.002614986833867,99.922570626783,0
380.95,381,1058,1058,5290,5290,2023-09-13,2023-09-22,445.99,0,0,40008818,10432511,0.0132220851913196,99.820901982158,0
398.85,399,349,352,5584,5280,2023-09-13,2023-09-29,445.99,3,-304,181598301,29583870,0.00290751618871148,99.9369206653536,-0.0575757575757576
254.94,255,880,880,5280,5280,2023-09-13,2023-11-17,445.99,0,0,390070868,38675143,0.00135360018733827,99.9963052867614,0
370.99,371,5211,5209,5211,5209,2023-09-13,2023-09-15,445.99,-2,-2,204169288,52571163,0.00255131418198412,99.925121940965,-0.000383950854290651
337.96,338,1302,1302,5208,5208,2023-09-13,2023-09-29,445.99,0,0,181598301,29583870,0.0028678682406836,99.9397885335943,0
380.99,381,5151,5151,10302,5151,2023-09-13,2023-09-15,445.99,0,-5151,204169288,52571163,0.00252290638345176,99.9276448473485,-1
289.99,290,5115,5115,5115,5115,2023-09-13,2023-09-29,445.99,0,0,181598301,29583870,0.00281665630781425,99.9426051899021,0
254.99,255,5107,5107,5107,5107,2023-09-13,2023-09-15,445.99,0,0,204169288,52571163,0.00250135563973755,99.9301462029882,0
447.02,498,1,1,5098,5098,2023-09-13,2023-09-29,445.99,0,0,181598301,29583870,0.00280729498675211,99.9454124848888,0
442.6,468,2,2,5080,5080,2023-09-13,2023-09-22,445.99,0,0,40008818,10432511,0.0126972009020611,99.8335991830601,0
445.69,496,1,1,5031,5031,2023-09-13,2023-09-15,445.99,0,0,204169288,52571163,0.00246413162786756,99.9326103346161,0
354.92,355,613,618,4904,4944,2023-09-13,2023-10-06,445.99,5,40,35655626,8296590,0.0138659744748276,99.8853729282442,0.00809061488673139
229.98,230,2463,2463,4926,4926,2023-09-13,2023-10-20,445.99,0,0,497615928,97292139,0.00098992008149707,99.9943088638433,0
159.99,160,4863,4863,4863,4863,2023-09-13,2023-09-15,445.99,0,0,204169288,52571163,0.00238184697004968,99.9349921815861,0
437.37,486,1,1,4863,4863,2023-09-13,2023-09-29,445.99,0,0,181598301,29583870,0.00267788848971665,99.9480903733786,0
449.8,474,2,2,4840,4840,2023-09-13,2023-10-06,445.99,0,0,35655626,8296590,0.0135742954001144,99.8989472236443,0
229.99,230,4837,4837,4837,4837,2023-09-13,2023-09-15,445.99,0,0,204169288,52571163,0.0023691124396731,99.9373612940258,0
360.99,361,4829,4829,4829,4829,2023-09-13,2023-09-15,445.99,0,0,204169288,52571163,0.00236519412263415,99.9397264881484,0
264.99,265,4822,4822,4822,4822,2023-09-13,2023-09-15,445.99,0,0,204169288,52571163,0.00236176559522508,99.9420882537436,0
341.94,342,803,803,4818,4818,2023-09-13,2023-09-29,445.99,0,0,181598301,29583870,0.00265310852219923,99.9507434819007,0
362.99,363,4815,4815,4815,4815,2023-09-13,2023-09-15,445.99,0,0,204169288,52571163,0.002358337067816,99.9444465908115,0
445.98,470,2,2,5318,4804,2023-09-13,2023-10-06,445.99,0,-514,35655626,8296590,0.0134733295665598,99.9124205532109,-0.10699417152373
403.66,404,144,141,4752,4794,2023-09-13,2023-10-06,445.99,-3,42.0000000000009,35655626,8296590,0.0134452835016836,99.9258658367126,0.00876095118898642
437.31,485,1,1,4769,4769,2023-09-13,2023-11-17,445.99,0,0,390070868,38675143,0.00122259835102579,99.9975278851124,0
234.99,235,4731,4731,4731,4731,2023-09-13,2023-09-15,445.99,0,0,204169288,52571163,0.00231719473890706,99.9467637855504,0
324.88,325,324,393,3888,4716,2023-09-13,2023-10-27,445.99,69,828.000000000001,12636806,8295984,0.0373195568563765,99.8787984875292,0.17557251908397
159.99,160,4707,4707,4707,4707,2023-09-13,2023-10-20,445.99,0,0,497615928,97292139,0.000945910236217358,99.9952547740795,0
331.95,332,938,938,4690,4690,2023-09-13,2023-09-29,445.99,0,0,181598301,29583870,0.00258262328126077,99.953326105182,0
184.99,185,4646,4646,4646,4646,2023-09-13,2023-09-15,445.99,0,0,204169288,52571163,0.00227556262036825,99.9490393481707,0
367.99,368,4593,4634,9186,4634,2023-09-13,2023-09-15,445.99,41,-4552,204169288,52571163,0.00226968514480983,99.9513090333155,-0.982304704359085
443.93,490,1,1,4607,4607,2023-09-13,2023-10-13,445.99,0,0,22195764,5051124,0.0207562127620387,99.7962449051089,0
449.13,495,1,1,4587,4587,2023-09-13,2023-12-15,445.99,0,0,481634514,35662575,0.000952381913394188,99.9973467433026,0
338.96,339,1143,1143,4572,4572,2023-09-13,2023-09-29,445.99,0,0,181598301,29583870,0.00251764469977062,99.9558437498818,0
351.95,352,912,912,4560,4560,2023-09-13,2023-09-29,445.99,0,0,181598301,29583870,0.00251103670843264,99.9583547865902,0
325.98,326,2205,2267,8820,4534,2023-09-13,2023-09-29,445.99,62,-4286,181598301,29583870,0.00249671939386702,99.9608515059841,-0.945302161446846
444.75,490,1,1,4525,4525,2023-09-13,2023-10-06,445.99,0,0,35655626,8296590,0.0126908443565119,99.9385566810691,0
154.99,155,4485,4485,4485,4485,2023-09-13,2023-09-15,445.99,0,0,204169288,52571163,0.00219670648995945,99.9535057398055,0
443.89,488,1,1,4411,4411,2023-09-13,2023-10-13,445.99,0,0,22195764,5051124,0.0198731613834063,99.8161180664923,0
445.13,489,1,1,4387,4387,2023-09-13,2023-12-15,445.99,0,0,481634514,35662575,0.00091085665011125,99.9982575999527,0
443.03,457.5,3,3,4341,4341,2023-09-13,2023-10-13,445.99,0,0,22195764,5051124,0.0195577858910376,99.8356758523834,0
445.68,489,1,1,4332,4332,2023-09-13,2023-09-15,445.99,0,0,204169288,52571163,0.0021217686765896,99.9556275084821,0
443.7,487,1,1,4330,4330,2023-09-13,2023-12-15,445.99,0,0,481634514,35662575,0.000899021950075613,99.9991566219027,0
344.99,345,4321,4321,8642,4321,2023-09-13,2023-09-22,445.99,0,-4321,40008818,10432511,0.0108001191137414,99.8443993021738,-1
442.2,485,1,1,4280,4280,2023-09-13,2023-09-22,445.99,0,0,40008818,10432511,0.0106976417048862,99.8550969438787,0
164.99,165,4248,4248,4248,4248,2023-09-13,2023-09-15,445.99,0,0,204169288,52571163,0.00208062634768066,99.9577081348298,0
374.97,375,1492,1414,5968,4242,2023-09-13,2023-09-22,445.99,-78,-1726,40008818,10432511,0.0106026626430203,99.8656996065218,-0.406883545497407
445.71,488,1,1,4229,4229,2023-09-13,2023-09-15,445.99,0,0,204169288,52571163,0.00207132034471316,99.9597794551745,0
284.99,285,4184,4184,4184,4184,2023-09-13,2023-09-15,445.99,0,0,204169288,52571163,0.00204927981136908,99.9618287349858,0
445.7,487,1,1,4130,4130,2023-09-13,2023-09-15,445.99,0,0,204169288,52571163,0.00202283117135619,99.9638515661572,0
304.98,305,2049,2049,4098,4098,2023-09-13,2023-09-29,445.99,0,0,181598301,29583870,0.00225662904192039,99.963108135026,0
440.38,481,1,1,4062,4062,2023-09-13,2023-12-15,445.99,0,0,481634514,35662575,0.000843378097276476,100,0
447,467,2,2,4000,4000,2023-09-13,2023-10-13,445.99,0,0,22195764,5051124,0.0180214567067842,99.8536973090902,0
239.96,240,1009,999,5045,3996,2023-09-13,2023-11-17,445.99,-10,-1049,390070868,38675143,0.0010244292326901,99.9985523143451,-0.262512512512513
346.95,347,795,795,3975,3975,2023-09-13,2023-09-29,445.99,0,0,181598301,29583870,0.00218889713070609,99.9652970321567,0
189.99,190,3963,3963,3963,3963,2023-09-13,2023-09-15,445.99,0,0,204169288,52571163,0.00194103630316818,99.9657926024604,0
396.93,397,558,566,3906,3962,2023-09-13,2023-09-22,445.99,8,56.0000000000005,40008818,10432511,0.0099028169240091,99.8756024234457,0.0141342756183747
219.99,220,3932,3932,3932,3932,2023-09-13,2023-09-15,445.99,0,0,204169288,52571163,0.00192585282464226,99.967718455285,0
347.95,348,783,783,3915,3915,2023-09-13,2023-09-29,445.99,0,0,181598301,29583870,0.00215585717401618,99.9674528893307,0
413.09,414,40,43,2920,3913,2023-09-13,2023-10-13,445.99,3,993.000000000001,22195764,5051124,0.0176294900234117,99.8713267991136,0.253769486327626
410.87,411,300,300,4800,3900,2023-09-13,2023-09-22,445.99,0,-900,40008818,10432511,0.00974785108622804,99.885350274532,-0.230769230769231
284.99,285,3873,3873,3873,3873,2023-09-13,2023-09-29,445.99,0,0,181598301,29583870,0.00213272920433325,99.9695856185351,0
309.98,310,1952,1936,3904,3872,2023-09-13,2023-09-29,445.99,-16,-32,181598301,29583870,0.00213217853838842,99.9717177970734,-0.00826446280991736
445.8,484,1,1,3820,3820,2023-09-13,2023-09-15,445.99,0,0,204169288,52571163,0.00187099638609701,99.9695894516711,0
447.13,485,1,1,3787,3787,2023-09-13,2023-09-29,445.99,0,0,181598301,29583870,0.00208537193307772,99.9738031690065,0
179.99,180,3733,3733,3733,3733,2023-09-13,2023-09-15,445.99,0,0,204169288,52571163,0.00182838468829847,99.9714178363594,0
365.99,366,3726,3726,3726,3726,2023-09-13,2023-09-15,445.99,0,0,204169288,52571163,0.00182495616088939,99.9732427925203,0
189.99,190,3624,3624,3624,3624,2023-09-13,2023-10-20,445.99,0,0,497615928,97292139,0.000728272508190293,99.9959830465877,0
314.99,315,3369,3569,3369,3569,2023-09-13,2023-09-29,445.99,200,200,181598301,29583870,0.00196532675710441,99.9757684957636,0.0560381059120202
356.99,357,3565,3565,3565,3565,2023-09-13,2023-09-15,445.99,0,0,204169288,52571163,0.00174610003048059,99.9749888925508,0
330.96,331,880,880,3520,3520,2023-09-13,2023-09-29,445.99,0,0,181598301,29583870,0.00193834412580765,99.9777068398894,0
447.53,465,2,2,3494,3494,2023-09-13,2023-09-22,445.99,0,0,40008818,10432511,0.00873307479366174,99.8940833493256,0
279.99,280,3467,3467,3467,3467,2023-09-13,2023-09-15,445.99,0,0,204169288,52571163,0.00169810064675349,99.9766869931975,0
445.8,480,1,1,3420,3420,2023-09-13,2023-09-22,445.99,0,0,40008818,10432511,0.00854811556792305,99.9026314648936,0
353.96,354,855,855,4275,3420,2023-09-13,2023-09-29,445.99,0,-855,181598301,29583870,0.00188327753132448,99.9795901174208,-0.25
449.8,484,1,1,3420,3420,2023-09-13,2023-09-29,445.99,0,0,181598301,29583870,0.00188327753132448,99.9814733949521,0
209.99,210,3415,3415,3415,3415,2023-09-13,2023-09-15,445.99,0,0,204169288,52571163,0.00167263158600034,99.9783596247836,0
363.99,364,3411,3411,3411,3411,2023-09-13,2023-09-15,445.99,0,0,204169288,52571163,0.00167067242748087,99.980030297211,0
442.14,476,1,1,3386,3386,2023-09-13,2023-09-22,445.99,0,0,40008818,10432511,0.00846313430204311,99.9110945991956,0
204.99,205,3384,3384,3384,3384,2023-09-13,2023-09-15,445.99,0,0,204169288,52571163,0.00165744810747442,99.9816877453185,0
447.16,481,1,1,3384,3384,2023-09-13,2023-09-22,445.99,0,0,40008818,10432511,0.00845813540405018,99.9195527345996,0
446.48,480,0,1,0,3352,2023-09-13,2023-10-13,445.99,1,3352,22195764,5051124,0.0151019807202852,99.8864287798339,1
445.76,479,0,1,0,3324,2023-09-13,2023-09-15,445.99,1,3324,204169288,52571163,0.00162806072968232,99.9833158060482,1
401.92,402,413,413,3304,3304,2023-09-13,2023-09-22,445.99,0,0,40008818,10432511,0.00825817948433268,99.927810914084,0
324.94,325,534,548,2670,3288,2023-09-13,2023-10-13,445.99,14,617.999999999999,22195764,5051124,0.0148136374129766,99.9012424172468,0.187956204379562
368.99,369,3239,3281,6478,3281,2023-09-13,2023-09-15,445.99,42,-3197,204169288,52571163,0.00160699977559798,99.9849228058238,-0.974398049375191
239.99,240,3267,3267,3267,3267,2023-09-13,2023-09-15,445.99,0,0,204169288,52571163,0.00160014272077983,99.9865229485446,0
442.6,475,1,1,3240,3240,2023-09-13,2023-10-06,445.99,0,0,35655626,8296590,0.0090869250199113,99.947643606089,0
274.99,275,3223,3223,3223,3223,2023-09-13,2023-09-15,445.99,0,0,204169288,52571163,0.00157859197706562,99.9881015405216,0
449.97,482,1,1,3203,3203,2023-09-13,2023-09-29,445.99,0,0,181598301,29583870,0.001763783021296,99.9832371779734,0
446.33,478,1,1,3167,3167,2023-09-13,2023-09-15,445.99,0,0,204169288,52571163,0.00155116375779299,99.9896527042794,0
446.5,478,1,1,3150,3150,2023-09-13,2023-10-13,445.99,0,0,22195764,5051124,0.0141918971565926,99.9154343144034,0
214.99,215,3218,3148,6436,3148,2023-09-13,2023-10-20,445.99,-70,-3288,497615928,97292139,0.000632616406121148,99.9966156629938,-1.04447268106734
449.97,481,1,1,3103,3103,2023-09-13,2023-09-29,445.99,0,0,181598301,29583870,0.00170871642681283,99.9849458944002,0
348.96,349,761,761,3044,3044,2023-09-13,2023-09-29,445.99,0,0,181598301,29583870,0.00167622713606775,99.9866221215363,0
194.99,195,3001,3001,3001,3001,2023-09-13,2023-09-15,445.99,0,0,204169288,52571163,0.00146985867923485,99.9911225629586,0
446.63,476,1,1,2937,2937,2023-09-13,2023-11-17,445.99,0,0,390070868,38675143,0.00075294010420691,99.9993052544493,0
445.66,475,0,1,0,2934,2023-09-13,2023-09-22,445.99,1,2934,40008818,10432511,0.00733338335563925,99.9351442974396,1
403.91,404,325,325,2925,2925,2023-09-13,2023-09-22,445.99,0,0,40008818,10432511,0.00731088831467103,99.9424551857543,0
444.06,473,1,1,2894,2894,2023-09-13,2023-09-15,445.99,0,0,204169288,52571163,0.00141745118883894,99.9925400141475,0
447.17,476,1,1,2883,2883,2023-09-13,2023-10-06,445.99,0,0,35655626,8296590,0.00808568050382848,99.9557292865928,0
402.91,403,309,309,2781,2781,2023-09-13,2023-09-22,445.99,0,0,40008818,10432511,0.00695096765917953,99.9494061534135,0
395.92,396,344,344,2752,2752,2023-09-13,2023-09-22,445.99,0,0,40008818,10432511,0.00687848363828194,99.9562846370518,0
444.57,472,0,1,0,2743,2023-09-13,2023-10-13,445.99,1,2743,22195764,5051124,0.0123582139366773,99.9277925283401,1
219.99,220,2809,2735,2809,2735,2023-09-13,2023-10-20,445.99,-74,-74,497615928,97292139,0.000549620670502332,99.9971652836643,-0.0270566727605119
444.8,472,1,1,2720,2720,2023-09-13,2023-10-06,445.99,0,0,35655626,8296590,0.00762852964634529,99.9633578162392,0
244.95,245,542,542,2710,2710,2023-09-13,2023-11-17,445.99,0,0,390070868,38675143,0.000694745550698239,100,0
366.99,367,2691,2691,2691,2691,2023-09-13,2023-09-15,445.99,0,0,204169288,52571163,0.00131802389397567,99.9938580380415,0
154.99,155,2672,2672,2672,2672,2023-09-13,2023-10-20,445.99,0,0,497615928,97292139,0.000536960304052004,99.9977022439684,0
326.98,327,1309,1317,6545,2634,2023-09-13,2023-09-29,445.99,8,-3911,181598301,29583870,0.00145045409868675,99.988072575635,-1.48481397114655
452,478,1,1,2600,2600,2023-09-13,2023-10-06,445.99,0,0,35655626,8296590,0.00729197686783006,99.970649793107,0
398.93,399,356,362,2848,2534,2023-09-13,2023-09-22,445.99,6,-314,40008818,10432511,0.00633360375705176,99.9626182408088,-0.123914759273875
224.99,225,2522,2522,2522,2522,2023-09-13,2023-09-15,445.99,0,0,204169288,52571163,0.00123524944652792,99.995093287488,0
443.4,456,0,2,0,2520,2023-09-13,2023-10-27,445.99,2,2520,12636806,8295984,0.0199417479385218,99.8987402354677,1
355.99,356,2507,2507,2507,2507,2023-09-13,2023-09-15,445.99,0,0,204169288,52571163,0.0012279026020799,99.9963211900901,0
264.99,265,2483,2483,2483,2483,2023-09-13,2023-09-29,445.99,0,0,181598301,29583870,0.00136730354101716,99.989439879176,0
362.95,363,484,494,4356,2470,2023-09-13,2023-09-29,445.99,10,-1886,181598301,29583870,0.00136014488373435,99.9908000240597,-0.763562753036437
429.05,432.5,4,7,1236,2415,2023-09-13,2023-10-27,445.99,3,1179,12636806,8295984,0.0191108417744167,99.9178510772422,0.488198757763975
347.99,348,2390,2390,2390,2390,2023-09-13,2023-09-15,445.99,0,0,204169288,52571163,0.0011705972153853,99.9974917873055,0
259.99,260,2348,2348,2348,2348,2023-09-13,2023-09-29,445.99,0,0,181598301,29583870,0.00129296363846488,99.9920929876982,0
379.6,380,31,55,1209,2200,2023-09-13,2023-10-27,445.99,24,991,12636806,8295984,0.0174094624860111,99.9352605397282,0.450454545454545
450.04,472,1,1,2196,2196,2023-09-13,2023-09-22,445.99,0,0,40008818,10432511,0.00548878999624533,99.9681070308051,0
332.97,333,731,731,2193,2193,2023-09-13,2023-09-29,445.99,0,0,181598301,29583870,0.00120761041701596,99.9933005981152,0
445.29,467,0,1,0,2171,2023-09-13,2023-10-06,445.99,1,2171,35655626,8296590,0.0060888006846381,99.9767385937916,1
401.54,402,34,47,1632,2162,2023-09-13,2023-10-13,445.99,13,530,22195764,5051124,0.00974059735001688,99.9375331256901,0.245143385753932
401.7,402,72,72,2160,2160,2023-09-13,2023-10-06,445.99,0,0,35655626,8296590,0.0060579500132742,99.9827965438049,0
449.41,471,1,1,2159,2159,2023-09-13,2023-09-15,445.99,0,0,204169288,52571163,0.00105745581088572,99.9985492431163,0
449.73,471,1,1,2127,2127,2023-09-13,2023-09-29,445.99,0,0,181598301,29583870,0.00117126646465707,99.9944718645799,0
344.9,345,207,207,2070,2070,2023-09-13,2023-10-13,445.99,0,0,22195764,5051124,0.00932610384576084,99.9468592295359,0
299.99,300,2061,2061,2061,2061,2023-09-13,2023-09-22,445.99,0,0,40008818,10432511,0.00515136438172205,99.9732583951868,0
379.77,380,82,88,1804,2024,2023-09-13,2023-10-13,445.99,6,220,22195764,5051124,0.00911885709363282,99.9559780866295,0.108695652173913
224.99,225,2005,2005,2005,2005,2023-09-13,2023-10-20,445.99,0,0,497615928,97292139,0.000402921186236627,99.9981051651546,0
244.98,245,968,980,968,1960,2023-09-13,2023-10-20,445.99,12,992,497615928,97292139,0.000393878067343536,99.998499043222,0.506122448979592
443.79,462.5,1,1,1871,1871,2023-09-13,2023-10-13,445.99,0,0,22195764,5051124,0.00842953637459832,99.9644076230041,0
363.93,364,267,267,1869,1869,2023-09-13,2023-09-29,445.99,0,0,181598301,29583870,0.00102919465089048,99.9955010592307,0
279.99,280,1845,1845,1845,1845,2023-09-13,2023-09-29,445.99,0,0,181598301,29583870,0.00101597866821452,99.9965170378989,0
209.99,210,1836,1836,1836,1836,2023-09-13,2023-10-20,445.99,0,0,497615928,97292139,0.000368959250838128,99.9988680024728,0
354.77,355,74,79,1628,1817,2023-09-13,2023-10-27,445.99,5,189,12636806,8295984,0.0143786333350374,99.9496391730632,0.104017611447441
314.99,315,1800,1760,1800,1760,2023-09-13,2023-09-22,445.99,-40,-39.9999999999998,40008818,10432511,0.00439903023378496,99.9776574254206,-0.0227272727272726
449.45,467,1,1,1755,1755,2023-09-13,2023-09-22,445.99,0,0,40008818,10432511,0.00438653298880262,99.9820439584094,0
194.99,195,1731,1731,1731,1731,2023-09-13,2023-10-20,445.99,0,0,497615928,97292139,0.000347858640087582,99.9992158611129,0
445.85,463,1,1,1345,1715,2023-09-13,2023-10-13,445.99,0,370,22195764,5051124,0.00772669956303374,99.9721343225671,0.215743440233236
343.97,344,561,561,1683,1683,2023-09-13,2023-09-29,445.99,0,0,181598301,29583870,0.000926770785151784,99.9974438086841,0
369.71,370,30,58,900,1682,2023-09-13,2023-10-27,445.99,28,782,12636806,8295984,0.0133103254097594,99.962949498473,0.464922711058264
324.96,325,417,420,2085,1680,2023-09-13,2023-10-06,445.99,3,-405,35655626,8296590,0.00471173889921327,99.9875082827041,-0.241071428571429
448.01,464,1,1,1599,1599,2023-09-13,2023-10-06,445.99,0,0,35655626,8296590,0.00448456577371549,99.9919928484778,0
446.72,462.5,1,1,1578,1578,2023-09-13,2023-09-22,445.99,0,0,40008818,10432511,0.00394413051642765,99.9859880889258,0
445.69,461,1,1,1465,1531,2023-09-13,2023-10-27,445.99,0,66,12636806,8295984,0.0121154032118559,99.9750649016848,0.0431090790333116
407.44,408,21,27,1176,1512,2023-09-13,2023-10-13,445.99,6,336,22195764,5051124,0.00681211063516444,99.9789464332023,0.222222222222222
352.99,353,1492,1492,1492,1492,2023-09-13,2023-09-15,445.99,0,0,204169288,52571163,0.000730766127763545,99.9992800092441,0
357.99,358,1470,1470,1470,1470,2023-09-13,2023-09-15,445.99,0,0,204169288,52571163,0.000719990755906442,100,0
449.95,464,1,1,1405,1405,2023-09-13,2023-10-13,445.99,0,0,22195764,5051124,0.00633003666825796,99.9852764698706,0
445.26,459,0,1,0,1374,2023-09-13,2023-10-27,445.99,1,1374,12636806,8295984,0.0108730006617178,99.9859379023465,1
333.93,334,195,195,1365,1365,2023-09-13,2023-09-29,445.99,0,0,181598301,29583870,0.000751659014695297,99.9981954676988,0
254.99,255,1229,1229,1229,1229,2023-09-13,2023-09-29,445.99,0,0,181598301,29583870,0.000676768446198183,99.998872236145,0
274.99,275,1100,1100,1100,1100,2023-09-13,2023-09-29,445.99,0,0,181598301,29583870,0.000605732539314892,99.9994779686843,0
344.9,345,110,110,1100,1100,2023-09-13,2023-10-06,445.99,0,0,35655626,8296590,0.00308506713638964,99.9950779156142,0
164.99,165,1098,1098,1098,1098,2023-09-13,2023-10-20,445.99,0,0,497615928,97292139,0.00022065210099143,99.9994365132139,0
269.99,270,948,948,948,948,2023-09-13,2023-09-29,445.99,0,0,181598301,29583870,0.00052203131570047,100,0
204.99,205,939,939,939,939,2023-09-13,2023-10-20,445.99,0,0,497615928,97292139,0.000188699747569173,99.9996252129614,0
339.94,340,150,152,900,912,2023-09-13,2023-10-06,445.99,2,11.9999999999999,35655626,8296590,0.00255780111671577,99.9976357167309,0.013157894736842
334.93,335,122,122,854,854,2023-09-13,2023-10-13,445.99,0,0,22195764,5051124,0.00384758100689843,99.9891240508775,0
339.84,340,6,48,90,768,2023-09-13,2023-10-27,445.99,42,678,12636806,8295984,0.00607748508602569,99.9920153874326,0.8828125
174.99,175,712,712,712,712,2023-09-13,2023-10-20,445.99,0,0,497615928,97292139,0.000143082236708468,99.9997682951981,0
309.99,310,710,710,710,710,2023-09-13,2023-09-22,445.99,0,0,40008818,10432511,0.0017746087874928,99.9877626977133,0
369.83,370,35,40,630,680,2023-09-13,2023-10-13,445.99,5,50.0000000000001,22195764,5051124,0.00306364764015332,99.9921876985176,0.073529411764706
381.95,382,131,131,655,655,2023-09-13,2023-09-22,445.99,0,0,40008818,10432511,0.00163713909268702,99.989399836806,0
329.98,330,310,310,620,620,2023-09-13,2023-09-22,445.99,0,0,40008818,10432511,0.00154965837781061,99.9909494951838,0
184.99,185,612,612,612,612,2023-09-13,2023-10-20,445.99,0,0,497615928,97292139,0.000122986416946043,99.9998912816151,0
405.42,406,7,10,378,580,2023-09-13,2023-10-13,445.99,3,202,22195764,5051124,0.00261311122248371,99.9948008097401,0.348275862068966
339.97,340,191,191,573,573,2023-09-13,2023-09-22,445.99,0,0,40008818,10432511,0.00143218427497658,99.9923816794588,0
359.98,360,278,277,834,554,2023-09-13,2023-09-22,445.99,-1,-280,40008818,10432511,0.00138469474404368,99.9937663742028,-0.505415162454874
179.99,180,541,541,541,541,2023-09-13,2023-10-20,445.99,0,0,497615928,97292139,0.000108718384914721,100,0
334.97,335,179,179,537,537,2023-09-13,2023-09-22,445.99,0,0,40008818,10432511,0.00134220411110371,99.9951085783139,0
344.82,345,8,28,144,504,2023-09-13,2023-10-27,445.99,20,360,12636806,8295984,0.00398834958770436,99.9960037370203,0.714285714285714
386.95,387,0,92,0,460,2023-09-13,2023-09-22,445.99,92,460,40008818,10432511,0.00114974653837562,99.9962583248523,1
324.99,325,450,458,450,458,2023-09-13,2023-09-22,445.99,8,8,40008818,10432511,0.00114474764038268,99.9974030724927,0.0174672489082969
364.86,365,33,32,528,448,2023-09-13,2023-10-13,445.99,-1,-80,22195764,5051124,0.00201840315115983,99.9968192128913,-0.178571428571428
364.71,365,6,15,168,435,2023-09-13,2023-10-27,445.99,9,267,12636806,8295984,0.00344232553700674,99.9994460625573,0.613793103448276
319.99,320,324,417,324,417,2023-09-13,2023-09-22,445.99,93,93,40008818,10432511,0.00104227023152746,99.9984453427242,0.223021582733813
334.96,335,102,103,612,412,2023-09-13,2023-10-06,445.99,1,-200,35655626,8296590,0.0011554978729023,99.9987912146038,-0.485436893203884
391.94,392,0,60,0,360,2023-09-13,2023-09-22,445.99,60,360,40008818,10432511,0.000899801638728742,99.9993451443629,1
349.93,350,49,49,343,343,2023-09-13,2023-10-06,445.99,0,0,35655626,8296590,0.000961980025256042,99.9997531946291,0
329.93,330,35,36,280,252,2023-09-13,2023-10-13,445.99,1,-27.9999999999999,22195764,5051124,0.00113535177252741,99.9979545646638,-0.111111111111111
304.99,305,231,231,231,231,2023-09-13,2023-09-22,445.99,0,0,40008818,10432511,0.000577372718184276,99.9999225170811,0
349.9,350,21,23,231,230,2023-09-13,2023-10-13,445.99,2,-0.999999999999972,22195764,5051124,0.00103623376064009,99.9989907984244,-0.0043478260869564
339.92,340,28,28,224,224,2023-09-13,2023-10-13,445.99,0,0,22195764,5051124,0.00100920157557992,100,0
329.96,330,16,22,80,88,2023-09-13,2023-10-06,445.99,6,8,35655626,8296590,0.000246805370911171,100,0.0909090909090909
334.86,335,5,5,70,70,2023-09-13,2023-10-27,445.99,0,0,12636806,8295984,0.000553937442736717,100,0
387.95,388,0,5,0,25,2023-09-13,2023-09-22,445.99,5,25,40008818,10432511,6.24862249117182e-05,99.999985003306,1
392.94,393,0,1,0,6,2023-09-13,2023-09-22,445.99,1,6,40008818,10432511,1.49966939788124e-05,100,1
446.34,481,0,0,0,0,2023-09-13,2023-09-15,445.99,0,0,204169288,52571163,0,100,
450.3,482,0,0,0,0,2023-09-13,2023-09-15,445.99,0,0,204169288,52571163,0,100,
483,483,0,0,0,0,2023-09-13,2023-09-15,445.99,0,0,204169288,52571163,0,100,
486,486,0,0,0,0,2023-09-13,2023-09-15,445.99,0,0,204169288,52571163,0,100,
491,491,0,0,0,0,2023-09-13,2023-09-15,445.99,0,0,204169288,52571163,0,100,
445.5,495,0,0,0,0,2023-09-13,2023-09-15,445.99,0,0,204169288,52571163,0,100,
445.74,504,0,0,0,0,2023-09-13,2023-09-15,445.99,0,0,204169288,52571163,0,100,
441.46,515,0,0,0,0,2023-09-13,2023-09-15,445.99,0,0,204169288,52571163,0,100,
450.27,520,0,0,0,0,2023-09-13,2023-09-15,445.99,0,0,204169288,52571163,0,100,
454.72,525,0,0,0,0,2023-09-13,2023-09-15,445.99,0,0,204169288,52571163,0,100,
446.53,535,0,0,0,0,2023-09-13,2023-09-15,445.99,0,0,204169288,52571163,0,100,
540,540,0,0,0,0,2023-09-13,2023-09-15,445.99,0,0,204169288,52571163,0,100,
545,545,0,0,0,0,2023-09-13,2023-09-15,445.99,0,0,204169288,52571163,0,100,
453.46,550,0,0,0,0,2023-09-13,2023-09-15,445.99,0,0,204169288,52571163,0,100,
442.15,560,0,0,0,0,2023-09-13,2023-09-15,445.99,0,0,204169288,52571163,0,100,
565,565,0,0,0,0,2023-09-13,2023-09-15,445.99,0,0,204169288,52571163,0,100,
570,570,0,0,0,0,2023-09-13,2023-09-15,445.99,0,0,204169288,52571163,0,100,
575,575,0,0,0,0,2023-09-13,2023-09-15,445.99,0,0,204169288,52571163,0,100,
580,580,0,0,0,0,2023-09-13,2023-09-15,445.99,0,0,204169288,52571163,0,100,
585,585,0,0,0,0,2023-09-13,2023-09-15,445.99,0,0,204169288,52571163,0,100,
440.13,590,0,0,0,0,2023-09-13,2023-09-15,445.99,0,0,204169288,52571163,0,100,
595,595,0,0,0,0,2023-09-13,2023-09-15,445.99,0,0,204169288,52571163,0,100,
420.32,600,0,0,0,0,2023-09-13,2023-09-15,445.99,0,0,204169288,52571163,0,100,
605,605,0,0,0,0,2023-09-13,2023-09-15,445.99,0,0,204169288,52571163,0,100,
610,610,0,0,0,0,2023-09-13,2023-09-15,445.99,0,0,204169288,52571163,0,100,
615,615,0,0,0,0,2023-09-13,2023-09-15,445.99,0,0,204169288,52571163,0,100,
620,620,0,0,0,0,2023-09-13,2023-09-15,445.99,0,0,204169288,52571163,0,100,
625,625,0,0,0,0,2023-09-13,2023-09-15,445.99,0,0,204169288,52571163,0,100,
630,630,0,0,0,0,2023-09-13,2023-09-15,445.99,0,0,204169288,52571163,0,100,
411.47,635,0,0,0,0,2023-09-13,2023-09-15,445.99,0,0,204169288,52571163,0,100,
640,640,0,0,0,0,2023-09-13,2023-09-15,445.99,0,0,204169288,52571163,0,100,
446.16,645,0,0,0,0,2023-09-13,2023-09-15,445.99,0,0,204169288,52571163,0,100,
449.55,650,0,0,0,0,2023-09-13,2023-09-15,445.99,0,0,204169288,52571163,0,100,
383,383,0,0,0,0,2023-09-13,2023-09-22,445.99,0,0,40008818,10432511,0,100,
384,384,0,0,0,0,2023-09-13,2023-09-22,445.99,0,0,40008818,10432511,0,100,
386,386,0,0,0,0,2023-09-13,2023-09-22,445.99,0,0,40008818,10432511,0,100,
389,389,0,0,0,0,2023-09-13,2023-09-22,445.99,0,0,40008818,10432511,0,100,
391,391,0,0,0,0,2023-09-13,2023-09-22,445.99,0,0,40008818,10432511,0,100,
466,466,0,0,0,0,2023-09-13,2023-09-22,445.99,0,0,40008818,10432511,0,100,
471,471,0,0,0,0,2023-09-13,2023-09-22,445.99,0,0,40008818,10432511,0,100,
473,473,0,0,0,0,2023-09-13,2023-09-22,445.99,0,0,40008818,10432511,0,100,
447.97,474,0,0,0,0,2023-09-13,2023-09-22,445.99,0,0,40008818,10432511,0,100,
477,477,0,0,0,0,2023-09-13,2023-09-22,445.99,0,0,40008818,10432511,0,100,
439.77,478,0,0,0,0,2023-09-13,2023-09-22,445.99,0,0,40008818,10432511,0,100,
479,479,0,0,0,0,2023-09-13,2023-09-22,445.99,0,0,40008818,10432511,0,100,
482,482,0,0,0,0,2023-09-13,2023-09-22,445.99,0,0,40008818,10432511,0,100,
483,483,0,0,0,0,2023-09-13,2023-09-22,445.99,0,0,40008818,10432511,0,100,
484,484,0,0,0,0,2023-09-13,2023-09-22,445.99,0,0,40008818,10432511,0,100,
486,486,0,0,0,0,2023-09-13,2023-09-22,445.99,0,0,40008818,10432511,0,100,
487,487,0,0,0,0,2023-09-13,2023-09-22,445.99,0,0,40008818,10432511,0,100,
488,488,0,0,0,0,2023-09-13,2023-09-22,445.99,0,0,40008818,10432511,0,100,
489,489,0,0,0,0,2023-09-13,2023-09-22,445.99,0,0,40008818,10432511,0,100,
450.83,490,0,0,0,0,2023-09-13,2023-09-22,445.99,0,0,40008818,10432511,0,100,
492,492,0,0,0,0,2023-09-13,2023-09-22,445.99,0,0,40008818,10432511,0,100,
493,493,0,0,0,0,2023-09-13,2023-09-22,445.99,0,0,40008818,10432511,0,100,
494,494,0,0,0,0,2023-09-13,2023-09-22,445.99,0,0,40008818,10432511,0,100,
495,495,0,0,0,0,2023-09-13,2023-09-22,445.99,0,0,40008818,10432511,0,100,
496,496,0,0,0,0,2023-09-13,2023-09-22,445.99,0,0,40008818,10432511,0,100,
497,497,0,0,0,0,2023-09-13,2023-09-22,445.99,0,0,40008818,10432511,0,100,
498,498,0,0,0,0,2023-09-13,2023-09-22,445.99,0,0,40008818,10432511,0,100,
499,499,0,0,0,0,2023-09-13,2023-09-22,445.99,0,0,40008818,10432511,0,100,
505,505,0,0,0,0,2023-09-13,2023-09-22,445.99,0,0,40008818,10432511,0,100,
510,510,0,0,0,0,2023-09-13,2023-09-22,445.99,0,0,40008818,10432511,0,100,
515,515,0,0,0,0,2023-09-13,2023-09-22,445.99,0,0,40008818,10432511,0,100,
437.6,520,0,0,0,0,2023-09-13,2023-09-22,445.99,0,0,40008818,10432511,0,100,
525,525,0,0,0,0,2023-09-13,2023-09-22,445.99,0,0,40008818,10432511,0,100,
530,530,0,0,0,0,2023-09-13,2023-09-22,445.99,0,0,40008818,10432511,0,100,
540,540,0,0,0,0,2023-09-13,2023-09-22,445.99,0,0,40008818,10432511,0,100,
443.9,472,0,0,0,0,2023-09-13,2023-09-29,445.99,0,0,181598301,29583870,0,100,
445.11,473,0,0,0,0,2023-09-13,2023-09-29,445.99,0,0,181598301,29583870,0,100,
449.9,475,0,0,0,0,2023-09-13,2023-09-29,445.99,0,0,181598301,29583870,0,100,
476,476,0,0,0,0,2023-09-13,2023-09-29,445.99,0,0,181598301,29583870,0,100,
444.94,477,0,0,0,0,2023-09-13,2023-09-29,445.99,0,0,181598301,29583870,0,100,
457.53,478,0,0,0,0,2023-09-13,2023-09-29,445.99,0,0,181598301,29583870,0,100,
455,479,0,0,0,0,2023-09-13,2023-09-29,445.99,0,0,181598301,29583870,0,100,
483,483,0,0,0,0,2023-09-13,2023-09-29,445.99,0,0,181598301,29583870,0,100,
488,488,0,0,0,0,2023-09-13,2023-09-29,445.99,0,0,181598301,29583870,0,100,
450.8,490,0,0,0,0,2023-09-13,2023-09-29,445.99,0,0,181598301,29583870,0,100,
492,492,0,0,0,0,2023-09-13,2023-09-29,445.99,0,0,181598301,29583870,0,100,
448.95,494,0,0,0,0,2023-09-13,2023-09-29,445.99,0,0,181598301,29583870,0,100,
451.55,495,0,0,0,0,2023-09-13,2023-09-29,445.99,0,0,181598301,29583870,0,100,
496,496,0,0,0,0,2023-09-13,2023-09-29,445.99,0,0,181598301,29583870,0,100,
451.53,500,0,0,0,0,2023-09-13,2023-09-29,445.99,0,0,181598301,29583870,0,100,
407,515,0,0,0,0,2023-09-13,2023-09-29,445.99,0,0,181598301,29583870,0,100,
435.05,520,0,0,0,0,2023-09-13,2023-09-29,445.99,0,0,181598301,29583870,0,100,
445.85,463,0,0,0,0,2023-09-13,2023-10-06,445.99,0,0,35655626,8296590,0,100,
469,469,0,0,0,0,2023-09-13,2023-10-06,445.99,0,0,35655626,8296590,0,100,
449.65,471,0,0,0,0,2023-09-13,2023-10-06,445.99,0,0,35655626,8296590,0,100,
482,482,0,0,0,0,2023-09-13,2023-10-06,445.99,0,0,35655626,8296590,0,100,
484,484,0,0,0,0,2023-09-13,2023-10-06,445.99,0,0,35655626,8296590,0,100,
485,485,0,0,0,0,2023-09-13,2023-10-06,445.99,0,0,35655626,8296590,0,100,
444.87,486,0,0,0,0,2023-09-13,2023-10-06,445.99,0,0,35655626,8296590,0,100,
488,488,0,0,0,0,2023-09-13,2023-10-06,445.99,0,0,35655626,8296590,0,100,
492,492,0,0,0,0,2023-09-13,2023-10-06,445.99,0,0,35655626,8296590,0,100,
494,494,0,0,0,0,2023-09-13,2023-10-06,445.99,0,0,35655626,8296590,0,100,
446.24,495,0,0,0,0,2023-09-13,2023-10-06,445.99,0,0,35655626,8296590,0,100,
500,500,0,0,0,0,2023-09-13,2023-10-06,445.99,0,0,35655626,8296590,0,100,
505,505,0,0,0,0,2023-09-13,2023-10-06,445.99,0,0,35655626,8296590,0,100,
510,510,0,0,0,0,2023-09-13,2023-10-06,445.99,0,0,35655626,8296590,0,100,
446.23,515,0,0,0,0,2023-09-13,2023-10-06,445.99,0,0,35655626,8296590,0,100,
520,520,0,0,0,0,2023-09-13,2023-10-06,445.99,0,0,35655626,8296590,0,100,
525,525,0,0,0,0,2023-09-13,2023-10-06,445.99,0,0,35655626,8296590,0,100,
530,530,0,0,0,0,2023-09-13,2023-10-06,445.99,0,0,35655626,8296590,0,100,
540,540,0,0,0,0,2023-09-13,2023-10-06,445.99,0,0,35655626,8296590,0,100,
468,468,0,0,0,0,2023-09-13,2023-10-13,445.99,0,0,22195764,5051124,0,100,
471,471,0,0,0,0,2023-09-13,2023-10-13,445.99,0,0,22195764,5051124,0,100,
447.37,474,0,0,0,0,2023-09-13,2023-10-13,445.99,0,0,22195764,5051124,0,100,
446.41,475,0,0,0,0,2023-09-13,2023-10-13,445.99,0,0,22195764,5051124,0,100,
476,476,0,0,0,0,2023-09-13,2023-10-13,445.99,0,0,22195764,5051124,0,100,
482,482,0,0,0,0,2023-09-13,2023-10-13,445.99,0,0,22195764,5051124,0,100,
446.38,484,0,0,0,0,2023-09-13,2023-10-13,445.99,0,0,22195764,5051124,0,100,
485,485,0,0,0,0,2023-09-13,2023-10-13,445.99,0,0,22195764,5051124,0,100,
486,486,0,0,0,0,2023-09-13,2023-10-13,445.99,0,0,22195764,5051124,0,100,
495,495,0,0,0,0,2023-09-13,2023-10-13,445.99,0,0,22195764,5051124,0,100,
505,505,0,0,0,0,2023-09-13,2023-10-13,445.99,0,0,22195764,5051124,0,100,
510,510,0,0,0,0,2023-09-13,2023-10-13,445.99,0,0,22195764,5051124,0,100,
515,515,0,0,0,0,2023-09-13,2023-10-13,445.99,0,0,22195764,5051124,0,100,
525,525,0,0,0,0,2023-09-13,2023-10-13,445.99,0,0,22195764,5051124,0,100,
530,530,0,0,0,0,2023-09-13,2023-10-13,445.99,0,0,22195764,5051124,0,100,
444.75,540,0,0,0,0,2023-09-13,2023-10-13,445.99,0,0,22195764,5051124,0,100,
438.6,476,0,0,0,0,2023-09-13,2023-10-20,445.99,0,0,497615928,97292139,0,100,
456.58,486,0,0,0,0,2023-09-13,2023-10-20,445.99,0,0,497615928,97292139,0,100,
488,488,0,0,0,0,2023-09-13,2023-10-20,445.99,0,0,497615928,97292139,0,100,
492,492,0,0,0,0,2023-09-13,2023-10-20,445.99,0,0,497615928,97292139,0,100,
494,494,0,0,0,0,2023-09-13,2023-10-20,445.99,0,0,497615928,97292139,0,100,
496,496,0,0,0,0,2023-09-13,2023-10-20,445.99,0,0,497615928,97292139,0,100,
438.16,498,0,0,0,0,2023-09-13,2023-10-20,445.99,0,0,497615928,97292139,0,100,
502,502,0,0,0,0,2023-09-13,2023-10-20,445.99,0,0,497615928,97292139,0,100,
451.26,504,0,0,0,0,2023-09-13,2023-10-20,445.99,0,0,497615928,97292139,0,100,
449.21,505,0,0,0,0,2023-09-13,2023-10-20,445.99,0,0,497615928,97292139,0,100,
506,506,0,0,0,0,2023-09-13,2023-10-20,445.99,0,0,497615928,97292139,0,100,
442.77,510,0,0,0,0,2023-09-13,2023-10-20,445.99,0,0,497615928,97292139,0,100,
455.07,520,0,0,0,0,2023-09-13,2023-10-20,445.99,0,0,497615928,97292139,0,100,
445.68,530,0,0,0,0,2023-09-13,2023-10-20,445.99,0,0,497615928,97292139,0,100,
438.84,535,0,0,0,0,2023-09-13,2023-10-20,445.99,0,0,497615928,97292139,0,100,
445.83,540,0,0,0,0,2023-09-13,2023-10-20,445.99,0,0,497615928,97292139,0,100,
456.29,545,0,0,0,0,2023-09-13,2023-10-20,445.99,0,0,497615928,97292139,0,100,
451,550,0,0,0,0,2023-09-13,2023-10-20,445.99,0,0,497615928,97292139,0,100,
450.59,555,0,0,0,0,2023-09-13,2023-10-20,445.99,0,0,497615928,97292139,0,100,
443.34,560,0,0,0,0,2023-09-13,2023-10-20,445.99,0,0,497615928,97292139,0,100,
444.99,570,0,0,0,0,2023-09-13,2023-10-20,445.99,0,0,497615928,97292139,0,100,
445.25,575,0,0,0,0,2023-09-13,2023-10-20,445.99,0,0,497615928,97292139,0,100,
452.56,580,0,0,0,0,2023-09-13,2023-10-20,445.99,0,0,497615928,97292139,0,100,
446.3,585,0,0,0,0,2023-09-13,2023-10-20,445.99,0,0,497615928,97292139,0,100,
446.27,590,0,0,0,0,2023-09-13,2023-10-20,445.99,0,0,497615928,97292139,0,100,
456.13,595,0,0,0,0,2023-09-13,2023-10-20,445.99,0,0,497615928,97292139,0,100,
330,330,0,0,0,0,2023-09-13,2023-10-27,445.99,0,0,12636806,8295984,0,100,
457,457,0,0,0,0,2023-09-13,2023-10-27,445.99,0,0,12636806,8295984,0,100,
457.5,457.5,0,0,0,0,2023-09-13,2023-10-27,445.99,0,0,12636806,8295984,0,100,
462,462,0,0,0,0,2023-09-13,2023-10-27,445.99,0,0,12636806,8295984,0,100,
463,463,0,0,0,0,2023-09-13,2023-10-27,445.99,0,0,12636806,8295984,0,100,
464,464,0,0,0,0,2023-09-13,2023-10-27,445.99,0,0,12636806,8295984,0,100,
465,465,0,0,0,0,2023-09-13,2023-10-27,445.99,0,0,12636806,8295984,0,100,
466,466,0,0,0,0,2023-09-13,2023-10-27,445.99,0,0,12636806,8295984,0,100,
467,467,0,0,0,0,2023-09-13,2023-10-27,445.99,0,0,12636806,8295984,0,100,
468,468,0,0,0,0,2023-09-13,2023-10-27,445.99,0,0,12636806,8295984,0,100,
469,469,0,0,0,0,2023-09-13,2023-10-27,445.99,0,0,12636806,8295984,0,100,
472,472,0,0,0,0,2023-09-13,2023-10-27,445.99,0,0,12636806,8295984,0,100,
474,474,0,0,0,0,2023-09-13,2023-10-27,445.99,0,0,12636806,8295984,0,100,
475,475,0,0,0,0,2023-09-13,2023-10-27,445.99,0,0,12636806,8295984,0,100,
476,476,0,0,0,0,2023-09-13,2023-10-27,445.99,0,0,12636806,8295984,0,100,
478,478,0,0,0,0,2023-09-13,2023-10-27,445.99,0,0,12636806,8295984,0,100,
480,480,0,0,0,0,2023-09-13,2023-10-27,445.99,0,0,12636806,8295984,0,100,
482,482,0,0,0,0,2023-09-13,2023-10-27,445.99,0,0,12636806,8295984,0,100,
484,484,0,0,0,0,2023-09-13,2023-10-27,445.99,0,0,12636806,8295984,0,100,
485,485,0,0,0,0,2023-09-13,2023-10-27,445.99,0,0,12636806,8295984,0,100,
444.46,490,0,0,0,0,2023-09-13,2023-10-27,445.99,0,0,12636806,8295984,0,100,
495,495,0,0,0,0,2023-09-13,2023-10-27,445.99,0,0,12636806,8295984,0,100,
500,500,0,0,0,0,2023-09-13,2023-10-27,445.99,0,0,12636806,8295984,0,100,
505,505,0,0,0,0,2023-09-13,2023-10-27,445.99,0,0,12636806,8295984,0,100,
510,510,0,0,0,0,2023-09-13,2023-10-27,445.99,0,0,12636806,8295984,0,100,
515,515,0,0,0,0,2023-09-13,2023-10-27,445.99,0,0,12636806,8295984,0,100,
520,520,0,0,0,0,2023-09-13,2023-10-27,445.99,0,0,12636806,8295984,0,100,
525,525,0,0,0,0,2023-09-13,2023-10-27,445.99,0,0,12636806,8295984,0,100,
530,530,0,0,0,0,2023-09-13,2023-10-27,445.99,0,0,12636806,8295984,0,100,
540,540,0,0,0,0,2023-09-13,2023-10-27,445.99,0,0,12636806,8295984,0,100,
474,474,0,0,0,0,2023-09-13,2023-11-17,445.99,0,0,390070868,38675143,0,100,
484,484,0,0,0,0,2023-09-13,2023-11-17,445.99,0,0,390070868,38675143,0,100,
488,488,0,0,0,0,2023-09-13,2023-11-17,445.99,0,0,390070868,38675143,0,100,
444.95,490,0,0,0,0,2023-09-13,2023-11-17,445.99,0,0,390070868,38675143,0,100,
492,492,0,0,0,0,2023-09-13,2023-11-17,445.99,0,0,390070868,38675143,0,100,
494,494,0,0,0,0,2023-09-13,2023-11-17,445.99,0,0,390070868,38675143,0,100,
496,496,0,0,0,0,2023-09-13,2023-11-17,445.99,0,0,390070868,38675143,0,100,
440.45,505,0,0,0,0,2023-09-13,2023-11-17,445.99,0,0,390070868,38675143,0,100,
520,520,0,0,0,0,2023-09-13,2023-11-17,445.99,0,0,390070868,38675143,0,100,
525,525,0,0,0,0,2023-09-13,2023-11-17,445.99,0,0,390070868,38675143,0,100,
439.89,540,0,0,0,0,2023-09-13,2023-11-17,445.99,0,0,390070868,38675143,0,100,
434.33,550,0,0,0,0,2023-09-13,2023-11-17,445.99,0,0,390070868,38675143,0,100,
444,560,0,0,0,0,2023-09-13,2023-11-17,445.99,0,0,390070868,38675143,0,100,
474,474,0,0,0,0,2023-09-13,2023-12-15,445.99,0,0,481634514,35662575,0,100,
436,478,0,0,0,0,2023-09-13,2023-12-15,445.99,0,0,481634514,35662575,0,100,
482,482,0,0,0,0,2023-09-13,2023-12-15,445.99,0,0,481634514,35662575,0,100,
483,483,0,0,0,0,2023-09-13,2023-12-15,445.99,0,0,481634514,35662575,0,100,
457.21,484,0,0,0,0,2023-09-13,2023-12-15,445.99,0,0,481634514,35662575,0,100,
486,486,0,0,0,0,2023-09-13,2023-12-15,445.99,0,0,481634514,35662575,0,100,
454.85,488,0,0,0,0,2023-09-13,2023-12-15,445.99,0,0,481634514,35662575,0,100,
493,493,0,0,0,0,2023-09-13,2023-12-15,445.99,0,0,481634514,35662575,0,100,
494,494,0,0,0,0,2023-09-13,2023-12-15,445.99,0,0,481634514,35662575,0,100,
496,496,0,0,0,0,2023-09-13,2023-12-15,445.99,0,0,481634514,35662575,0,100,
497,497,0,0,0,0,2023-09-13,2023-12-15,445.99,0,0,481634514,35662575,0,100,
450.44,498,0,0,0,0,2023-09-13,2023-12-15,445.99,0,0,481634514,35662575,0,100,
499,499,0,0,0,0,2023-09-13,2023-12-15,445.99,0,0,481634514,35662575,0,100,
501,501,0,0,0,0,2023-09-13,2023-12-15,445.99,0,0,481634514,35662575,0,100,
450.54,505,0,0,0,0,2023-09-13,2023-12-15,445.99,0,0,481634514,35662575,0,100,
441.04,530,0,0,0,0,2023-09-13,2023-12-15,445.99,0,0,481634514,35662575,0,100,
440.46,535,0,0,0,0,2023-09-13,2023-12-15,445.99,0,0,481634514,35662575,0,100,
411.85,545,0,0,0,0,2023-09-13,2023-12-15,445.99,0,0,481634514,35662575,0,100,
454.85,550,0,0,0,0,2023-09-13,2023-12-15,445.99,0,0,481634514,35662575,0,100,
450.28,560,0,0,0,0,2023-09-13,2023-12-15,445.99,0,0,481634514,35662575,0,100,
565,565,0,0,0,0,2023-09-13,2023-12-15,445.99,0,0,481634514,35662575,0,100,
575,575,0,0,0,0,2023-09-13,2023-12-15,445.99,0,0,481634514,35662575,0,100,
580,580,0,0,0,0,2023-09-13,2023-12-15,445.99,0,0,481634514,35662575,0,100,
585,585,0,0,0,0,2023-09-13,2023-12-15,445.99,0,0,481634514,35662575,0,100,
450.23,595,0,0,0,0,2023-09-13,2023-12-15,445.99,0,0,481634514,35662575,0,100,
605,605,0,0,0,0,2023-09-13,2023-12-15,445.99,0,0,481634514,35662575,0,100,
610,610,0,0,0,0,2023-09-13,2023-12-15,445.99,0,0,481634514,35662575,0,100,
615,615,0,0,0,0,2023-09-13,2023-12-15,445.99,0,0,481634514,35662575,0,100,
620,620,0,0,0,0,2023-09-13,2023-12-15,445.99,0,0,481634514,35662575,0,100,
625,625,0,0,0,0,2023-09-13,2023-12-15,445.99,0,0,481634514,35662575,0,100,
630,630,0,0,0,0,2023-09-13,2023-12-15,445.99,0,0,481634514,35662575,0,100,
635,635,0,0,0,0,2023-09-13,2023-12-15,445.99,0,0,481634514,35662575,0,100,
640,640,0,0,0,0,2023-09-13,2023-12-15,445.99,0,0,481634514,35662575,0,100,
645,645,0,0,0,0,2023-09-13,2023-12-15,445.99,0,0,481634514,35662575,0,100,
650,650,0,0,0,0,2023-09-13,2023-12-15,445.99,0,0,481634514,35662575,0,100,
655,655,0,0,0,0,2023-09-13,2023-12-15,445.99,0,0,481634514,35662575,0,100,
660,660,0,0,0,0,2023-09-13,2023-12-15,445.99,0,0,481634514,35662575,0,100,
665,665,0,0,0,0,2023-09-13,2023-12-15,445.99,0,0,481634514,35662575,0,100,
670,670,0,0,0,0,2023-09-13,2023-12-15,445.99,0,0,481634514,35662575,0,100,
675,675,0,0,0,0,2023-09-13,2023-12-15,445.99,0,0,481634514,35662575,0,100,
680,680,0,0,0,0,2023-09-13,2023-12-15,445.99,0,0,481634514,35662575,0,100,
685,685,0,0,0,0,2023-09-13,2023-12-15,445.99,0,0,481634514,35662575,0,100,
690,690,0,0,0,0,2023-09-13,2023-12-15,445.99,0,0,481634514,35662575,0,100,
695,695,0,0,0,0,2023-09-13,2023-12-15,445.99,0,0,481634514,35662575,0,100,
451.18,700,0,0,0,0,2023-09-13,2023-12-15,445.99,0,0,481634514,35662575,0,100,
705,705,0,0,0,0,2023-09-13,2023-12-15,445.99,0,0,481634514,35662575,0,100,
710,710,0,0,0,0,2023-09-13,2023-12-15,445.99,0,0,481634514,35662575,0,100,
442.92,715,0,0,0,0,2023-09-13,2023-12-15,445.99,0,0,481634514,35662575,0,100,
