Watch,strike,open_interest.yt,open_interest.td,OI_Dollar.yt,OI_Dollar.td,Date.td,expiry,stkClose,diff_oi,diff_oi_d,totalOI,totalOIdiff,OI_pct,cum_sep_OI,pct
454.11,450,97899,107962,19971396,44372382,2023-08-03,2023-08-18,448.84,10063,24400986,303147069,149589725,14.6372459236939,14.6372459236939,0.549913818014097
444.52,440,91581,94170,26283747,42564840,2023-08-03,2023-09-15,448.84,2589,16281093,612682077,237570121,6.94729641977107,6.94729641977107,0.382500979681822
432.89,430,138678,146739,24962040,42407571,2023-08-03,2023-09-15,448.84,8061,17445531,612682077,237570121,6.92162747891187,13.8689238986829,0.411377746676413
461.57,455,59383,59349,20368369,38992293,2023-08-03,2023-08-18,448.84,-34,18623924,303147069,149589725,12.8625004122999,27.4997463359938,0.477630900034527
450.72,445,56279,67350,20823230,38524200,2023-08-03,2023-09-15,448.84,11071,17700970,612682077,237570121,6.2877961419459,20.1567200406288,0.459476640657042
438.52,430,43823,43570,28616419,37121640,2023-08-03,2023-12-15,448.84,-253,8505221,463353257,105207973,8.01152024706713,8.01152024706713,0.229117598252663
457.29,450,50218,49568,24154858,36135072,2023-08-03,2023-09-15,448.84,-650,11980214,612682077,237570121,5.89785034628979,26.0545703869186,0.331539784949093
463.36,450,25531,25689,27011798,34320504,2023-08-03,2023-12-15,448.84,158,7308706,463353257,105207973,7.40698451591978,15.4185047629869,0.212954506728689
458.63,450,38396,39011,22999204,33666493,2023-08-03,2023-09-29,448.84,615,10667289,193559650,66678490,17.3933425690737,17.3933425690737,0.316851802770191
441.61,435,46300,46076,20186800,30456236,2023-08-03,2023-10-20,448.84,-224,10269436,344413796,107013117,8.84291986956295,8.84291986956295,0.337186643812453
435.22,430,51220,57707,19361160,30123054,2023-08-03,2023-10-20,448.84,6487,10761894,344413796,107013117,8.74618100373656,17.5891008732995,0.35726437299485
459.9,450,28891,29958,21379340,29658420,2023-08-03,2023-10-20,448.84,1067,8279080,344413796,107013117,8.61127525797486,26.2003761312744,0.279147709149712
447.57,445,111723,109028,13630206,28020196,2023-08-03,2023-08-18,448.84,-2695,14389990,303147069,149589725,9.24310305635843,36.7428493923522,0.513557792386606
423.84,420,68767,70392,19117226,27030528,2023-08-03,2023-10-20,448.84,1625,7913302,344413796,107013117,7.84827097924962,34.048647110524,0.292754251785241
404.34,400,61845,60357,21583905,26194938,2023-08-03,2023-12-15,448.84,-1488,4611033,463353257,105207973,5.65334064329238,21.0718454062793,0.176027635568368
447.15,440,37682,36528,19707686,26117520,2023-08-03,2023-10-20,448.84,-1154,6409834,344413796,107013117,7.58318055296484,41.6318276634888,0.245422766020664
430.95,428,52496,85927,8609344,25348465,2023-08-03,2023-09-15,448.84,33431,16739121,612682077,237570121,4.13729501018193,30.1918653971006,0.660360341346113
440.1,435,46176,46195,15007200,23559450,2023-08-03,2023-09-29,448.84,19,8552250,193559650,66678490,12.1716742099916,29.5650167790653,0.36300720093211
415.55,410,38636,40517,16072576,22486935,2023-08-03,2023-12-15,448.84,1881,6414359,463353257,105207973,4.85308663752416,25.9249320438035,0.285248256376425
427.41,425,91183,91768,13312718,22116088,2023-08-03,2023-09-15,448.84,585,8803370,612682077,237570121,3.60971682218803,33.8015822192886,0.398052765932203
477.53,460,12671,12506,17549335,21923018,2023-08-03,2023-12-15,448.84,-165,4373683,463353257,105207973,4.73138316582503,30.6563152096285,0.199501866029577
453.62,445,25836,25219,15837468,21738778,2023-08-03,2023-10-20,448.84,-617,5901310,344413796,107013117,6.31181975068153,47.9436474141704,0.271464660985084
444.42,435,22137,22871,16425654,21544482,2023-08-03,2023-12-15,448.84,734,5118828,463353257,105207973,4.64968826149851,35.306003471127,0.237593458965502
464.38,455,22254,22757,13975512,21346066,2023-08-03,2023-09-15,448.84,503,7370554,612682077,237570121,3.48403630550466,37.2856185247932,0.345288635386024
432.64,425,27691,27566,15866943,21060424,2023-08-03,2023-12-15,448.84,-125,5193481,463353257,105207973,4.54521980407704,39.851223275204,0.246599071319742
438.59,435,55442,53552,12529892,19225168,2023-08-03,2023-09-15,448.84,-1890,6695276,612682077,237570121,3.13787014859911,40.4234886733923,0.348255786373362
474.33,460,13152,13157,14243616,18853981,2023-08-03,2023-10-20,448.84,5,4610365,344413796,107013117,5.4742235122312,53.4178709264016,0.244530054421928
472.32,460,12313,13670,10342920,16841440,2023-08-03,2023-09-15,448.84,1357,6498520,612682077,237570121,2.74880572359227,43.1722943969846,0.385864866662233
468.77,455,12559,12101,13413012,16663077,2023-08-03,2023-11-17,448.84,-458,3250065,178436543,50264301,9.33837694894145,9.33837694894145,0.195045908987878
412.93,410,57611,56350,12213532,16510550,2023-08-03,2023-10-20,448.84,-1261,4297018,344413796,107013117,4.79381203417299,58.2116829605746,0.260258925353789
465.91,456,15307,16114,10163848,15968974,2023-08-03,2023-09-15,448.84,807,5805126,612682077,237570121,2.60640462639158,45.7786990233762,0.363525295989586
429.68,425,31541,33026,10124661,15456168,2023-08-03,2023-10-20,448.84,1485,5331507,344413796,107013117,4.48767389097271,62.6993568515473,0.344943649680826
426.59,420,23284,23453,12224100,15455527,2023-08-03,2023-12-15,448.84,169,3231427,463353257,105207973,3.33558181938063,43.1868050945847,0.209079056314288
418.37,415,45814,45540,10903732,15346980,2023-08-03,2023-10-20,448.84,-274,4443248,344413796,107013117,4.45597132816364,67.1553281797109,0.289519371237859
466.91,455,12423,12684,11081316,15106644,2023-08-03,2023-10-20,448.84,261,4025328,344413796,107013117,4.38619015133761,71.5415183310485,0.26646077050601
450.69,440,13325,13691,11113050,14635679,2023-08-03,2023-12-15,448.84,366,3522629,463353257,105207973,3.15864381633126,46.3454489109159,0.240687774034946
400.95,400,151241,151523,9376942,14394685,2023-08-03,2023-09-15,448.84,282,5017743,612682077,237570121,2.3494542341574,48.1281532575336,0.348583036030313
429.74,427,51661,51504,7955794,14112096,2023-08-03,2023-09-15,448.84,-157,6156302,612682077,237570121,2.30333096556373,50.4314842230973,0.436242922383748
421.94,420,69199,71341,8234681,13840154,2023-08-03,2023-09-15,448.84,2142,5605473,612682077,237570121,2.25894546610019,52.6904296891975,0.405015218761294
457.29,445,10615,10594,9808260,13020026,2023-08-03,2023-12-15,448.84,-21,3211766,463353257,105207973,2.80995672379616,49.1554056347121,0.246678923682641
422.85,420,45070,45671,8337950,13016235,2023-08-03,2023-09-29,448.84,601,4678285,193559650,66678490,6.7246634306272,36.2896802096925,0.359419217615539
441.62,440,80373,78834,6108348,12771108,2023-08-03,2023-08-18,448.84,-1539,6662760,303147069,149589725,4.21284231516024,40.9556917075124,0.521705712613189
463.19,456,17822,17534,6790182,12606946,2023-08-03,2023-08-18,448.84,-288,5816764,303147069,149589725,4.15868972165454,45.114381429167,0.461393584140045
460.07,454,20108,20320,6153048,12334240,2023-08-03,2023-08-18,448.84,212,6181192,303147069,149589725,4.06873140508576,49.1831128342527,0.501140889102207
459.81,455,31521,24535,4412940,11801335,2023-08-03,2023-08-04,448.84,-6986,7388395,64122278,31929455,18.4044225627792,18.4044225627792,0.626064339331101
467.13,458,12746,12714,6041604,11607882,2023-08-03,2023-08-18,448.84,-32,5566278,303147069,149589725,3.82912559184268,53.0122384260954,0.479525722263545
462.92,454,12044,12916,7142092,11521072,2023-08-03,2023-09-15,448.84,872,4378980,612682077,237570121,1.88043235349938,54.5708620426969,0.380084422699554
416.62,415,69474,69543,6877926,11265966,2023-08-03,2023-09-15,448.84,69,4388040,612682077,237570121,1.83879477186012,56.409656814557,0.389495228371895
469.22,458,8817,10030,6559848,11253660,2023-08-03,2023-09-15,448.84,1213,4693812,612682077,237570121,1.83678622608051,58.2464430406375,0.417092039389852
460.09,452,12830,13844,6761410,11199796,2023-08-03,2023-09-15,448.84,1014,4438386,612682077,237570121,1.82799471707086,60.0744377577084,0.396291682455645
411.31,410,84068,85206,7061712,11161986,2023-08-03,2023-09-15,448.84,1138,4100274,612682077,237570121,1.82182349035812,61.8962612480665,0.367342693316405
455.98,449,14349,15951,6485748,11133798,2023-08-03,2023-09-15,448.84,1602,4648050,612682077,237570121,1.81722273556894,63.7134839836355,0.417472097122653
448.35,443,19850,20177,6629900,10794695,2023-08-03,2023-09-15,448.84,327,4164795,612682077,237570121,1.76187543348032,65.4753594171158,0.385818682232337
456.21,453,34484,33306,2827688,10691226,2023-08-03,2023-08-04,448.84,-1178,7863538,64122278,31929455,16.6731849420571,35.0776075048363,0.735513214293665
428.42,425,31167,31199,6950241,10670058,2023-08-03,2023-09-29,448.84,32,3719817,193559650,66678490,5.51254251596343,41.8022227256559,0.348622003741685
470.41,460,11345,10217,6489340,10635897,2023-08-03,2023-08-18,448.84,-1128,4146557,303147069,149589725,3.50849409004182,56.5207325161372,0.389864343364739
372.49,370,41572,41702,8231256,10383798,2023-08-03,2023-12-15,448.84,130,2152542,463353257,105207973,2.24101111692412,51.3964167516362,0.207298138889066
439.8,436,28352,26803,6634368,10185140,2023-08-03,2023-09-15,448.84,-1549,3550772,612682077,237570121,1.66238582494066,67.1377452420564,0.348622797526593
437.29,430,13786,13717,7196292,9999693,2023-08-03,2023-11-17,448.84,-69,2803401,178436543,50264301,5.60406115915393,14.9424381080954,0.280348706705296
461.82,450,6187,8394,5630170,9921708,2023-08-03,2023-11-17,448.84,2207,4291538,178436543,50264301,5.56035654647266,20.502794654568,0.432540244078943
351.89,350,52158,51879,7458594,9805131,2023-08-03,2023-12-15,448.84,-279,2346537,463353257,105207973,2.11612432887247,53.5125410805087,0.23931725134524
430.73,430,126656,130506,4559616,9526938,2023-08-03,2023-08-18,448.84,3850,4967322,303147069,149589725,3.14267857889136,59.6634110950286,0.521397536123359
385.67,385,141265,141186,6074395,9459462,2023-08-03,2023-09-15,448.84,-79,3385067,612682077,237570121,1.54394299345564,68.6816882355121,0.357849843891756
455.13,445,9529,9330,7518381,9451290,2023-08-03,2023-11-17,448.84,-199,1932909,178436543,50264301,5.29672332869619,25.7995179832642,0.204512717311605
452.02,445,13010,13369,6140720,9385038,2023-08-03,2023-09-29,448.84,359,3244318,193559650,66678490,4.84865414873399,46.6508768743899,0.345690448989125
476.4,462,5783,6475,5372407,9324000,2023-08-03,2023-09-15,448.84,692,3951593,612682077,237570121,1.52183332106841,70.2035215565805,0.423808773058773
409.99,405,18336,18357,7004352,9160143,2023-08-03,2023-12-15,448.84,21,2155791,463353257,105207973,1.97692427140962,55.4894653519183,0.23534468839624
483.5,465,3959,4948,5700960,9153800,2023-08-03,2023-11-17,448.84,989,3452840,178436543,50264301,5.13000299495827,30.9295209782225,0.377202910266774
442.8,435,11740,11677,6997040,9108060,2023-08-03,2023-11-17,448.84,-63,2111020,178436543,50264301,5.10436923225979,36.0338902104823,0.231774933410628
377.86,375,32291,31845,6910274,9107670,2023-08-03,2023-12-15,448.84,-446,2197396,463353257,105207973,1.9655996504628,57.4550650023811,0.241268732837268
448.83,440,10261,10275,6967219,9072825,2023-08-03,2023-11-17,448.84,14,2105606,178436543,50264301,5.08462271654747,41.1185129270298,0.232078321801644
445.85,440,14229,15055,5535081,8807175,2023-08-03,2023-09-29,448.84,826,3272094,193559650,66678490,4.55010897157543,51.2009858459653,0.371525943335973
421.12,415,13425,13784,6390300,8435808,2023-08-03,2023-12-15,448.84,359,2045508,463353257,105207973,1.82059969851469,59.2756647008958,0.242479202940607
455.81,450,14948,14472,5172008,8408232,2023-08-03,2023-09-01,448.84,-476,3236224,91969817,42577148,9.14238200560951,9.14238200560951,0.384887572084119
393.72,390,22248,22265,6318432,8282580,2023-08-03,2023-12-15,448.84,17,1964148,463353257,105207973,1.78753032915446,61.0631950300503,0.23714204994096
419.95,418,40606,40873,4466660,7970235,2023-08-03,2023-09-15,448.84,267,3503575,612682077,237570121,1.30087614754887,71.5043977041294,0.439582396253059
451.41,448,22098,23340,3624072,7958940,2023-08-03,2023-08-18,448.84,1242,4334868,303147069,149589725,2.62543854580365,62.2888496408323,0.544653936328205
456.98,452,17212,15973,4320212,7954554,2023-08-03,2023-08-18,448.84,-1239,3634342,303147069,149589725,2.62399172330444,64.9128413641367,0.456888217742943
402.24,400,35648,35455,5810624,7941920,2023-08-03,2023-10-20,448.84,-193,2131296,344413796,107013117,2.3059238892974,73.8474422203459,0.268360295747124
435.18,432,26047,24362,5079165,7747116,2023-08-03,2023-09-15,448.84,-1685,2667951,612682077,237570121,1.26445938127222,72.7688570854016,0.344379895692797
482,465,4561,4486,5974910,7626200,2023-08-03,2023-10-20,448.84,-75,1651290,344413796,107013117,2.21425508750526,76.0616973078512,0.216528546327135
437.51,434,35705,20525,7605165,7204275,2023-08-03,2023-09-15,448.84,-15180,-400889.999999999,612682077,237570121,1.17585861745389,73.9447157028555,-0.0556461267788916
381.39,380,52070,51569,5363210,7168091,2023-08-03,2023-10-20,448.84,-501,1804881,344413796,107013117,2.08124386515574,78.1429411730069,0.251793817907725
438.18,431,9785,9785,5303470,7025630,2023-08-03,2023-11-17,448.84,0,1722160,178436543,50264301,3.93732689609437,45.0558398231241,0.245125348189415
468.63,456,2735,5503,2497055,6950289,2023-08-03,2023-10-20,448.84,2768,4453234,344413796,107013117,2.01800539952819,80.1609465725351,0.640726450367747
478.02,464,4944,4943,4192512,6930086,2023-08-03,2023-08-25,448.84,-1,2737574,97519709,36213018,7.10634401093219,7.10634401093219,0.395027421016132
471.66,458,4087,5035,4029782,6877810,2023-08-03,2023-10-20,448.84,948,2848028,344413796,107013117,1.99696123670958,82.1579078092447,0.41408936856354
451.47,450,43389,46403,1562004,6821241,2023-08-03,2023-08-04,448.84,3014,5259237,64122278,31929455,10.6378644252158,45.7154719300522,0.771008823760955
448.83,446,22135,23998,2966090,6791434,2023-08-03,2023-08-18,448.84,1863,3825344,303147069,149589725,2.24030996651332,67.15315133065,0.563260130334772
362.21,360,30912,30690,5162304,6782490,2023-08-03,2023-12-15,448.84,-222,1620186,463353257,105207973,1.46378381883264,62.5269788488829,0.238877757283829
452.02,446,12126,11200,4717014,6742400,2023-08-03,2023-09-15,448.84,-926,2025386,612682077,237570121,1.10047286400382,75.0451885668593,0.300395408163265
462.47,455,8343,8686,3529089,6488442,2023-08-03,2023-08-25,448.84,343,2959353,97519709,36213018,6.65346735191755,13.7598113628497,0.456096085932493
424.12,422,31422,30454,4084860,6456248,2023-08-03,2023-09-15,448.84,-968,2371388,612682077,237570121,1.05376805399842,76.0989566208577,0.367301256085578
397.03,395,31568,31569,4545792,6408507,2023-08-03,2023-10-20,448.84,1,1862715,344413796,107013117,1.86069985419516,84.0186076634398,0.290662864220949
453.16,442,5415,5708,4646070,6370128,2023-08-03,2023-12-15,448.84,293,1724058,463353257,105207973,1.37478865288304,63.9017675017659,0.270647308813889
390.57,390,111373,111379,3675309,6348603,2023-08-03,2023-09-08,448.84,6,2673294,29175941,13324771,21.7597197636231,21.7597197636231,0.421083819542661
436.31,433,18754,19126,3863324,6330706,2023-08-03,2023-09-15,448.84,372,2467382,612682077,237570121,1.03327749213725,77.132234112995,0.38974831559071
423.14,421,29501,29440,3658124,6300160,2023-08-03,2023-09-15,448.84,-61,2642036,612682077,237570121,1.02829187216456,78.1605259851595,0.419360143234458
443.74,439,9403,13133,2548213,6225042,2023-08-03,2023-09-15,448.84,3730,3676829,612682077,237570121,1.0160313535661,79.1765573387256,0.590651275927134
403.28,400,18222,18403,4591944,6036184,2023-08-03,2023-11-17,448.84,181,1444240,178436543,50264301,3.38281828291193,48.4386581060361,0.239263746764512
399.14,395,14389,14488,4575702,5998032,2023-08-03,2023-12-15,448.84,99,1422330,463353257,105207973,1.29448361684873,65.1962511186147,0.237132779551693
434.19,430,14072,14176,3771296,5939744,2023-08-03,2023-09-29,448.84,104,2168448,193559650,66678490,3.06868916119656,54.2696750071619,0.36507431970132
449.74,444,9387,10293,3313611,5908182,2023-08-03,2023-09-15,448.84,906,2594571,612682077,237570121,0.964314482468532,80.1408718211942,0.439148793994498
425.66,420,10645,10413,4236710,5893758,2023-08-03,2023-11-17,448.84,-232,1657048,178436543,50264301,3.30299943100781,51.7416575370439,0.281153043609867
502.16,475,2119,2119,4615182,5755204,2023-08-03,2023-12-15,448.84,0,1140022,463353257,105207973,1.24207694950982,66.4383280681245,0.198085419734904
461.56,456,13056,10344,2363136,5751264,2023-08-03,2023-08-04,448.84,-2712,3388128,64122278,31929455,8.96921347678883,54.684685406841,0.589110150394765
465.43,457,6893,6800,2915739,5732400,2023-08-03,2023-08-18,448.84,-93,2816661,303147069,149589725,1.89096335943792,69.0441146900879,0.491358069918359
466.8,458,13004,6446,3706140,5672480,2023-08-03,2023-08-04,448.84,-6558,1966340,64122278,31929455,8.84634822237601,63.531033629217,0.346645558908978
479.87,465,3823,3806,3865053,5659522,2023-08-03,2023-08-25,448.84,-17,1794469,97519709,36213018,5.80346481550719,19.5632761783569,0.317070770287667
475.96,460,2783,3520,3478750,5617920,2023-08-03,2023-11-17,448.84,737,2139170,178436543,50264301,3.14841338301426,54.8900709200581,0.38077615914787
474.25,462,4585,4573,3383730,5601925,2023-08-03,2023-08-25,448.84,-12,2218195,97519709,36213018,5.74440290833928,25.3076790866962,0.395970135266002
385.37,385,151184,151385,3174864,5601245,2023-08-03,2023-09-01,448.84,201,2426381,91969817,42577148,6.09030786698206,15.2326898725916,0.433186014894903
434.24,431,17312,17083,3254656,5534892,2023-08-03,2023-09-15,448.84,-229,2280236,612682077,237570121,0.903387288086118,81.0442591092803,0.411974795533499
459.45,453,9307,8558,3331906,5519910,2023-08-03,2023-08-25,448.84,-749,2188004,97519709,36213018,5.66030196008891,30.9679810467851,0.396383999014477
477.81,462,2994,3428,3488010,5419668,2023-08-03,2023-10-20,448.84,434,1931658,344413796,107013117,1.57359201720247,85.5921996806423,0.356416297086833
482.55,466,3233,3236,3766445,5355580,2023-08-03,2023-09-15,448.84,3,1589135,612682077,237570121,0.874120559593259,81.9183796688735,0.296725097935238
443.24,440,16101,16481,2833776,5339844,2023-08-03,2023-09-01,448.84,380,2506068,91969817,42577148,5.80608309789287,21.0387729704844,0.469314833916496
420.4,420,117964,131735,2713172,5269400,2023-08-03,2023-08-18,448.84,13771,2556228,303147069,149589725,1.73823221098008,70.782346901068,0.485107981933427
464.25,457,7219,7253,2526650,5258425,2023-08-03,2023-08-11,448.84,34,2731775,61838439,35859636,8.50348922940956,8.50348922940956,0.519504414344599
465.66,455,4780,4923,3475060,5247918,2023-08-03,2023-09-29,448.84,143,1772858,193559650,66678490,2.71126652688202,56.9809415340439,0.337821208334429
367.42,365,21465,21466,3885165,5194772,2023-08-03,2023-12-15,448.84,1,1309607,463353257,105207973,1.12112560374211,67.5594536718666,0.252100958425124
471.28,460,4701,4602,2416314,5191056,2023-08-03,2023-08-11,448.84,-99,2774742,61838439,35859636,8.39454566438846,16.898034893798,0.534523611380806
442.11,438,11263,12609,2883328,5182299,2023-08-03,2023-09-15,448.84,1346,2298971,612682077,237570121,0.845838191542202,82.7642178604157,0.44361990691776
406.24,405,41697,41642,3002184,5163608,2023-08-03,2023-09-15,448.84,-55,2161424,612682077,237570121,0.842787506578228,83.607005366994,0.418587933088647
419.98,415,10536,10340,3771888,5149320,2023-08-03,2023-11-17,448.84,-196,1377432,178436543,50264301,2.88579901483521,57.7758699348933,0.267497844375568
476.15,463,3927,3903,3051279,5132445,2023-08-03,2023-08-25,448.84,-24,2081166,97519709,36213018,5.26298227571618,36.2309633225013,0.405492119253105
383.07,380,16663,16653,3899142,5112471,2023-08-03,2023-12-15,448.84,-10,1213329,463353257,105207973,1.1033635617673,68.6628172336339,0.237327311978885
391.77,390,28486,28673,3617722,5075121,2023-08-03,2023-10-20,448.84,187,1457399,344413796,107013117,1.47355334163211,87.0657530222744,0.287165370047335
446.3,444,20731,21760,2301141,5004800,2023-08-03,2023-08-18,448.84,1029,2703659,303147069,149589725,1.65094784406443,72.4332947451324,0.540213195332481
465.9,458,6359,6324,2543600,4995960,2023-08-03,2023-08-11,448.84,-35,2452360,61838439,35859636,8.07905257763703,24.977087471435,0.490868621846452
457.8,454,16695,13064,1819755,4964320,2023-08-03,2023-08-04,448.84,-3631,3144565,64122278,31929455,7.74195826293009,71.2729918921471,0.633433179166532
407.74,405,17712,18079,3259008,4953646,2023-08-03,2023-10-20,448.84,367,1694638,344413796,107013117,1.43828326783983,88.5040362901142,0.342099132638869
370.48,370,103073,103102,3298336,4948896,2023-08-03,2023-09-15,448.84,29,1650560,612682077,237570121,0.807742903829061,84.414748270823,0.333520849902685
482.17,466,3056,3054,3327984,4938318,2023-08-03,2023-09-01,448.84,-2,1610334,91969817,42577148,5.36949856059842,26.4082715310829,0.326089571388477
436.06,435,47913,46505,2395650,4929530,2023-08-03,2023-08-18,448.84,-1408,2533880,303147069,149589725,1.62611831157107,74.0594130567035,0.514020606426982
439.33,432,6786,6723,3745872,4927959,2023-08-03,2023-11-17,448.84,-63,1182087,178436543,50264301,2.76174314809495,60.5376130829883,0.23987354602585
447.85,443,10043,10036,2460535,4867460,2023-08-03,2023-09-08,448.84,-7,2406925,29175941,13324771,16.6831294318836,38.4428491955067,0.494493021000686
425.54,425,75453,90094,2037231,4865076,2023-08-03,2023-08-18,448.84,14641,2827845,303147069,149589725,1.60485668426502,75.6642697409685,0.581254023575377
449.06,447,5233,23319,408174,4803714,2023-08-03,2023-08-11,448.84,18086,4395540,61838439,35859636,7.76816827475221,32.7452557461873,0.915029495927526
388.26,385,14824,14717,3824592,4797742,2023-08-03,2023-12-15,448.84,-107,973150,463353257,105207973,1.03543936025468,69.6982565938886,0.202835000298057
461.28,448,3613,3608,3587709,4791424,2023-08-03,2023-12-15,448.84,-5,1203715,463353257,105207973,1.03407582176551,70.7323324156541,0.251222809753426
448.44,445,14461,13870,2675285,4771280,2023-08-03,2023-08-25,448.84,-591,2095995,97519709,36213018,4.89263149872607,41.1235948212274,0.439294067839238
418.88,417,25481,25315,2675505,4759220,2023-08-03,2023-09-15,448.84,-166,2083715,612682077,237570121,0.776784596556755,85.1915328673798,0.43782699686083
443.68,438,8748,8287,3149280,4707016,2023-08-03,2023-09-29,448.84,-461,1557736,193559650,66678490,2.43181675519665,59.4127582892406,0.33093917675232
441.37,437,10148,10628,2496408,4644436,2023-08-03,2023-09-15,448.84,480,2148028,612682077,237570121,0.758049920889068,85.9495827882689,0.462494907885479
447.24,442,7378,8849,2316692,4636876,2023-08-03,2023-09-15,448.84,1471,2320184,612682077,237570121,0.756816001980094,86.7063987902489,0.500376546623201
390.72,390,64362,63919,3153738,4602168,2023-08-03,2023-09-15,448.84,-443,1448430,612682077,237570121,0.751151073740321,87.4575498639893,0.314727754397493
453.46,447,7487,7097,3062183,4584662,2023-08-03,2023-09-15,448.84,-390,1522479,612682077,237570121,0.748293800668825,88.2058436646581,0.332080969109609
405.82,405,55760,55834,2732240,4578388,2023-08-03,2023-09-08,448.84,74,1846148,29175941,13324771,15.6923404801237,54.1351896756304,0.403231006196941
439.35,438,36755,33851,2352320,4569885,2023-08-03,2023-08-18,448.84,-2904,2217565,303147069,149589725,1.50748117574576,77.1717509167143,0.485256193536599
400.57,400,78522,78632,2434182,4482024,2023-08-03,2023-09-01,448.84,110,2047842,91969817,42577148,4.87336405159967,31.2816355826825,0.456901167865232
406.74,405,25031,25085,2953658,4364790,2023-08-03,2023-09-29,448.84,54,1411132,193559650,66678490,2.25501027719362,61.6677685664342,0.323298944508212
486.11,465,1985,2047,3162105,4321217,2023-08-03,2023-12-15,448.84,62,1159112,463353257,105207973,0.932596660262604,71.6649290759167,0.268237397011074
452,441,3922,3919,3282714,4310900,2023-08-03,2023-12-15,448.84,-3,1028186,463353257,105207973,0.930370065360305,72.595299141277,0.238508432113944
452.85,449,15737,11139,2864134,4288515,2023-08-03,2023-08-18,448.84,-4598,1424381,303147069,149589725,1.41466484045076,78.586415757165,0.332138514147671
411.06,407,10533,10532,3138834,4275992,2023-08-03,2023-11-17,448.84,-1,1137158,178436543,50264301,2.39636563683034,62.9339787198186,0.265940160786082
443.98,442,21889,21576,1948121,4272048,2023-08-03,2023-08-18,448.84,-313,2323927,303147069,149589725,1.40923282355733,79.9956485807224,0.543984290438684
468.47,459,4763,4502,2110009,4263394,2023-08-03,2023-08-11,448.84,-261,2153385,61838439,35859636,6.89440753832741,39.6396632845147,0.505087026908609
417.57,415,16086,16465,2589846,4231505,2023-08-03,2023-09-29,448.84,379,1641659,193559650,66678490,2.18615036759986,63.853918934034,0.387961020960627
453.1,450,14081,13540,1760125,4197400,2023-08-03,2023-08-11,448.84,-541,2437275,61838439,35859636,6.78768750938231,46.427350793897,0.580663029494449
462.33,456,7152,6582,2145600,4166406,2023-08-03,2023-08-11,448.84,-570,2020806,61838439,35859636,6.73756658055356,53.1649173744505,0.48502378308787
449.21,445,10339,9810,2491699,4130010,2023-08-03,2023-09-01,448.84,-529,1638311,91969817,42577148,4.4906145676032,35.7722501502857,0.396684511659778
376.29,375,31842,32002,2961306,4128258,2023-08-03,2023-10-20,448.84,160,1166952,344413796,107013117,1.19863316973516,89.7026694598494,0.282674193328033
445.75,441,7933,8468,2371967,4022300,2023-08-03,2023-09-15,448.84,535,1650333,612682077,237570121,0.656506881953395,88.8623505466115,0.410295850632723
471.12,455,2808,2480,3392064,3997760,2023-08-03,2023-12-15,448.84,-328,605696.000000001,463353257,105207973,0.862788798741518,73.4580879400185,0.151508844953174
382.65,382,61290,61253,2696760,3981445,2023-08-03,2023-09-15,448.84,-37,1284685,612682077,237570121,0.64983866012454,89.512189206736,0.322668026307032
468.78,454,2728,2689,3159024,3974342,2023-08-03,2023-12-15,448.84,-39,815318,463353257,105207973,0.857734771464011,74.3158227114825,0.205145405201666
459.75,447,3067,3108,2971923,3962700,2023-08-03,2023-12-15,448.84,41,990777,463353257,105207973,0.855222217635129,75.1710449291177,0.25002574002574
455.08,450,9280,7780,2607680,3952240,2023-08-03,2023-08-25,448.84,-1500,1344560,97519709,36213018,4.05276024767465,45.176355068902,0.340202012023561
469.11,457,3068,3233,2417584,3915163,2023-08-03,2023-09-29,448.84,165,1497579,193559650,66678490,2.02271651142167,65.8766354454557,0.382507446050139
468.92,459,3968,3905,2313344,3873760,2023-08-03,2023-08-25,448.84,-63,1560416,97519709,36213018,3.97228420769795,49.1486392766,0.402816901408451
321.11,320,34542,34543,3074238,3834273,2023-08-03,2023-12-15,448.84,1,760035.000000001,463353257,105207973,0.827505351926338,75.998550281044,0.198221409899608
454.68,448,5726,5732,2479358,3828976,2023-08-03,2023-09-15,448.84,6,1349618,612682077,237570121,0.624953159842474,90.1371423665785,0.352474917575874
395.9,395,42122,42412,2274588,3817080,2023-08-03,2023-09-15,448.84,290,1542492,612682077,237570121,0.623011532945495,90.760153899524,0.40410261246817
461.08,455,6488,6263,1699856,3807904,2023-08-03,2023-08-11,448.84,-225,2108048,61838439,35859636,6.15782684941319,59.3227442238637,0.553597989865291
386.7,385,22428,22365,2579220,3802050,2023-08-03,2023-10-20,448.84,-63,1222830,344413796,107013117,1.10391919375959,90.806588653609,0.321623860811931
468.7,459,4069,3914,2083328,3796580,2023-08-03,2023-08-18,448.84,-155,1713252,303147069,149589725,1.25238881989652,81.2480374006189,0.45126192520637
467.48,453,2602,2610,2976688,3779280,2023-08-03,2023-12-15,448.84,8,802592.000000001,463353257,105207973,0.815636869473867,76.8141871505179,0.212366376664338
470.5,460,3450,3431,2221800,3602550,2023-08-03,2023-08-25,448.84,-19,1380750,97519709,36213018,3.69417632286003,52.84281559946,0.383270183619936
448.21,439,3300,3883,2174700,3576243,2023-08-03,2023-11-17,448.84,583,1401543,178436543,50264301,2.00420997844595,64.9381886982646,0.391903738084912
454.53,452,15002,13986,960128,3538458,2023-08-03,2023-08-04,448.84,-1016,2578330,64122278,31929455,5.51829740047601,76.7912892926231,0.728659206920077
418.43,418,84372,81376,1771812,3499168,2023-08-03,2023-08-18,448.84,-2996,1727356,303147069,149589725,1.15428066368671,82.4023180643056,0.493647632808713
380.56,380,62284,62348,2304508,3491488,2023-08-03,2023-09-15,448.84,64,1186980,612682077,237570121,0.569869452864703,91.3300233523887,0.339963935147421
447.8,446,4939,19359,340791,3484620,2023-08-03,2023-08-11,448.84,14420,3143829,61838439,35859636,5.63503874992705,64.9577829737908,0.902201387812731
448.22,442,5469,5575,2275104,3467650,2023-08-03,2023-09-29,448.84,106,1192546,193559650,66678490,1.79151491542788,67.6681503608836,0.343906103557164
480.48,465,2227,2232,2298264,3455136,2023-08-03,2023-09-01,448.84,5,1156872,91969817,42577148,3.75681512990289,39.5290652801886,0.334826762246117
465.56,454,3007,2964,2543922,3426384,2023-08-03,2023-10-20,448.84,-43,882462.000000001,344413796,107013117,0.994845165842312,91.8014338194513,0.257549066304302
414.46,410,7403,7624,2361557,3400304,2023-08-03,2023-11-17,448.84,221,1038747,178436543,50264301,1.90560965978813,66.8437983580527,0.305486509441509
445.55,437,3897,3970,2478492,3394350,2023-08-03,2023-11-17,448.84,73,915858,178436543,50264301,1.90227289933542,68.7460712573881,0.269818374651995
450.09,449,35143,30171,1019147,3288639,2023-08-03,2023-08-04,448.84,-4972,2269492,64122278,31929455,5.12869957614419,81.9199888687673,0.690100676906161
300.87,300,37222,37228,2419430,3238836,2023-08-03,2023-12-15,448.84,6,819406,463353257,105207973,0.698999295045422,77.5131864455633,0.252993976848473
462.71,453,2764,3335,1865700,3238285,2023-08-03,2023-09-29,448.84,571,1372585,193559650,66678490,1.67301656104462,69.3411669219282,0.423861704575107
472.06,460,2505,2685,1713420,3238110,2023-08-03,2023-09-01,448.84,180,1524690,91969817,42577148,3.52083988598129,43.0499051661699,0.470858000500292
442.46,440,9562,13070,1176126,3215220,2023-08-03,2023-08-25,448.84,3508,2039094,97519709,36213018,3.29699507204231,56.1398106715023,0.634200459066565
477.75,463,2177,2176,1889636,3209600,2023-08-03,2023-09-01,448.84,-1,1319964,91969817,42577148,3.48984058541728,46.5397457515872,0.411254985044865
446.94,438,3308,3586,2107196,3205884,2023-08-03,2023-11-17,448.84,278,1098688,178436543,50264301,1.79665215773655,70.5427234151247,0.342709842277512
464.54,454,2917,3041,2068153,3205214,2023-08-03,2023-09-29,448.84,124,1137061,193559650,66678490,1.65593087195601,70.9970977938842,0.354753535957349
442.03,434,3992,3949,2267456,3171047,2023-08-03,2023-11-17,448.84,-43,903591,178436543,50264301,1.77712869050596,72.3198521056306,0.284950364974092
439.9,434,141,5366,59502,3165940,2023-08-03,2023-10-20,448.84,5225,3106438,344413796,107013117,0.919225663074194,92.7206594825255,0.981205581912481
482.35,464,1683,1717,2135727,3150695,2023-08-03,2023-10-20,448.84,34,1014968,344413796,107013117,0.914799301477459,93.6354587840029,0.322140987940756
472.43,461,2778,2692,1894596,3076956,2023-08-03,2023-08-25,448.84,-86,1182360,97519709,36213018,3.1552145013066,59.2950251728089,0.384262888387094
454.4,443,2655,2652,2368260,3023280,2023-08-03,2023-12-15,448.84,-3,655020,463353257,105207973,0.652478417778771,78.1656648633421,0.216658728268635
477.56,459,1880,1626,2402640,3017856,2023-08-03,2023-12-15,448.84,-254,615216,463353257,105207973,0.651307820633276,78.8169726839753,0.20385863341392
474.25,460,2102,2111,1946452,3008175,2023-08-03,2023-09-29,448.84,9,1061723,193559650,66678490,1.55413331239233,72.5512311062765,0.352945889118818
413.24,409,7446,7075,2323152,2999800,2023-08-03,2023-11-17,448.84,-371,676648,178436543,50264301,1.68115787806985,74.0010099837005,0.225564370958064
466.65,456,2717,2771,2132845,2951115,2023-08-03,2023-09-29,448.84,54,818270,193559650,66678490,1.52465402784103,74.0758851341176,0.277274860518821
447.68,437,2755,2757,2052475,2944476,2023-08-03,2023-12-15,448.84,2,892001,463353257,105207973,0.635471091552077,79.4524437755274,0.302940489241549
431.12,425,4977,4810,2239650,2943720,2023-08-03,2023-11-17,448.84,-167,704070,178436543,50264301,1.64972933823314,75.6507393219336,0.239176959765195
375.52,375,55723,55784,1894582,2900768,2023-08-03,2023-09-15,448.84,61,1006186,612682077,237570121,0.473454032506324,91.803477384895,0.3468688292204
442.08,433,3185,3175,2229500,2882900,2023-08-03,2023-12-15,448.84,-10,653400,463353257,105207973,0.622181878825123,80.0746256543525,0.226646779284748
462.14,449,2189,2191,2265615,2878974,2023-08-03,2023-12-15,448.84,2,613359,463353257,105207973,0.621334577130209,80.6959602314827,0.213047773269227
410.27,410,106793,106567,1708688,2877309,2023-08-03,2023-08-18,448.84,-226,1168621,303147069,149589725,0.949146237663278,83.3514643019689,0.406150677594933
452.94,451,14233,14791,683184,2869454,2023-08-03,2023-08-04,448.84,558,2186270,64122278,31929455,4.47497202142444,86.3949608901917,0.761911499539634
460.17,451,2686,3102,1633088,2844534,2023-08-03,2023-09-29,448.84,416,1211446,193559650,66678490,1.46959038208635,75.5454755162039,0.42588557563383
444.02,436,3524,3538,2114400,2837476,2023-08-03,2023-11-17,448.84,14,723076,178436543,50264301,1.59018772292624,77.2409270448599,0.25483070165175
357.02,355,14026,14025,2258186,2833050,2023-08-03,2023-12-15,448.84,-1,574864,463353257,105207973,0.611423348643905,81.3073835801266,0.20291346781737
461.09,454,3349,3878,1312808,2749502,2023-08-03,2023-08-25,448.84,529,1436694,97519709,36213018,2.81943212115204,62.114457293961,0.522528807034874
458.84,453,3402,4698,942354,2743632,2023-08-03,2023-08-18,448.84,1296,1801278,303147069,149589725,0.905049819234769,84.2565141212037,0.656530467642891
360.96,360,28301,28312,2037672,2717952,2023-08-03,2023-10-20,448.84,11,680280,344413796,107013117,0.789153057039562,94.4246118410425,0.250291395874541
490.9,470,1468,1294,2128600,2704460,2023-08-03,2023-09-15,448.84,-174,575860,612682077,237570121,0.441413271503289,92.2448906563983,0.212929753074551
433.46,427,3929,4150,1921281,2680900,2023-08-03,2023-11-17,448.84,221,759619,178436543,50264301,1.50243888103122,78.7433659258911,0.283344772277966
427.67,421,3654,4016,1922004,2678672,2023-08-03,2023-12-15,448.84,362,756668,463353257,105207973,0.578105788517205,81.8854893686438,0.282478780530054
471.58,459,2123,2113,1921315,2658154,2023-08-03,2023-09-29,448.84,-10,736839,193559650,66678490,1.37329965207108,76.918775168275,0.277199515152245
415.31,415,81620,85014,1469160,2635434,2023-08-03,2023-08-18,448.84,3394,1166274,303147069,149589725,0.869358232191913,85.1258723533956,0.442535840396686
474.4,457,1734,1501,2195244,2611740,2023-08-03,2023-12-15,448.84,-233,416496,463353257,105207973,0.563660654272686,82.4491500229165,0.159470697695789
387.44,385,10456,10607,1955272,2588108,2023-08-03,2023-11-17,448.84,151,632836,178436543,50264301,1.45043608023722,80.1938020061283,0.24451684396478
440.13,438,11964,11977,1304076,2551101,2023-08-03,2023-08-25,448.84,13,1247025,97519709,36213018,2.61598504154683,64.7304423355078,0.488818357250458
481.2,465,1579,1566,1871115,2536920,2023-08-03,2023-09-29,448.84,-13,665805,193559650,66678490,1.31066573017672,78.2294408984517,0.262446194598174
456.15,444,2067,2076,1930578,2522340,2023-08-03,2023-12-15,448.84,9,591762,463353257,105207973,0.544366519905567,82.9935165428221,0.234608339874878
461.97,452,2030,2524,1321530,2516428,2023-08-03,2023-09-29,448.84,494,1194898,193559650,66678490,1.30007881291375,79.5295197113655,0.474838938368195
432.3,426,3909,3908,1817685,2462040,2023-08-03,2023-11-17,448.84,-1,644355,178436543,50264301,1.37978463301657,81.5735866391449,0.26171589413657
440.72,438,1504,9046,233120,2460512,2023-08-03,2023-09-01,448.84,7542,2227392,91969817,42577148,2.67534728268515,49.2150930342723,0.905255491539972
447.88,438,2386,2470,1803816,2440360,2023-08-03,2023-12-15,448.84,84,636544,463353257,105207973,0.526673755527308,83.5201902983494,0.260840203904342
341.58,340,15391,15416,1862311,2435728,2023-08-03,2023-12-15,448.84,25,573417.000000001,463353257,105207973,0.525674086283589,84.045864384633,0.235419143681068
463.64,457,11689,3636,2665092,2414304,2023-08-03,2023-08-04,448.84,-8053,-250788.000000001,64122278,31929455,3.76515631587512,90.1601172060668,-0.103875899638157
409.38,408,17373,17341,1372467,2393058,2023-08-03,2023-09-15,448.84,-32,1020591,612682077,237570121,0.390587237628627,92.6354778940269,0.426479842945721
467.36,458,2108,2555,1129888,2391480,2023-08-03,2023-08-25,448.84,447,1261592,97519709,36213018,2.45230428240921,67.182746617917,0.527536086440196
385.99,385,24099,24025,1807425,2378475,2023-08-03,2023-09-29,448.84,-74,571050,193559650,66678490,1.22880724365848,80.758326955024,0.240090814492479
441.3,432,2552,2549,1748120,2370570,2023-08-03,2023-12-15,448.84,-3,622450,463353257,105207973,0.511611813273604,84.5574761979066,0.262573980097614
370.78,370,30400,30287,1550400,2362386,2023-08-03,2023-09-29,448.84,-113,811986,193559650,66678490,1.22049507735729,81.9788220323812,0.343714363359756
449.72,439,2076,2166,1681560,2321952,2023-08-03,2023-12-15,448.84,90,640392,463353257,105207973,0.501119170939593,85.0585953688462,0.275798982924712
436.87,435,11464,12366,1008832,2312442,2023-08-03,2023-08-25,448.84,902,1303610,97519709,36213018,2.37125605040515,69.5540026683222,0.563737382386239
375.4,375,55573,55587,1444898,2223480,2023-08-03,2023-09-08,448.84,14,778582,29175941,13324771,7.62093671631705,61.7561263919474,0.350163707341645
410.33,409,16410,16693,1329210,2220169,2023-08-03,2023-09-15,448.84,283,890959,612682077,237570121,0.362368850558036,92.997846744585,0.401302333290844
433.97,432,5414,11253,568470,2216841,2023-08-03,2023-09-01,448.84,5839,1648371,91969817,42577148,2.41040057739813,51.6254936116705,0.74356753596672
360.39,360,56582,56735,1471132,2212665,2023-08-03,2023-09-15,448.84,153,741533,612682077,237570121,0.361144071789128,93.3589908163741,0.33513116535942
432.04,429,7211,7235,1218659,2199440,2023-08-03,2023-09-15,448.84,24,980781,612682077,237570121,0.358985529782357,93.7179763461564,0.445923053140799
456.95,451,3693,3647,1122672,2169965,2023-08-03,2023-08-25,448.84,-46,1047293,97519709,36213018,2.22515532731953,71.7791579956417,0.482631286679739
350.76,350,25089,28503,1455162,2166228,2023-08-03,2023-10-20,448.84,3414,711066,344413796,107013117,0.628960867758038,95.0535727088005,0.328250765847362
467.64,452,1374,1370,1530636,2142680,2023-08-03,2023-12-15,448.84,-4,612044,463353257,105207973,0.462429036082075,85.5210244049283,0.285644146582784
380.3,380,70937,71095,1418740,2132850,2023-08-03,2023-09-01,448.84,158,714110,91969817,42577148,2.3190760507874,53.9445696624579,0.334814919005087
474.33,458,1362,1305,1791030,2131065,2023-08-03,2023-12-15,448.84,-57,340035,463353257,105207973,0.459922309340754,85.980946714269,0.159561064538153
463.53,452,1743,1846,1345596,2128438,2023-08-03,2023-10-20,448.84,103,782842,344413796,107013117,0.617988601130252,95.6715613099308,0.367801176261653
475.54,461,1472,1462,1446976,2125748,2023-08-03,2023-09-29,448.84,-10,678772,193559650,66678490,1.09823922496243,83.0770612573437,0.319309720625399
392.72,390,7764,7783,1591620,2116976,2023-08-03,2023-11-17,448.84,19,525356,178436543,50264301,1.18640272020962,82.7599893593545,0.248163418007573
451.02,447,5134,5264,1108944,2116128,2023-08-03,2023-08-25,448.84,130,1007184,97519709,36213018,2.16994905101696,73.9491070466587,0.475956085832237
408.7,405,5457,5694,1560702,2106780,2023-08-03,2023-11-17,448.84,237,546078,178436543,50264301,1.1806886440296,83.9406780033841,0.259200296186598
458.76,452,3874,3114,1282294,2105064,2023-08-03,2023-08-25,448.84,-760,822770,97519709,36213018,2.15860365210893,76.1077106987676,0.390852724667754
475,462,1793,1617,1224619,2102100,2023-08-03,2023-08-18,448.84,-176,877481,303147069,149589725,0.69342580382989,85.8192981572255,0.417430664573522
400.21,400,97717,99877,1172604,2097417,2023-08-03,2023-08-18,448.84,2160,924813,303147069,149589725,0.691881009082097,86.5111791663076,0.440929486125077
412.24,408,4665,4894,1408830,2075056,2023-08-03,2023-11-17,448.84,229,666226,178436543,50264301,1.16290977459701,85.1035877779811,0.321064106221712
427.01,425,10272,10293,1068288,2068893,2023-08-03,2023-09-08,448.84,21,1000605,29175941,13324771,7.09109262319937,68.8472190151468,0.483642701676694
437.37,435,7855,8628,1021150,2044836,2023-08-03,2023-09-01,448.84,773,1023686,91969817,42577148,2.22337726299923,56.1679469254571,0.500620098628937
463.41,455,1876,2397,889224,2015877,2023-08-03,2023-09-01,448.84,521,1126653,91969817,42577148,2.19188975878902,58.3598366842461,0.558889753690329
381.98,379,6763,6763,1636646,2015374,2023-08-03,2023-12-15,448.84,0,378728,463353257,105207973,0.434954102416075,86.4159008166851,0.187919463087248
401.62,400,12625,12190,1313000,1974780,2023-08-03,2023-09-29,448.84,-435,661780,193559650,66678490,1.02024363032275,84.0973048876664,0.33511581036875
465.09,451,1359,1373,1497618,1934557,2023-08-03,2023-12-15,448.84,14,436939,463353257,105207973,0.417512334439035,86.8334131511241,0.225859977245437
457.55,453,3862,4245,753090,1931475,2023-08-03,2023-08-11,448.84,383,1178385,61838439,35859636,3.12342133992095,68.0812043137117,0.610095911155982
366.05,365,18415,18394,1399540,1931370,2023-08-03,2023-10-20,448.84,-21,531830,344413796,107013117,0.560770219552994,96.2323315294838,0.275364119769904
452.53,448,4249,4227,1015511,1914831,2023-08-03,2023-08-25,448.84,-22,899320,97519709,36213018,1.96353231529844,78.071243014066,0.469660246778959
396.46,395,12673,13051,1165916,1905446,2023-08-03,2023-09-29,448.84,378,739530,193559650,66678490,0.98442314810964,85.0817280357761,0.388113858907573
370.25,370,75929,76040,1214864,1901000,2023-08-03,2023-09-01,448.84,111,686136,91969817,42577148,2.06698247534841,60.4268191595945,0.36093424513414
472.89,461,1650,1584,1212750,1883376,2023-08-03,2023-09-01,448.84,-66,670626,91969817,42577148,2.04781966675002,62.4746388263445,0.35607653490328
450.03,447,6229,6177,921892,1871631,2023-08-03,2023-08-18,448.84,-52,949739,303147069,149589725,0.61740032855142,87.128579494859,0.507439233481386
432.84,432,22374,22277,917334,1871268,2023-08-03,2023-08-18,448.84,-97,953934,303147069,149589725,0.617280584692046,87.745860079551,0.50977946504723
425.41,423,6611,7751,872652,1867991,2023-08-03,2023-09-15,448.84,1140,995339,612682077,237570121,0.304887488980684,94.0228638351371,0.532839290981595
371.14,370,16476,16212,1383984,1848168,2023-08-03,2023-10-20,448.84,-264,464184,344413796,107013117,0.536612650673262,96.7689441801571,0.251158985546768
450.37,448,4395,7711,408735,1827507,2023-08-03,2023-08-11,448.84,3316,1418772,61838439,35859636,2.95529290446675,71.0364972181785,0.776342853953501
326.28,325,15071,14242,1522171,1822976,2023-08-03,2023-12-15,448.84,-829,300805,463353257,105207973,0.393431139731904,87.226844290856,0.165007657807892
463.86,456,2494,2311,1154722,1816446,2023-08-03,2023-08-25,448.84,-183,661724,97519709,36213018,1.86264501671144,79.9338880307775,0.364295993384885
455.53,451,2373,3974,522060,1800222,2023-08-03,2023-08-18,448.84,1601,1278162,303147069,149589725,0.593844435289592,88.3397045148406,0.710002433033259
295.87,295,20355,20352,1221300,1770624,2023-08-03,2023-12-15,448.84,-3,549324,463353257,105207973,0.382132632770077,87.6089769236261,0.310243168510085
391.22,390,14050,14422,1124000,1759484,2023-08-03,2023-09-29,448.84,372,635484,193559650,66678490,0.909013836303176,85.9907418720792,0.361176344882932
460.27,453,1848,2411,776160,1752797,2023-08-03,2023-09-01,448.84,563,976637,91969817,42577148,1.90583939076447,64.380478217109,0.557187740508456
336.44,335,12060,12062,1398960,1736928,2023-08-03,2023-12-15,448.84,2,337968,463353257,105207973,0.374860427494524,87.9838373511207,0.194578013596419
395.48,395,35829,35967,967383,1726416,2023-08-03,2023-09-01,448.84,138,759033,91969817,42577148,1.87715498009526,66.2576331972043,0.439658228376011
435.18,434,14767,14599,679282,1722682,2023-08-03,2023-08-18,448.84,-168,1043400,303147069,149589725,0.568266091334038,88.9079706061747,0.605683463343786
438.5,436,4551,6880,628038,1720000,2023-08-03,2023-09-01,448.84,2329,1091962,91969817,42577148,1.87017877832681,68.1278119755311,0.634861627906977
437.21,436,15429,14203,833166,1718563,2023-08-03,2023-08-18,448.84,-1226,885397,303147069,149589725,0.566907344896678,89.4748779510714,0.515196126065789
420.36,414,2609,2639,1215794,1678404,2023-08-03,2023-12-15,448.84,30,462610,463353257,105207973,0.362229891479969,88.3460672426006,0.275624938930079
412.26,410,7173,7404,968355,1673304,2023-08-03,2023-09-29,448.84,231,704949,193559650,66678490,0.86449009388062,86.8552319659599,0.421291648140445
451.63,449,5307,6321,578463,1662423,2023-08-03,2023-08-11,448.84,1014,1083960,61838439,35859636,2.68833273750652,73.724829955685,0.652036214609639
370.12,370,137314,137316,823884,1647792,2023-08-03,2023-08-18,448.84,2,823908,303147069,149589725,0.543561910539204,90.0184398616105,0.500007282472545
502.83,475,567,587,1155546,1633621,2023-08-03,2023-11-17,448.84,20,478075,178436543,50264301,0.915519305930512,86.0191070839116,0.292647437808402
458.41,446,1293,1294,1238694,1605854,2023-08-03,2023-12-15,448.84,1,367160,463353257,105207973,0.346572291386742,88.6926395339873,0.228638469001541
446.57,445,10198,10223,622078,1605011,2023-08-03,2023-08-11,448.84,25,982933,61838439,35859636,2.59549080790995,76.320320763595,0.61241511740418
433.6,432,9960,9985,766920,1597600,2023-08-03,2023-08-25,448.84,25,830680,97519709,36213018,1.63823294427591,81.5721209750534,0.519954932398598
453.68,449,4439,3393,1118628,1587924,2023-08-03,2023-08-25,448.84,-1046,469296,97519709,36213018,1.62831084740009,83.2004318224535,0.295540592622821
459,454,2748,3147,612804,1573500,2023-08-03,2023-08-11,448.84,399,960696,61838439,35859636,2.54453382951662,78.8648545931116,0.610547187797903
459.1,452,1861,2209,729512,1568390,2023-08-03,2023-09-01,448.84,348,838878,91969817,42577148,1.70533121752324,69.8331431930543,0.534865690293868
445.43,436,1651,1653,1238250,1558779,2023-08-03,2023-12-15,448.84,2,320529,463353257,105207973,0.336412656315913,89.0290521903033,0.205628251342878
465.74,457,1946,1782,969108,1557468,2023-08-03,2023-08-25,448.84,-164,588360,97519709,36213018,1.59708023739078,84.7975120598442,0.377766991039302
429.77,429,20065,20164,662145,1552628,2023-08-03,2023-08-18,448.84,99,890483,303147069,149589725,0.512169886755527,90.5306097483661,0.573532745770397
493.57,470,641,650,1171748,1532050,2023-08-03,2023-12-15,448.84,9,360302,463353257,105207973,0.330644055449037,89.3596962457523,0.235176397637153
413.55,412,10099,9830,908910,1523650,2023-08-03,2023-09-15,448.84,-269,614740,612682077,237570121,0.248685257362278,94.2715490924994,0.403465362780166
426.43,424,6410,6269,884580,1523367,2023-08-03,2023-09-15,448.84,-141,638787,612682077,237570121,0.248639067011585,94.520188159511,0.419325743566718
448.78,448,10153,19524,233519,1522872,2023-08-03,2023-08-04,448.84,9371,1289353,64122278,31929455,2.37494993549668,92.5350671415635,0.846658813084751
480.31,463,867,868,1319574,1502508,2023-08-03,2023-12-15,448.84,1,182934,463353257,105207973,0.324268358385576,89.6839646041379,0.121752429937145
331.35,330,11243,11080,1158029,1495800,2023-08-03,2023-12-15,448.84,-163,337771,463353257,105207973,0.322820650853869,90.0067852549917,0.225812942906806
375.79,375,18917,18890,1078269,1492310,2023-08-03,2023-09-29,448.84,-27,414041,193559650,66678490,0.77098196860761,87.6262139345675,0.277449725593208
415.72,414,8505,8660,859005,1489520,2023-08-03,2023-09-15,448.84,155,630515,612682077,237570121,0.243114668425334,94.7633028279363,0.423300794886944
474,461,1162,1139,729736,1480700,2023-08-03,2023-08-18,448.84,-23,750964,303147069,149589725,0.488442789463355,91.0190525378294,0.50716823124198
456.05,452,3123,3630,527787,1470150,2023-08-03,2023-08-11,448.84,507,942363,61838439,35859636,2.37740477245876,81.2422593655703,0.640997857361494
453.02,448,2862,2855,844290,1433210,2023-08-03,2023-09-01,448.84,-7,588920,91969817,42577148,1.55834821330568,71.39149140636,0.410909775957466
454.47,449,2530,2601,794420,1422747,2023-08-03,2023-09-01,448.84,71,628327,91969817,42577148,1.54697165484194,72.9384630612019,0.441629467501952
380.9,380,16043,15787,994666,1420830,2023-08-03,2023-09-29,448.84,-256,426164,193559650,66678490,0.734052784245064,88.3602667188125,0.299940175812729
479.04,464,941,930,859133,1398720,2023-08-03,2023-09-01,448.84,-11,539587,91969817,42577148,1.52084677954725,74.4593098407492,0.385771991535118
470.32,458,1248,1129,1053312,1390928,2023-08-03,2023-09-29,448.84,-119,337616,193559650,66678490,0.718604316550479,89.078871035363,0.242727157696157
377.53,377,25952,25962,986176,1375986,2023-08-03,2023-09-15,448.84,10,389810,612682077,237570121,0.224584013741274,94.9878868416776,0.28329503352505
428.64,426,5372,5211,805800,1375704,2023-08-03,2023-09-15,448.84,-161,569904,612682077,237570121,0.224537986607367,95.212424828285,0.414263533434518
474.75,462,1045,1076,830775,1371900,2023-08-03,2023-09-01,448.84,31,541125,91969817,42577148,1.49168503836427,75.9509948791134,0.394434725563088
403.07,402,12500,12628,812500,1351196,2023-08-03,2023-09-15,448.84,128,538696,612682077,237570121,0.220537869593989,95.4329626978789,0.398680872353086
431.23,430,11495,10811,712690,1329753,2023-08-03,2023-08-25,448.84,-684,617063,97519709,36213018,1.36357359310824,86.1610856529525,0.46404332233129
467,457.5,779,1395,444030,1325250,2023-08-03,2023-09-01,448.84,616,881220,91969817,42577148,1.44096187556837,77.3919567546818,0.66494623655914
440.67,433,1689,1691,976242,1296997,2023-08-03,2023-11-17,448.84,2,320755,178436543,50264301,0.726867365952052,86.7459744498637,0.247305891995124
445.13,443,5520,6019,546480,1282047,2023-08-03,2023-08-18,448.84,499,735567,303147069,149589725,0.422912550079777,91.4419650879092,0.573744176305549
437.61,437,1387,20992,34675,1280512,2023-08-03,2023-08-11,448.84,19605,1245837,61838439,35859636,2.07073791109119,83.3129972766615,0.972920987854858
350.32,350,39911,39894,838131,1276608,2023-08-03,2023-09-15,448.84,-17,438477,612682077,237570121,0.208363855892589,95.6413265537716,0.343470352684614
418.71,414,2569,2701,922271,1272171,2023-08-03,2023-11-17,448.84,132,349900,178436543,50264301,0.712954296587107,87.4589287464508,0.275041641414558
421.11,420,9178,11412,569036,1266732,2023-08-03,2023-09-01,448.84,2234,697696,91969817,42577148,1.37733447920202,78.7692912338838,0.550784222708513
478.83,463,791,793,832923,1255319,2023-08-03,2023-09-29,448.84,2,422396,193559650,66678490,0.648543743491993,89.727414778855,0.33648498907449
435.87,429,1397,1822,712470,1251714,2023-08-03,2023-11-17,448.84,425,539244,178436543,50264301,0.701489716711223,88.160418463162,0.430804480895796
392.5,389,3560,3562,993240,1246700,2023-08-03,2023-12-15,448.84,2,253460,463353257,105207973,0.26906037265645,90.2758456276482,0.203304724472608
484.44,466,665,675,901740,1244700,2023-08-03,2023-10-20,448.84,10,342960,344413796,107013117,0.361396672971834,97.1303408531289,0.275536273800916
439.4,431,1472,1471,952384,1235640,2023-08-03,2023-12-15,448.84,-1,283256,463353257,105207973,0.266673424937207,90.5425190525854,0.229238289469425
472.06,456,751,761,931240,1222166,2023-08-03,2023-12-15,448.84,10,290926,463353257,105207973,0.26376549242644,90.8062845450119,0.238041313536786
422.05,416,2016,2013,965664,1217865,2023-08-03,2023-12-15,448.84,-3,252201,463353257,105207973,0.262837258959852,91.0691218039717,0.207084529073419
467.14,457,901,1195,493748,1211730,2023-08-03,2023-09-01,448.84,294,717982,91969817,42577148,1.3175300761988,80.0868213100826,0.592526387891692
377.04,375,5654,5927,859408,1209108,2023-08-03,2023-11-17,448.84,273,349700,178436543,50264301,0.677612320700474,88.8380307838625,0.289221475666359
386.5,383,3406,3406,848094,1192100,2023-08-03,2023-12-15,448.84,0,344006,463353257,105207973,0.257276706700693,91.3263985106724,0.288571428571429
456,448,1631,1480,884002,1184000,2023-08-03,2023-09-29,448.84,-151,299998,193559650,66678490,0.611697737622485,90.3391125164775,0.253376689189189
407.21,406,10028,9780,732044,1183380,2023-08-03,2023-09-15,448.84,-248,451336,612682077,237570121,0.193147481283348,95.8344740350549,0.381395663269618
365.15,365,78105,78103,624840,1171545,2023-08-03,2023-08-25,448.84,-2,546705,97519709,36213018,1.20134177184635,87.3624274247988,0.466653009487472
408.25,407,12542,9363,978276,1170375,2023-08-03,2023-09-15,448.84,-3179,192099,612682077,237570121,0.191024846969695,96.0254988820246,0.164134572252483
453.32,446,1634,1597,805562,1169004,2023-08-03,2023-09-29,448.84,-37,363442,193559650,66678490,0.60395025512807,90.9430627716056,0.310898850645507
449.74,446,2895,3081,564525,1152294,2023-08-03,2023-08-25,448.84,186,587769,97519709,36213018,1.18160114690252,88.5440285717013,0.510085967643674
445.25,445,36944,45668,480272,1141700,2023-08-03,2023-08-04,448.84,8724,661428,64122278,31929455,1.78050442936541,94.3155715709289,0.579336077778751
427.44,424,3310,3316,714960,1140704,2023-08-03,2023-09-29,448.84,6,425744,193559650,66678490,0.589329439271046,91.5323922108766,0.373229163744495
461.81,454,1057,1455,471422,1136355,2023-08-03,2023-09-01,448.84,398,664933,91969817,42577148,1.2355738404916,81.3223951505742,0.585145487105702
360.15,358,5208,5282,880152,1135630,2023-08-03,2023-12-15,448.84,74,255478,463353257,105207973,0.245089460976855,91.5714879716493,0.224965877970818
450.92,444,1630,1623,743280,1123116,2023-08-03,2023-09-29,448.84,-7,379836,193559650,66678490,0.580242834702377,92.112635045579,0.338198369536183
457.42,451,1820,1737,655200,1115154,2023-08-03,2023-09-01,448.84,-83,459954,91969817,42577148,1.21252171242224,82.5349168629965,0.412457830936355
431.75,430,3873,6341,379554,1109675,2023-08-03,2023-09-01,448.84,2468,730121,91969817,42577148,1.20656432316267,83.7414811861592,0.657959312411292
405.25,405,44611,44260,624554,1106500,2023-08-03,2023-08-18,448.84,-351,481946,303147069,149589725,0.365004353711894,91.8069694416211,0.435558969724356
408.82,404,2293,2291,882805,1104262,2023-08-03,2023-12-15,448.84,-2,221457,463353257,105207973,0.238319680139855,91.8098076517891,0.200547514991913
465.3,456,1264,1180,671184,1097400,2023-08-03,2023-09-01,448.84,-84,426216,91969817,42577148,1.19321755310223,84.9346987392614,0.388387096774194
446,443,3549,3639,553644,1091700,2023-08-03,2023-08-25,448.84,90,538056,97519709,36213018,1.11946601481348,89.6634945865148,0.492860676009893
402.34,399,3236,3259,834888,1088506,2023-08-03,2023-11-17,448.84,23,253618,178436543,50264301,0.610024147351924,89.4480549312144,0.232996418944866
421.01,419,5313,5414,600369,1088214,2023-08-03,2023-09-15,448.84,101,487845,612682077,237570121,0.177614792541091,96.2031136745657,0.448298772116514
434.89,427,1342,1366,838750,1077774,2023-08-03,2023-12-15,448.84,24,239024,463353257,105207973,0.232603091424908,92.042410743214,0.221775622718678
444.05,441,3281,3527,439654,1075735,2023-08-03,2023-08-25,448.84,246,636081,97519709,36213018,1.10309496514187,90.7665895516567,0.591298972330546
365.23,365,46181,46294,646534,1064762,2023-08-03,2023-09-01,448.84,113,418228,91969817,42577148,1.15772982347024,86.0924285627316,0.392790125868504
428.75,428,14554,14168,480282,1062600,2023-08-03,2023-08-18,448.84,-386,582318,303147069,149589725,0.35052293380412,92.1574923754252,0.548012422360249
469.41,459,1086,1009,693954,1050369,2023-08-03,2023-09-01,448.84,-77,356415,91969817,42577148,1.14208012396067,87.2345086866923,0.339323609131648
416.37,416,27677,27803,553540,1028711,2023-08-03,2023-08-18,448.84,126,475171,303147069,149589725,0.339343871406522,92.4968362468317,0.461909127053176
423.97,417,1458,1472,737748,1025984,2023-08-03,2023-12-15,448.84,14,288236,463353257,105207973,0.221425874211563,92.2638366174256,0.280936154949785
414.67,413,6097,6142,567021,1025714,2023-08-03,2023-09-15,448.84,45,458693,612682077,237570121,0.167413743359756,96.3705274179254,0.447193857157063
385.16,382,3231,3234,781902,1021944,2023-08-03,2023-12-15,448.84,3,240042,463353257,105207973,0.22055396925806,92.4843905866836,0.234887625936451
361.2,359,4641,4636,867867,1019920,2023-08-03,2023-12-15,448.84,-5,152053,463353257,105207973,0.220117153509077,92.7045077401927,0.149083261432269
395.28,395,36322,36344,653796,1017632,2023-08-03,2023-08-25,448.84,22,363836,97519709,36213018,1.04351418850112,91.8101037401578,0.357531995849187
385.15,385,67650,67625,541200,1014375,2023-08-03,2023-08-18,448.84,-25,473175,303147069,149589725,0.334614813643473,92.8314510604752,0.466469500924214
417.78,416,5257,5591,536214,995198,2023-08-03,2023-09-15,448.84,334,458984,612682077,237570121,0.162433019890673,96.5329604378161,0.461198676042355
459.52,452.5,1137,1398,454800,981396,2023-08-03,2023-09-01,448.84,261,526596,91969817,42577148,1.06708486763652,88.3015935543288,0.536578506535588
452.11,447,1061,1911,292836,976521,2023-08-03,2023-09-01,448.84,850,683685,91969817,42577148,1.06178421557586,89.3633777699047,0.700123192435186
440.78,440,6440,12470,218960,972660,2023-08-03,2023-08-11,448.84,6030,753700,61838439,35859636,1.57290516340492,84.8859024400665,0.77488536590381
417.74,412,1718,1691,778254,970634,2023-08-03,2023-12-15,448.84,-27,192380,463353257,105207973,0.209480344712458,92.9139880849052,0.198200351522819
483.21,467,587,587,951527,951527,2023-08-03,2023-12-15,448.84,0,0,463353257,105207973,0.205356709082116,93.1193447939873,0
455.13,446,578,1041,359516,950433,2023-08-03,2023-10-20,448.84,463,590917,344413796,107013117,0.275956715740853,97.4062975688697,0.62173451468962
447.23,444,2922,2934,479208,947682,2023-08-03,2023-08-25,448.84,12,468474,97519709,36213018,0.971785098333302,92.7818888384911,0.494336707883024
311,310,9553,9470,754687,947000,2023-08-03,2023-12-15,448.84,-83,192313,463353257,105207973,0.204379700734466,93.3237244947217,0.203076029567054
447.55,447,10597,16527,180149,908985,2023-08-03,2023-08-04,448.84,5930,728836,64122278,31929455,1.41758064178568,95.7331522127146,0.801813011215807
417.6,413,1919,1962,648622,902520,2023-08-03,2023-11-17,448.84,43,253898,178436543,50264301,0.505793255588907,89.9538481868033,0.281321189558126
426.7,421,1213,1577,509460,898890,2023-08-03,2023-11-17,448.84,364,389430,178436543,50264301,0.503758918933999,90.4576071057373,0.433234322330875
346.69,345,4662,5318,610722,898742,2023-08-03,2023-12-15,448.84,656,288020,463353257,105207973,0.193964752901262,93.517689247623,0.320470168301915
408.27,408,33308,33285,499620,898695,2023-08-03,2023-08-18,448.84,-23,399075,303147069,149589725,0.29645511763137,93.1279061781066,0.444060554470649
392.77,392,11584,11520,590784,887040,2023-08-03,2023-09-15,448.84,-64,296256,612682077,237570121,0.144779818652995,96.6777402564691,0.333982683982684
409.3,409,29329,29291,469264,878730,2023-08-03,2023-08-18,448.84,-38,409466,303147069,149589725,0.289869205365796,93.4177753834724,0.465974759027232
380.12,380,72693,73122,581544,877464,2023-08-03,2023-08-18,448.84,429,295920,303147069,149589725,0.289451586285995,93.7072269697584,0.337244604906868
451.2,446,1802,1675,459510,871000,2023-08-03,2023-09-01,448.84,-127,411490,91969817,42577148,0.947049834838749,90.3104276047434,0.472433983926521
481.6,465,664,523,735712,868180,2023-08-03,2023-09-15,448.84,-141,132468,612682077,237570121,0.141701550052035,96.8194418065212,0.152581261950287
413.32,413,27107,27062,487926,865984,2023-08-03,2023-08-18,448.84,-45,378058,303147069,149589725,0.285664645499178,93.9928916152576,0.436564647845688
275.63,275,13703,13703,616635,863289,2023-08-03,2023-12-15,448.84,0,246654,463353257,105207973,0.186313355298159,93.7040026029212,0.285714285714286
406.27,406,32044,31948,448616,862596,2023-08-03,2023-08-18,448.84,-96,413980,303147069,149589725,0.28454703614502,94.2774386514026,0.479923394033824
422.48,422,17805,17848,427320,856704,2023-08-03,2023-08-18,448.84,43,429384,303147069,149589725,0.282603425072205,94.5600420764748,0.501204616763783
477.93,461,241,497,330170,841421,2023-08-03,2023-12-15,448.84,256,511251,463353257,105207973,0.181593846010238,93.8855964489314,0.607604278951916
454.46,451,2598,2405,379308,832130,2023-08-03,2023-08-11,448.84,-193,452822,61838439,35859636,1.34565169085203,86.2315541309185,0.544172184634612
444.17,443,5742,7103,264132,831051,2023-08-03,2023-08-11,448.84,1361,566919,61838439,35859636,1.3439068214513,87.5754609523698,0.682171130291643
438.61,434,975,1781,298350,821041,2023-08-03,2023-09-29,448.84,806,522691,193559650,66678490,0.424179832935222,92.5368148785142,0.636619852114572
423.33,418,1018,1503,392948,801099,2023-08-03,2023-11-17,448.84,485,408151,178436543,50264301,0.448954561958757,90.9065616676961,0.509488839706453
384.2,381,2495,2498,588820,799360,2023-08-03,2023-12-15,448.84,3,210540,463353257,105207973,0.172516322681207,94.0581127716126,0.263385708566854
435.83,428,1002,1017,646290,796311,2023-08-03,2023-12-15,448.84,15,150021,463353257,105207973,0.171858293422981,94.2299710650356,0.188394986380949
371.8,370,3818,4419,534520,795420,2023-08-03,2023-11-17,448.84,601,260900,178436543,50264301,0.445771917919302,91.3523335856154,0.3280028161223
424.45,418,1226,1229,620356,792705,2023-08-03,2023-12-15,448.84,3,172349,463353257,105207973,0.171080053506562,94.4010511185422,0.21741883802928
452.27,444,390,958,230100,792266,2023-08-03,2023-10-20,448.84,568,562166,344413796,107013117,0.230033177881179,97.6363307467509,0.709567241305319
413.35,408,1486,1469,594400,785915,2023-08-03,2023-12-15,448.84,-17,191515,463353257,105207973,0.169614648894116,94.5706657674363,0.243684113421935
405.2,404,6699,6526,468930,783120,2023-08-03,2023-09-15,448.84,-173,314190,612682077,237570121,0.127818330158204,96.9472601366793,0.401202880784554
350.5,350,15845,15643,538730,782150,2023-08-03,2023-09-29,448.84,-202,243420,193559650,66678490,0.404087318818772,92.940902197333,0.31121907562488
340.26,340,29958,29942,509286,778492,2023-08-03,2023-09-15,448.84,-16,269206,612682077,237570121,0.127062962868424,97.0743230995478,0.345804452711139
365.63,365,11825,12231,567600,770553,2023-08-03,2023-09-29,448.84,406,202953,193559650,66678490,0.398095884137009,93.33899808147,0.263386165520088
443.31,434,826,822,597198,765282,2023-08-03,2023-12-15,448.84,-4,168084,463353257,105207973,0.165161674907575,94.7358274423438,0.219636682948247
440.55,439,1679,4935,112493,764925,2023-08-03,2023-08-18,448.84,3256,652432,303147069,149589725,0.252328021024013,94.8123700974988,0.852935908749224
389.3,386,2316,2317,604476,764610,2023-08-03,2023-12-15,448.84,1,160134,463353257,105207973,0.165016645172735,94.9008440875166,0.209432259583317
469.93,459,698,698,482318,762914,2023-08-03,2023-09-08,448.84,0,280596,29175941,13324771,2.61487367279773,71.4620926879445,0.36779505946935
417.34,417,22259,22299,445180,758166,2023-08-03,2023-08-18,448.84,40,312986,303147069,149589725,0.250098410154841,95.0624685076536,0.412819883772156
404.07,403,7070,7084,480760,757988,2023-08-03,2023-09-15,448.84,14,277228,612682077,237570121,0.123716365869798,97.1980394654176,0.36574193786709
402.28,398,1730,1710,583010,731880,2023-08-03,2023-12-15,448.84,-20,148870,463353257,105207973,0.157952920141015,95.0587970076576,0.203407662458327
305.99,305,7342,7342,513940,726858,2023-08-03,2023-12-15,448.84,0,212918,463353257,105207973,0.156869081854754,95.2156660895124,0.292929292929293
412.42,411,4530,5079,394110,721218,2023-08-03,2023-09-15,448.84,549,327108,612682077,237570121,0.117714884615435,97.315754350033,0.453549412244287
388.71,388,10374,10155,487578,721005,2023-08-03,2023-09-15,448.84,-219,233427,612682077,237570121,0.117680119439825,97.4334344694728,0.323752262466973
406.06,402,1571,1774,438309,720244,2023-08-03,2023-11-17,448.84,203,281935,178436543,50264301,0.403641534346471,91.7559751199618,0.391443732957165
365.43,365,16440,16706,460320,718358,2023-08-03,2023-09-15,448.84,266,258038,612682077,237570121,0.117248084604897,97.5506825540777,0.359205298750762
453.1,447.5,1033,1282,293372,717920,2023-08-03,2023-09-01,448.84,249,424548,91969817,42577148,0.780603923567664,91.0910315283111,0.591358368620459
442.6,436,610,1075,281820,709500,2023-08-03,2023-10-20,448.84,465,427680,344413796,107013117,0.206002200910674,97.8423329476616,0.602790697674419
439.63,437,2094,2693,303630,708259,2023-08-03,2023-09-01,448.84,599,404629,91969817,42577148,0.77009939032498,91.8611309186361,0.571300894164423
412.32,412,22630,21980,384710,703360,2023-08-03,2023-08-18,448.84,-650,318650,303147069,149589725,0.232019396499591,95.2944879041532,0.453039695177434
400.26,397,2148,2149,521964,700574,2023-08-03,2023-11-17,448.84,1,178610,178436543,50264301,0.392618007624145,92.148593127586,0.254948085427093
330.22,330,31091,31064,466365,683408,2023-08-03,2023-09-15,448.84,-27,217043,612682077,237570121,0.111543657902694,97.6622262119804,0.317589200009365
449.9,442,168,861,91896,680190,2023-08-03,2023-10-20,448.84,693,588294,344413796,107013117,0.197492088847684,98.0398250365093,0.864896573016363
442.8,441,3512,3759,270424,676620,2023-08-03,2023-08-18,448.84,247,406196,303147069,149589725,0.223198595398592,95.5176864995518,0.600331057314298
393.84,393,7737,8054,433272,676536,2023-08-03,2023-09-15,448.84,317,243264,612682077,237570121,0.110422032143108,97.7726482441235,0.359572883039484
445.45,442,2613,1944,517374,670680,2023-08-03,2023-09-01,448.84,-669,153306,91969817,42577148,0.729239245958269,92.5903701645943,0.228582930756844
407.88,404,1603,1724,466473,668912,2023-08-03,2023-11-17,448.84,121,202439,178436543,50264301,0.37487388443745,92.5234670120234,0.302639211136891
380.06,380,111373,111372,445492,668232,2023-08-03,2023-08-11,448.84,-1,222740,61838439,35859636,1.08060942482717,88.656070377197,0.333327347388332
459.44,452,752,895,328624,665880,2023-08-03,2023-09-08,448.84,143,337256,29175941,13324771,2.28229142635023,73.7443841142947,0.506481648345047
430.15,424,1120,1081,512960,664815,2023-08-03,2023-11-17,448.84,-39,151855,178436543,50264301,0.372577830091676,92.8960448421151,0.228416928017569
398.03,394,1643,1645,476470,662935,2023-08-03,2023-12-15,448.84,2,186465,463353257,105207973,0.143073344146149,95.3587394336585,0.281271919569792
445.36,444,4034,4833,209768,657288,2023-08-03,2023-08-11,448.84,799,447520,61838439,35859636,1.06291169477936,89.7189820719763,0.680858314772216
240.32,240,20928,20527,565056,656864,2023-08-03,2023-12-15,448.84,-401,91808,463353257,105207973,0.141763112717259,95.5005025463758,0.139767135967263
419.39,419,16801,16802,336020,655278,2023-08-03,2023-08-18,448.84,1,319258,303147069,149589725,0.216158448162334,95.7338449477142,0.487210008576513
468.24,458,641,639,389728,654336,2023-08-03,2023-09-01,448.84,-2,264608,91969817,42577148,0.711468198311192,93.3018383629055,0.404391627543036
431.82,428,1663,1688,417413,644816,2023-08-03,2023-09-29,448.84,25,227403,193559650,66678490,0.333135547620591,93.6721336290906,0.352663395449245
416.44,411,1171,1185,497675,644640,2023-08-03,2023-12-15,448.84,14,146965,463353257,105207973,0.139124952778739,95.6396274991545,0.227979957805907
449.69,447.5,2929,2936,254823,642984,2023-08-03,2023-08-11,448.84,7,388161,61838439,35859636,1.03978045112038,90.7587625230967,0.603686872457169
421.47,421,13581,13631,339525,640657,2023-08-03,2023-08-18,448.84,50,301132,303147069,149589725,0.211335376625396,95.9451803243395,0.470036228434248
395.19,395,34093,33456,409116,635664,2023-08-03,2023-08-18,448.84,-637,226548,303147069,149589725,0.209688321281444,96.154868645621,0.356395831760175
432.32,432,7580,19776,136440,632832,2023-08-03,2023-08-11,448.84,12196,496392,61838439,35859636,1.02336347785234,91.782126000949,0.784397754854369
406.66,403,1417,1708,382590,625128,2023-08-03,2023-11-17,448.84,291,242538,178436543,50264301,0.350336309754667,93.2463811518698,0.387981341421277
482.32,466,378,378,616896,616896,2023-08-03,2023-12-15,448.84,0,0,463353257,105207973,0.133137296583199,95.7727647957377,0
355.35,355,17501,17487,420024,612045,2023-08-03,2023-09-15,448.84,-14,192021,612682077,237570121,0.0998960183390512,97.8725442624626,0.313736735043992
477.2,463,1372,425,1030372,603500,2023-08-03,2023-08-18,448.84,-947,-426872,303147069,149589725,0.199078289620541,96.3539469352415,-0.707327257663629
350.11,350,55001,54822,440008,603042,2023-08-03,2023-08-25,448.84,-179,163034,97519709,36213018,0.618379613909636,93.4002684524007,0.270352645421049
382.25,380,2557,2665,429576,599625,2023-08-03,2023-11-17,448.84,108,170049,178436543,50264301,0.336043833801465,93.5824249856712,0.283592245153221
423.48,423,12260,12474,306500,598752,2023-08-03,2023-08-18,448.84,214,292252,303147069,149589725,0.197512053134843,96.5514589883764,0.488101918657474
491.33,470,286,279,459888,595107,2023-08-03,2023-10-20,448.84,-7,135219,344413796,107013117,0.172788374598095,98.2126134111074,0.227217962484058
428.95,423,1076,1000,479896,595000,2023-08-03,2023-11-17,448.84,-76,115104,178436543,50264301,0.33345187594225,93.9158768616135,0.193452100840336
414.46,409,1090,1087,464340,593502,2023-08-03,2023-12-15,448.84,-3,129162,463353257,105207973,0.128088448939078,95.9008532446768,0.217626899319632
390.17,390,32570,34902,358270,593334,2023-08-03,2023-08-18,448.84,2332,235064,303147069,149589725,0.195724801812285,96.7471837901886,0.396174835758612
361.49,360,1386,3982,160776,593318,2023-08-03,2023-11-17,448.84,2596,432542,178436543,50264301,0.332509243916477,94.24838610553,0.729022210686344
436.53,432,1291,1309,392464,592977,2023-08-03,2023-09-29,448.84,18,200513,193559650,66678490,0.306353622772102,93.9784872518627,0.338146336198537
427.59,427,9811,9853,274708,581327,2023-08-03,2023-08-18,448.84,42,306619,303147069,149589725,0.191764018011997,96.9389478082007,0.52744668663248
290.76,290,7669,7632,429464,580032,2023-08-03,2023-12-15,448.84,-37,150568,463353257,105207973,0.125181379700542,96.0260346243773,0.259585678031557
200.17,200,34747,34065,486458,579105,2023-08-03,2023-12-15,448.84,-682,92646.9999999999,463353257,105207973,0.124981316360964,96.1510159407383,0.159983077334853
434.84,428,890,844,436990,577296,2023-08-03,2023-11-17,448.84,-46,140306,178436543,50264301,0.323530141468836,94.5719162469988,0.243039965632882
366.64,365,3570,3514,453390,576296,2023-08-03,2023-11-17,448.84,-56,122906,178436543,50264301,0.322969718147925,94.8948859651467,0.213268875716646
437.01,429,721,718,474418,575118,2023-08-03,2023-12-15,448.84,-3,100700,463353257,105207973,0.124120849764524,96.2751367905028,0.175094502345606
441.9,441,2849,6325,108262,569250,2023-08-03,2023-08-11,448.84,3476,460988,61838439,35859636,0.92054393546383,92.7026699364128,0.809816425120773
490.9,470,36,270,49968,564300,2023-08-03,2023-08-25,448.84,234,514332,97519709,36213018,0.578652259924196,93.9789207123249,0.911451355661882
395.84,392,1467,1468,422496,563712,2023-08-03,2023-12-15,448.84,1,141216,463353257,105207973,0.121659228997283,96.3967960195001,0.250510899182561
478.88,464,402,378,419286,562464,2023-08-03,2023-09-15,448.84,-24,143178,612682077,237570121,0.0918035668276942,97.9643478292903,0.254554958183991
420.77,420,6488,7232,259520,556864,2023-08-03,2023-08-25,448.84,744,297344,97519709,36213018,0.571027134627729,94.5499478469527,0.533961613607631
320.18,320,32345,30729,355795,553122,2023-08-03,2023-09-15,448.84,-1616,197327,612682077,237570121,0.0902787956044616,98.0546266248947,0.356751313453451
316.07,315,5167,5153,428861,551371,2023-08-03,2023-12-15,448.84,-14,122510,463353257,105207973,0.118995818346001,96.5157918378461,0.222191591505538
436.43,434,1354,2263,162480,549909,2023-08-03,2023-09-01,448.84,909,387429,91969817,42577148,0.59792333826216,93.8997617011677,0.704532931812354
401.32,398,1619,1653,378846,548796,2023-08-03,2023-11-17,448.84,34,169950,178436543,50264301,0.307558076822862,95.2024440419696,0.309677913104323
397.46,396,3791,3728,348772,544288,2023-08-03,2023-09-29,448.84,-63,195516,193559650,66678490,0.281199103222185,94.2596863550849,0.359214239520254
460.8,453,321,696,151191,542880,2023-08-03,2023-09-08,448.84,375,391689,29175941,13324771,1.86071119351386,75.6050953078086,0.72150198938992
479.49,464,345,345,534405,534405,2023-08-03,2023-12-15,448.84,0,0,463353257,105207973,0.115334249177405,96.6311260870235,0
386.68,386,7593,7787,341685,529516,2023-08-03,2023-09-15,448.84,194,187831,612682077,237570121,0.0864259001328678,98.1410525250276,0.354722048058982
468.28,458,469,506,298753,520168,2023-08-03,2023-09-08,448.84,37,221415,29175941,13324771,1.78286623214655,77.3879615399551,0.425660555820427
398,397,4883,5181,297863,518100,2023-08-03,2023-09-15,448.84,298,220237,612682077,237570121,0.0845626172936017,98.2256151423212,0.425085890754681
396.94,396,4412,5376,247072,505344,2023-08-03,2023-09-15,448.84,964,258272,612682077,237570121,0.0824806239598878,98.3080957662811,0.511081560283688
426.57,426,9404,8848,272716,504336,2023-08-03,2023-08-18,448.84,-556,231620,303147069,149589725,0.166366774273513,97.1053145824742,0.459257320516481
424.16,419,819,977,322686,504132,2023-08-03,2023-11-17,448.84,158,181446,178436543,50264301,0.282527329617678,95.4849713715873,0.359917640617933
394.96,392,1696,1696,379904,502016,2023-08-03,2023-11-17,448.84,0,122112,178436543,50264301,0.28134147387063,95.7663128454579,0.243243243243243
435.38,433,1422,2082,159264,495516,2023-08-03,2023-09-01,448.84,660,336252,91969817,42577148,0.538781109024062,94.4385428101918,0.678589591456179
444.75,442,1762,1797,248442,494175,2023-08-03,2023-08-25,448.84,35,245733,97519709,36213018,0.506743718851745,95.0566915658044,0.497259068143876
418.81,413,926,845,427812,490945,2023-08-03,2023-12-15,448.84,-81,63133,463353257,105207973,0.105954796385515,96.737080883409,0.128594852783917
467.4,457,455,472,279825,490880,2023-08-03,2023-09-08,448.84,17,211055,29175941,13324771,1.68248215198955,79.0704436919447,0.429952330508475
335.61,335,8001,8044,352044,490684,2023-08-03,2023-10-20,448.84,43,138640,344413796,107013117,0.142469321989645,98.355082733097,0.282544366639222
410.8,410,7121,6103,291961,488240,2023-08-03,2023-09-01,448.84,-1018,196279,91969817,42577148,0.530869817866442,94.9694126280582,0.402013354088154
424.5,424,9746,9733,243650,486650,2023-08-03,2023-08-18,448.84,-13,243000,303147069,149589725,0.160532642326158,97.2658472248003,0.499332168909894
360.56,360,8582,8635,351862,483560,2023-08-03,2023-09-29,448.84,53,131698,193559650,66678490,0.249824795612102,94.509511150697,0.272350897510133
433.89,433,5277,5430,226911,483270,2023-08-03,2023-08-18,448.84,153,256359,303147069,149589725,0.159417671955126,97.4252648967554,0.530467440561177
404.87,401,1245,1245,317475,481815,2023-08-03,2023-11-17,448.84,0,164340,178436543,50264301,0.2700203623649,96.0363332078228,0.34108527131783
446.33,442.5,1085,1258,222425,481814,2023-08-03,2023-09-01,448.84,173,259389,91969817,42577148,0.523882742965554,95.4932953710237,0.538359200853441
305.41,305,11751,11751,317277,481791,2023-08-03,2023-10-20,448.84,0,164514,344413796,107013117,0.139887253529182,98.4949699866262,0.341463414634146
300.33,300,14560,14584,364000,481272,2023-08-03,2023-10-20,448.84,24,117272,344413796,107013117,0.139736562701455,98.6347065493277,0.243670938679167
486.1,468,282,260,366600,470600,2023-08-03,2023-09-15,448.84,-22,104000,612682077,237570121,0.0768098199157864,98.3849055861969,0.220994475138122
407.79,403,977,969,363444,464151,2023-08-03,2023-12-15,448.84,-8,100707,463353257,105207973,0.100172167344882,96.8372530507539,0.216970339393861
425.92,425,3668,5035,179732,463220,2023-08-03,2023-08-25,448.84,1367,283488,97519709,36213018,0.475001417405788,95.5316929832102,0.611994300764216
356.42,355,1561,3234,168588,459228,2023-08-03,2023-11-17,448.84,1673,290640,178436543,50264301,0.257362080815475,96.2936952886383,0.632888238522041
416.45,412,702,1030,240084,458350,2023-08-03,2023-11-17,448.84,328,218266,178436543,50264301,0.256870029139715,96.550565317778,0.476199410930512
438.25,437,2997,3621,173826,452625,2023-08-03,2023-08-18,448.84,624,278799,303147069,149589725,0.149308717215405,97.5745736139709,0.615960231980116
345.29,345,15580,15587,296020,452023,2023-08-03,2023-09-15,448.84,7,156003,612682077,237570121,0.0737777416655196,98.4586833278624,0.345121819022483
397.96,395,1505,1520,338625,449920,2023-08-03,2023-11-17,448.84,15,111295,178436543,50264301,0.252145660544432,96.8027109783224,0.247366198435277
300.12,300,36781,37387,331029,448644,2023-08-03,2023-09-15,448.84,606,117615,612682077,237570121,0.0732262321425799,98.531909560005,0.26215663198438
355.07,355,64013,64004,256052,448028,2023-08-03,2023-08-18,448.84,-9,191976,303147069,149589725,0.147792291536225,97.7223659055071,0.428491076450579
345.72,345,6219,6218,335826,447696,2023-08-03,2023-10-20,448.84,-1,111870,344413796,107013117,0.129987824297259,98.7646943736249,0.249879382438083
393.34,392,3333,3339,286638,447426,2023-08-03,2023-09-29,448.84,6,160788,193559650,66678490,0.231156648609356,94.7406677993063,0.359362218556812
340.67,340,6599,6643,323351,445081,2023-08-03,2023-10-20,448.84,44,121730,344413796,107013117,0.129228563190308,98.8939229368152,0.273500778509979
441.08,436,464,868,153120,440944,2023-08-03,2023-09-29,448.84,404,287824,193559650,66678490,0.227807810150514,94.9684756094568,0.652745019775754
415.44,411,771,991,258285,440004,2023-08-03,2023-11-17,448.84,220,181719,178436543,50264301,0.246588502894275,97.0492994812167,0.412993972782066
394.82,394,5306,5312,302442,435584,2023-08-03,2023-09-15,448.84,6,133142,612682077,237570121,0.071094620905648,98.6030041809106,0.305663201586835
490.85,468,191,190,341890,434150,2023-08-03,2023-12-15,448.84,-1,92260.0000000001,463353257,105207973,0.0936974097928915,96.9309504605468,0.212507197973051
500.5,475,165,170,320100,433500,2023-08-03,2023-10-20,448.84,5,113400,344413796,107013117,0.125866038188552,99.0197889750038,0.26159169550173
411.02,406,1066,862,428532,432724,2023-08-03,2023-12-15,448.84,-204,4192,463353257,105207973,0.093389653242472,97.0243401137893,0.0096874682245496
402.03,401,4116,4158,271656,428274,2023-08-03,2023-09-15,448.84,42,156618,612682077,237570121,0.0699015061933989,98.672905687104,0.365695792880259
446.38,446,9994,11222,149910,426436,2023-08-03,2023-08-04,448.84,1228,276526,64122278,31929455,0.66503563706829,96.3981878497829,0.648458385314561
410.51,410,7868,8349,212436,425799,2023-08-03,2023-08-25,448.84,481,213363,97519709,36213018,0.436628661391924,95.9683216446021,0.501088541776754
420.94,416,856,856,320144,422864,2023-08-03,2023-11-17,448.84,0,102720,178436543,50264301,0.236982847173855,97.2862823283906,0.242914979757085
434.67,433,1144,2522,85800,421174,2023-08-03,2023-08-25,448.84,1378,335374,97519709,36213018,0.4318860303408,96.4002076749429,0.796283721217359
491.7,470,196,194,346332,420980,2023-08-03,2023-11-17,448.84,-2,74648,178436543,50264301,0.235927009637258,97.5222093380278,0.177319587628866
511.94,480,126,131,315252,418414,2023-08-03,2023-12-15,448.84,5,103162,463353257,105207973,0.0903012968353862,97.1146414106246,0.246554847591142
412.16,407,805,807,324415,416412,2023-08-03,2023-12-15,448.84,2,91997,463353257,105207973,0.0898692290836751,97.2045106397083,0.220927831090362
355.83,355,5174,5004,320788,415332,2023-08-03,2023-10-20,448.84,-170,94544,344413796,107013117,0.120590988172843,99.1403799631766,0.22763475966215
383.63,383,6544,6536,268304,411768,2023-08-03,2023-09-15,448.84,-8,143464,612682077,237570121,0.0672074499088048,98.7401131370128,0.348409784150298
425.12,422,928,1308,190240,408096,2023-08-03,2023-09-29,448.84,380,217856,193559650,66678490,0.210837331024312,95.1793129404811,0.533835176037011
448.16,447.5,6066,6153,121320,406098,2023-08-03,2023-08-04,448.84,87,284778,64122278,31929455,0.633318111374646,97.0315059611575,0.701254377022295
395.07,395,57817,57785,289085,404495,2023-08-03,2023-08-11,448.84,-32,115410,61838439,35859636,0.654115800044694,93.3567857364575,0.28531873076305
393.54,391,1555,1575,334325,400050,2023-08-03,2023-11-17,448.84,20,65725,178436543,50264301,0.224197349530584,97.7464066875584,0.164291963504562
464,455,310,444,162750,399600,2023-08-03,2023-09-08,448.84,134,236850,29175941,13324771,1.36962163448301,80.4400653264277,0.592717717717718
443.04,442,3489,3832,132582,398528,2023-08-03,2023-08-11,448.84,343,265946,61838439,35859636,0.644466462033429,94.001252198491,0.667320740324394
355.52,355,7458,7608,290862,395616,2023-08-03,2023-09-29,448.84,150,104754,193559650,66678490,0.204389706222345,95.3837026467035,0.264787066246057
375.13,375,30338,30350,182028,394550,2023-08-03,2023-08-18,448.84,12,212522,303147069,149589725,0.130151349080007,97.8525172545871,0.538644024838424
441.32,439,1895,1688,217925,391616,2023-08-03,2023-08-25,448.84,-207,173691,97519709,36213018,0.401576259830718,96.8017839347736,0.443523757966988
403.44,399,880,881,293920,391164,2023-08-03,2023-12-15,448.84,1,97244.0000000001,463353257,105207973,0.0844202547603977,97.2889308944687,0.248601609555072
380.21,380,18568,18616,222816,390936,2023-08-03,2023-08-25,448.84,48,168120,97519709,36213018,0.400878964886985,97.2026628996606,0.430044815519676
400.01,399,3878,3868,236558,390668,2023-08-03,2023-09-15,448.84,-10,154110,612682077,237570121,0.0637635757051858,98.803876712718,0.394478175842403
485,467,222,217,286602,390600,2023-08-03,2023-09-29,448.84,-5,103998,193559650,66678490,0.201798257023093,95.5855009037266,0.266251920122888
315.2,315,19711,19524,216821,390480,2023-08-03,2023-09-15,448.84,-187,173659,612682077,237570121,0.0637328909492484,98.8676096036673,0.444732124564638
444.89,438,580,558,284780,384462,2023-08-03,2023-10-20,448.84,-22,99682,344413796,107013117,0.111627932581423,99.252007895758,0.259276599507884
422.06,417,823,759,319324,384054,2023-08-03,2023-11-17,448.84,-64,64730,178436543,50264301,0.215232818089286,97.9616395056477,0.168544006832372
485.06,466,202,201,258560,383106,2023-08-03,2023-09-29,448.84,-1,124546,193559650,66678490,0.197926582322297,95.7834274860489,0.325095404405047
396.03,393,1262,1260,272592,381780,2023-08-03,2023-11-17,448.84,-2,109188,178436543,50264301,0.213958415457533,98.1755979211052,0.285997171145686
270.59,270,6451,6461,277393,381199,2023-08-03,2023-12-15,448.84,10,103806,463353257,105207973,0.0822696278144431,97.3712005222832,0.272314460426182
404.25,404,15236,15216,228540,380400,2023-08-03,2023-08-18,448.84,-20,151860,303147069,149589725,0.125483647674654,97.9780009022617,0.399211356466877
389.74,389,5002,5115,230092,378510,2023-08-03,2023-09-15,448.84,113,148418,612682077,237570121,0.0617791860100389,98.9293887896773,0.392111172756334
415.9,415,4509,4179,225450,376110,2023-08-03,2023-09-01,448.84,-330,150660,91969817,42577148,0.408949383904939,95.9022447549287,0.400574300071788
433.5,426,500,501,296000,375750,2023-08-03,2023-12-15,448.84,1,79750,463353257,105207973,0.0810936352175032,97.4522941575007,0.212242182302063
442.31,439,365,1130,58400,374030,2023-08-03,2023-09-01,448.84,765,315630,91969817,42577148,0.406687772359056,96.3089325272878,0.843862791754672
428.89,422,473,539,252109,371371,2023-08-03,2023-12-15,448.84,66,119262,463353257,105207973,0.0801485679424069,97.5324427254431,0.321139776665383
427.82,422,484,629,208120,366078,2023-08-03,2023-11-17,448.84,145,157958,178436543,50264301,0.205158648472583,98.3807565695778,0.431487278667388
365.49,363,1459,1459,293259,363291,2023-08-03,2023-12-15,448.84,0,70032.0000000001,463353257,105207973,0.0784047580354011,97.6108474834785,0.19277108433735
363.16,361,1661,1663,274065,359208,2023-08-03,2023-12-15,448.84,2,85143.0000000001,463353257,105207973,0.0775235729054129,97.6883710563839,0.237029798890894
426.36,425,2465,2619,189805,356184,2023-08-03,2023-09-01,448.84,154,166379,91969817,42577148,0.387283580220672,96.6962161075084,0.467115311187476
350.07,350,47812,50671,191248,354697,2023-08-03,2023-08-18,448.84,2859,163449,303147069,149589725,0.117004924761453,98.0950058270232,0.460813031968131
446.76,443,774,937,163314,352312,2023-08-03,2023-09-01,448.84,163,188998,91969817,42577148,0.38307350334295,97.0792896108514,0.536450646018302
401.22,397,824,824,275216,347728,2023-08-03,2023-12-15,448.84,0,72512,463353257,105207973,0.0750459816018947,97.7634170379858,0.208530805687204
457.45,448,300,363,200400,343035,2023-08-03,2023-10-20,448.84,63,142635,344413796,107013117,0.0995996687658818,99.3516075645239,0.415803052166689
220.23,220,14905,14905,298100,342815,2023-08-03,2023-12-15,448.84,0,44715,463353257,105207973,0.0739856674839344,97.8374027054697,0.130434782608696
465.48,456,360,361,204480,342228,2023-08-03,2023-09-08,448.84,1,137748,29175941,13324771,1.17298016197661,81.6130454884043,0.402503594095165
416.32,414,612,1461,99144,338952,2023-08-03,2023-09-29,448.84,849,239808,193559650,66678490,0.175115009765723,95.9585424958146,0.707498406854068
437.86,436,1730,1810,166080,336660,2023-08-03,2023-08-25,448.84,80,170580,97519709,36213018,0.345222523172213,97.5478854228328,0.506683300659419
489.56,470,201,172,284415,336432,2023-08-03,2023-08-18,448.84,-29,52017,303147069,149589725,0.110979796410303,98.2059856234335,0.154613710943073
425.18,425,5794,18645,75322,335610,2023-08-03,2023-08-11,448.84,12851,260288,61838439,35859636,0.54272068542998,94.543972883921,0.775566878221746
460,452.5,18,445,8190,333750,2023-08-03,2023-09-08,448.84,427,325560,29175941,13324771,1.14392197324501,82.7569674616493,0.975460674157303
456.58,450,337,506,130419,332948,2023-08-03,2023-09-08,448.84,169,202529,29175941,13324771,1.14117313302765,83.898140594677,0.608290183452071
398.99,398,3311,3323,195349,328977,2023-08-03,2023-09-15,448.84,12,133628,612682077,237570121,0.0536945689044532,98.9830833585818,0.406192530176882
480.25,462,153,179,227817,326675,2023-08-03,2023-12-15,448.84,26,98858,463353257,105207973,0.0705023640310788,97.9079050695008,0.302618810744624
399.19,399,17008,17126,204096,325394,2023-08-03,2023-08-18,448.84,118,121298,303147069,149589725,0.107338659441236,98.3133242828747,0.372772700172714
440.05,440,36151,64869,216906,324345,2023-08-03,2023-08-04,448.84,28718,107439,64122278,31929455,0.505822640923643,97.5373286020812,0.33124913286778
435.43,435,5834,7403,116680,318329,2023-08-03,2023-08-11,448.84,1569,201649,61838439,35859636,0.514775284026817,95.0587481679478,0.633460979049977
410,406,788,788,222216,315200,2023-08-03,2023-11-17,448.84,0,92984,178436543,50264301,0.176645430751256,98.557402000329,0.295
414.2,412,381,1431,54864,314820,2023-08-03,2023-09-29,448.84,1050,259956,193559650,66678490,0.162647535268843,96.1211900310835,0.825728987993139
425.74,419,427,465,214354,313410,2023-08-03,2023-12-15,448.84,38,99056,463353257,105207973,0.0676395374943917,97.9755446069952,0.316058836667624
476.35,462,219,218,225132,312830,2023-08-03,2023-09-29,448.84,-1,87698,193559650,66678490,0.161619428429427,96.2828094595129,0.280337563532909
351.26,350,2437,2475,238826,311850,2023-08-03,2023-11-17,448.84,38,73024,178436543,50264301,0.174768012626203,98.7321700129553,0.234163860830528
379.78,377,1115,1114,245300,309692,2023-08-03,2023-12-15,448.84,-1,64391.9999999999,463353257,105207973,0.0668371259554996,98.0423817329507,0.207922710305723
394.81,391,742,810,221858,308610,2023-08-03,2023-12-15,448.84,68,86752,463353257,105207973,0.0666036108169625,98.1089853437676,0.281105602540423
449.88,445,541,630,155808,307440,2023-08-03,2023-09-08,448.84,89,151632,29175941,13324771,1.05374493319684,84.9518855278738,0.493208430913349
430,423,440,439,238480,307300,2023-08-03,2023-12-15,448.84,-1,68820,463353257,105207973,0.0663208891612474,98.1753062329289,0.223950536934592
310.15,310,20237,20242,202370,303630,2023-08-03,2023-09-15,448.84,5,101260,612682077,237570121,0.0495575130068641,99.0326408715886,0.33349800744327
389.12,388,2660,2658,210140,297696,2023-08-03,2023-09-29,448.84,-2,87556.0000000001,193559650,66678490,0.153800650083837,96.4366101095967,0.294112114371708
280.68,280,4386,4373,214914,297364,2023-08-03,2023-12-15,448.84,-13,82450.0000000001,463353257,105207973,0.064176520938969,98.2394827538679,0.277269608964098
365.08,365,36720,36730,183600,293840,2023-08-03,2023-08-18,448.84,10,110240,303147069,149589725,0.0969298502437442,98.4102541331185,0.375170160631636
444.16,444,20142,18010,201420,288160,2023-08-03,2023-08-04,448.84,-2132,86740,64122278,31929455,0.449391395608247,97.9867199976894,0.301013325930039
406.65,402,619,619,223459,287835,2023-08-03,2023-12-15,448.84,0,64376.0000000001,463353257,105207973,0.0621199906662143,98.3016027445341,0.223655913978495
444.75,441,481,765,90909,286875,2023-08-03,2023-09-01,448.84,284,195966,91969817,42577148,0.311922986646804,97.3912125974982,0.683105882352941
343.43,343,6663,6668,206553,286724,2023-08-03,2023-09-29,448.84,5,80171,193559650,66678490,0.148132113278775,96.5847422228755,0.279610356998368
448.09,444,734,700,160746,286300,2023-08-03,2023-09-01,448.84,-34,125554,91969817,42577148,0.311297781531956,97.7025103790301,0.438539993014321
477.65,464,727,208,577238,283920,2023-08-03,2023-08-18,448.84,-519,-293318,303147069,149589725,0.0936575111666344,98.5039116442851,-1.03310087348549
335.24,335,11640,11674,174600,280176,2023-08-03,2023-09-15,448.84,34,105576,612682077,237570121,0.0457294264868793,99.0783702980755,0.376820284392668
378.78,376,1004,1004,203812,279112,2023-08-03,2023-12-15,448.84,0,75300,463353257,105207973,0.0602374097480446,98.3618401542821,0.269784172661871
390.1,389,2517,2528,201360,278080,2023-08-03,2023-09-29,448.84,11,76720,193559650,66678490,0.143666306484848,96.7284085293603,0.275891829689298
325.19,325,14543,14541,189059,276279,2023-08-03,2023-09-15,448.84,-2,87220,612682077,237570121,0.0450933706683246,99.1234636687438,0.315695365916338
436.53,436,2362,5163,56688,273639,2023-08-03,2023-08-11,448.84,2801,216951,61838439,35859636,0.442506318763965,95.5012544867117,0.792836547421968
265.48,265,5663,5667,220857,272016,2023-08-03,2023-12-15,448.84,4,51159,463353257,105207973,0.0587059648099118,98.420546119092,0.188073495676725
381.62,381,4372,4353,179252,269886,2023-08-03,2023-09-15,448.84,-19,90634,612682077,237570121,0.0440499257496641,99.1675135944935,0.335823273530305
285.77,285,3260,3463,176040,266651,2023-08-03,2023-12-15,448.84,203,90611,463353257,105207973,0.0575481009298269,98.4780942200219,0.339811213908817
349.3,349,8666,8767,181986,263010,2023-08-03,2023-09-15,448.84,101,81024,612682077,237570121,0.0429276471229303,99.2104412416164,0.308064332154671
431.37,424,356,355,206480,261635,2023-08-03,2023-12-15,448.84,-1,55155,463353257,105207973,0.0564655575519134,98.5345597775738,0.210808951401762
210.2,210,13075,13080,209200,261600,2023-08-03,2023-12-15,448.84,5,52400,463353257,105207973,0.0564580039198904,98.5910177814937,0.200305810397554
384.68,384,3829,3815,164647,259420,2023-08-03,2023-09-15,448.84,-14,94773,612682077,237570121,0.0423416988579544,99.2527829404744,0.365326497571506
330.55,330,4605,4601,188805,253055,2023-08-03,2023-10-20,448.84,-4,64250,344413796,107013117,0.0734741183248072,99.4250816828487,0.253897374088637
471.58,460,173,218,123695,252444,2023-08-03,2023-09-08,448.84,45,128749,29175941,13324771,0.865247156895471,85.8171326847693,0.510010140862924
400.19,396,593,601,189760,251819,2023-08-03,2023-12-15,448.84,8,62059,463353257,105207973,0.0543470874965707,98.6453648689902,0.246442881593526
320.47,320,5398,5356,183532,251732,2023-08-03,2023-10-20,448.84,-42,68199.9999999999,344413796,107013117,0.0730899873708892,99.4981716702196,0.270923045143247
381.21,378,781,781,189002,250701,2023-08-03,2023-12-15,448.84,0,61699,463353257,105207973,0.0541058029079528,98.6994706718982,0.246105919003115
399.58,398,1738,1580,168586,249640,2023-08-03,2023-09-29,448.84,-158,81054,193559650,66678490,0.128973161503444,96.8573816908638,0.324683544303797
382.99,382,2475,2479,160875,245421,2023-08-03,2023-09-29,448.84,4,84546,193559650,66678490,0.126793471676561,96.9841751625403,0.344493747478822
453.8,448,280,416,99400,241280,2023-08-03,2023-09-08,448.84,136,141880,29175941,13324771,0.826982752672827,86.6441154374421,0.58803050397878
325.51,325,4716,4693,179208,239343,2023-08-03,2023-10-20,448.84,-23,60135,344413796,107013117,0.0694928608492791,99.5676645310689,0.251250297689926
405.54,401,523,521,186188,236534,2023-08-03,2023-12-15,448.84,-2,50346,463353257,105207973,0.0510483084831321,98.7505189803813,0.212848892759603
412.77,412,2833,3070,124652,236390,2023-08-03,2023-09-01,448.84,237,111738,91969817,42577148,0.257029977563183,97.9595403565933,0.472684969753374
475.9,463,181,182,157832,234780,2023-08-03,2023-09-08,448.84,1,76948,29175941,13324771,0.804704122482288,87.4488195599244,0.32774512309396
391.75,391,2988,3101,152388,232575,2023-08-03,2023-09-15,448.84,113,80187,612682077,237570121,0.037960144213587,99.290743084688,0.344779103514995
414.33,414,7006,7009,133114,231297,2023-08-03,2023-08-18,448.84,3,98183,303147069,149589725,0.0762986100320832,98.5802102543172,0.424488860642378
383.97,383,2354,2382,162426,231054,2023-08-03,2023-09-29,448.84,28,68628,193559650,66678490,0.119370953605258,97.1035461161456,0.297021475499234
351.34,351,6709,6709,147598,228106,2023-08-03,2023-09-15,448.84,0,80508,612682077,237570121,0.0372307283929247,99.3279738130809,0.352941176470588
391.42,388,659,661,181884,226062,2023-08-03,2023-12-15,448.84,2,44178,463353257,105207973,0.0487882617818741,98.7993072421632,0.195424264139926
402.25,402,9013,9012,117169,225300,2023-08-03,2023-08-18,448.84,-1,108131,303147069,149589725,0.0743203623057296,98.6545306166229,0.47994229915668
387.7,387,3203,3174,150541,222180,2023-08-03,2023-09-15,448.84,-29,71639,612682077,237570121,0.0362635057137472,99.3642373187946,0.322436762984967
374.92,374,2382,2382,178650,219144,2023-08-03,2023-09-29,448.84,0,40494,193559650,66678490,0.113217811666843,97.2167639278124,0.184782608695652
374.03,372,1079,1079,219037,219037,2023-08-03,2023-12-15,448.84,0,0,463353257,105207973,0.047272139925845,98.846579382089,0
360.08,360,27402,27366,137010,218928,2023-08-03,2023-08-18,448.84,-36,81918,303147069,149589725,0.0722184122453119,98.7267490288682,0.374177811883359
430.34,429,1620,1633,113400,218822,2023-08-03,2023-08-25,448.84,13,105422,97519709,36213018,0.224387462025753,97.7722728848586,0.481770571514747
475.42,462.5,168,169,141792,218348,2023-08-03,2023-09-08,448.84,1,76556,29175941,13324771,0.748383745360604,88.197203305285,0.350614615201422
365.04,365,54148,54154,108296,216616,2023-08-03,2023-08-11,448.84,6,108320,61838439,35859636,0.350293447737256,95.851547934449,0.500055397569893
418.6,416,875,833,142625,216580,2023-08-03,2023-09-29,448.84,-42,73955,193559650,66678490,0.111893155417464,97.3286570832299,0.341467356173239
399.19,396,639,678,152082,216282,2023-08-03,2023-11-17,448.84,39,64200,178436543,50264301,0.121209476693348,98.8533794896486,0.296834688046162
480.44,464,133,130,148827,213720,2023-08-03,2023-09-29,448.84,-3,64893,193559650,66678490,0.11041557473368,97.4390726579636,0.303635597978664
393.19,393,11216,11211,123376,213009,2023-08-03,2023-08-18,448.84,-5,89633,303147069,149589725,0.0702658946044436,98.7970149234727,0.420794426526579
368.83,368,2532,2532,177240,210156,2023-08-03,2023-09-29,448.84,0,32916,193559650,66678490,0.10857428188158,97.5476469398452,0.156626506024096
434.59,432,315,811,46305,210049,2023-08-03,2023-09-08,448.84,496,163744,29175941,13324771,0.719939075829637,88.9171423811146,0.7795514379978
502.45,476,0,79,0,208955,2023-08-03,2023-12-15,448.84,79,208955,463353257,105207973,0.0450962622671281,98.8916756443562,1
376.12,376,17099,17078,119693,204936,2023-08-03,2023-08-18,448.84,-21,85243,303147069,149589725,0.067602830756711,98.8646177542294,0.415949369559277
397.03,394,642,662,146376,200586,2023-08-03,2023-11-17,448.84,20,54210,178436543,50264301,0.112413072248323,98.9657925618969,0.270258143639138
398.7,397,915,1177,86010,200090,2023-08-03,2023-09-29,448.84,262,114080,193559650,66678490,0.103373817838584,97.6510207576838,0.570143435454046
363.41,363,4077,4877,110079,199957,2023-08-03,2023-09-15,448.84,800,89878,612682077,237570121,0.032636339058438,99.3968736578531,0.44948663962752
439.74,439,2526,2683,75780,198542,2023-08-03,2023-08-11,448.84,157,122762,61838439,35859636,0.321065672437171,96.1726136068862,0.618317534828903
396.79,393,510,511,150450,193669,2023-08-03,2023-12-15,448.84,1,43219,463353257,105207973,0.0417972674356317,98.9334729117918,0.22315910135334
305.14,305,13973,13829,125757,193606,2023-08-03,2023-09-15,448.84,-144,67849,612682077,237570121,0.0315997492448274,99.4284734070979,0.350448849725732
444.18,440,373,463,79822,193534,2023-08-03,2023-09-08,448.84,90,113712,29175941,13324771,0.663334217737827,89.5804765988525,0.58755567497184
430.26,430,7736,7377,116040,191802,2023-08-03,2023-08-11,448.84,-359,75762,61838439,35859636,0.310166302871908,96.4827799097581,0.395001094879094
330.35,330,5474,5474,136850,191590,2023-08-03,2023-09-29,448.84,0,54740,193559650,66678490,0.0989824067154492,97.7500031643992,0.285714285714286
432.5,430,569,751,73401,187750,2023-08-03,2023-09-08,448.84,182,114349,29175941,13324771,0.643509664349815,90.2239862632023,0.609049267643143
340.41,340,4363,4535,126527,185935,2023-08-03,2023-09-29,448.84,172,59408,193559650,66678490,0.096060826727058,97.8460639911263,0.319509506010165
376.6,376,3093,3093,108255,185580,2023-08-03,2023-09-15,448.84,0,77325,612682077,237570121,0.0302897713131569,99.458763178411,0.416666666666667
423.33,422,491,1387,32406,184471,2023-08-03,2023-09-01,448.84,896,152065,91969817,42577148,0.200577761288793,98.1601181178821,0.824330111508042
435.79,434,944,1030,89680,184370,2023-08-03,2023-08-25,448.84,86,94690,97519709,36213018,0.189059218788276,97.9613321036469,0.513586809133807
430.94,429,561,950,53856,184300,2023-08-03,2023-09-01,448.84,389,130444,91969817,42577148,0.200391830724204,98.3605099486063,0.707780792186652
190.14,190,13131,13124,157572,183736,2023-08-03,2023-12-15,448.84,-7,26164,463353257,105207973,0.0396535466675267,98.9731264584593,0.142399965167414
420.15,420,8391,12243,92301,183645,2023-08-03,2023-08-11,448.84,3852,91344,61838439,35859636,0.296975478310505,96.7797553880686,0.497394429469901
510.91,480,59,59,143311,182369,2023-08-03,2023-11-17,448.84,0,39058,178436543,50264301,0.102203840611281,99.0679964025082,0.214170171465545
235.3,235,6051,6048,151275,181440,2023-08-03,2023-12-15,448.84,-3,30165,463353257,105207973,0.0391580284068231,99.0122844868661,0.166253306878307
428.05,427,1703,1722,91962,180810,2023-08-03,2023-08-25,448.84,19,88848,97519709,36213018,0.185408674671086,98.146740778318,0.4913887506222
225.26,225,6943,6943,145803,180518,2023-08-03,2023-12-15,448.84,0,34715,463353257,105207973,0.0389590441575336,99.0512435310237,0.192307692307692
481.43,466,111,116,119880,178988,2023-08-03,2023-09-08,448.84,5,59108,29175941,13324771,0.613478070852968,90.8374643340552,0.33023442912374
346.37,346,4786,4786,177082,177082,2023-08-03,2023-09-29,448.84,0,0,193559650,66678490,0.0914870428831629,97.9375510340094,0
368.46,366,643,715,126028,175890,2023-08-03,2023-12-15,448.84,72,49862,463353257,105207973,0.0379602381860456,99.0892037692097,0.283483995679118
438.96,437,1172,891,119544,174636,2023-08-03,2023-08-25,448.84,-281,55092,97519709,36213018,0.179077646755488,98.3258184250735,0.315467601181887
476.5,462,116,120,98020,174000,2023-08-03,2023-09-08,448.84,4,75980,29175941,13324771,0.596381792792904,91.4338461268481,0.436666666666667
368.47,368,3457,3662,103710,172114,2023-08-03,2023-09-15,448.84,205,68404,612682077,237570121,0.028091894060743,99.4868550724718,0.397434258689009
150.07,150,23616,24348,141696,170436,2023-08-03,2023-12-15,448.84,732,28740,463353257,105207973,0.0367831664988167,99.1259869357085,0.168626346546504
250.37,250,4507,4570,139717,169090,2023-08-03,2023-12-15,448.84,63,29373,463353257,105207973,0.0364926753930209,99.1624796111016,0.17371222425927
431.8,431,1859,2105,68783,168400,2023-08-03,2023-08-18,448.84,246,99617,303147069,149589725,0.0555505948170655,98.9201683490464,0.591549881235154
371.51,371,3292,3292,105344,167892,2023-08-03,2023-09-15,448.84,0,62548,612682077,237570121,0.0274027927864454,99.5142578652582,0.372549019607843
371.46,369,682,682,133672,167772,2023-08-03,2023-12-15,448.84,0,34100,463353257,105207973,0.0362082271928435,99.1986878382944,0.203252032520325
425.51,424,859,1108,61848,167308,2023-08-03,2023-09-01,448.84,249,105460,91969817,42577148,0.181916204095524,98.5424261527018,0.630334472948096
468.24,457.5,132,155,82368,166470,2023-08-03,2023-09-08,448.84,23,84102,29175941,13324771,0.570572856587556,92.0044189834357,0.505208145611822
440.39,437.5,547,574,79862,165886,2023-08-03,2023-09-01,448.84,27,86024,91969817,42577148,0.180370044663675,98.7227961973655,0.518572995912856
437.85,435,476,579,79492,165015,2023-08-03,2023-09-08,448.84,103,85523,29175941,13324771,0.565585870906443,92.5700048543422,0.518274096294276
429.61,426,538,457,127506,164977,2023-08-03,2023-09-29,448.84,-81,37471,193559650,66678490,0.0852331568072168,98.0227841908166,0.227128630051462
390.47,387,370,474,98420,164478,2023-08-03,2023-12-15,448.84,104,66058,463353257,105207973,0.0354973225104577,99.2341851608049,0.401622101436058
429.28,428,1230,1284,72570,164352,2023-08-03,2023-08-25,448.84,54,91782,97519709,36213018,0.168532086165269,98.4943505112387,0.558447721962617
265.18,265,9083,9093,127162,163674,2023-08-03,2023-10-20,448.84,10,36512,344413796,107013117,0.0475224865847128,99.6151870176536,0.223077581045248
320.35,320,4661,4663,93220,163205,2023-08-03,2023-09-29,448.84,2,69985,193559650,66678490,0.084317676747194,98.1071018675638,0.428816519101743
390.28,390,5725,5727,91600,160356,2023-08-03,2023-08-25,448.84,2,68756,97519709,36213018,0.164434452937098,98.6587849641758,0.428770984559356
438.6,438,2595,2655,70065,159300,2023-08-03,2023-08-11,448.84,60,89235,61838439,35859636,0.257606761386716,97.0373621494553,0.560169491525424
348.86,347,1224,855,200736,159030,2023-08-03,2023-12-15,448.84,-369,-41706,463353257,105207973,0.0343215457315756,99.2685067065364,-0.262252405206565
392.18,392,8747,8783,87470,158094,2023-08-03,2023-08-18,448.84,36,70624,303147069,149589725,0.0521509248040924,98.9723192738506,0.446721570711096
275.43,275,3666,3666,106314,157638,2023-08-03,2023-11-17,448.84,0,51324,178436543,50264301,0.0883440114618226,99.15634041397,0.325581395348837
372.98,371,793,793,157014,157014,2023-08-03,2023-12-15,448.84,0,0,463353257,105207973,0.0338864565270553,99.3023931630635,0
255.4,255,3935,3925,129855,157000,2023-08-03,2023-12-15,448.84,-10,27145,463353257,105207973,0.0338834350742462,99.3362765981377,0.172898089171975
361.39,361,3962,3960,106974,154440,2023-08-03,2023-09-15,448.84,-2,47466,612682077,237570121,0.0252072005690481,99.5394650658273,0.307342657342657
549.79,500,31,31,137051,154349,2023-08-03,2023-12-15,448.84,0,17298,463353257,105207973,0.0333113014030243,99.3695878995408,0.112070696927094
411.32,411,4822,4815,81974,154080,2023-08-03,2023-08-18,448.84,-7,72106,303147069,149589725,0.0508268150202699,99.0231460888708,0.467977673935618
477.56,464,259,113,205387,153228,2023-08-03,2023-08-11,448.84,-146,-52159,61838439,35859636,0.247787626075102,97.2851497755304,-0.340401232150782
335.05,335,28246,30145,84738,150725,2023-08-03,2023-08-18,448.84,1899,65987,303147069,149589725,0.0497200914715095,99.0728661803423,0.437797312987228
375.71,373,434,553,89404,149863,2023-08-03,2023-12-15,448.84,119,60459,463353257,105207973,0.0323431415957437,99.4019310411365,0.403428464664393
392.37,391,1019,1093,84577,149741,2023-08-03,2023-09-29,448.84,74,65164,193559650,66678490,0.0773616815281491,98.184463549092,0.435178074141351
424,423,420,1493,19320,149300,2023-08-03,2023-08-25,448.84,1073,129980,97519709,36213018,0.153097257498994,98.8118822216748,0.870596115204287
509.74,480,39,50,91689,148700,2023-08-03,2023-10-20,448.84,11,57011,344413796,107013117,0.043174809408622,99.6583618270622,0.383396099529253
433.17,431,569,684,59745,148428,2023-08-03,2023-09-01,448.84,115,88683,91969817,42577148,0.161387730063658,98.8841839274292,0.597481607243916
462.37,454,137,176,68500,147312,2023-08-03,2023-09-08,448.84,39,78812,29175941,13324771,0.504909164712117,93.0749140190543,0.535000543065059
378.55,378,2703,2666,102714,146630,2023-08-03,2023-09-15,448.84,-37,43916,612682077,237570121,0.0239324774633484,99.5633975432906,0.299502148264339
346.29,346,4950,4950,99000,143550,2023-08-03,2023-09-15,448.84,0,44550,612682077,237570121,0.0234297697596922,99.5868273130503,0.310344827586207
401.22,401,6540,6504,85020,143088,2023-08-03,2023-08-18,448.84,-36,58068,303147069,149589725,0.0472008522041821,99.1200670325465,0.405820194565582
407.28,407,5128,5075,76920,142100,2023-08-03,2023-08-18,448.84,-53,65180,303147069,149589725,0.0468749377880345,99.1669419703345,0.45869106263195
388.16,387,1159,1225,86925,142100,2023-08-03,2023-09-29,448.84,66,55175,193559650,66678490,0.0734140612467526,98.2578776103387,0.388282899366643
325.29,325,4916,4899,103236,142071,2023-08-03,2023-09-29,448.84,-17,38835,193559650,66678490,0.0733990787852737,98.331276689124,0.273349240872521
330.91,330,1519,1553,106330,141323,2023-08-03,2023-11-17,448.84,34,34993,178436543,50264301,0.079200704981154,99.2355411189512,0.247610084699589
475.58,463,352,111,248160,139638,2023-08-03,2023-08-11,448.84,-241,-108522,61838439,35859636,0.225811004058495,97.5109607795889,-0.777166673828041
479.42,465,409,96,359920,138432,2023-08-03,2023-08-18,448.84,-313,-221488,303147069,149589725,0.0456649640244419,99.212606934359,-1.59997688395747
377.9,377,1522,1529,89798,137610,2023-08-03,2023-09-29,448.84,7,47812,193559650,66678490,0.0710943629005322,98.4023710520245,0.347445679819781
482.75,465,80,77,79440,136675,2023-08-03,2023-09-08,448.84,-3,57235,29175941,13324771,0.468451043275691,93.54336506233,0.418767148344613
432.46,431,897,933,59202,136218,2023-08-03,2023-08-25,448.84,36,77016,97519709,36213018,0.139682533302063,98.9515647549769,0.565387834206933
391.17,391,7966,7964,79660,135388,2023-08-03,2023-08-18,448.84,-2,55728,303147069,149589725,0.044660830944732,99.2572677653037,0.411616982302715
445.31,441,221,313,50609,134903,2023-08-03,2023-09-08,448.84,92,84294,29175941,13324771,0.462377545937593,94.0057426082675,0.624848965553027
415.59,415,2203,2284,68293,134756,2023-08-03,2023-08-25,448.84,81,66463,97519709,36213018,0.138183349173037,99.0897481041499,0.493209949835258
250.17,250,7901,7908,86911,134436,2023-08-03,2023-10-20,448.84,7,47525,344413796,107013117,0.0390332796076496,99.6973951066699,0.353513939718528
330.04,330,33535,33555,100605,134220,2023-08-03,2023-08-18,448.84,20,33615,303147069,149589725,0.0442755394082336,99.301543304712,0.250447027268663
380.03,379,1287,1303,79794,134209,2023-08-03,2023-09-29,448.84,16,54415,193559650,66678490,0.0693372818146757,98.4717083338392,0.405449709035907
370.69,368,496,496,96720,133424,2023-08-03,2023-12-15,448.84,0,36704,463353257,105207973,0.0287953085436065,99.4307263496801,0.275092936802974
260.46,260,2880,2894,100800,133124,2023-08-03,2023-12-15,448.84,14,32324,463353257,105207973,0.0287305631262672,99.4594569128064,0.242811213605361
441.4,438,330,390,63690,132600,2023-08-03,2023-09-08,448.84,60,68910,29175941,13324771,0.454484055887006,94.4602266641546,0.519683257918552
519.82,485,39,38,114738,132316,2023-08-03,2023-10-20,448.84,-1,17578,344413796,107013117,0.0384177409664507,99.7358128476363,0.132848635085704
394.52,393,618,869,55620,132088,2023-08-03,2023-09-29,448.84,251,76468,193559650,66678490,0.068241495580303,98.5399498294195,0.578917085579311
431.33,431,3911,3992,66487,131736,2023-08-03,2023-08-11,448.84,81,65249,61838439,35859636,0.213032544369369,97.7239933239583,0.495301208477561
387.08,386,1207,1218,96560,131544,2023-08-03,2023-09-29,448.84,11,34984,193559650,66678490,0.0679604452684224,98.6079102746879,0.265949036063979
403.24,403,5410,5408,75740,129792,2023-08-03,2023-08-18,448.84,-2,54052,303147069,149589725,0.0428148622476043,99.3443581669596,0.416450936883629
341.11,340,1142,1169,97070,129759,2023-08-03,2023-11-17,448.84,27,32689,178436543,50264301,0.0727199696981352,99.3082610886493,0.251920868687336
500.97,477,54,54,129438,129438,2023-08-03,2023-12-15,448.84,0,0,463353257,105207973,0.0279350577652247,99.4873919705716,0
491.2,470,64,61,96640,129320,2023-08-03,2023-09-29,448.84,-3,32680,193559650,66678490,0.0668114454639694,98.6747217201519,0.252706464583978
429.8,428,617,717,56147,129060,2023-08-03,2023-09-01,448.84,100,72913,91969817,42577148,0.140328647169103,99.0245125745983,0.564954284828762
180.11,180,11650,11650,104850,128150,2023-08-03,2023-12-15,448.84,0,23300,463353257,105207973,0.0276570841067812,99.5150490546784,0.181818181818182
455.28,449,183,204,65331,128112,2023-08-03,2023-09-08,448.84,21,62781,29175941,13324771,0.439101518610831,94.8993281827654,0.490047770700637
372.5,372,2188,2559,72204,127950,2023-08-03,2023-09-15,448.84,371,55746,612682077,237570121,0.0208835878840308,99.6077109009344,0.435685814771395
405.43,405,2956,2944,67988,126592,2023-08-03,2023-08-25,448.84,-12,58604,97519709,36213018,0.12981170811328,99.2195598122632,0.462936046511628
358.99,357,636,636,100488,126564,2023-08-03,2023-12-15,448.84,0,26076,463353257,105207973,0.027314796667114,99.5423638513455,0.206030150753769
364.3,362,492,547,95448,125810,2023-08-03,2023-12-15,448.84,55,30362,463353257,105207973,0.0271520698515345,99.569515921197,0.241332167554248
427.5,426,326,836,25428,125400,2023-08-03,2023-09-01,448.84,510,99972,91969817,42577148,0.136349080698943,99.1608616552972,0.797224880382775
387.15,387,8209,8230,82090,123450,2023-08-03,2023-08-18,448.84,21,41360,303147069,149589725,0.0407228083739117,99.3850809753335,0.335034426893479
310.67,310,1225,1835,63700,122945,2023-08-03,2023-11-17,448.84,610,59245,178436543,50264301,0.0689012451894453,99.3771623338388,0.481882142421408
396.19,396,6507,6467,78084,122873,2023-08-03,2023-08-18,448.84,-40,44789,303147069,149589725,0.0405324717158984,99.4256134470494,0.364514580094895
359.37,359,3113,3319,77825,122803,2023-08-03,2023-09-15,448.84,206,44978,612682077,237570121,0.0200435110818494,99.6277544120162,0.366261410551859
280.48,280,2550,2558,84150,122784,2023-08-03,2023-11-17,448.84,8,38634,178436543,50264301,0.0688110170347786,99.4459733508736,0.314650117279124
405.68,405,1734,1805,62424,122740,2023-08-03,2023-09-01,448.84,71,60316,91969817,42577148,0.133456827471996,99.2943184827692,0.491412742382272
347.31,347,3854,3869,77080,119939,2023-08-03,2023-09-15,448.84,15,42859,612682077,237570121,0.0195760582041639,99.6473304702204,0.357339981157088
486.19,469,69,69,118611,118611,2023-08-03,2023-12-15,448.84,0,0,463353257,105207973,0.0255983956534485,99.5951143168505,0
480.5,465,467,76,415630,117800,2023-08-03,2023-08-11,448.84,-391,-297830,61838439,35859636,0.190496399820183,97.9144897237784,-2.52826825127334
362.4,362,2939,2945,79353,117800,2023-08-03,2023-09-15,448.84,6,38447,612682077,237570121,0.0192269374969818,99.6665574077173,0.326375212224109
345.44,345,2506,2656,77686,116864,2023-08-03,2023-09-29,448.84,150,39178,193559650,66678490,0.060376219940468,98.7350979400924,0.335244386637459
367.68,367,1697,1702,91638,115736,2023-08-03,2023-09-29,448.84,5,24098,193559650,66678490,0.0597934538525979,98.794891393945,0.208215248496578
367.44,367,2254,2619,65366,115236,2023-08-03,2023-09-15,448.84,365,49870,612682077,237570121,0.0188084496553667,99.6853658573727,0.432764066784685
443.11,443,7135,10315,64215,113465,2023-08-03,2023-08-04,448.84,3180,49250,64122278,31929455,0.176950981061528,98.1636709787509,0.434054554267836
446.77,442.5,178,265,45390,113155,2023-08-03,2023-09-08,448.84,87,67765,29175941,13324771,0.387836676801615,95.287164859567,0.59886880827184
379.61,379,1850,1851,72150,112911,2023-08-03,2023-09-15,448.84,1,40761,612682077,237570121,0.018428970625821,99.7037948279985,0.36100114249276
347.76,346,762,632,102108,111232,2023-08-03,2023-12-15,448.84,-130,9124,463353257,105207973,0.0240058742049589,99.6191201910555,0.082026754890679
369.67,367,415,415,78850,110805,2023-08-03,2023-12-15,448.84,0,31955,463353257,105207973,0.0239137198942793,99.6430339109497,0.288389513108614
443.64,442.5,840,957,36960,109098,2023-08-03,2023-08-11,448.84,117,72138,61838439,35859636,0.176424246414111,98.0909139701926,0.661222020568663
354.98,353,586,548,100206,108504,2023-08-03,2023-12-15,448.84,-38,8298,463353257,105207973,0.0234171225432867,99.666451033493,0.0764764432647644
346.16,345,915,926,85095,107416,2023-08-03,2023-11-17,448.84,11,22321,178436543,50264301,0.060198431439013,99.5061717823125,0.207799582929917
398.2,398,4596,5330,50556,106600,2023-08-03,2023-08-18,448.84,734,56044,303147069,149589725,0.0351644501632968,99.4607778972127,0.525741088180113
354.23,354,4633,4633,106559,106559,2023-08-03,2023-09-15,448.84,0,0,612682077,237570121,0.0173922175954235,99.721187045594,0
373.52,373,2012,2024,66396,105248,2023-08-03,2023-09-15,448.84,12,38852,612682077,237570121,0.0171782403877958,99.7383652859818,0.369147157190635
376.88,376,1185,1187,67545,104456,2023-08-03,2023-09-29,448.84,2,36911,193559650,66678490,0.0539657929738972,98.8488571869189,0.353364095887264
340.05,340,20806,20798,62418,103990,2023-08-03,2023-08-18,448.84,-8,41572,303147069,149589725,0.0343034819182105,99.4950813791309,0.399769208577748
478.44,464,78,71,72618,102524,2023-08-03,2023-09-08,448.84,-7,29906,29175941,13324771,0.351399120254596,95.6385639798216,0.291697553743514
366.33,364,441,440,84672,102520,2023-08-03,2023-12-15,448.84,-1,17848,463353257,105207973,0.022125667285425,99.6885767007784,0.17409285992977
486.8,467.5,53,53,63441,102290,2023-08-03,2023-09-08,448.84,0,38849,29175941,13324771,0.350597089567737,95.9891610693893,0.37979274611399
295.17,295,6211,6004,80743,102068,2023-08-03,2023-09-29,448.84,-207,21325,193559650,66678490,0.0527320647665978,98.9015892516855,0.208929341223498
448.75,444,198,214,53856,101650,2023-08-03,2023-09-08,448.84,16,47794,29175941,13324771,0.34840350136436,96.3375645707537,0.470181997048696
374.5,374,2049,2028,69666,101400,2023-08-03,2023-09-15,448.84,-21,31734,612682077,237570121,0.0165501821917993,99.7549154681736,0.312958579881657
300.2,300,5076,5058,71064,101160,2023-08-03,2023-09-29,448.84,-18,30096,193559650,66678490,0.0522629587313265,98.9538522104168,0.297508896797153
428.63,427,343,619,28812,100897,2023-08-03,2023-09-01,448.84,276,72085,91969817,42577148,0.109706644300488,99.4040251270697,0.714441460102877
397.2,397,4986,4977,59832,99540,2023-08-03,2023-08-18,448.84,-9,39708,303147069,149589725,0.0328355475539828,99.5279169266849,0.398915009041592
315.26,315,3825,3826,68850,99476,2023-08-03,2023-09-29,448.84,1,30626,193559650,66678490,0.0513929426923432,99.0052451531091,0.30787325586071
364.41,364,2344,2421,67976,99261,2023-08-03,2023-09-15,448.84,77,31285,612682077,237570121,0.0162010614846172,99.7711165296582,0.315179174096574
345.07,345,13054,14048,52216,98336,2023-08-03,2023-08-18,448.84,994,46120,303147069,149589725,0.0324383805934142,99.5603553072783,0.469004230393752
270.36,270,1875,2729,48750,98244,2023-08-03,2023-11-17,448.84,854,49494,178436543,50264301,0.0550582287396142,99.5612300110522,0.503786490778063
320.03,320,32575,32618,65150,97854,2023-08-03,2023-08-18,448.84,43,32704,303147069,149589725,0.0322793818600305,99.5926346891383,0.334212193676293
369.45,369,1797,2171,53910,97695,2023-08-03,2023-09-15,448.84,374,43785,612682077,237570121,0.0159454639963297,99.7870619936545,0.448180561953017
457.92,451,104,139,43472,96188,2023-08-03,2023-09-08,448.84,35,52716,29175941,13324771,0.329682597041172,96.6672471677949,0.548051732024785
394.22,394,4331,4340,47641,95480,2023-08-03,2023-08-18,448.84,9,47839,303147069,149589725,0.0314962636171818,99.6241309527555,0.501036866359447
290.1,290,9520,9502,66640,95020,2023-08-03,2023-09-15,448.84,-18,28380,612682077,237570121,0.0155088590913685,99.8025708527459,0.298673963376131
442.09,442,6588,10379,52704,93411,2023-08-03,2023-08-04,448.84,3791,40707,64122278,31929455,0.145676359158669,98.3093473379096,0.435783794199827
473.6,461,73,74,60590,93240,2023-08-03,2023-09-08,448.84,1,32650,29175941,13324771,0.31957838137937,96.9868255491742,0.3501716001716
474.5,462,1965,74,1241880,92500,2023-08-03,2023-08-11,448.84,-1891,-1149380,61838439,35859636,0.149583336021791,98.2404973062143,-12.4257297297297
400.07,400,13541,13196,81246,92372,2023-08-03,2023-08-11,448.84,-345,11126,61838439,35859636,0.149376345027079,98.3898736512414,0.120447754730871
434.47,434,1886,1958,39606,92026,2023-08-03,2023-08-11,448.84,72,52420,61838439,35859636,0.148816822494501,98.5386904737359,0.569621628670158
366.42,366,2137,2139,59836,89838,2023-08-03,2023-09-15,448.84,2,30002,612682077,237570121,0.0146630697016456,99.8172339224475,0.333956677575191
250.05,250,17987,17935,53961,89675,2023-08-03,2023-09-15,448.84,-52,35714,612682077,237570121,0.0146364653653807,99.8318703878129,0.398260384722609
378.13,378,6907,6896,48349,89648,2023-08-03,2023-08-18,448.84,-11,41299,303147069,149589725,0.0295724449178164,99.6537033976733,0.460679546671426
414.91,414,484,984,22748,89544,2023-08-03,2023-09-01,448.84,500,66796,91969817,42577148,0.0973623770502881,99.50138750412,0.745957294737783
430,428,5,446,605,89200,2023-08-03,2023-09-08,448.84,441,88595,29175941,13324771,0.305731355845558,97.2925569050198,0.993217488789238
335.34,335,2585,2584,72380,87856,2023-08-03,2023-09-29,448.84,-1,15476,193559650,66678490,0.0453896253687171,99.0506347784778,0.176151884902568
385.07,384,777,819,52836,87633,2023-08-03,2023-09-29,448.84,42,34797,193559650,66678490,0.0452744154063101,99.0959091938842,0.397076443805416
352.3,352,2865,2865,63030,85950,2023-08-03,2023-09-15,448.84,0,22920,612682077,237570121,0.0140284828341731,99.8458988706471,0.266666666666667
419.03,418,351,834,19305,85902,2023-08-03,2023-09-01,448.84,483,66597,91969817,42577148,0.0934023822185055,99.5947898863385,0.77526716490885
382.01,381,759,849,55407,85749,2023-08-03,2023-09-29,448.84,90,30342,193559650,66678490,0.0443010720467825,99.140210265931,0.353846692089704
469.63,460,7287,89,3111549,85707,2023-08-03,2023-08-04,448.84,-7198,-3025842,64122278,31929455,0.133661814073418,98.443009151983,-35.3044908817249
358.06,356,412,413,59740,85078,2023-08-03,2023-12-15,448.84,1,25338,463353257,105207973,0.0183613687213167,99.7069380694997,0.297820823244552
210.12,210,7173,7082,71730,84984,2023-08-03,2023-11-17,448.84,-91,13254,178436543,50264301,0.0476270155043297,99.6088570265565,0.155958768709404
215.13,215,6537,6537,65370,84981,2023-08-03,2023-11-17,448.84,0,19611,178436543,50264301,0.047625334234367,99.6564823607909,0.230769230769231
357.37,357,2286,2286,57150,84582,2023-08-03,2023-09-15,448.84,0,27432,612682077,237570121,0.013805202269692,99.8597040729168,0.324324324324324
245.35,245,2381,2402,69049,84070,2023-08-03,2023-12-15,448.84,21,15021,463353257,105207973,0.0181438241190565,99.7250818936188,0.178672534792435
388.17,388,4851,4851,48510,82467,2023-08-03,2023-08-18,448.84,0,33957,303147069,149589725,0.0272036276887111,99.680907025362,0.411764705882353
349.62,348,505,505,81810,81810,2023-08-03,2023-12-15,448.84,0,0,463353257,105207973,0.0176560753084336,99.7427379689272,0
381.14,381,5862,5802,46896,81228,2023-08-03,2023-08-18,448.84,-60,34332,303147069,149589725,0.0267949151769632,99.707701940539,0.422662136209189
315.85,315,939,954,51645,81090,2023-08-03,2023-11-17,448.84,15,29445,178436543,50264301,0.045444727092701,99.7019270878836,0.363115057343692
491.17,470,64,38,85376,80446,2023-08-03,2023-09-08,448.84,-26,-4930,29175941,13324771,0.275727182201253,97.5682840872211,-0.0612833453496756
353.87,352,429,429,68640,80223,2023-08-03,2023-12-15,448.84,0,11583,463353257,105207973,0.0173135720507086,99.7600515409779,0.144385026737968
230.27,230,2931,2902,67413,78354,2023-08-03,2023-12-15,448.84,-29,10941,463353257,105207973,0.0169102081006846,99.7769617490786,0.139635500421166
315.42,315,1875,1856,61875,77952,2023-08-03,2023-10-20,448.84,-19,16077,344413796,107013117,0.0226332396975178,99.7584460873339,0.206242302955665
348.51,348,1518,1521,75900,77571,2023-08-03,2023-09-29,448.84,3,1671,193559650,66678490,0.0400760179097245,99.1802862838407,0.0215415554782071
205.2,205,3875,3875,54250,77500,2023-08-03,2023-12-15,448.84,0,23250,463353257,105207973,0.0167258994793253,99.793687648558,0.3
386.54,384,305,305,77470,77470,2023-08-03,2023-12-15,448.84,0,0,463353257,105207973,0.0167194249375914,99.8104070734956,0
300.57,300,1318,1339,59310,76323,2023-08-03,2023-11-17,448.84,21,17013,178436543,50264301,0.0427731891219166,99.7447002770055,0.2229079045635
376.51,374,300,300,62100,75300,2023-08-03,2023-12-15,448.84,0,13200,463353257,105207973,0.0162510997521703,99.8266581732477,0.175298804780876
375.01,375,71870,73752,71870,73752,2023-08-03,2023-08-04,448.84,1882,1882,64122278,31929455,0.115017747809895,98.5580268997929,0.0255179520555375
420.74,418,234,268,42354,73432,2023-08-03,2023-09-29,448.84,34,31078,193559650,66678490,0.0379376590110594,99.2182239428517,0.423221483821767
468.88,459,6200,74,2145200,73112,2023-08-03,2023-08-04,448.84,-6126,-2072088,64122278,31929455,0.114019654760238,98.6720465545532,-28.3412846044425
427.09,426,654,665,38586,72485,2023-08-03,2023-08-25,448.84,11,33899,97519709,36213018,0.0743285647007007,99.2938883769639,0.467669172932331
452.66,447,124,128,40796,72448,2023-08-03,2023-09-08,448.84,4,31652,29175941,13324771,0.248314184622186,97.8165982718432,0.436892667844523
295.3,295,2411,2411,57864,72330,2023-08-03,2023-10-20,448.84,0,14466,344413796,107013117,0.021000900904678,99.7794469882385,0.2
435.03,435,24451,24056,122255,72168,2023-08-03,2023-08-04,448.84,-395,-50087,64122278,31929455,0.112547467511993,98.7845940220652,-0.69403336658907
451.42,446,131,131,39562,71002,2023-08-03,2023-09-08,448.84,0,31440,29175941,13324771,0.243358046275183,98.0599563181184,0.442804428044281
310.41,310,1703,1703,51090,69823,2023-08-03,2023-10-20,448.84,0,18733,344413796,107013117,0.0202729974266188,99.7997199856652,0.268292682926829
424.98,424,713,710,38502,69580,2023-08-03,2023-08-25,448.84,-3,31078,97519709,36213018,0.0713496796837243,99.3652380566476,0.446651336590974
348.32,348,2136,2136,42720,68352,2023-08-03,2023-09-15,448.84,0,25632,612682077,237570121,0.0111561938182827,99.8708602667351,0.375
300.02,300,34821,34171,34821,68342,2023-08-03,2023-08-18,448.84,-650,33521,303147069,149589725,0.0225441731056288,99.7302461136446,0.490489011149805
386.15,386,2549,4415,25490,66225,2023-08-03,2023-08-18,448.84,1866,40735,303147069,149589725,0.0218458321957254,99.7520919458403,0.615100037750094
295.12,295,5507,5470,44056,65640,2023-08-03,2023-09-15,448.84,-37,21584,612682077,237570121,0.0107135498922062,99.8815738166273,0.328823887873248
485.73,467,35,35,40495,65555,2023-08-03,2023-09-08,448.84,0,25060,29175941,13324771,0.224688554175511,98.2846448722939,0.382274426054458
371.76,371,852,852,43452,64752,2023-08-03,2023-09-29,448.84,0,21300,193559650,66678490,0.0334532532994351,99.2516771961512,0.328947368421053
185.12,185,5271,5231,63252,62772,2023-08-03,2023-12-15,448.84,-40,-480,463353257,105207973,0.0135473311240801,99.8402055043718,-0.00764672146817052
487,468,3,33,4542,62700,2023-08-03,2023-10-20,448.84,30,58158,344413796,107013117,0.0182048456618735,99.817924831327,0.92755980861244
360.27,360,86,2321,1548,62667,2023-08-03,2023-09-08,448.84,2235,61119,29175941,13324771,0.214789987407775,98.4994348597017,0.975298003734023
336.44,336,1407,1409,42210,61996,2023-08-03,2023-09-29,448.84,2,19786,193559650,66678490,0.0320294028223341,99.2837065989735,0.319149622556294
378.94,378,648,654,45360,61476,2023-08-03,2023-09-29,448.84,6,16116,193559650,66678490,0.0317607517889188,99.3154673507624,0.2621510833496
383.18,383,3398,3398,27184,61164,2023-08-03,2023-08-18,448.84,0,33980,303147069,149589725,0.0201763454951959,99.7722682913355,0.555555555555556
382.12,382,4762,5077,38096,60924,2023-08-03,2023-08-18,448.84,315,22828,303147069,149589725,0.0200971760013949,99.7923654673369,0.374696342984702
270.07,270,8417,8417,42085,58919,2023-08-03,2023-09-15,448.84,0,16834,612682077,237570121,0.00961656986744203,99.8911903864947,0.285714285714286
355.55,354,380,380,58900,58900,2023-08-03,2023-12-15,448.84,0,0,463353257,105207973,0.0127116836042873,99.8529171879761,0
373.85,373,682,682,56606,57970,2023-08-03,2023-09-29,448.84,0,1364,193559650,66678490,0.0299494238597766,99.3454167746222,0.0235294117647059
424.17,424,3540,3380,42480,57460,2023-08-03,2023-08-11,448.84,-160,14980,61838439,35859636,0.0929195512195901,98.6316100249555,0.26070309780717
389.16,389,2719,3590,27190,57440,2023-08-03,2023-08-18,448.84,871,30250,303147069,149589725,0.0189478988497164,99.8113133661866,0.526636490250696
484.4,467,61,33,66368,57420,2023-08-03,2023-08-18,448.84,-28,-8948.00000000001,303147069,149589725,0.0189413013918997,99.8302546675785,-0.155834204110066
352.77,351,321,321,56817,56817,2023-08-03,2023-12-15,448.84,0,0,463353257,105207973,0.0122621345898946,99.865179322566,0
325.04,325,13992,13991,27984,55964,2023-08-03,2023-08-18,448.84,-1,27980,303147069,149589725,0.01846100646284,99.8487156740414,0.499964262740333
155.08,155,6976,6981,48832,55848,2023-08-03,2023-12-15,448.84,5,7015.99999999999,463353257,105207973,0.0120530068918885,99.8772323294579,0.125626701045695
440.53,437,149,156,27267,55068,2023-08-03,2023-09-08,448.84,7,27801,29175941,13324771,0.188744554974251,98.688179414676,0.504848550882545
422.95,422,268,577,11792,54815,2023-08-03,2023-08-25,448.84,309,43023,97519709,36213018,0.0562091505010541,99.4214472071487,0.784876402444586
415.13,415,4277,4168,38493,54184,2023-08-03,2023-08-11,448.84,-109,15691,61838439,35859636,0.0876218754486995,98.7192319004042,0.289587332053743
375.17,375,3156,3152,34716,53584,2023-08-03,2023-08-25,448.84,-4,18868,97519709,36213018,0.0549468415661495,99.4763940487148,0.352120035831592
490.55,470,41,26,53669,53430,2023-08-03,2023-08-11,448.84,-15,-238.999999999985,61838439,35859636,0.0864025691204786,98.8056344695247,-0.00447314242934654
358.67,358,216,790,9936,52930,2023-08-03,2023-09-29,448.84,574,42994,193559650,66678490,0.0273455753820592,99.3727623500043,0.812280370300397
500.12,475,1,21,1885,52752,2023-08-03,2023-08-18,448.84,20,50867,303147069,149589725,0.0174014547374694,99.8661171287788,0.964266757658477
438.27,437.5,773,683,20098,52591,2023-08-03,2023-08-11,448.84,-90,32493,61838439,35859636,0.0850458078348323,98.8906802773595,0.617843357228423
599.42,525,7,7,48993,52094,2023-08-03,2023-12-15,448.84,0,3101.00000000001,463353257,105207973,0.0112428259029158,99.8884751553608,0.059527008868584
438.98,436,105,174,19635,51852,2023-08-03,2023-09-08,448.84,69,32217,29175941,13324771,0.177721774252285,98.8659011889282,0.62132608192548
366.69,366,746,746,54458,51474,2023-08-03,2023-09-29,448.84,0,-2984.00000000001,193559650,66678490,0.0265933524884964,99.3993557024928,-0.0579710144927538
418.69,418,500,741,20000,51129,2023-08-03,2023-08-25,448.84,241,31129,97519709,36213018,0.0524294017325257,99.5288234504473,0.608832560777641
160.08,160,6344,6349,44408,50792,2023-08-03,2023-12-15,448.84,5,6383.99999999999,463353257,105207973,0.0109618307916631,99.8994369861525,0.125689084895259
235.13,235,3842,3860,30736,50180,2023-08-03,2023-10-20,448.84,18,19444,344413796,107013117,0.014569683497812,99.8324945148248,0.387485053806297
270.2,270,2669,2505,40035,50100,2023-08-03,2023-10-20,448.84,-164,10065,344413796,107013117,0.0145464556245592,99.8470409704494,0.200898203592814
550.06,500,10,10,42190,50060,2023-08-03,2023-08-18,448.84,0,7870,303147069,149589725,0.0165134369153343,99.8826305656942,0.157211346384339
230.18,230,2734,2772,38276,49896,2023-08-03,2023-11-17,448.84,38,11620,178436543,50264301,0.0279628820201925,99.7726631590257,0.232884399551066
220.15,220,3283,3283,39396,49245,2023-08-03,2023-11-17,448.84,0,9849,178436543,50264301,0.0275980464382792,99.800261205464,0.2
362.71,362,773,693,43288,49203,2023-08-03,2023-09-29,448.84,-80,5914.99999999999,193559650,66678490,0.0254200707637155,99.4247757732565,0.12021624697681
352.49,352,998,999,37924,48951,2023-08-03,2023-09-29,448.84,1,11027,193559650,66678490,0.0252898783398296,99.4500656515963,0.22526608240894
411.04,410,336,469,19488,48776,2023-08-03,2023-09-08,448.84,133,29288,29175941,13324771,0.167178840949809,99.033080029878,0.600459242250287
384.17,384,2867,2866,22936,48722,2023-08-03,2023-08-18,448.84,-1,25786,303147069,149589725,0.0160720669873935,99.8987026326816,0.529247567833833
369.84,369,570,570,29070,47880,2023-08-03,2023-09-29,448.84,0,18810,193559650,66678490,0.0247365605383147,99.4748022121346,0.392857142857143
429.24,429,2349,1972,37584,47328,2023-08-03,2023-08-11,448.84,-377,9744,61838439,35859636,0.076534920294479,98.967215197654,0.205882352941176
361.69,361,681,681,29283,46989,2023-08-03,2023-09-29,448.84,0,17706,193559650,66678490,0.0242762373252896,99.4990784494599,0.376811594202899
290.29,290,1596,1596,33516,46284,2023-08-03,2023-10-20,448.84,0,12768,344413796,107013117,0.0134384860704012,99.8604794565198,0.275862068965517
417.87,417,408,531,13872,46197,2023-08-03,2023-08-25,448.84,123,32325,97519709,36213018,0.0473719625229809,99.5761954129703,0.699720761088382
350.43,349,319,319,45617,45617,2023-08-03,2023-12-15,448.84,0,0,463353257,105207973,0.00984497234255979,99.909281958495,0
493.72,472,21,21,35385,45612,2023-08-03,2023-09-29,448.84,0,10227,193559650,66678490,0.0235648287233419,99.5226432781832,0.224217311233886
416.96,416,438,471,22776,45216,2023-08-03,2023-09-01,448.84,33,22440,91969817,42577148,0.0491639556051308,99.6439538419436,0.496284501061571
356.4,356,1128,1128,45120,45120,2023-08-03,2023-09-29,448.84,0,0,193559650,66678490,0.0233106435148028,99.5459539216981,0
433.35,433,1153,1277,20754,44695,2023-08-03,2023-08-11,448.84,124,23941,61838439,35859636,0.072277050848583,99.0394922485026,0.535652757579148
195.18,195,2482,2482,37230,44676,2023-08-03,2023-12-15,448.84,0,7446,463353257,105207973,0.00964188755017211,99.9189238460452,0.166666666666667
416.77,416,590,580,19470,44660,2023-08-03,2023-08-25,448.84,-10,25190,97519709,36213018,0.0457958708633965,99.6219912838337,0.564039408866995
400.34,400,1211,1313,24220,44642,2023-08-03,2023-08-25,448.84,102,20422,97519709,36213018,0.0457774130560623,99.6677686968898,0.457461583262399
305.6,305,739,738,36211,44280,2023-08-03,2023-11-17,448.84,-1,8069,178436543,50264301,0.0248155446499544,99.8250767501139,0.182226738934056
358.36,358,1029,1228,25725,44208,2023-08-03,2023-09-15,448.84,199,18483,612682077,237570121,0.00721548771533593,99.89840587421,0.418091748099891
335.97,335,443,454,34111,44038,2023-08-03,2023-11-17,448.84,11,9927,178436543,50264301,0.0246799222062938,99.8497566723202,0.225418956355875
353.31,353,1399,1417,32177,43927,2023-08-03,2023-09-15,448.84,18,11750,612682077,237570121,0.00716962379821664,99.9055754980083,0.267489243517654
353.58,353,753,753,46686,43674,2023-08-03,2023-09-29,448.84,0,-3012.00000000001,193559650,66678490,0.0225635869872672,99.5685175086853,-0.0689655172413795
355.2,355,2058,2178,26754,43560,2023-08-03,2023-09-01,448.84,120,16806,91969817,42577148,0.0473633648743696,99.691317206818,0.385812672176308
325.87,325,493,493,33524,42891,2023-08-03,2023-11-17,448.84,0,9367,178436543,50264301,0.0240371166572085,99.8737937889774,0.218390804597701
421.23,421,821,1847,27914,42481,2023-08-03,2023-08-11,448.84,1026,14567,61838439,35859636,0.0686967534869371,99.1081890019895,0.342906240436901
359.58,359,649,730,37642,42340,2023-08-03,2023-09-29,448.84,81,4698.00000000001,193559650,66678490,0.0218743937592365,99.5903919024445,0.110958904109589
499.86,475,17,17,31518,42262,2023-08-03,2023-09-15,448.84,0,10744,612682077,237570121,0.00689786784802585,99.9124733658563,0.254223652453741
170.1,170,4206,4211,33648,42110,2023-08-03,2023-12-15,448.84,5,8462,463353257,105207973,0.0090880984138631,99.928011944459,0.200949893137022
473,461,400,35,226800,42000,2023-08-03,2023-08-11,448.84,-365,-184800,61838439,35859636,0.0679189201396238,99.1761079221292,-4.4
285.11,285,3813,3815,26691,41965,2023-08-03,2023-09-15,448.84,2,15274,612682077,237570121,0.00684939246231615,99.9193227583186,0.363969974979149
446.44,442,87,94,20532,41736,2023-08-03,2023-09-08,448.84,7,21204,29175941,13324771,0.14304937071267,99.1761294005907,0.508050603795285
375.27,375,1436,1542,24412,41634,2023-08-03,2023-09-01,448.84,106,17222,91969817,42577148,0.0452691995679409,99.7365864063859,0.41365230340587
165.08,165,5101,5106,35707,40848,2023-08-03,2023-12-15,448.84,5,5140.99999999999,463353257,105207973,0.00881573602492234,99.936827680484,0.125856835095965
326.31,326,1254,1303,31350,40393,2023-08-03,2023-09-29,448.84,49,9043,193559650,66678490,0.0208685022937374,99.6112604047383,0.223875423959597
255.18,255,2209,2229,24299,40122,2023-08-03,2023-10-20,448.84,20,15823,344413796,107013117,0.0116493591331051,99.8721288156529,0.394372164897064
510.84,480,11,13,25696,40092,2023-08-03,2023-08-11,448.84,2,14396,61838439,35859636,0.0648334606247095,99.2409413827539,0.359074129502145
390.01,390,39891,39889,79782,39889,2023-08-03,2023-08-04,448.84,-2,-39893,64122278,31929455,0.0622077088402879,98.8468017309054,-1.00010027827221
521.18,485,6,11,17448,39798,2023-08-03,2023-11-17,448.84,5,22350,178436543,50264301,0.0223037273256297,99.896097516303,0.561586009347203
290.17,290,2302,2306,25322,39202,2023-08-03,2023-09-29,448.84,4,13880,193559650,66678490,0.0202531880998958,99.6315135928382,0.354063568185297
363.63,363,617,617,46275,38871,2023-08-03,2023-09-29,448.84,0,-7404,193559650,66678490,0.0200821813843949,99.6515957742226,-0.19047619047619
509.82,480,69,13,162357,38766,2023-08-03,2023-09-15,448.84,-56,-123591,612682077,237570121,0.00632726196101865,99.9256500202796,-3.18812877263582
340.15,340,2533,2562,22797,38430,2023-08-03,2023-09-01,448.84,29,15633,91969817,42577148,0.0417854479366856,99.7783718543226,0.406791569086651
215.2,215,1911,1911,34398,38220,2023-08-03,2023-12-15,448.84,0,3822.00000000001,463353257,105207973,0.00824856616902987,99.945076246653,0.1
175.1,175,3815,3815,34335,38150,2023-08-03,2023-12-15,448.84,0,3815,463353257,105207973,0.00823345890498402,99.953309705558,0.1
471.86,461,2100,35,1050000,38010,2023-08-03,2023-08-04,448.84,-2065,-1011990,64122278,31929455,0.0592773700273094,98.9060791009328,-26.6243093922652
430.02,430,17977,18792,71908,37584,2023-08-03,2023-08-04,448.84,815,-34324,64122278,31929455,0.0586130143411312,98.9646921152739,-0.913260962111537
235.19,235,1970,1977,27580,37563,2023-08-03,2023-11-17,448.84,7,9983,178436543,50264301,0.0210511812033928,99.9171486975064,0.265766845033677
285.16,285,2317,2319,23170,37104,2023-08-03,2023-09-29,448.84,2,13934,193559650,66678490,0.0191692845073857,99.67076505873,0.375539025442001
310.22,310,1647,1648,27999,36256,2023-08-03,2023-09-29,448.84,1,8257,193559650,66678490,0.0187311766682777,99.6894962353982,0.227741615180936
570.21,510,6,6,33264,36126,2023-08-03,2023-12-15,448.84,0,2862,463353257,105207973,0.00779664315600138,99.961106348714,0.0792227204783259
360.01,360,36077,36077,36077,36077,2023-08-03,2023-08-04,448.84,0,0,64122278,31929455,0.056262817113266,99.0209549323872,0
520.96,485,36,10,103788,35960,2023-08-03,2023-08-18,448.84,-26,-67828,303147069,149589725,0.011862229154523,99.9105648618361,-1.88620689655172
421.84,421,408,425,18768,35700,2023-08-03,2023-08-25,448.84,17,16932,97519709,36213018,0.0366079845459752,99.7043766814357,0.474285714285714
437.04,437,8403,8830,42015,35320,2023-08-03,2023-08-04,448.84,427,-6695,64122278,31929455,0.0550822601779681,99.0760371925651,-0.189552661381653
341.3,341,1170,1170,35100,35100,2023-08-03,2023-09-29,448.84,0,0,193559650,66678490,0.0181339447555314,99.7076301801538,0
390.42,390,725,826,17400,34692,2023-08-03,2023-09-01,448.84,101,17292,91969817,42577148,0.0377210710335544,99.8160929253562,0.49844344517468
200.06,200,5696,5696,28480,34176,2023-08-03,2023-10-20,448.84,0,5696,344413796,107013117,0.00992294745359155,99.8820517631065,0.166666666666667
240.12,240,2840,2847,34080,34164,2023-08-03,2023-10-20,448.84,7,84,344413796,107013117,0.00991946327260363,99.8919712263791,0.00245872848612575
265.07,265,4858,4861,19432,34027,2023-08-03,2023-09-15,448.84,3,14595,612682077,237570121,0.00555377760789304,99.9312037978875,0.428924089693479
260.06,260,5832,5669,23328,34014,2023-08-03,2023-09-15,448.84,-163,10686,612682077,237570121,0.00555165578966332,99.9367554536772,0.314164755688834
255.06,255,5736,5663,17208,33978,2023-08-03,2023-09-15,448.84,-73,16770,612682077,237570121,0.00554577998533487,99.9423012336625,0.493554653010772
280.27,280,1175,1249,21150,33723,2023-08-03,2023-10-20,448.84,74,12573,344413796,107013117,0.00979141962129763,99.9017626460004,0.372831598612223
360.17,360,1744,1978,15696,33626,2023-08-03,2023-08-25,448.84,234,17930,97519709,36213018,0.03448123496759,99.7388579164033,0.533218342948909
441.06,441,4075,5529,28525,33174,2023-08-03,2023-08-04,448.84,1454,4649,64122278,31929455,0.0517355294208356,99.127772721986,0.140139868571773
421.4,420,165,234,13365,32760,2023-08-03,2023-09-08,448.84,69,19395,29175941,13324771,0.112284296160319,99.288413696751,0.592032967032967
339.42,339,772,772,32424,32424,2023-08-03,2023-09-29,448.84,0,0,193559650,66678490,0.0167514252066482,99.7243816053604,0
245.04,245,8076,8075,24228,32300,2023-08-03,2023-09-15,448.84,-1,8072,612682077,237570121,0.00527190221691437,99.9475731358794,0.249907120743034
351.48,351,634,670,31700,32160,2023-08-03,2023-09-29,448.84,36,459.999999999996,193559650,66678490,0.0166150331435297,99.740996638504,0.0143034825870646
215.09,215,3554,3554,21324,31986,2023-08-03,2023-10-20,448.84,0,10662,344413796,107013117,0.00928708442329645,99.9110497304237,0.333333333333333
305.23,305,1502,1385,24032,31855,2023-08-03,2023-09-29,448.84,-117,7823,193559650,66678490,0.0164574589796995,99.7574540974836,0.245581541359284
520.32,485,8,9,22880,31788,2023-08-03,2023-12-15,448.84,1,8908,463353257,105207973,0.00686042442127476,99.9679667731353,0.280231533912168
427.25,427,1276,1271,19140,31775,2023-08-03,2023-08-11,448.84,-5,12635,61838439,35859636,0.0513838973199178,99.2923252800738,0.397639653815893
310.02,310,15880,15877,15880,31754,2023-08-03,2023-08-18,448.84,-3,15874,303147069,149589725,0.0104747837756597,99.9210396456117,0.499905523713548
479.01,464,302,21,233446,31521,2023-08-03,2023-08-04,448.84,-281,-201925,64122278,31929455,0.0491576422160173,99.176930364202,-6.40604676247581
338.42,338,748,748,31416,31416,2023-08-03,2023-09-29,448.84,0,0,193559650,66678490,0.0162306555111047,99.7736847529948,0
438.05,438,7394,6139,44364,30695,2023-08-03,2023-08-04,448.84,-1255,-13669,64122278,31929455,0.0478694783738033,99.2247998425758,-0.445316826844763
327.24,327,1252,1252,30048,30048,2023-08-03,2023-09-29,448.84,0,0,193559650,66678490,0.0155238966385814,99.7892086496333,0
335.15,335,1860,1991,14880,29865,2023-08-03,2023-09-01,448.84,131,14985,91969817,42577148,0.032472610008564,99.8485655353647,0.501757910597689
416.33,415,205,221,13940,29393,2023-08-03,2023-09-08,448.84,16,15453,29175941,13324771,0.10074396572162,99.3891576624727,0.525737420474263
280.08,280,3645,3650,18225,29200,2023-08-03,2023-09-15,448.84,5,10975,612682077,237570121,0.00476593017752011,99.9523390660569,0.375856164383562
290.49,290,584,595,21608,29155,2023-08-03,2023-11-17,448.84,11,7547,178436543,50264301,0.0163391419211703,99.9334878394276,0.258857828845824
496.1,472,1961,12,3178781,28920,2023-08-03,2023-09-15,448.84,-1949,-3149861,612682077,237570121,0.00472022947718773,99.9570592955341,-108.916355463347
1004.55,720,1,1,28455,28455,2023-08-03,2023-12-15,448.84,0,0,463353257,105207973,0.00614110283463487,99.9741078759699,0
491.79,470,74,13,103008,28327,2023-08-03,2023-09-01,448.84,-61,-74681,91969817,42577148,0.030800322240502,99.8793658576052,-2.63638931055177
473.71,462,961,24,552575,28104,2023-08-03,2023-08-04,448.84,-937,-524471,64122278,31929455,0.0438287610430809,99.2686286036189,-18.6617919157415
356.36,356,785,780,18840,28080,2023-08-03,2023-09-15,448.84,-5,9240,612682077,237570121,0.00458312737619057,99.9616424229103,0.329059829059829
275.08,275,3440,3439,17200,27512,2023-08-03,2023-09-15,448.84,-1,10312,612682077,237570121,0.00449042024123059,99.9661328431515,0.374818261122419
400.69,400,98,395,4312,27255,2023-08-03,2023-09-08,448.84,297,22943,29175941,13324771,0.0934160101297161,99.4825736726024,0.841790497156485
285.25,285,1078,1078,21560,26950,2023-08-03,2023-10-20,448.84,0,5390,344413796,107013117,0.00782488980203337,99.9188746202257,0.2
357.56,357,474,475,19434,26600,2023-08-03,2023-09-29,448.84,1,7166,193559650,66678490,0.013742533632397,99.8029511832657,0.269398496240602
328.25,328,1054,1054,26350,26350,2023-08-03,2023-09-29,448.84,0,0,193559650,66678490,0.0136133744817166,99.8165645577475,0
354.6,354,433,433,17753,25980,2023-08-03,2023-09-29,448.84,0,8227,193559650,66678490,0.0134222189387096,99.8299867766862,0.316666666666667
331.35,331,737,737,20636,25795,2023-08-03,2023-09-29,448.84,0,5159,193559650,66678490,0.0133266411672061,99.8433134178534,0.2
412.53,412,456,481,14592,25493,2023-08-03,2023-08-25,448.84,25,10901,97519709,36213018,0.0261413823537968,99.7649992987571,0.427607578550975
332.38,332,662,662,25156,25156,2023-08-03,2023-09-29,448.84,0,0,193559650,66678490,0.0129965103780669,99.8563099282314,0
372.76,372,549,331,36783,25156,2023-08-03,2023-09-29,448.84,-218,-11627,193559650,66678490,0.0129965103780669,99.8693064386095,-0.462195897598983
380.02,380,12532,12531,12532,25062,2023-08-03,2023-08-04,448.84,-1,12530,64122278,31929455,0.039084700016428,99.3077133036353,0.499960098954593
419.15,419,1703,1670,18733,25050,2023-08-03,2023-08-11,448.84,-33,6317,61838439,35859636,0.0405087845118471,99.3328340645856,0.252175648702595
488.22,469,31,13,38068,24986,2023-08-03,2023-08-18,448.84,-18,-13082,303147069,149589725,0.0082422040504703,99.9292818496622,-0.523573200992556
476.13,463,505,19,332290,24947,2023-08-03,2023-08-04,448.84,-486,-307343,64122278,31929455,0.0389053551715677,99.3466186588068,-12.3198380566802
414.55,414,187,450,5797,24750,2023-08-03,2023-08-25,448.84,263,18953,97519709,36213018,0.0253794850843946,99.7903787838415,0.765777777777778
395.3,394,188,190,16732,24700,2023-08-03,2023-09-29,448.84,2,7968,193559650,66678490,0.0127609240872258,99.8820673626967,0.322591093117409
374.1,374,2348,2444,16436,24440,2023-08-03,2023-08-18,448.84,96,8004,303147069,149589725,0.00806209345207293,99.9373439431143,0.327495908346972
265.1,265,2403,2410,19224,24100,2023-08-03,2023-09-29,448.84,7,4876,193559650,66678490,0.0124509421255928,99.8945183048223,0.202323651452282
453.97,447.5,33,37,11517,23939,2023-08-03,2023-09-08,448.84,4,12422,29175941,13324771,0.0820504812509732,99.5646241538534,0.518902209783199
220.08,220,2889,2982,17334,23856,2023-08-03,2023-10-20,448.84,93,6522,344413796,107013117,0.00692655180398174,99.9258011720297,0.273390342052314
350.03,350,7898,7883,15796,23649,2023-08-03,2023-08-11,448.84,-15,7853,61838439,35859636,0.0382432033900468,99.3710772679757,0.332064780751829
412.11,412,2147,2140,17176,23540,2023-08-03,2023-08-11,448.84,-7,6364,61838439,35859636,0.038066937621113,99.4091442055968,0.27034834324554
225.1,225,2150,2346,15050,23460,2023-08-03,2023-10-20,448.84,196,8410,344413796,107013117,0.00681157383138044,99.9326127458611,0.35848252344416
385.07,385,3322,3330,16610,23310,2023-08-03,2023-08-11,448.84,8,6700,61838439,35859636,0.0376950006774912,99.4468392062743,0.287430287430287
499.11,474,9,9,16920,22599,2023-08-03,2023-10-20,448.84,0,5679,344413796,107013117,0.00656158384549729,99.9391743297066,0.251294305057746
432.84,432.5,667,663,12006,22542,2023-08-03,2023-08-11,448.84,-4,10536,61838439,35859636,0.0364530547092238,99.4832922609835,0.467394197498004
442.6,442.5,2276,2196,18208,21960,2023-08-03,2023-08-04,448.84,-80,3752,64122278,31929455,0.0342470677663698,99.3808657265732,0.170856102003643
415.01,415,21806,21824,65418,21824,2023-08-03,2023-08-04,448.84,18,-43594,64122278,31929455,0.0340349729933176,99.4149006995666,-1.99752565982405
487.18,469,12,12,17544,21816,2023-08-03,2023-09-29,448.84,0,4272,193559650,66678490,0.0112709441249765,99.9057892489473,0.195819581958196
340.11,340,1954,1953,9770,21483,2023-08-03,2023-08-25,448.84,-1,11713,97519709,36213018,0.0220293930532545,99.8124081768948,0.545221803286319
385.25,385,871,853,11323,21325,2023-08-03,2023-08-25,448.84,-18,10002,97519709,36213018,0.0218673745222107,99.834275551417,0.469026963657679
487.3,468,11,11,14729,21230,2023-08-03,2023-09-29,448.84,0,6501,193559650,66678490,0.0109681950757816,99.9167574440231,0.306217616580311
442.61,439,31,58,6324,20938,2023-08-03,2023-09-08,448.84,27,14614,29175941,13324771,0.0717646090660795,99.6363887629194,0.697965421721272
355.14,355,1479,1495,11832,20930,2023-08-03,2023-08-25,448.84,16,9098,97519709,36213018,0.0214623281946012,99.8557378796116,0.434687052078356
215.03,215,6958,6958,13916,20874,2023-08-03,2023-09-15,448.84,0,6958,612682077,237570121,0.00340698720977927,99.9695398303613,0.333333333333333
419.77,419,220,268,8140,20636,2023-08-03,2023-08-25,448.84,48,12496,97519709,36213018,0.0211608506748108,99.8768987302864,0.605543710021322
426.2,426,740,1024,9620,20480,2023-08-03,2023-08-11,448.84,284,10860,61838439,35859636,0.0331185591537975,99.5164108201373,0.5302734375
414.14,414,1514,1458,13626,20412,2023-08-03,2023-08-11,448.84,-56,6786,61838439,35859636,0.0330085951878572,99.5494194153252,0.332451499118166
347.45,347,448,450,16128,20250,2023-08-03,2023-09-29,448.84,2,4122,193559650,66678490,0.0104618912051143,99.9272193352282,0.203555555555556
420.02,420,10127,10115,20254,20230,2023-08-03,2023-08-04,448.84,-12,-24,64122278,31929455,0.0315490974915146,99.4464497970581,-0.00118635689569946
501.02,476,6,8,12390,20016,2023-08-03,2023-10-20,448.84,2,7626,344413796,107013117,0.00581161388784786,99.9449859435944,0.38099520383693
320.84,320,252,238,15372,19992,2023-08-03,2023-11-17,448.84,-14,4620,178436543,50264301,0.0112039830316596,99.9446918224593,0.23109243697479
491.91,472,10,10,19910,19910,2023-08-03,2023-12-15,448.84,0,0,463353257,105207973,0.00429693753075313,99.9784048135007,0
425.82,424,71,109,6887,19838,2023-08-03,2023-09-08,448.84,38,12951,29175941,13324771,0.0679943793415266,99.704383142261,0.652837987700373
295.02,295,9516,9851,9516,19702,2023-08-03,2023-08-18,448.84,335,10186,303147069,149589725,0.00649915569528399,99.9438430988096,0.517003349913714
490.38,471,10,10,19380,19380,2023-08-03,2023-12-15,448.84,0,0,463353257,105207973,0.00418255396012032,99.9825873674608,0
350.17,350,784,1133,7840,19261,2023-08-03,2023-09-01,448.84,349,11421,91969817,42577148,0.0209427403775306,99.9003085979828,0.592959867088936
484.37,467,379,11,416900,19107,2023-08-03,2023-09-01,448.84,-368,-397793,91969817,42577148,0.0207752941380758,99.9210838921208,-20.8192285549799
370.18,370,1010,1057,13130,19026,2023-08-03,2023-08-25,448.84,47,5896,97519709,36213018,0.0195099023521491,99.8964086326386,0.30989172711027
333.29,333,654,654,18966,18966,2023-08-03,2023-09-29,448.84,0,0,193559650,66678490,0.00979852980721964,99.9370178650354,0
275.17,275,1111,1111,18887,18887,2023-08-03,2023-10-20,448.84,0,0,344413796,107013117,0.00548381052656787,99.950469754121,0
330.02,330,9250,9250,9250,18500,2023-08-03,2023-08-11,448.84,0,9250,61838439,35859636,0.0299166672043581,99.5793360825295,0.5
485.39,467,88,10,90816,18390,2023-08-03,2023-08-11,448.84,-78,-72426,61838439,35859636,0.0297387843182782,99.6090748668478,-3.93833605220229
439.04,439,3596,4594,21576,18376,2023-08-03,2023-08-04,448.84,998,-3200,64122278,31929455,0.0286577466882883,99.4751075437464,-0.174140182847192
540.7,495,4,4,14896,18280,2023-08-03,2023-08-18,448.84,0,3384,303147069,149589725,0.00603007644451281,99.9498731752541,0.185120350109409
260.16,260,1117,1138,14521,18208,2023-08-03,2023-10-20,448.84,21,3687,344413796,107013117,0.00528666395233482,99.9557564180733,0.202493409490334
390.05,390,3642,3641,14568,18205,2023-08-03,2023-08-11,448.84,-1,3637,61838439,35859636,0.0294396176462346,99.638514484494,0.199780280142818
494.59,472,6,8,10644,18072,2023-08-03,2023-10-20,448.84,2,7428,344413796,107013117,0.00524717656780508,99.9610035946412,0.411022576361222
250.26,250,693,694,13860,18044,2023-08-03,2023-11-17,448.84,1,4184,178436543,50264301,0.0101122784025243,99.9548041008618,0.231877632454001
285.43,285,395,419,13430,18017,2023-08-03,2023-11-17,448.84,24,4587,178436543,50264301,0.0100971469728597,99.9649012478346,0.254592884497974
432.03,432,3365,5935,10095,17805,2023-08-03,2023-08-04,448.84,2570,7710,64122278,31929455,0.0277672605455471,99.5028748042919,0.433024431339511
428.23,428,848,771,13568,17733,2023-08-03,2023-08-11,448.84,-77,4165,61838439,35859636,0.0286763383532369,99.6671908228473,0.234872835955563
150.01,150,17443,17443,17443,17443,2023-08-03,2023-09-15,448.84,0,0,612682077,237570121,0.00284699041392066,99.9723868207752,0
408.48,408,310,359,8370,17232,2023-08-03,2023-08-25,448.84,49,8862,97519709,36213018,0.0176702742211833,99.9140789068598,0.514275766016713
335.2,335,855,856,8550,17120,2023-08-03,2023-09-08,448.84,1,8570,29175941,13324771,0.0586784844403133,99.7630616267013,0.500584112149533
370.01,370,4969,17043,4969,17043,2023-08-03,2023-08-04,448.84,12074,12074,64122278,31929455,0.0265789060082987,99.5294537103002,0.708443349175615
364.67,364,476,250,23324,16750,2023-08-03,2023-09-29,448.84,-226,-6574,193559650,66678490,0.00865366309558836,99.945671528131,-0.392477611940299
190.05,190,3324,3324,16620,16620,2023-08-03,2023-10-20,448.84,0,0,344413796,107013117,0.00482559066826696,99.9658291853094,0
436.03,436,5474,5502,21896,16506,2023-08-03,2023-08-04,448.84,28,-5390,64122278,31929455,0.0257414435588205,99.555195153859,-0.326547921967769
493.58,473,8,8,16464,16464,2023-08-03,2023-12-15,448.84,0,0,463353257,105207973,0.0035532285035821,99.9861405959643,0
405.09,405,1809,1801,10854,16209,2023-08-03,2023-08-11,448.84,-8,5355,61838439,35859636,0.0262118518224563,99.6934026746697,0.330372015546918
413.58,413,257,269,8481,15602,2023-08-03,2023-08-25,448.84,12,7121,97519709,36213018,0.015998817223706,99.9300777240835,0.456415844122548
315.03,315,5213,5155,10426,15465,2023-08-03,2023-08-18,448.84,-58,5039,303147069,149589725,0.00510148425680474,99.9549746595109,0.325832525056579
200.01,200,14696,14696,29392,14696,2023-08-03,2023-09-15,448.84,0,-14696,612682077,237570121,0.00239863390030259,99.9747854546755,-1
410.1,410,1467,1447,11736,14470,2023-08-03,2023-08-11,448.84,-20,2734,61838439,35859636,0.0233996851052466,99.716802359775,0.188942639944713
235.03,235,4755,4754,14265,14262,2023-08-03,2023-09-15,448.84,-1,-3,612682077,237570121,0.00232779781478739,99.9771132524903,-0.000210349179638199
329.43,329,331,331,14233,14233,2023-08-03,2023-09-29,448.84,0,0,193559650,66678490,0.00735328876653786,99.9530248168975,0
542.15,495,3,3,12540,14145,2023-08-03,2023-09-15,448.84,0,1605,612682077,237570121,0.00230870145071993,99.9794219539411,0.113467656415694
422.17,422,970,831,11640,14127,2023-08-03,2023-08-11,448.84,-139,2487,61838439,35859636,0.0228450139241063,99.7396473736991,0.176045869611383
729.74,590,1,1,14117,13974,2023-08-03,2023-12-15,448.84,0,-142.999999999998,463353257,105207973,0.00301584153966571,99.989156437504,-0.0102332903964504
589.82,520,0,2,0,13964,2023-08-03,2023-08-04,448.84,2,13964,64122278,31929455,0.0217771427272125,99.5769722965862,1
423.19,423,881,719,10572,13661,2023-08-03,2023-08-11,448.84,-162,3089,61838439,35859636,0.0220914373339857,99.7617388110331,0.226118146548569
485.01,468,138,8,170292,13608,2023-08-03,2023-09-01,448.84,-130,-156684,91969817,42577148,0.014796158613646,99.9358800507345,-11.5141093474427
719.78,585,0,1,0,13478,2023-08-03,2023-10-20,448.84,1,13478,344413796,107013117,0.00391331594626366,99.9697425012557,1
260.34,260,396,396,9108,13464,2023-08-03,2023-11-17,448.84,0,4356,178436543,50264301,0.00754553959275035,99.9724467874274,0.323529411764706
230.03,230,4418,4419,8836,13257,2023-08-03,2023-09-15,448.84,1,4421,612682077,237570121,0.00216376494395151,99.981585718885,0.333484197027985
579.28,515,0,2,0,12856,2023-08-03,2023-08-11,448.84,2,12856,61838439,35859636,0.0207896580313096,99.7825284690644,1
240.2,240,613,633,9808,12660,2023-08-03,2023-11-17,448.84,20,2852,178436543,50264301,0.00709495924273763,99.9795417466702,0.225276461295419
280.15,280,842,843,9262,12645,2023-08-03,2023-09-29,448.84,1,3383,193559650,66678490,0.00653286984141581,99.9595576867389,0.267536575721629
570.07,510,0,2,0,12014,2023-08-03,2023-08-11,448.84,2,12014,61838439,35859636,0.0194280453942248,99.8019565144586,1
488.96,469,105,6,128625,11976,2023-08-03,2023-09-01,448.84,-99,-116649,91969817,42577148,0.013021663400722,99.9489017141352,-9.74023046092184
220.03,220,3928,3928,7856,11784,2023-08-03,2023-09-15,448.84,0,3928,612682077,237570121,0.00192334661684579,99.9835090655019,0.333333333333333
355.01,355,11541,11541,11541,11541,2023-08-03,2023-08-04,448.84,0,0,64122278,31929455,0.0179984248220252,99.5949707214083,0
290.01,290,11516,11516,11516,11516,2023-08-03,2023-08-18,448.84,0,0,303147069,149589725,0.00379881621088674,99.9587734757218,0
494.97,472,0,5,0,11485,2023-08-03,2023-08-18,448.84,5,11485,303147069,149589725,0.00378859015127077,99.962562065873,1
260.1,260,1139,1140,9112,11400,2023-08-03,2023-09-29,448.84,1,2288,193559650,66678490,0.0058896572710273,99.96544734401,0.200701754385965
486.96,468,28,6,29512,11376,2023-08-03,2023-08-18,448.84,-22,-18136,303147069,149589725,0.00375263400616946,99.9663146998792,-1.59423347398031
270.12,270,943,944,7544,11328,2023-08-03,2023-09-29,448.84,1,3784,193559650,66678490,0.00585245943563134,99.9712998034456,0.334039548022599
210.07,210,1592,1592,7960,11144,2023-08-03,2023-10-20,448.84,0,3184,344413796,107013117,0.00323564274411354,99.9729781439998,0.285714285714286
160.03,160,3711,3711,7422,11133,2023-08-03,2023-10-20,448.84,0,3711,344413796,107013117,0.00323244891154128,99.9762105929113,0.333333333333333
486.43,468,85,6,100980,11058,2023-08-03,2023-09-08,448.84,-79,-89922,29175941,13324771,0.0379010911764594,99.8009627178777,-8.13185024416712
480.75,465,40,7,33320,11025,2023-08-03,2023-08-04,448.84,-33,-22295,64122278,31929455,0.0171937123007389,99.612164433709,-2.02222222222222
250.01,250,11021,11021,11021,11021,2023-08-03,2023-08-18,448.84,0,0,303147069,149589725,0.00363552912992208,99.9699502290092,0
507.48,481,4,4,10592,10592,2023-08-03,2023-12-15,448.84,0,0,463353257,105207973,0.00228594486819373,99.9914423823722,0
195.04,195,2633,2633,10532,10532,2023-08-03,2023-10-20,448.84,0,0,344413796,107013117,0.0030579495137297,99.9792685424251,0
433.03,433,3502,3500,17510,10500,2023-08-03,2023-08-04,448.84,-2,-7010,64122278,31929455,0.0163749640959418,99.6285393978049,-0.667619047619048
659.69,555,1,1,9946,10469,2023-08-03,2023-12-15,448.84,0,523,463353257,105207973,0.00225939924708461,99.9937017816193,0.0499570159518579
644.44,540,1,1,10444,10444,2023-08-03,2023-12-15,448.84,0,0,463353257,105207973,0.00225400379563966,99.9959557854149,0
260.01,260,10236,10236,10236,10236,2023-08-03,2023-08-18,448.84,0,0,303147069,149589725,0.0033765789106145,99.9733268079198,0
150.02,150,4544,5094,4544,10188,2023-08-03,2023-10-20,448.84,550,5644,344413796,107013117,0.00295806965874271,99.9822266120838,0.553985080486847
550.9,500,2,2,10180,10180,2023-08-03,2023-09-15,448.84,0,0,612682077,237570121,0.00166154689065598,99.9851706123925,0
418.14,418,731,727,7310,10178,2023-08-03,2023-08-11,448.84,-4,2868,61838439,35859636,0.0164590183138355,99.8184155327724,0.281784240518766
360.21,360,364,482,4732,10122,2023-08-03,2023-09-01,448.84,118,5390,91969817,42577148,0.0110057846478046,99.959907498783,0.532503457814661
305.02,305,5044,5018,10088,10036,2023-08-03,2023-08-18,448.84,-26,-52,303147069,149589725,0.00331060433244697,99.9766374122522,-0.00518134715025907
483.71,467,2781,6,3106377,10026,2023-08-03,2023-08-25,448.84,-2775,-3096351,97519709,36213018,0.0102809986850966,99.9403587227685,-308.832136445242
550.06,500,0,2,0,10012,2023-08-03,2023-08-11,448.84,2,10012,61838439,35859636,0.0161905768675694,99.83460610964,1
225.03,225,3279,3281,6558,9843,2023-08-03,2023-09-15,448.84,2,3285,612682077,237570121,0.00160654283347022,99.986777155226,0.333739713501981
240.03,240,3241,3241,6482,9723,2023-08-03,2023-09-15,448.84,0,3241,612682077,237570121,0.00158695681904206,99.988364112045,0.333333333333333
428.02,428,4682,4676,14046,9352,2023-08-03,2023-08-04,448.84,-6,-4694,64122278,31929455,0.0145846346881188,99.6431240324931,-0.501924721984602
195.01,195,9243,9243,9243,9243,2023-08-03,2023-08-18,448.84,0,0,303147069,149589725,0.00304901513001269,99.9796864273822,0
422.68,422.5,507,509,6084,9162,2023-08-03,2023-08-11,448.84,2,3078,61838439,35859636,0.0148160272933151,99.8494221369333,0.335952848722986
337.27,337,335,335,9045,9045,2023-08-03,2023-09-29,448.84,0,0,193559650,66678490,0.00467297807161772,99.9759727815172,0
345.15,345,478,602,4302,9030,2023-08-03,2023-09-01,448.84,124,4728,91969817,42577148,0.00981843858621574,99.9697259373692,0.52358803986711
629.08,540,0,1,0,8908,2023-08-03,2023-08-11,448.84,1,8908,61838439,35859636,0.014405279538185,99.8638274164715,1
539.36,495,5,2,19040,8872,2023-08-03,2023-11-17,448.84,-3,-10168,178436543,50264301,0.00497207570312545,99.9845138223733,-1.14607754733995
335.09,335,981,982,4905,8838,2023-08-03,2023-08-25,448.84,1,3933,97519709,36213018,0.00906278340104563,99.9494215061696,0.445010183299389
230.1,230,850,866,5950,8660,2023-08-03,2023-10-20,448.84,16,2710,344413796,107013117,0.00251441727961443,99.9847410293634,0.312933025404157
437.55,437.5,1606,1721,8030,8605,2023-08-03,2023-08-04,448.84,115,575.000000000001,64122278,31929455,0.0134196729567218,99.6565437054498,0.0668216153399188
295.51,295,167,167,6847,8517,2023-08-03,2023-11-17,448.84,0,1670,178436543,50264301,0.00477312542420193,99.9892869477975,0.196078431372549
255.08,255,1052,1058,5260,8464,2023-08-03,2023-09-29,448.84,6,3204,193559650,66678490,0.00437281220543641,99.9803455937227,0.378544423440454
245.15,245,561,561,5610,8415,2023-08-03,2023-10-20,448.84,0,2805,344413796,107013117,0.00244328191777777,99.9871843112812,0.333333333333333
531.8,490,6,2,20622,8360,2023-08-03,2023-12-15,448.84,-4,-12262,463353257,105207973,0.00180423896318916,99.9977600243781,-1.46674641148325
432.54,432.5,1911,2065,7644,8260,2023-08-03,2023-08-04,448.84,154,616,64122278,31929455,0.0128816384221409,99.6694253438719,0.0745762711864407
265.37,265,219,219,5694,8103,2023-08-03,2023-11-17,448.84,0,2409,178436543,50264301,0.00454111016934463,99.9938280579668,0.297297297297297
609.87,530,1,1,7386,7987,2023-08-03,2023-09-15,448.84,0,601,612682077,237570121,0.00130361247698127,99.989667724522,0.0752472768248404
344.46,344,173,173,6228,7958,2023-08-03,2023-09-29,448.84,0,1730,193559650,66678490,0.00411139408445924,99.9844569878071,0.217391304347826
481.8,466,196,5,192080,7900,2023-08-03,2023-08-25,448.84,-191,-184180,97519709,36213018,0.00810092655219059,99.9575224327218,-23.3139240506329
205.07,205,1127,1127,5635,7889,2023-08-03,2023-10-20,448.84,0,2254,344413796,107013117,0.00229055865114068,99.9894748699323,0.285714285714286
481.63,466,597,5,564762,7815,2023-08-03,2023-08-18,448.84,-592,-556947,303147069,149589725,0.00257795664189648,99.9822643840241,-71.2664107485605
427.74,427.5,291,324,4365,7776,2023-08-03,2023-08-11,448.84,33,3411,61838439,35859636,0.0125747029287075,99.8764021194002,0.438657407407407
527.5,489,2,2,6260,7700,2023-08-03,2023-12-15,448.84,0,1440,463353257,105207973,0.00166179904504265,99.9994218234232,0.187012987012987
275.09,275,835,835,7515,7515,2023-08-03,2023-09-29,448.84,0,0,193559650,66678490,0.00388252406945353,99.9883395118766,0
506.6,482,3,3,7380,7380,2023-08-03,2023-10-20,448.84,0,0,344413796,107013117,0.00214277130756981,99.9916176412399,0
431.02,431,2928,3637,8784,7274,2023-08-03,2023-08-04,448.84,709,-1510,64122278,31929455,0.0113439513175125,99.6807692951894,-0.207588671982403
425.02,425,3635,3616,7270,7232,2023-08-03,2023-08-04,448.84,-19,-37.9999999999991,64122278,31929455,0.0112784514611287,99.6920477466506,-0.00525442477876094
436.98,434,9,24,1521,7152,2023-08-03,2023-09-08,448.84,15,5631,29175941,13324771,0.024513348172729,99.8254760660505,0.787332214765101
434.02,434,3449,3546,13796,7092,2023-08-03,2023-08-04,448.84,97,-6704,64122278,31929455,0.0110601186065161,99.7031078652571,-0.945290468133108
426.04,426,1754,1745,5262,6980,2023-08-03,2023-08-04,448.84,-9,1718,64122278,31929455,0.0108854523228261,99.7139933175799,0.246131805157593
406.02,406,3474,3474,3474,6948,2023-08-03,2023-08-04,448.84,0,3474,64122278,31929455,0.0108355476703432,99.7248288652502,0.5
200.01,200,6907,6907,6907,6907,2023-08-03,2023-08-18,448.84,0,0,303147069,149589725,0.00227843205701586,99.9845428160811,0
205.02,205,3370,3370,6740,6740,2023-08-03,2023-09-15,448.84,0,0,612682077,237570121,0.00110008114371526,99.9907678056657,0
414.04,414,1649,1662,6596,6648,2023-08-03,2023-08-04,448.84,13,51.9999999999991,64122278,31929455,0.0103676915533163,99.7351965568036,0.00782190132370624
417.13,417,498,506,4980,6578,2023-08-03,2023-08-11,448.84,8,1598,61838439,35859636,0.010637396587582,99.8870395159878,0.242930982061417
210.02,210,3261,3260,6522,6520,2023-08-03,2023-09-15,448.84,-1,-2,612682077,237570121,0.00106417345059696,99.9918319791163,-0.000306748466257669
320.1,320,468,651,2808,6510,2023-08-03,2023-09-01,448.84,183,3702,91969817,42577148,0.00707840921331832,99.9768043465826,0.568663594470046
315.04,315,1621,1621,6484,6484,2023-08-03,2023-08-25,448.84,0,0,97519709,36213018,0.00664891237524099,99.964171345097,0
408.11,408,583,584,4081,6424,2023-08-03,2023-08-11,448.84,1,2343,61838439,35859636,0.0103883605470701,99.8974278765349,0.36472602739726
334.27,334,237,237,6399,6399,2023-08-03,2023-09-29,448.84,0,0,193559650,66678490,0.00330595762081612,99.9916454694974,0
245.24,245,260,260,4680,6240,2023-08-03,2023-11-17,448.84,0,1560,178436543,50264301,0.00349704152248679,99.9973250994893,0.25
408.01,408,6228,6227,18684,6227,2023-08-03,2023-08-04,448.84,-1,-12457,64122278,31929455,0.00971113346908854,99.7449076902726,-2.00048177292436
416.13,416,479,475,4790,6175,2023-08-03,2023-08-11,448.84,-4,1385,61838439,35859636,0.00998569837767089,99.9074135749125,0.224291497975708
330.12,330,511,511,6132,6132,2023-08-03,2023-09-08,448.84,0,0,29175941,13324771,0.0210173169735982,99.846493383024,0
280.01,280,6109,6110,6109,6110,2023-08-03,2023-08-18,448.84,1,1,303147069,149589725,0.00201552336301823,99.9865583394442,0.00016366612111293
195.02,195,3003,3003,6006,6006,2023-08-03,2023-09-15,448.84,0,0,612682077,237570121,0.00098028002212965,99.9928122591384,0
170.01,170,5914,5914,5914,5914,2023-08-03,2023-09-15,448.84,0,0,612682077,237570121,0.000965264077734724,99.9937775232162,0
365.01,365,5842,5842,5842,5842,2023-08-03,2023-08-04,448.84,0,0,64122278,31929455,0.00911071811890401,99.7540184083915,0
507.2,478,0,2,0,5840,2023-08-03,2023-10-20,448.84,2,5840,344413796,107013117,0.00169563474745361,99.9933132759874,1
325.11,325,528,528,5808,5808,2023-08-03,2023-09-08,448.84,0,0,29175941,13324771,0.019906812945639,99.8664001959697,0
345.06,345,966,966,5796,5796,2023-08-03,2023-08-25,448.84,0,0,97519709,36213018,0.00594341396158186,99.9701147590586,0
488.28,469,1852,3,2387228,5784,2023-08-03,2023-08-25,448.84,-1849,-2381444,97519709,36213018,0.00593110875669246,99.9760458678153,-411.729598893499
400.01,400,5791,5689,17373,5689,2023-08-03,2023-08-04,448.84,-102,-11684,64122278,31929455,0.00887211149922029,99.7628905198908,-2.05378801195289
325.01,325,5676,5676,5676,5676,2023-08-03,2023-08-04,448.84,0,0,64122278,31929455,0.00885183773414912,99.7717423576249,0
506.28,478,0,2,0,5656,2023-08-03,2023-08-04,448.84,2,5656,64122278,31929455,0.00882064732634733,99.7805630049513,1
405.01,405,5642,5624,11284,5624,2023-08-03,2023-08-04,448.84,-18,-5660,64122278,31929455,0.00877074267386446,99.7893337476251,-1.00640113798009
413.11,413,404,507,3232,5577,2023-08-03,2023-08-11,448.84,103,2345,61838439,35859636,0.00901866232425434,99.9164322372368,0.420476958938497
395.01,395,5479,5475,5479,5475,2023-08-03,2023-08-04,448.84,-4,-4,64122278,31929455,0.00853837413574109,99.7978721217609,-0.000730593607305936
491.81,474,3,3,5343,5343,2023-08-03,2023-09-08,448.84,0,0,29175941,13324771,0.0183130340166235,99.8847132299863,0
175.01,175,5082,5283,5082,5283,2023-08-03,2023-09-15,448.84,201,201,612682077,237570121,0.000862274285199957,99.9946397975014,0.0380465644520159
485.56,468,2,3,2244,5268,2023-08-03,2023-08-04,448.84,1,3024,64122278,31929455,0.00821555341499252,99.8060876751759,0.574031890660592
419.01,419,5141,5141,10282,5141,2023-08-03,2023-08-04,448.84,0,-5141,64122278,31929455,0.00801749432545113,99.8141051695013,-1
345.15,345,333,333,4995,4995,2023-08-03,2023-09-08,448.84,0,0,29175941,13324771,0.0171202704310377,99.9018335004174,0
349.56,349,89,89,3204,4984,2023-08-03,2023-09-29,448.84,0,1780,193559650,66678490,0.00257491682796492,99.9942203863254,0.357142857142857
548.28,499,0,1,0,4928,2023-08-03,2023-08-11,448.84,1,4928,61838439,35859636,0.00796915329638253,99.9244013905332,1
310.01,310,4925,4925,4925,4925,2023-08-03,2023-08-04,448.84,0,0,64122278,31929455,0.00768063792119176,99.8217858074225,0
160.01,160,4864,4864,4864,4864,2023-08-03,2023-09-15,448.84,0,0,612682077,237570121,0.000793886451488281,99.9954336839529,0
330.12,330,265,400,1855,4800,2023-08-03,2023-09-01,448.84,135,2945,91969817,42577148,0.00521910356742365,99.98202345015,0.613541666666667
427.51,427.5,4761,4748,19044,4748,2023-08-03,2023-08-04,448.84,-13,-14296,64122278,31929455,0.00740460281214588,99.8291904102346,-3.01095197978096
545.22,498,0,1,0,4722,2023-08-03,2023-08-11,448.84,1,4722,61838439,35859636,0.00763602716426914,99.9320374176974,1
497.58,474,200,2,362600,4716,2023-08-03,2023-09-15,448.84,-198,-357884,612682077,237570121,0.000769730367026878,99.9962034143199,-75.8871925360475
185.01,185,4646,4646,4646,4646,2023-08-03,2023-09-15,448.84,0,0,612682077,237570121,0.000758305191943782,99.9969617195118,0
423.02,423,2306,2310,4612,4620,2023-08-03,2023-08-04,448.84,4,8,64122278,31929455,0.0072049842022144,99.8363953944369,0.00173160173160173
395.64,395,68,72,2584,4608,2023-08-03,2023-09-08,448.84,4,2024,29175941,13324771,0.0157938350643086,99.9176273354817,0.439236111111111
375.04,375,1138,1140,4552,4560,2023-08-03,2023-08-11,448.84,2,8,61838439,35859636,0.00737405418658773,99.939411471884,0.00175438596491228
155.01,155,4485,4485,4485,4485,2023-08-03,2023-09-15,448.84,0,0,612682077,237570121,0.000732027289252661,99.9976937468011,0
325.11,325,261,406,2088,4466,2023-08-03,2023-09-01,448.84,145,2378,91969817,42577148,0.00485594094419042,99.9868793910942,0.532467532467532
265.01,265,4284,4294,4284,4294,2023-08-03,2023-08-18,448.84,10,10,303147069,149589725,0.001416474193257,99.9879748136374,0.00232883092687471
290.01,290,4254,4254,4254,4254,2023-08-03,2023-08-04,448.84,0,0,64122278,31929455,0.00663419973944157,99.8430295941763,0
155.02,155,2096,2096,4192,4192,2023-08-03,2023-10-20,448.84,0,0,344413796,107013117,0.00121714055844615,99.9945304165458,0
165.04,165,1046,1046,2092,4184,2023-08-03,2023-10-20,448.84,0,2092,344413796,107013117,0.00121481777112088,99.9957452343169,0.5
165.01,165,4148,4148,4148,4148,2023-08-03,2023-09-15,448.84,0,0,612682077,237570121,0.000677023232066898,99.9983707700332,0
427.97,426,8,21,952,4137,2023-08-03,2023-09-08,448.84,13,3185,29175941,13324771,0.0141794912458865,99.9318068267275,0.769881556683587
275.01,275,4101,4105,4101,4105,2023-08-03,2023-08-18,448.84,4,4,303147069,149589725,0.00135412821688868,99.9893289418543,0.00097442143727162
530.86,490,1,1,3048,4086,2023-08-03,2023-10-20,448.84,0,1038,344413796,107013117,0.00118636362638621,99.9969315979433,0.254038179148311
330.07,330,559,574,3913,4018,2023-08-03,2023-08-25,448.84,15,105,97519709,36213018,0.00412019277046858,99.9801660605858,0.0261324041811848
535.11,495,1,1,4011,4011,2023-08-03,2023-10-20,448.84,0,0,344413796,107013117,0.00116458749521172,99.9980961854385,0
215.01,215,3988,3988,3988,3988,2023-08-03,2023-08-18,448.84,0,0,303147069,149589725,0.00131553308866067,99.990644474943,0
490.84,471,2,2,3968,3968,2023-08-03,2023-09-29,448.84,0,0,193559650,66678490,0.00205001403959968,99.996270400365,0
528.56,489,0,1,0,3956,2023-08-03,2023-08-04,448.84,1,3956,64122278,31929455,0.00616946266319484,99.8491990568395,1
190.01,190,3948,3947,3948,3947,2023-08-03,2023-09-15,448.84,-1,-1.00000000000045,612682077,237570121,0.000644216657899722,99.9990149866911,-0.000253356979984914
370.33,370,76,119,1748,3927,2023-08-03,2023-09-08,448.84,43,2179,29175941,13324771,0.0134597201166537,99.9452665468442,0.554876496052967
370.05,370,835,784,2505,3920,2023-08-03,2023-08-11,448.84,-51,1415,61838439,35859636,0.00633909921303156,99.9457505710971,0.360969387755102
410.01,410,4021,3910,4021,3910,2023-08-03,2023-08-04,448.84,-111,-111,64122278,31929455,0.00609772472525072,99.8552967815647,-0.0283887468030691
325.07,325,564,557,2820,3899,2023-08-03,2023-08-25,448.84,-7,1079,97519709,36213018,0.00399816615531533,99.9841642267411,0.276737625032059
394.02,394,1932,1932,1932,3864,2023-08-03,2023-08-04,448.84,0,1932,64122278,31929455,0.00602598678730659,99.8613227683521,0.5
300.06,300,588,638,2352,3828,2023-08-03,2023-09-01,448.84,50,1476,91969817,42577148,0.00416223509502036,99.9910416261892,0.385579937304075
180.01,180,3732,3732,3732,3732,2023-08-03,2023-09-15,448.84,0,0,612682077,237570121,0.000609125048715927,99.9996241117398,0
429.02,429,1503,1864,4509,3728,2023-08-03,2023-08-04,448.84,361,-781,64122278,31929455,0.00581389201425439,99.8671366603663,-0.209495708154506
255.01,255,3727,3727,3727,3727,2023-08-03,2023-08-18,448.84,0,0,303147069,149589725,0.00122943626415204,99.9918739112071,0
350.01,350,3686,3686,3686,3686,2023-08-03,2023-08-04,448.84,0,0,64122278,31929455,0.00574839215787062,99.8728850525242,0
523.62,487,0,1,0,3662,2023-08-03,2023-08-04,448.84,1,3662,64122278,31929455,0.00571096366850847,99.8785960161927,1
412.02,412,1673,1830,3346,3660,2023-08-03,2023-08-04,448.84,157,314,64122278,31929455,0.00570784462772829,99.8843038608204,0.085792349726776
385.01,385,3124,3601,3124,3601,2023-08-03,2023-08-04,448.84,477,477,64122278,31929455,0.005615832924713,99.8899196937451,0.132463204665371
427.02,427,1807,1791,5421,3582,2023-08-03,2023-08-04,448.84,-16,-1839,64122278,31929455,0.0055862020373013,99.8955058957824,-0.513400335008375
300.04,300,874,880,1748,3520,2023-08-03,2023-08-25,448.84,6,1772,97519709,36213018,0.00360952676755834,99.9877737535086,0.503409090909091
404.01,404,3479,3449,10437,3449,2023-08-03,2023-08-04,448.84,-30,-6988,64122278,31929455,0.00537878582541937,99.9008846816078,-2.02609452015077
424.02,424,1703,1711,3406,3422,2023-08-03,2023-08-04,448.84,8,16,64122278,31929455,0.00533667877488694,99.9062213603827,0.00467562828755114
519.11,485,0,1,0,3411,2023-08-03,2023-08-11,448.84,1,3411,61838439,35859636,0.00551598658562516,99.9512665576827,1
403.01,403,3384,3384,6768,3384,2023-08-03,2023-08-04,448.84,0,-3384,64122278,31929455,0.00527741700006354,99.9114987773828,-1
355.25,355,132,135,2112,3375,2023-08-03,2023-09-08,448.84,3,1263,29175941,13324771,0.0115677502912417,99.9568342971354,0.374222222222222
517.64,484,0,1,0,3364,2023-08-03,2023-08-04,448.84,1,3364,64122278,31929455,0.00524622659226174,99.9167450039751,1
255.27,255,124,124,2480,3348,2023-08-03,2023-11-17,448.84,0,868.000000000001,178436543,50264301,0.00187629727841118,99.9992013967677,0.259259259259259
422.02,422,1657,1654,3314,3308,2023-08-03,2023-08-04,448.84,-3,-6,64122278,31929455,0.00515889345041672,99.9219038974255,-0.00181378476420798
416.01,416,3290,3290,6580,3290,2023-08-03,2023-08-04,448.84,0,-3290,64122278,31929455,0.0051308220833951,99.9270347195089,-1
295.01,295,3256,3256,3256,3256,2023-08-03,2023-08-04,448.84,0,0,64122278,31929455,0.00507779839013205,99.932112517899,0
300.01,300,3239,3239,3239,3239,2023-08-03,2023-08-04,448.84,0,0,64122278,31929455,0.00505128654350053,99.9371638044425,0
513.35,482,0,1,0,3135,2023-08-03,2023-08-11,448.84,1,3135,61838439,35859636,0.00506966225327907,99.956336219936,1
418.02,418,1591,1555,3182,3110,2023-08-03,2023-08-04,448.84,-36,-72,64122278,31929455,0.00485010841317896,99.9420139128557,-0.0231511254019293
385.5,385,13,62,416,3100,2023-08-03,2023-09-08,448.84,49,2684,29175941,13324771,0.0106251928601035,99.9674594899955,0.865806451612903
342.42,342,73,73,2190,3066,2023-08-03,2023-09-29,448.84,0,876,193559650,66678490,0.00158400782394471,99.9978544081889,0.285714285714286
320.11,320,272,272,2992,2992,2023-08-03,2023-09-08,448.84,0,0,29175941,13324771,0.0102550248507837,99.9777145148463,0
509.9,480,1,1,2370,2990,2023-08-03,2023-08-18,448.84,0,620,303147069,149589725,0.000986319943604667,99.9928602311507,0.207357859531773
285.01,285,2892,2892,2892,2892,2023-08-03,2023-08-18,448.84,0,0,303147069,149589725,0.000953992400302574,99.993814223551,0
170.03,170,926,933,1852,2799,2023-08-03,2023-10-20,448.84,7,947,344413796,107013117,0.000812685215431963,99.998908870654,0.338335119685602
422.52,422.5,1381,1382,2762,2764,2023-08-03,2023-08-04,448.84,1,2,64122278,31929455,0.00431051435820792,99.9463244272139,0.000723589001447178
503.53,476,1,1,1940,2753,2023-08-03,2023-09-01,448.84,0,813,91969817,42577148,0.0029933733585661,99.9940349995477,0.295314202687977
503.5,476,1,1,1985,2750,2023-08-03,2023-08-04,448.84,0,765,64122278,31929455,0.00428868107274667,99.9506131082867,0.278181818181818
505.05,478,0,1,0,2705,2023-08-03,2023-08-11,448.84,1,2705,61838439,35859636,0.00437430188042101,99.9607105218164,1
406.1,406,7,270,49,2700,2023-08-03,2023-08-11,448.84,263,2651,61838439,35859636,0.0043662162946901,99.9650767381111,0.981851851851852
510.79,484,1,1,2679,2679,2023-08-03,2023-12-15,448.84,0,0,463353257,105207973,0.000578176576840162,100,0
501.3,475,0,1,0,2630,2023-08-03,2023-08-04,448.84,1,2630,64122278,31929455,0.0041015386259359,99.9547146469126,1
340.02,340,1246,1261,1246,2522,2023-08-03,2023-08-11,448.84,15,1276,61838439,35859636,0.00407836944266979,99.9691551075537,0.505947660586836
245.02,245,1260,1260,2520,2520,2023-08-03,2023-08-18,448.84,0,0,303147069,149589725,0.000831279684910957,99.9946455032359,0
310.08,310,227,315,1362,2520,2023-08-03,2023-09-01,448.84,88,1158,91969817,42577148,0.00274002937289742,99.9967750289206,0.45952380952381
396.02,396,1117,1259,1117,2518,2023-08-03,2023-08-04,448.84,142,1401,64122278,31929455,0.00392687234224586,99.9586415192548,0.556393963463066
501.09,476,0,1,0,2509,2023-08-03,2023-08-11,448.84,1,2509,61838439,35859636,0.00405734691976943,99.9732124544735,1
210.01,210,2492,2492,2492,2492,2023-08-03,2023-08-18,448.84,0,0,303147069,149589725,0.000822043243967501,99.9954675464799,0
380.41,380,50,60,1300,2460,2023-08-03,2023-09-08,448.84,10,1160,29175941,13324771,0.00843160465672727,99.9861461195031,0.471544715447155
503.9,480,2,1,4780,2390,2023-08-03,2023-09-29,448.84,-1,-2390,193559650,66678490,0.00123476148050485,99.9990891696694,-1
225.02,225,1190,1190,2380,2380,2023-08-03,2023-08-18,448.84,0,0,303147069,149589725,0.000785097480193681,99.9962526439601,0
499.03,476,1,1,2303,2303,2023-08-03,2023-09-15,448.84,0,0,612682077,237570121,0.000375888260233864,100,0
495.87,473,0,1,0,2287,2023-08-03,2023-08-18,448.84,1,2287,303147069,149589725,0.000754419301345777,99.9970070632614,1
205.01,205,2281,2281,2281,2281,2023-08-03,2023-08-18,448.84,0,0,303147069,149589725,0.000752440064000751,99.9977595033254,0
310.05,310,446,448,1784,2240,2023-08-03,2023-08-25,448.84,2,456,97519709,36213018,0.00229697157935531,99.990070725088,0.203571428571429
345.03,345,274,741,822,2223,2023-08-03,2023-08-11,448.84,467,1401,61838439,35859636,0.00359485141596152,99.9768073058895,0.630229419703104
320.07,320,294,307,1470,2149,2023-08-03,2023-08-25,448.84,13,679,97519709,36213018,0.002203657108944,99.9922743821969,0.315960912052117
270.01,270,2140,2144,2140,2144,2023-08-03,2023-08-18,448.84,4,4,303147069,149589725,0.000707247477955988,99.9984667508034,0.00186567164179104
495.21,474,1,1,1918,2121,2023-08-03,2023-08-25,448.84,0,203,97519709,36213018,0.00217494496420206,99.9944493271611,0.0957095709570957
491.16,470,3,1,4137,2116,2023-08-03,2023-08-04,448.84,-2,-2021,64122278,31929455,0.0032999451454298,99.9619414644003,-0.955103969754253
360.03,360,697,697,1394,2091,2023-08-03,2023-08-11,448.84,0,697,61838439,35859636,0.00338139195266556,99.9801886978421,0.333333333333333
489.67,469,1,1,1329,2067,2023-08-03,2023-08-11,448.84,0,738,61838439,35859636,0.0033425811411572,99.9835312789833,0.357039187227866
300.01,300,1405,1887,1405,1887,2023-08-03,2023-08-11,448.84,482,482,61838439,35859636,0.00305150005484453,99.9865827790381,0.255431902490726
275.03,275,544,624,1088,1872,2023-08-03,2023-08-25,448.84,80,784,97519709,36213018,0.00191961196274694,99.9963689391239,0.418803418803419
180.04,180,458,460,1374,1840,2023-08-03,2023-10-20,448.84,2,466,344413796,107013117,0.000534241084814152,99.9994431117388,0.253260869565217
487.25,469,0,1,0,1825,2023-08-03,2023-09-08,448.84,1,1825,29175941,13324771,0.00625515386118994,99.9924012733642,1
413.01,413,1793,1798,5379,1798,2023-08-03,2023-08-04,448.84,5,-3581,64122278,31929455,0.00280401766138128,99.9647454820616,-1.9916573971079
397.02,397,520,896,1040,1792,2023-08-03,2023-08-04,448.84,376,752,64122278,31929455,0.00279466053904074,99.9675401426007,0.419642857142857
490.63,473,1,1,1763,1763,2023-08-03,2023-09-29,448.84,0,0,193559650,66678490,0.000910830330598345,100,0
484.42,467,3,1,3180,1742,2023-08-03,2023-08-04,448.84,-2,-1438,64122278,31929455,0.00271668451953625,99.9702568271202,-0.825487944890929
485.38,468,673,1,819714,1738,2023-08-03,2023-08-25,448.84,-672,-817976,97519709,36213018,0.00178220384148193,99.9981511429654,-470.642117376295
482.8,466,3,1,2847,1680,2023-08-03,2023-08-04,448.84,-2,-1167,64122278,31929455,0.00261999425535069,99.9728768213756,-0.694642857142857
417.01,417,1648,1639,4944,1639,2023-08-03,2023-08-04,448.84,-9,-3305,64122278,31929455,0.00255605391935701,99.9754328752949,-2.01647345942648
482.28,466,134,1,128774,1628,2023-08-03,2023-08-11,448.84,-133,-127146,61838439,35859636,0.00263266671398351,99.9892154457521,-78.0995085995086
315.09,315,127,174,635,1566,2023-08-03,2023-09-01,448.84,47,931,91969817,42577148,0.00170273253887197,99.9984777614595,0.594508301404853
402.01,402,1553,1553,1553,1553,2023-08-03,2023-08-04,448.84,0,0,64122278,31929455,0.0024219351658093,99.9778548104607,0
225.15,225,95,95,1330,1425,2023-08-03,2023-11-17,448.84,0,95,178436543,50264301,0.000798603232298667,100,0.0666666666666667
305.07,305,34,200,136,1400,2023-08-03,2023-09-01,448.84,166,1264,91969817,42577148,0.00152223854049856,100,0.902857142857143
411.12,411,5,110,40,1320,2023-08-03,2023-08-11,448.84,105,1280,61838439,35859636,0.00213459463295961,99.9913500403851,0.96969696969697
235.01,235,1302,1302,1302,1302,2023-08-03,2023-08-18,448.84,0,0,303147069,149589725,0.000429494503870661,99.9988962453073,0
230.01,230,1237,1237,1237,1237,2023-08-03,2023-08-18,448.84,0,0,303147069,149589725,0.000408052765966212,99.9993042980732,0
399.02,399,218,612,872,1224,2023-08-03,2023-08-04,448.84,394,352,64122278,31929455,0.00190885295746979,99.9797636634182,0.287581699346405
404.11,404,11,111,66,1221,2023-08-03,2023-08-11,448.84,100,1155,61838439,35859636,0.00197450003548764,99.9933245404206,0.945945945945946
185.03,185,396,396,1188,1188,2023-08-03,2023-10-20,448.84,0,0,344413796,107013117,0.00034493391780392,99.9997880456566,0
320.01,320,1142,1142,1142,1142,2023-08-03,2023-08-04,448.84,0,0,64122278,31929455,0.00178097228548243,99.9815446357037,0
398.01,398,1092,1128,1092,1128,2023-08-03,2023-08-04,448.84,36,36,64122278,31929455,0.00175913900002118,99.9833037747037,0.0319148936170213
305.01,305,1071,1071,1071,1071,2023-08-03,2023-08-04,448.84,0,0,64122278,31929455,0.00167024633778607,99.9849740210415,0
240.01,240,1055,1055,1055,1055,2023-08-03,2023-08-18,448.84,0,0,303147069,149589725,0.000348015899833754,99.9996523139731,0
220.01,220,1054,1054,1054,1054,2023-08-03,2023-08-18,448.84,0,0,303147069,149589725,0.000347686026942916,100,0
285.04,285,158,259,316,1036,2023-08-03,2023-08-25,448.84,101,720,97519709,36213018,0.00106234935545183,99.9992134923208,0.694980694980695
345.01,345,964,964,964,964,2023-08-03,2023-08-04,448.84,0,0,64122278,31929455,0.00150337765604647,99.9864773986975,0
411.01,411,954,958,1908,958,2023-08-03,2023-08-04,448.84,4,-950,64122278,31929455,0.00149402053370593,99.9879714192313,-0.991649269311065
409.01,409,955,951,955,951,2023-08-03,2023-08-04,448.84,-4,-4.00000000000011,64122278,31929455,0.0014831038909753,99.9894545231222,-0.00420609884332294
392.02,392,467,467,934,934,2023-08-03,2023-08-04,448.84,0,0,64122278,31929455,0.00145659204434378,99.9909111151666,0
421.01,421,875,875,2625,875,2023-08-03,2023-08-04,448.84,0,-1750,64122278,31929455,0.00136458034132849,99.9922756955079,-2
285.01,285,811,811,811,811,2023-08-03,2023-08-04,448.84,0,0,64122278,31929455,0.00126477103636274,99.9935404665442,0
315.07,315,113,113,791,791,2023-08-03,2023-09-08,448.84,0,0,29175941,13324771,0.00271113792011027,99.9951124112844,0
275.01,275,759,759,759,759,2023-08-03,2023-08-04,448.84,0,0,64122278,31929455,0.00118367597607808,99.9947241425203,0
330.01,330,753,753,753,753,2023-08-03,2023-08-04,448.84,0,0,64122278,31929455,0.00117431885373754,99.9958984613741,0
175.02,175,365,365,730,730,2023-08-03,2023-10-20,448.84,0,0,344413796,107013117,0.000211954343431702,100,0
325.02,325,269,271,269,542,2023-08-03,2023-08-11,448.84,2,273,61838439,35859636,0.000876477493230384,99.9942010179138,0.503690036900369
401.02,401,269,269,538,538,2023-08-03,2023-08-04,448.84,0,0,64122278,31929455,0.000839021969868257,99.9967374833439,0
355.03,355,136,171,272,513,2023-08-03,2023-08-11,448.84,35,241,61838439,35859636,0.00082958109599112,99.9950305990098,0.469785575048733
394.07,394,60,73,300,511,2023-08-03,2023-08-11,448.84,13,211,61838439,35859636,0.000826346861698757,99.9958569458715,0.412915851272016
315.01,315,461,461,461,461,2023-08-03,2023-08-04,448.84,0,0,64122278,31929455,0.00071893889983135,99.9974564222438,0
335.02,335,226,227,226,454,2023-08-03,2023-08-11,448.84,1,228,61838439,35859636,0.00073417118436641,99.9965911170558,0.502202643171806
305.01,305,29,441,58,441,2023-08-03,2023-08-11,448.84,412,383,61838439,35859636,0.00071314866146605,99.9973042657173,0.868480725623583
340.01,340,404,404,404,404,2023-08-03,2023-08-04,448.84,0,0,64122278,31929455,0.000630046237596238,99.9980864684814,0
335.02,335,171,171,342,342,2023-08-03,2023-08-04,448.84,0,0,64122278,31929455,0.000533355973410676,99.9986198244548,0
365.3,365,8,11,160,330,2023-08-03,2023-09-08,448.84,3,170,29175941,13324771,0.00113106891736585,99.9962434802017,0.515151515151515
305.05,305,52,65,156,325,2023-08-03,2023-08-25,448.84,13,169,97519709,36213018,0.000333265965754676,99.9995467582866,0.52
290.03,290,107,107,321,321,2023-08-03,2023-08-25,448.84,0,0,97519709,36213018,0.000329164230791542,99.9998759225174,0
407.01,407,281,304,843,304,2023-08-03,2023-08-04,448.84,23,-539,64122278,31929455,0.000474094198587268,99.9990939186534,-1.77302631578947
320.01,320,303,303,303,303,2023-08-03,2023-08-11,448.84,0,0,61838439,35859636,0.000489986495293001,99.9977942522126,0
300.08,300,11,33,55,264,2023-08-03,2023-09-08,448.84,22,209,29175941,13324771,0.000904855133892682,99.9971483353356,0.791666666666667
350.22,350,6,11,84,242,2023-08-03,2023-09-08,448.84,5,158,29175941,13324771,0.000829450539401625,99.997977785875,0.652892561983471
391.01,391,232,232,232,232,2023-08-03,2023-08-04,448.84,0,0,64122278,31929455,0.00036180873050081,99.9994557273839,0
310.11,310,18,21,126,231,2023-08-03,2023-09-08,448.84,3,105,29175941,13324771,0.000791748242156097,99.9987695341172,0.454545454545454
393.01,393,224,226,448,226,2023-08-03,2023-08-04,448.84,2,-222,64122278,31929455,0.000352451608160272,99.999808178992,-0.982300884955752
407.11,407,11,20,77,220,2023-08-03,2023-08-11,448.84,9,143,61838439,35859636,0.000355765772159934,99.9981500179848,0.65
310.01,310,214,214,428,214,2023-08-03,2023-08-11,448.84,0,-214,61838439,35859636,0.000346063069282845,99.9984960810541,-1
401.1,401,0,21,0,210,2023-08-03,2023-08-11,448.84,21,210,61838439,35859636,0.000339594600698119,99.9988356756548,1
340.19,340,10,11,150,209,2023-08-03,2023-09-08,448.84,1,59,29175941,13324771,0.00071634364766504,99.9994858777649,0.282296650717703
315.01,315,203,203,203,203,2023-08-03,2023-08-11,448.84,0,0,61838439,35859636,0.000328274780674849,99.9991639504354,0
409.11,409,12,15,84,165,2023-08-03,2023-08-11,448.84,3,81,61838439,35859636,0.000266824329119951,99.9994307747646,0.490909090909091
305.06,305,25,25,150,150,2023-08-03,2023-09-08,448.84,0,0,29175941,13324771,0.000514122235166297,100,0
280.01,280,107,107,107,107,2023-08-03,2023-08-04,448.84,0,0,64122278,31929455,0.000166868681739598,99.9999750476738,0
393.08,393,6,12,30,96,2023-08-03,2023-08-11,448.84,6,66,61838439,35859636,0.000155243246033426,99.9995860180106,0.6875
399.09,399,0,10,0,90,2023-08-03,2023-08-11,448.84,10,90,61838439,35859636,0.000145540543156337,99.9997315585537,1
388.06,388,0,11,0,66,2023-08-03,2023-08-11,448.84,11,66,61838439,35859636,0.00010672973164798,99.9998382882854,1
280.02,280,32,32,32,64,2023-08-03,2023-08-25,448.84,0,32,97519709,36213018,6.56277594101517e-05,99.9999415502768,0.5
295.03,295,19,19,38,57,2023-08-03,2023-08-25,448.84,0,19,97519709,36213018,5.84497232246663e-05,100,0.333333333333333
402.09,402,4,4,24,36,2023-08-03,2023-08-11,448.84,0,12,61838439,35859636,5.82162172625347e-05,99.9998965045027,0.333333333333333
391.05,391,6,6,30,30,2023-08-03,2023-08-11,448.84,0,0,61838439,35859636,4.85135143854456e-05,99.999945018017,0
403.11,403,2,2,12,22,2023-08-03,2023-08-11,448.84,0,10,61838439,35859636,3.55765772159934e-05,99.9999805945943,0.454545454545455
389.01,389,16,16,16,16,2023-08-03,2023-08-04,448.84,0,0,64122278,31929455,2.49523262414352e-05,100,0
396.07,396,0,1,0,7,2023-08-03,2023-08-11,448.84,1,7,61838439,35859636,1.13198200232706e-05,99.9999919144143,1
397.05,397,1,1,5,5,2023-08-03,2023-08-11,448.84,0,0,61838439,35859636,8.0855857309076e-06,100,0
388,388,0,0,0,0,2023-08-03,2023-08-04,448.84,0,0,64122278,31929455,0,100,
487.74,469,1,0,1212,0,2023-08-03,2023-08-04,448.84,-1,-1212,64122278,31929455,0,100,-Inf
494.07,471,0,0,0,0,2023-08-03,2023-08-04,448.84,0,0,64122278,31929455,0,100,
493.74,472,0,0,0,0,2023-08-03,2023-08-04,448.84,0,0,64122278,31929455,0,100,
498.16,473,0,0,0,0,2023-08-03,2023-08-04,448.84,0,0,64122278,31929455,0,100,
497.61,474,0,0,0,0,2023-08-03,2023-08-04,448.84,0,0,64122278,31929455,0,100,
503.53,477,0,0,0,0,2023-08-03,2023-08-04,448.84,0,0,64122278,31929455,0,100,
508.28,479,0,0,0,0,2023-08-03,2023-08-04,448.84,0,0,64122278,31929455,0,100,
510.28,480,3,0,7098,0,2023-08-03,2023-08-04,448.84,-3,-7098,64122278,31929455,0,100,-Inf
512.28,481,0,0,0,0,2023-08-03,2023-08-04,448.84,0,0,64122278,31929455,0,100,
514.28,482,0,0,0,0,2023-08-03,2023-08-04,448.84,0,0,64122278,31929455,0,100,
516.28,483,0,0,0,0,2023-08-03,2023-08-04,448.84,0,0,64122278,31929455,0,100,
520.28,485,0,0,0,0,2023-08-03,2023-08-04,448.84,0,0,64122278,31929455,0,100,
522.28,486,0,0,0,0,2023-08-03,2023-08-04,448.84,0,0,64122278,31929455,0,100,
526.56,488,0,0,0,0,2023-08-03,2023-08-04,448.84,0,0,64122278,31929455,0,100,
529.99,490,0,0,0,0,2023-08-03,2023-08-04,448.84,0,0,64122278,31929455,0,100,
532.56,491,0,0,0,0,2023-08-03,2023-08-04,448.84,0,0,64122278,31929455,0,100,
534.56,492,0,0,0,0,2023-08-03,2023-08-04,448.84,0,0,64122278,31929455,0,100,
535.84,493,0,0,0,0,2023-08-03,2023-08-04,448.84,0,0,64122278,31929455,0,100,
538.56,494,0,0,0,0,2023-08-03,2023-08-04,448.84,0,0,64122278,31929455,0,100,
539.78,495,0,0,0,0,2023-08-03,2023-08-04,448.84,0,0,64122278,31929455,0,100,
542.44,496,0,0,0,0,2023-08-03,2023-08-04,448.84,0,0,64122278,31929455,0,100,
544.71,497,0,0,0,0,2023-08-03,2023-08-04,448.84,0,0,64122278,31929455,0,100,
546.29,498,0,0,0,0,2023-08-03,2023-08-04,448.84,0,0,64122278,31929455,0,100,
548.29,499,0,0,0,0,2023-08-03,2023-08-04,448.84,0,0,64122278,31929455,0,100,
549.44,500,2,0,8666,0,2023-08-03,2023-08-04,448.84,-2,-8666,64122278,31929455,0,100,-Inf
560.27,505,0,0,0,0,2023-08-03,2023-08-04,448.84,0,0,64122278,31929455,0,100,
570.5,510,0,0,0,0,2023-08-03,2023-08-04,448.84,0,0,64122278,31929455,0,100,
579.73,515,0,0,0,0,2023-08-03,2023-08-04,448.84,0,0,64122278,31929455,0,100,
600,525,0,0,0,0,2023-08-03,2023-08-04,448.84,0,0,64122278,31929455,0,100,
389,389,0,0,0,0,2023-08-03,2023-08-11,448.84,0,0,61838439,35859636,0,100,
392.07,392,0,0,0,0,2023-08-03,2023-08-11,448.84,0,0,61838439,35859636,0,100,
398.08,398,0,0,0,0,2023-08-03,2023-08-11,448.84,0,0,61838439,35859636,0,100,
487.35,468,32,0,36128,0,2023-08-03,2023-08-11,448.84,-32,-36128,61838439,35859636,0,100,-Inf
491.26,471,0,0,0,0,2023-08-03,2023-08-11,448.84,0,0,61838439,35859636,0,100,
493.26,472,0,0,0,0,2023-08-03,2023-08-11,448.84,0,0,61838439,35859636,0,100,
494.95,473,0,0,0,0,2023-08-03,2023-08-11,448.84,0,0,61838439,35859636,0,100,
500.07,474,0,0,0,0,2023-08-03,2023-08-11,448.84,0,0,61838439,35859636,0,100,
496.96,475,0,0,0,0,2023-08-03,2023-08-11,448.84,0,0,61838439,35859636,0,100,
497.47,477,0,0,0,0,2023-08-03,2023-08-11,448.84,0,0,61838439,35859636,0,100,
507.4,479,0,0,0,0,2023-08-03,2023-08-11,448.84,0,0,61838439,35859636,0,100,
511.22,481,0,0,0,0,2023-08-03,2023-08-11,448.84,0,0,61838439,35859636,0,100,
517.97,483,0,0,0,0,2023-08-03,2023-08-11,448.84,0,0,61838439,35859636,0,100,
518.35,484,0,0,0,0,2023-08-03,2023-08-11,448.84,0,0,61838439,35859636,0,100,
486,486,0,0,0,0,2023-08-03,2023-08-11,448.84,0,0,61838439,35859636,0,100,
522.23,487,0,0,0,0,2023-08-03,2023-08-11,448.84,0,0,61838439,35859636,0,100,
528.37,488,0,0,0,0,2023-08-03,2023-08-11,448.84,0,0,61838439,35859636,0,100,
527.21,489,0,0,0,0,2023-08-03,2023-08-11,448.84,0,0,61838439,35859636,0,100,
529.19,490,0,0,0,0,2023-08-03,2023-08-11,448.84,0,0,61838439,35859636,0,100,
530.23,491,0,0,0,0,2023-08-03,2023-08-11,448.84,0,0,61838439,35859636,0,100,
532.23,492,0,0,0,0,2023-08-03,2023-08-11,448.84,0,0,61838439,35859636,0,100,
493,493,0,0,0,0,2023-08-03,2023-08-11,448.84,0,0,61838439,35859636,0,100,
494,494,0,0,0,0,2023-08-03,2023-08-11,448.84,0,0,61838439,35859636,0,100,
532.09,495,0,0,0,0,2023-08-03,2023-08-11,448.84,0,0,61838439,35859636,0,100,
496,496,0,0,0,0,2023-08-03,2023-08-11,448.84,0,0,61838439,35859636,0,100,
543.39,497,0,0,0,0,2023-08-03,2023-08-11,448.84,0,0,61838439,35859636,0,100,
560.07,505,0,0,0,0,2023-08-03,2023-08-11,448.84,0,0,61838439,35859636,0,100,
520,520,0,0,0,0,2023-08-03,2023-08-11,448.84,0,0,61838439,35859636,0,100,
593.21,525,0,0,0,0,2023-08-03,2023-08-11,448.84,0,0,61838439,35859636,0,100,
601.91,530,0,0,0,0,2023-08-03,2023-08-11,448.84,0,0,61838439,35859636,0,100,
484.8,471,0,0,0,0,2023-08-03,2023-08-18,448.84,0,0,303147069,149589725,0,100,
498.61,474,0,0,0,0,2023-08-03,2023-08-18,448.84,0,0,303147069,149589725,0,100,
497.19,476,0,0,0,0,2023-08-03,2023-08-18,448.84,0,0,303147069,149589725,0,100,
498.05,477,0,0,0,0,2023-08-03,2023-08-18,448.84,0,0,303147069,149589725,0,100,
505.65,478,0,0,0,0,2023-08-03,2023-08-18,448.84,0,0,303147069,149589725,0,100,
479,479,0,0,0,0,2023-08-03,2023-08-18,448.84,0,0,303147069,149589725,0,100,
512.41,482,0,0,0,0,2023-08-03,2023-08-18,448.84,0,0,303147069,149589725,0,100,
513.6,484,0,0,0,0,2023-08-03,2023-08-18,448.84,0,0,303147069,149589725,0,100,
520.77,486,0,0,0,0,2023-08-03,2023-08-18,448.84,0,0,303147069,149589725,0,100,
520.8,488,0,0,0,0,2023-08-03,2023-08-18,448.84,0,0,303147069,149589725,0,100,
530.72,490,0,0,0,0,2023-08-03,2023-08-18,448.84,0,0,303147069,149589725,0,100,
533.96,492,0,0,0,0,2023-08-03,2023-08-18,448.84,0,0,303147069,149589725,0,100,
494,494,0,0,0,0,2023-08-03,2023-08-18,448.84,0,0,303147069,149589725,0,100,
541.83,496,0,0,0,0,2023-08-03,2023-08-18,448.84,0,0,303147069,149589725,0,100,
538.26,498,0,0,0,0,2023-08-03,2023-08-18,448.84,0,0,303147069,149589725,0,100,
547.17,502,0,0,0,0,2023-08-03,2023-08-18,448.84,0,0,303147069,149589725,0,100,
504,504,0,0,0,0,2023-08-03,2023-08-18,448.84,0,0,303147069,149589725,0,100,
560.07,505,0,0,0,0,2023-08-03,2023-08-18,448.84,0,0,303147069,149589725,0,100,
570.07,510,0,0,0,0,2023-08-03,2023-08-18,448.84,0,0,303147069,149589725,0,100,
595.9,515,0,0,0,0,2023-08-03,2023-08-18,448.84,0,0,303147069,149589725,0,100,
584.11,520,0,0,0,0,2023-08-03,2023-08-18,448.84,0,0,303147069,149589725,0,100,
595.94,525,0,0,0,0,2023-08-03,2023-08-18,448.84,0,0,303147069,149589725,0,100,
530,530,0,0,0,0,2023-08-03,2023-08-18,448.84,0,0,303147069,149589725,0,100,
620.13,535,0,0,0,0,2023-08-03,2023-08-18,448.84,0,0,303147069,149589725,0,100,
642.23,540,0,0,0,0,2023-08-03,2023-08-18,448.84,0,0,303147069,149589725,0,100,
634.93,545,0,0,0,0,2023-08-03,2023-08-18,448.84,0,0,303147069,149589725,0,100,
643.63,550,0,0,0,0,2023-08-03,2023-08-18,448.84,0,0,303147069,149589725,0,100,
653.18,555,0,0,0,0,2023-08-03,2023-08-18,448.84,0,0,303147069,149589725,0,100,
667.09,560,0,0,0,0,2023-08-03,2023-08-18,448.84,0,0,303147069,149589725,0,100,
489.17,471,0,0,0,0,2023-08-03,2023-08-25,448.84,0,0,97519709,36213018,0,100,
487.76,472,0,0,0,0,2023-08-03,2023-08-25,448.84,0,0,97519709,36213018,0,100,
492.21,475,0,0,0,0,2023-08-03,2023-08-25,448.84,0,0,97519709,36213018,0,100,
476,476,0,0,0,0,2023-08-03,2023-08-25,448.84,0,0,97519709,36213018,0,100,
478,478,0,0,0,0,2023-08-03,2023-08-25,448.84,0,0,97519709,36213018,0,100,
505.65,480,0,0,0,0,2023-08-03,2023-08-25,448.84,0,0,97519709,36213018,0,100,
509.18,482,0,0,0,0,2023-08-03,2023-08-25,448.84,0,0,97519709,36213018,0,100,
484,484,0,0,0,0,2023-08-03,2023-08-25,448.84,0,0,97519709,36213018,0,100,
520.56,485,0,0,0,0,2023-08-03,2023-08-25,448.84,0,0,97519709,36213018,0,100,
486,486,0,0,0,0,2023-08-03,2023-08-25,448.84,0,0,97519709,36213018,0,100,
488,488,0,0,0,0,2023-08-03,2023-08-25,448.84,0,0,97519709,36213018,0,100,
526,490,0,0,0,0,2023-08-03,2023-08-25,448.84,0,0,97519709,36213018,0,100,
492,492,0,0,0,0,2023-08-03,2023-08-25,448.84,0,0,97519709,36213018,0,100,
494,494,0,0,0,0,2023-08-03,2023-08-25,448.84,0,0,97519709,36213018,0,100,
495,495,0,0,0,0,2023-08-03,2023-08-25,448.84,0,0,97519709,36213018,0,100,
496,496,0,0,0,0,2023-08-03,2023-08-25,448.84,0,0,97519709,36213018,0,100,
498,498,0,0,0,0,2023-08-03,2023-08-25,448.84,0,0,97519709,36213018,0,100,
543.19,500,0,0,0,0,2023-08-03,2023-08-25,448.84,0,0,97519709,36213018,0,100,
502,502,0,0,0,0,2023-08-03,2023-08-25,448.84,0,0,97519709,36213018,0,100,
505,505,0,0,0,0,2023-08-03,2023-08-25,448.84,0,0,97519709,36213018,0,100,
510,510,0,0,0,0,2023-08-03,2023-08-25,448.84,0,0,97519709,36213018,0,100,
575.98,515,0,0,0,0,2023-08-03,2023-08-25,448.84,0,0,97519709,36213018,0,100,
520,520,0,0,0,0,2023-08-03,2023-08-25,448.84,0,0,97519709,36213018,0,100,
525,525,0,0,0,0,2023-08-03,2023-08-25,448.84,0,0,97519709,36213018,0,100,
530,530,0,0,0,0,2023-08-03,2023-08-25,448.84,0,0,97519709,36213018,0,100,
540,540,0,0,0,0,2023-08-03,2023-08-25,448.84,0,0,97519709,36213018,0,100,
485.82,471,1,0,1482,0,2023-08-03,2023-09-01,448.84,-1,-1482,91969817,42577148,0,100,-Inf
487.32,472,1,0,1532,0,2023-08-03,2023-09-01,448.84,-1,-1532,91969817,42577148,0,100,-Inf
498.54,474,0,0,0,0,2023-08-03,2023-09-01,448.84,0,0,91969817,42577148,0,100,
496.09,475,0,0,0,0,2023-08-03,2023-09-01,448.84,0,0,91969817,42577148,0,100,
498.98,478,0,0,0,0,2023-08-03,2023-09-01,448.84,0,0,91969817,42577148,0,100,
505.02,480,0,0,0,0,2023-08-03,2023-09-01,448.84,0,0,91969817,42577148,0,100,
505.5,482,0,0,0,0,2023-08-03,2023-09-01,448.84,0,0,91969817,42577148,0,100,
515.57,484,0,0,0,0,2023-08-03,2023-09-01,448.84,0,0,91969817,42577148,0,100,
515.4,485,0,0,0,0,2023-08-03,2023-09-01,448.84,0,0,91969817,42577148,0,100,
486,486,0,0,0,0,2023-08-03,2023-09-01,448.84,0,0,91969817,42577148,0,100,
488,488,0,0,0,0,2023-08-03,2023-09-01,448.84,0,0,91969817,42577148,0,100,
525.38,490,0,0,0,0,2023-08-03,2023-09-01,448.84,0,0,91969817,42577148,0,100,
492,492,0,0,0,0,2023-08-03,2023-09-01,448.84,0,0,91969817,42577148,0,100,
494,494,0,0,0,0,2023-08-03,2023-09-01,448.84,0,0,91969817,42577148,0,100,
539.85,495,0,0,0,0,2023-08-03,2023-09-01,448.84,0,0,91969817,42577148,0,100,
496,496,0,0,0,0,2023-08-03,2023-09-01,448.84,0,0,91969817,42577148,0,100,
498,498,0,0,0,0,2023-08-03,2023-09-01,448.84,0,0,91969817,42577148,0,100,
551.5,500,0,0,0,0,2023-08-03,2023-09-01,448.84,0,0,91969817,42577148,0,100,
502,502,0,0,0,0,2023-08-03,2023-09-01,448.84,0,0,91969817,42577148,0,100,
504,504,0,0,0,0,2023-08-03,2023-09-01,448.84,0,0,91969817,42577148,0,100,
559.19,505,0,0,0,0,2023-08-03,2023-09-01,448.84,0,0,91969817,42577148,0,100,
510,510,0,0,0,0,2023-08-03,2023-09-01,448.84,0,0,91969817,42577148,0,100,
515,515,0,0,0,0,2023-08-03,2023-09-01,448.84,0,0,91969817,42577148,0,100,
520,520,0,0,0,0,2023-08-03,2023-09-01,448.84,0,0,91969817,42577148,0,100,
525,525,0,0,0,0,2023-08-03,2023-09-01,448.84,0,0,91969817,42577148,0,100,
530,530,0,0,0,0,2023-08-03,2023-09-01,448.84,0,0,91969817,42577148,0,100,
624.79,540,0,0,0,0,2023-08-03,2023-09-01,448.84,0,0,91969817,42577148,0,100,
471,471,0,0,0,0,2023-08-03,2023-09-08,448.84,0,0,29175941,13324771,0,100,
487.78,472,0,0,0,0,2023-08-03,2023-09-08,448.84,0,0,29175941,13324771,0,100,
490.84,475,0,0,0,0,2023-08-03,2023-09-08,448.84,0,0,29175941,13324771,0,100,
476,476,0,0,0,0,2023-08-03,2023-09-08,448.84,0,0,29175941,13324771,0,100,
478,478,0,0,0,0,2023-08-03,2023-09-08,448.84,0,0,29175941,13324771,0,100,
480,480,0,0,0,0,2023-08-03,2023-09-08,448.84,0,0,29175941,13324771,0,100,
482,482,0,0,0,0,2023-08-03,2023-09-08,448.84,0,0,29175941,13324771,0,100,
484,484,0,0,0,0,2023-08-03,2023-09-08,448.84,0,0,29175941,13324771,0,100,
485,485,0,0,0,0,2023-08-03,2023-09-08,448.84,0,0,29175941,13324771,0,100,
486,486,0,0,0,0,2023-08-03,2023-09-08,448.84,0,0,29175941,13324771,0,100,
488,488,0,0,0,0,2023-08-03,2023-09-08,448.84,0,0,29175941,13324771,0,100,
490,490,0,0,0,0,2023-08-03,2023-09-08,448.84,0,0,29175941,13324771,0,100,
492,492,0,0,0,0,2023-08-03,2023-09-08,448.84,0,0,29175941,13324771,0,100,
494,494,0,0,0,0,2023-08-03,2023-09-08,448.84,0,0,29175941,13324771,0,100,
495,495,0,0,0,0,2023-08-03,2023-09-08,448.84,0,0,29175941,13324771,0,100,
496,496,0,0,0,0,2023-08-03,2023-09-08,448.84,0,0,29175941,13324771,0,100,
498,498,0,0,0,0,2023-08-03,2023-09-08,448.84,0,0,29175941,13324771,0,100,
500,500,0,0,0,0,2023-08-03,2023-09-08,448.84,0,0,29175941,13324771,0,100,
502,502,0,0,0,0,2023-08-03,2023-09-08,448.84,0,0,29175941,13324771,0,100,
504,504,0,0,0,0,2023-08-03,2023-09-08,448.84,0,0,29175941,13324771,0,100,
505,505,0,0,0,0,2023-08-03,2023-09-08,448.84,0,0,29175941,13324771,0,100,
506,506,0,0,0,0,2023-08-03,2023-09-08,448.84,0,0,29175941,13324771,0,100,
510,510,0,0,0,0,2023-08-03,2023-09-08,448.84,0,0,29175941,13324771,0,100,
515,515,0,0,0,0,2023-08-03,2023-09-08,448.84,0,0,29175941,13324771,0,100,
520,520,0,0,0,0,2023-08-03,2023-09-08,448.84,0,0,29175941,13324771,0,100,
525,525,0,0,0,0,2023-08-03,2023-09-08,448.84,0,0,29175941,13324771,0,100,
530,530,0,0,0,0,2023-08-03,2023-09-08,448.84,0,0,29175941,13324771,0,100,
540,540,0,0,0,0,2023-08-03,2023-09-08,448.84,0,0,29175941,13324771,0,100,
500.7,478,0,0,0,0,2023-08-03,2023-09-15,448.84,0,0,612682077,237570121,0,100,
513.7,482,0,0,0,0,2023-08-03,2023-09-15,448.84,0,0,612682077,237570121,0,100,
511.26,484,0,0,0,0,2023-08-03,2023-09-15,448.84,0,0,612682077,237570121,0,100,
513,485,0,0,0,0,2023-08-03,2023-09-15,448.84,0,0,612682077,237570121,0,100,
486,486,0,0,0,0,2023-08-03,2023-09-15,448.84,0,0,612682077,237570121,0,100,
488,488,0,0,0,0,2023-08-03,2023-09-15,448.84,0,0,612682077,237570121,0,100,
526.8,490,0,0,0,0,2023-08-03,2023-09-15,448.84,0,0,612682077,237570121,0,100,
533,492,0,0,0,0,2023-08-03,2023-09-15,448.84,0,0,612682077,237570121,0,100,
535.82,494,0,0,0,0,2023-08-03,2023-09-15,448.84,0,0,612682077,237570121,0,100,
496,496,0,0,0,0,2023-08-03,2023-09-15,448.84,0,0,612682077,237570121,0,100,
498,498,0,0,0,0,2023-08-03,2023-09-15,448.84,0,0,612682077,237570121,0,100,
502,502,0,0,0,0,2023-08-03,2023-09-15,448.84,0,0,612682077,237570121,0,100,
504,504,0,0,0,0,2023-08-03,2023-09-15,448.84,0,0,612682077,237570121,0,100,
563.97,505,0,0,0,0,2023-08-03,2023-09-15,448.84,0,0,612682077,237570121,0,100,
584.51,510,0,0,0,0,2023-08-03,2023-09-15,448.84,0,0,612682077,237570121,0,100,
588.54,515,0,0,0,0,2023-08-03,2023-09-15,448.84,0,0,612682077,237570121,0,100,
589.73,520,0,0,0,0,2023-08-03,2023-09-15,448.84,0,0,612682077,237570121,0,100,
595.28,525,0,0,0,0,2023-08-03,2023-09-15,448.84,0,0,612682077,237570121,0,100,
535,535,0,0,0,0,2023-08-03,2023-09-15,448.84,0,0,612682077,237570121,0,100,
540,540,0,0,0,0,2023-08-03,2023-09-15,448.84,0,0,612682077,237570121,0,100,
545,545,0,0,0,0,2023-08-03,2023-09-15,448.84,0,0,612682077,237570121,0,100,
646.54,550,0,0,0,0,2023-08-03,2023-09-15,448.84,0,0,612682077,237570121,0,100,
555,555,0,0,0,0,2023-08-03,2023-09-15,448.84,0,0,612682077,237570121,0,100,
560,560,0,0,0,0,2023-08-03,2023-09-15,448.84,0,0,612682077,237570121,0,100,
565,565,0,0,0,0,2023-08-03,2023-09-15,448.84,0,0,612682077,237570121,0,100,
570,570,0,0,0,0,2023-08-03,2023-09-15,448.84,0,0,612682077,237570121,0,100,
575,575,0,0,0,0,2023-08-03,2023-09-15,448.84,0,0,612682077,237570121,0,100,
580,580,0,0,0,0,2023-08-03,2023-09-15,448.84,0,0,612682077,237570121,0,100,
585,585,0,0,0,0,2023-08-03,2023-09-15,448.84,0,0,612682077,237570121,0,100,
590,590,0,0,0,0,2023-08-03,2023-09-15,448.84,0,0,612682077,237570121,0,100,
595,595,0,0,0,0,2023-08-03,2023-09-15,448.84,0,0,612682077,237570121,0,100,
779.68,600,0,0,0,0,2023-08-03,2023-09-15,448.84,0,0,612682077,237570121,0,100,
605,605,0,0,0,0,2023-08-03,2023-09-15,448.84,0,0,612682077,237570121,0,100,
610,610,0,0,0,0,2023-08-03,2023-09-15,448.84,0,0,612682077,237570121,0,100,
615,615,0,0,0,0,2023-08-03,2023-09-15,448.84,0,0,612682077,237570121,0,100,
620,620,0,0,0,0,2023-08-03,2023-09-15,448.84,0,0,612682077,237570121,0,100,
625,625,0,0,0,0,2023-08-03,2023-09-15,448.84,0,0,612682077,237570121,0,100,
630,630,0,0,0,0,2023-08-03,2023-09-15,448.84,0,0,612682077,237570121,0,100,
858.53,635,0,0,0,0,2023-08-03,2023-09-15,448.84,0,0,612682077,237570121,0,100,
640,640,0,0,0,0,2023-08-03,2023-09-15,448.84,0,0,612682077,237570121,0,100,
843.84,645,0,0,0,0,2023-08-03,2023-09-15,448.84,0,0,612682077,237570121,0,100,
850.45,650,0,0,0,0,2023-08-03,2023-09-15,448.84,0,0,612682077,237570121,0,100,
491.61,474,2,0,3522,0,2023-08-03,2023-09-29,448.84,-2,-3522,193559650,66678490,0,100,-Inf
494.44,475,1,0,1944,0,2023-08-03,2023-09-29,448.84,-1,-1944,193559650,66678490,0,100,-Inf
476,476,0,0,0,0,2023-08-03,2023-09-29,448.84,0,0,193559650,66678490,0,100,
477,477,0,0,0,0,2023-08-03,2023-09-29,448.84,0,0,193559650,66678490,0,100,
498.47,478,25,0,51175,0,2023-08-03,2023-09-29,448.84,-25,-51175,193559650,66678490,0,100,-Inf
503,479,0,0,0,0,2023-08-03,2023-09-29,448.84,0,0,193559650,66678490,0,100,
481,481,0,0,0,0,2023-08-03,2023-09-29,448.84,0,0,193559650,66678490,0,100,
482,482,0,0,0,0,2023-08-03,2023-09-29,448.84,0,0,193559650,66678490,0,100,
483,483,0,0,0,0,2023-08-03,2023-09-29,448.84,0,0,193559650,66678490,0,100,
512.41,484,0,0,0,0,2023-08-03,2023-09-29,448.84,0,0,193559650,66678490,0,100,
519.3,485,1,0,2969,0,2023-08-03,2023-09-29,448.84,-1,-2969,193559650,66678490,0,100,-Inf
486,486,0,0,0,0,2023-08-03,2023-09-29,448.84,0,0,193559650,66678490,0,100,
488,488,0,0,0,0,2023-08-03,2023-09-29,448.84,0,0,193559650,66678490,0,100,
529.2,490,1,0,3181,0,2023-08-03,2023-09-29,448.84,-1,-3181,193559650,66678490,0,100,-Inf
492,492,0,0,0,0,2023-08-03,2023-09-29,448.84,0,0,193559650,66678490,0,100,
494,494,0,0,0,0,2023-08-03,2023-09-29,448.84,0,0,193559650,66678490,0,100,
578.15,495,0,0,0,0,2023-08-03,2023-09-29,448.84,0,0,193559650,66678490,0,100,
496,496,0,0,0,0,2023-08-03,2023-09-29,448.84,0,0,193559650,66678490,0,100,
498,498,0,0,0,0,2023-08-03,2023-09-29,448.84,0,0,193559650,66678490,0,100,
545,500,0,0,0,0,2023-08-03,2023-09-29,448.84,0,0,193559650,66678490,0,100,
502,502,0,0,0,0,2023-08-03,2023-09-29,448.84,0,0,193559650,66678490,0,100,
504,504,0,0,0,0,2023-08-03,2023-09-29,448.84,0,0,193559650,66678490,0,100,
555.22,505,0,0,0,0,2023-08-03,2023-09-29,448.84,0,0,193559650,66678490,0,100,
510,510,0,0,0,0,2023-08-03,2023-09-29,448.84,0,0,193559650,66678490,0,100,
623,515,0,0,0,0,2023-08-03,2023-09-29,448.84,0,0,193559650,66678490,0,100,
604.95,520,0,0,0,0,2023-08-03,2023-09-29,448.84,0,0,193559650,66678490,0,100,
525,525,0,0,0,0,2023-08-03,2023-09-29,448.84,0,0,193559650,66678490,0,100,
530,530,0,0,0,0,2023-08-03,2023-09-29,448.84,0,0,193559650,66678490,0,100,
540,540,0,0,0,0,2023-08-03,2023-09-29,448.84,0,0,193559650,66678490,0,100,
550,550,0,0,0,0,2023-08-03,2023-09-29,448.84,0,0,193559650,66678490,0,100,
484,484,0,0,0,0,2023-08-03,2023-10-20,448.84,0,0,344413796,107013117,0,100,
515.42,486,0,0,0,0,2023-08-03,2023-10-20,448.84,0,0,344413796,107013117,0,100,
488,488,0,0,0,0,2023-08-03,2023-10-20,448.84,0,0,344413796,107013117,0,100,
492,492,0,0,0,0,2023-08-03,2023-10-20,448.84,0,0,344413796,107013117,0,100,
494,494,0,0,0,0,2023-08-03,2023-10-20,448.84,0,0,344413796,107013117,0,100,
496,496,0,0,0,0,2023-08-03,2023-10-20,448.84,0,0,344413796,107013117,0,100,
498,498,0,0,0,0,2023-08-03,2023-10-20,448.84,0,0,344413796,107013117,0,100,
547.45,500,0,0,0,0,2023-08-03,2023-10-20,448.84,0,0,344413796,107013117,0,100,
502,502,0,0,0,0,2023-08-03,2023-10-20,448.84,0,0,344413796,107013117,0,100,
556.74,504,0,0,0,0,2023-08-03,2023-10-20,448.84,0,0,344413796,107013117,0,100,
560.79,505,0,0,0,0,2023-08-03,2023-10-20,448.84,0,0,344413796,107013117,0,100,
506,506,0,0,0,0,2023-08-03,2023-10-20,448.84,0,0,344413796,107013117,0,100,
563.86,510,0,0,0,0,2023-08-03,2023-10-20,448.84,0,0,344413796,107013117,0,100,
592.14,515,0,0,0,0,2023-08-03,2023-10-20,448.84,0,0,344413796,107013117,0,100,
584.93,520,0,0,0,0,2023-08-03,2023-10-20,448.84,0,0,344413796,107013117,0,100,
525,525,0,0,0,0,2023-08-03,2023-10-20,448.84,0,0,344413796,107013117,0,100,
614.32,530,0,0,0,0,2023-08-03,2023-10-20,448.84,0,0,344413796,107013117,0,100,
631.16,535,0,0,0,0,2023-08-03,2023-10-20,448.84,0,0,344413796,107013117,0,100,
634.17,540,0,0,0,0,2023-08-03,2023-10-20,448.84,0,0,344413796,107013117,0,100,
633.71,545,0,0,0,0,2023-08-03,2023-10-20,448.84,0,0,344413796,107013117,0,100,
644.4,550,0,0,0,0,2023-08-03,2023-10-20,448.84,0,0,344413796,107013117,0,100,
659.41,555,0,0,0,0,2023-08-03,2023-10-20,448.84,0,0,344413796,107013117,0,100,
665.61,560,0,0,0,0,2023-08-03,2023-10-20,448.84,0,0,344413796,107013117,0,100,
711.16,565,0,0,0,0,2023-08-03,2023-10-20,448.84,0,0,344413796,107013117,0,100,
685.93,570,0,0,0,0,2023-08-03,2023-10-20,448.84,0,0,344413796,107013117,0,100,
575,575,0,0,0,0,2023-08-03,2023-10-20,448.84,0,0,344413796,107013117,0,100,
707.44,580,0,0,0,0,2023-08-03,2023-10-20,448.84,0,0,344413796,107013117,0,100,
725.45,590,0,0,0,0,2023-08-03,2023-10-20,448.84,0,0,344413796,107013117,0,100,
733.87,595,0,0,0,0,2023-08-03,2023-10-20,448.84,0,0,344413796,107013117,0,100,
749.63,600,1,0,14390,0,2023-08-03,2023-10-20,448.84,-1,-14390,344413796,107013117,0,100,-Inf
529.73,490,10,0,33000,0,2023-08-03,2023-11-17,448.84,-10,-33000,178436543,50264301,0,100,-Inf
547.74,500,0,0,0,0,2023-08-03,2023-11-17,448.84,0,0,178436543,50264301,0,100,
574.35,505,0,0,0,0,2023-08-03,2023-11-17,448.84,0,0,178436543,50264301,0,100,
510,510,0,0,0,0,2023-08-03,2023-11-17,448.84,0,0,178436543,50264301,0,100,
515,515,0,0,0,0,2023-08-03,2023-11-17,448.84,0,0,178436543,50264301,0,100,
520,520,0,0,0,0,2023-08-03,2023-11-17,448.84,0,0,178436543,50264301,0,100,
525,525,0,0,0,0,2023-08-03,2023-11-17,448.84,0,0,178436543,50264301,0,100,
530,530,0,0,0,0,2023-08-03,2023-11-17,448.84,0,0,178436543,50264301,0,100,
540,540,0,0,0,0,2023-08-03,2023-11-17,448.84,0,0,178436543,50264301,0,100,
550,550,0,0,0,0,2023-08-03,2023-11-17,448.84,0,0,178436543,50264301,0,100,
560,560,0,0,0,0,2023-08-03,2023-11-17,448.84,0,0,178436543,50264301,0,100,
474,474,0,0,0,0,2023-08-03,2023-12-15,448.84,0,0,463353257,105207973,0,100,
503.89,478,0,0,0,0,2023-08-03,2023-12-15,448.84,0,0,463353257,105207973,0,100,
479,479,0,0,0,0,2023-08-03,2023-12-15,448.84,0,0,463353257,105207973,0,100,
482,482,0,0,0,0,2023-08-03,2023-12-15,448.84,0,0,463353257,105207973,0,100,
483,483,0,0,0,0,2023-08-03,2023-12-15,448.84,0,0,463353257,105207973,0,100,
486,486,0,0,0,0,2023-08-03,2023-12-15,448.84,0,0,463353257,105207973,0,100,
487,487,0,0,0,0,2023-08-03,2023-12-15,448.84,0,0,463353257,105207973,0,100,
521.15,488,0,0,0,0,2023-08-03,2023-12-15,448.84,0,0,463353257,105207973,0,100,
491,491,0,0,0,0,2023-08-03,2023-12-15,448.84,0,0,463353257,105207973,0,100,
492,492,0,0,0,0,2023-08-03,2023-12-15,448.84,0,0,463353257,105207973,0,100,
493,493,0,0,0,0,2023-08-03,2023-12-15,448.84,0,0,463353257,105207973,0,100,
494,494,0,0,0,0,2023-08-03,2023-12-15,448.84,0,0,463353257,105207973,0,100,
535.78,495,0,0,0,0,2023-08-03,2023-12-15,448.84,0,0,463353257,105207973,0,100,
496,496,0,0,0,0,2023-08-03,2023-12-15,448.84,0,0,463353257,105207973,0,100,
497,497,0,0,0,0,2023-08-03,2023-12-15,448.84,0,0,463353257,105207973,0,100,
498,498,0,0,0,0,2023-08-03,2023-12-15,448.84,0,0,463353257,105207973,0,100,
499,499,0,0,0,0,2023-08-03,2023-12-15,448.84,0,0,463353257,105207973,0,100,
501,501,0,0,0,0,2023-08-03,2023-12-15,448.84,0,0,463353257,105207973,0,100,
584.63,505,0,0,0,0,2023-08-03,2023-12-15,448.84,0,0,463353257,105207973,0,100,
637.25,515,0,0,0,0,2023-08-03,2023-12-15,448.84,0,0,463353257,105207973,0,100,
649.53,520,0,0,0,0,2023-08-03,2023-12-15,448.84,0,0,463353257,105207973,0,100,
605.02,530,0,0,0,0,2023-08-03,2023-12-15,448.84,0,0,463353257,105207973,0,100,
636.89,535,0,0,0,0,2023-08-03,2023-12-15,448.84,0,0,463353257,105207973,0,100,
678.15,545,0,0,0,0,2023-08-03,2023-12-15,448.84,0,0,463353257,105207973,0,100,
645.15,550,0,0,0,0,2023-08-03,2023-12-15,448.84,0,0,463353257,105207973,0,100,
669.72,560,0,0,0,0,2023-08-03,2023-12-15,448.84,0,0,463353257,105207973,0,100,
565,565,0,0,0,0,2023-08-03,2023-12-15,448.84,0,0,463353257,105207973,0,100,
570,570,0,0,0,0,2023-08-03,2023-12-15,448.84,0,0,463353257,105207973,0,100,
575,575,0,0,0,0,2023-08-03,2023-12-15,448.84,0,0,463353257,105207973,0,100,
580,580,0,0,0,0,2023-08-03,2023-12-15,448.84,0,0,463353257,105207973,0,100,
585,585,0,0,0,0,2023-08-03,2023-12-15,448.84,0,0,463353257,105207973,0,100,
739.77,595,0,0,0,0,2023-08-03,2023-12-15,448.84,0,0,463353257,105207973,0,100,
746.92,600,0,0,0,0,2023-08-03,2023-12-15,448.84,0,0,463353257,105207973,0,100,
605,605,0,0,0,0,2023-08-03,2023-12-15,448.84,0,0,463353257,105207973,0,100,
610,610,0,0,0,0,2023-08-03,2023-12-15,448.84,0,0,463353257,105207973,0,100,
615,615,0,0,0,0,2023-08-03,2023-12-15,448.84,0,0,463353257,105207973,0,100,
620,620,0,0,0,0,2023-08-03,2023-12-15,448.84,0,0,463353257,105207973,0,100,
625,625,0,0,0,0,2023-08-03,2023-12-15,448.84,0,0,463353257,105207973,0,100,
630,630,0,0,0,0,2023-08-03,2023-12-15,448.84,0,0,463353257,105207973,0,100,
635,635,0,0,0,0,2023-08-03,2023-12-15,448.84,0,0,463353257,105207973,0,100,
640,640,0,0,0,0,2023-08-03,2023-12-15,448.84,0,0,463353257,105207973,0,100,
645,645,0,0,0,0,2023-08-03,2023-12-15,448.84,0,0,463353257,105207973,0,100,
650,650,0,0,0,0,2023-08-03,2023-12-15,448.84,0,0,463353257,105207973,0,100,
655,655,0,0,0,0,2023-08-03,2023-12-15,448.84,0,0,463353257,105207973,0,100,
660,660,0,0,0,0,2023-08-03,2023-12-15,448.84,0,0,463353257,105207973,0,100,
665,665,0,0,0,0,2023-08-03,2023-12-15,448.84,0,0,463353257,105207973,0,100,
670,670,0,0,0,0,2023-08-03,2023-12-15,448.84,0,0,463353257,105207973,0,100,
675,675,0,0,0,0,2023-08-03,2023-12-15,448.84,0,0,463353257,105207973,0,100,
680,680,0,0,0,0,2023-08-03,2023-12-15,448.84,0,0,463353257,105207973,0,100,
685,685,0,0,0,0,2023-08-03,2023-12-15,448.84,0,0,463353257,105207973,0,100,
690,690,0,0,0,0,2023-08-03,2023-12-15,448.84,0,0,463353257,105207973,0,100,
695,695,0,0,0,0,2023-08-03,2023-12-15,448.84,0,0,463353257,105207973,0,100,
944.77,700,0,0,0,0,2023-08-03,2023-12-15,448.84,0,0,463353257,105207973,0,100,
705,705,0,0,0,0,2023-08-03,2023-12-15,448.84,0,0,463353257,105207973,0,100,
710,710,0,0,0,0,2023-08-03,2023-12-15,448.84,0,0,463353257,105207973,0,100,
715,715,0,0,0,0,2023-08-03,2023-12-15,448.84,0,0,463353257,105207973,0,100,
