Watch,strike,open_interest.yt,open_interest.td,OI_Dollar.yt,OI_Dollar.td,Date.td,expiry,stkClose,diff_oi,diff_oi_d,totalOI,totalOIdiff,OI_pct,cum_sep_OI,pct
453.6,460,137315,136839,98454855,87576960,2024-05-07,2024-12-20,516.57,-476,-10877895,537706253,-56832135,16.2871381002891,16.2871381002891,-0.124209552375419
462.45,470,59887,59922,51203385,45241110,2024-05-07,2024-12-20,516.57,35,-5962275,537706253,-56832135,8.41372212943188,24.700860229721,-0.131788875206643
509.15,540,12545,12545,41034695,38701325,2024-05-07,2024-12-20,516.57,0,-2333370,537706253,-56832135,7.19748464595222,31.8983448756732,-0.060291734197731
498.79,510,28048,27877,36742880,31250117,2024-05-07,2024-09-20,516.57,-171,-5492763,300792694,-48138153,10.389254002293,10.389254002293,-0.175767757925514
509.62,530,15153,15162,34867053,30900156,2024-05-07,2024-09-20,516.57,9,-3966897,300792694,-48138153,10.2729077588567,20.6621617611497,-0.128377895567906
496.56,500,72496,78997,33130672,27174968,2024-05-07,2024-06-21,516.57,6501,-5955704,348355461,-84761006,7.80093067064047,7.80093067064047,-0.21916139882851
504.99,530,10667,10716,28982239,26800716,2024-05-07,2024-12-20,516.57,49,-2181523,537706253,-56832135,4.98426712549315,36.8826120011664,-0.081397937278989
478.94,490,23264,23279,28684512,25746574,2024-05-07,2024-12-20,516.57,15,-2937938,537706253,-56832135,4.78822291099524,41.6708349121616,-0.114109861762578
486.59,500,18007,18340,27010500,24593940,2024-05-07,2024-12-20,516.57,333,-2416560,537706253,-56832135,4.57386163221725,46.2446965443789,-0.0982583514475517
506.83,535,8436,8436,25189896,23764212,2024-05-07,2024-12-20,516.57,0,-1425684,537706253,-56832135,4.41955284459004,50.6642493889689,-0.0599929002484911
500.19,520,11444,11472,25668892,22726032,2024-05-07,2024-12-20,516.57,28,-2942860,537706253,-56832135,4.22647716540503,54.8907265543739,-0.129492909276903
504.23,510,37119,38933,27913488,22464341,2024-05-07,2024-06-21,516.57,1814,-5449147,348355461,-84761006,6.44868346128784,14.2496141319283,-0.242568744838765
465.86,470,52416,50145,24635520,20760030,2024-05-07,2024-09-20,516.57,-2271,-3875490,300792694,-48138153,6.90177335224771,27.5639351133974,-0.186680366068835
470.42,475,39816,39635,21102480,18152830,2024-05-07,2024-09-20,516.57,-181,-2949650,300792694,-48138153,6.03499698034554,33.598932093743,-0.162489815637562
397.54,400,67481,67366,18287351,16572036,2024-05-07,2024-12-20,516.57,-115,-1715315,537706253,-56832135,3.08198684830991,57.9727134026838,-0.10350659387899
510.36,520,15972,15919,19485840,15345916,2024-05-07,2024-06-21,516.57,-53,-4139924,348355461,-84761006,4.40524628376645,18.6548604156948,-0.269773664863016
491.52,500,14227,17653,14155865,14969744,2024-05-07,2024-09-20,516.57,3426,813879,300792694,-48138153,4.97676449548339,38.5756965892263,0.0543682644138738
470.75,480,16129,16124,16467709,14914700,2024-05-07,2024-12-20,516.57,-5,-1553009,537706253,-56832135,2.77376354036932,60.7464769430532,-0.104126063548043
487.91,490,72355,71114,20404110,14862826,2024-05-07,2024-06-21,516.57,-1241,-5541284,348355461,-84761006,4.26656896875804,22.9214293844528,-0.372828424419421
505.04,520,9778,9793,17033276,14650328,2024-05-07,2024-09-20,516.57,15,-2382948,300792694,-48138153,4.87057308645934,43.4462696756857,-0.16265492485902
502.06,515,11045,11221,16655860,14519974,2024-05-07,2024-09-20,516.57,176,-2135886,300792694,-48138153,4.82723626259353,48.2735059382792,-0.147099850178795
474.96,480,28234,28214,16742762,14219856,2024-05-07,2024-09-20,516.57,-20,-2522906,300792694,-48138153,4.72746056790861,53.0009665061878,-0.177421346601541
508.7,545,3897,3897,14146110,14146110,2024-05-07,2024-12-20,516.57,0,0,537706253,-56832135,2.63082490134256,63.3773018443957,0
500.73,510,14965,15154,16835625,14047758,2024-05-07,2024-08-16,516.57,189,-2787867,103324269,-17142661,13.5957971306819,13.5957971306819,-0.198456365777372
512.56,550,3696,3699,18110400,13849056,2024-05-07,2024-12-20,516.57,3,-4261344,537706253,-56832135,2.57558023971873,65.9528820841144,-0.307699239572719
456.75,460,41628,41545,15568872,13502125,2024-05-07,2024-09-20,516.57,-83,-2066747,300792694,-48138153,4.48884739201811,57.4898138982059,-0.153068276289843
449.12,455,23268,22953,15170736,13496364,2024-05-07,2024-12-20,516.57,-315,-1674372,537706253,-56832135,2.50998829280864,68.4628703769231,-0.124060969309956
507.75,525,7749,7761,15304275,13387725,2024-05-07,2024-09-20,516.57,12,-1916550,300792694,-48138153,4.45081455336146,61.9406284515674,-0.143157257861212
495.33,505,15821,13837,18209971,13380379,2024-05-07,2024-09-20,516.57,-1984,-4829592,300792694,-48138153,4.44837233978828,66.3890007913557,-0.360945829710803
502.75,525,5851,5837,14381758,12987325,2024-05-07,2024-12-20,516.57,-14,-1394433,537706253,-56832135,2.41531968942902,70.8781900663521,-0.107368761465506
466.74,475,15695,15682,14596350,12953332,2024-05-07,2024-12-20,516.57,-13,-1643018,537706253,-56832135,2.40899783622193,73.287187902574,-0.126841340899778
492.34,495,45262,47305,16249058,12583130,2024-05-07,2024-06-21,516.57,2043,-3665928,348355461,-84761006,3.61215235836363,26.5335817428164,-0.291336734182989
483.53,490,20743,19080,15785423,12344760,2024-05-07,2024-09-20,516.57,-1663,-3440663,300792694,-48138153,4.1040757459355,70.4930765372912,-0.278714450503696
479.31,485,20192,20358,13892096,11583702,2024-05-07,2024-09-20,516.57,166,-2308394,300792694,-48138153,3.85105829731356,74.3441348346047,-0.199279470414553
444.73,450,21139,21100,12535427,11119700,2024-05-07,2024-12-20,516.57,-39,-1415727,537706253,-56832135,2.06798785358369,75.3551757561577,-0.127317013948218
487.59,495,14664,14685,12977640,10881585,2024-05-07,2024-09-20,516.57,21,-2096055,300792694,-48138153,3.61763607197188,77.9617709065766,-0.192624052470297
508.05,510,54205,55445,19405390,10811775,2024-05-07,2024-05-17,516.57,1240,-8593615,97672171,-63323414,11.0694529355757,11.0694529355757,-0.794838497841474
487,489,13493,52644,3629617,10528800,2024-05-07,2024-06-21,516.57,39151,6899183,348355461,-84761006,3.02243001151057,29.556011754327,0.655267741812932
511.59,525,7550,7556,12200800,10132596,2024-05-07,2024-06-28,516.57,6,-2068204,83365113,-15781476,12.154480016119,12.154480016119,-0.204113930921553
496.67,515,5314,5363,10707710,9830379,2024-05-07,2024-12-20,516.57,49,-877331,537706253,-56832135,1.8282061897465,77.1833819459042,-0.0892469150985939
485.14,490,19688,19694,11655296,9571284,2024-05-07,2024-08-16,516.57,6,-2084012,103324269,-17142661,9.26334547791478,22.8591426085966,-0.217735885801738
478.68,480,69476,72216,12366728,9532512,2024-05-07,2024-06-21,516.57,2740,-2834216,348355461,-84761006,2.73643248555245,32.2924442398795,-0.297320999963074
500.56,505,15956,21410,9414040,9506040,2024-05-07,2024-06-21,516.57,5454,92000,348355461,-84761006,2.72883335105804,35.0212775909375,0.00967805731934644
490.26,505,6300,6399,10476900,9432126,2024-05-07,2024-12-20,516.57,99,-1044774,537706253,-56832135,1.75414102911688,78.9375229750211,-0.110767604249562
499.4,500,154917,155559,18590040,9333540,2024-05-07,2024-05-17,516.57,642,-9256500,97672171,-63323414,9.55598703749505,20.6254399730707,-0.991745897055137
511.53,515,20292,26286,11809944,9121242,2024-05-07,2024-05-17,516.57,5994,-2688702,97672171,-63323414,9.33862932154953,29.9640692946203,-0.294773672269632
512.28,525,7081,6927,11081765,8811144,2024-05-07,2024-06-21,516.57,-154,-2270621,348355461,-84761006,2.52935434820125,37.5506319391387,-0.257698773280745
497.12,505,10722,10886,10185900,8578168,2024-05-07,2024-08-16,516.57,164,-1607732,103324269,-17142661,8.30218116520137,31.161323773798,-0.187421370157358
493.71,510,5090,5211,9197630,8488719,2024-05-07,2024-12-20,516.57,121,-708911,537706253,-56832135,1.57869077263641,80.5162137476575,-0.083512129450863
435.41,440,18057,18054,9046557,8286786,2024-05-07,2024-12-20,516.57,-3,-759771,537706253,-56832135,1.54113625306864,82.0573500007262,-0.091684641065909
507.51,515,9056,10040,8729984,7519960,2024-05-07,2024-06-21,516.57,984,-1210024,348355461,-84761006,2.1587030610667,39.7093350002054,-0.160908302703738
496.08,500,13249,19064,6849733,7473088,2024-05-07,2024-06-28,516.57,5815,623355,83365113,-15781476,8.96428701536097,21.1187670314799,0.0834133091969478
469.14,470,98488,85953,11326120,7391958,2024-05-07,2024-06-21,516.57,-12535,-3934162,348355461,-84761006,2.12195840960277,41.8312934098082,-0.532221909269506
473.95,475,64902,70011,9216084,7351155,2024-05-07,2024-06-21,516.57,5109,-1864929,348355461,-84761006,2.11024537376206,43.9415387835703,-0.25369197085356
511.65,526,5094,5095,8466228,7311325,2024-05-07,2024-06-21,516.57,1,-1154903,348355461,-84761006,2.09881165032174,46.040350433892,-0.157960834732419
416.69,420,21904,21905,8082576,7250555,2024-05-07,2024-12-20,516.57,1,-832020.999999999,537706253,-56832135,1.34842303944715,83.4057730401733,-0.11475273272184
442.64,445,30730,30715,8481480,7248740,2024-05-07,2024-09-20,516.57,-15,-1232740,300792694,-48138153,2.40987901122359,80.3716499178002,-0.170062659165593
430.67,435,16354,16357,7637318,7082581,2024-05-07,2024-12-20,516.57,3,-554736.999999999,537706253,-56832135,1.31718404993144,84.7229570901047,-0.0783241307088474
506.52,510,18377,19983,9519286,6954084,2024-05-07,2024-05-31,516.57,1606,-2565202,66348411,-19082513,10.4811613348208,10.4811613348208,-0.368877051240681
476.38,480,17960,18788,7866480,6801256,2024-05-07,2024-08-16,516.57,828,-1065224,103324269,-17142661,6.58243805238051,37.7437618261785,-0.156621659293519
500.17,507,9793,9821,8559082,6707743,2024-05-07,2024-07-19,516.57,28,-1851339,117399288,-25407869,5.71361471970767,5.71361471970767,-0.276000288025346
494.84,500,11028,12748,7113060,6577968,2024-05-07,2024-07-19,516.57,1720,-535092,117399288,-25407869,5.60307316344201,11.3166878831497,-0.0813460935048635
493.39,500,9674,9779,7826266,6463919,2024-05-07,2024-08-16,516.57,105,-1362347,103324269,-17142661,6.25595425214187,43.9997160783204,-0.210761768518448
461.43,465,18941,17976,7955220,6417432,2024-05-07,2024-09-20,516.57,-965,-1537788,300792694,-48138153,2.13350660704545,82.5051565248456,-0.239626691798215
509.92,519,7061,7059,8459078,6409572,2024-05-07,2024-06-21,516.57,-2,-2049506,348355461,-84761006,1.83995163491925,47.8803020688113,-0.319757075823472
494.94,498,20250,20430,8788500,6251580,2024-05-07,2024-06-21,516.57,180,-2536920,348355461,-84761006,1.79459796096034,49.6749000297716,-0.405804612593936
506.88,520,4507,4648,7103032,6098176,2024-05-07,2024-08-16,516.57,141,-1004856,103324269,-17142661,5.90197836289556,49.9016944412159,-0.164779763653919
447.4,450,22821,22823,6869121,5933980,2024-05-07,2024-09-20,516.57,2,-935140.999999999,300792694,-48138153,1.97278062877418,84.4779371536198,-0.157590858075019
514.6,530,3930,3819,7694940,5881260,2024-05-07,2024-06-21,516.57,-111,-1813680,348355461,-84761006,1.68829275221266,51.3631927819843,-0.308382897542363
440,445,11677,11698,6410673,5849000,2024-05-07,2024-12-20,516.57,21,-561673,537706253,-56832135,1.08776864084562,85.8107257309504,-0.0960288938280048
449.67,450,220,175459,9460,5790147,2024-05-07,2024-06-14,516.57,175239,5780687,17277101,14428074,33.5134175577257,33.5134175577257,0.998366190012102
511.69,524,4637,4639,6839575,5710609,2024-05-07,2024-06-21,516.57,2,-1128966,348355461,-84761006,1.63930514641767,53.0024979284019,-0.197696252711401
428.23,430,32278,32256,6616990,5709312,2024-05-07,2024-09-20,516.57,-22,-907677.999999999,300792694,-48138153,1.89808865503894,86.3760258086588,-0.158982027957134
513.43,527,4147,4144,7340190,5623408,2024-05-07,2024-06-21,516.57,-3,-1716782,348355461,-84761006,1.61427295666825,54.6167708850702,-0.305292093335571
421.44,425,15726,15729,6196044,5599524,2024-05-07,2024-12-20,516.57,3,-596520,537706253,-56832135,1.04137230481491,86.8520980357653,-0.10653048366254
510.76,521,5447,5451,7070206,5581824,2024-05-07,2024-06-21,516.57,4,-1488382,348355461,-84761006,1.60233572454316,56.2191066096133,-0.2666479631031
426.04,430,13208,13734,5653024,5438664,2024-05-07,2024-12-20,516.57,526,-214360.000000001,537706253,-56832135,1.01145634250231,87.8635543782676,-0.0394140914018592
378.02,380,27461,27460,5794271,5437080,2024-05-07,2024-12-20,516.57,-1,-357191,537706253,-56832135,1.01116175786782,88.8747161361354,-0.065695373251819
480.57,482,37596,37712,7556796,5392816,2024-05-07,2024-06-21,516.57,116,-2163980,348355461,-84761006,1.54807850134435,57.7671851109577,-0.401270875920855
457.88,460,25283,25302,6548297,5364024,2024-05-07,2024-08-16,516.57,19,-1184273,103324269,-17142661,5.19144635806715,55.0931407992831,-0.22078070493346
493.89,495,29402,48116,5145350,5340876,2024-05-07,2024-05-31,516.57,18714,195526,66348411,-19082513,8.0497421407726,18.5309034755934,0.0366093502264423
452.13,455,18387,18403,6288354,5281661,2024-05-07,2024-09-20,516.57,16,-1006693,300792694,-48138153,1.75591399171417,88.131939800373,-0.190601592945856
404.85,405,0,350223,0,5253345,2024-05-07,2024-06-14,516.57,350223,5253345,17277101,14428074,30.4064032501749,63.9198208079006,1
444.6,445,29540,129577,1477000,5183080,2024-05-07,2024-06-21,516.57,100037,3706080,348355461,-84761006,1.48787103412167,59.2550561450794,0.715034303927395
504.04,515,3587,4680,4767123,5129280,2024-05-07,2024-08-16,516.57,1093,362157,103324269,-17142661,4.96425481606843,60.0573956153515,0.070605816020962
497.71,502,11766,11813,6612492,5067777,2024-05-07,2024-06-28,516.57,47,-1544715,83365113,-15781476,6.07901413148687,27.1977811629668,-0.304811162764265
475,485,4989,4992,5662515,4992000,2024-05-07,2024-12-20,516.57,3,-670515,537706253,-56832135,0.928387938981249,89.8031040751167,-0.134317908653846
512.65,529,3047,3047,5929462,4981845,2024-05-07,2024-06-21,516.57,0,-947617,348355461,-84761006,1.4301038903478,60.6851600354272,-0.190214067278287
463.5,465,33052,33017,6279880,4952550,2024-05-07,2024-07-19,516.57,-35,-1327330,117399288,-25407869,4.21855198985534,15.535239873005,-0.268009409294202
512.67,520,6569,6640,6956571,4867120,2024-05-07,2024-05-31,516.57,71,-2089451,66348411,-19082513,7.33569941863416,25.8666028942276,-0.429299257055507
503.94,505,35000,45283,7350000,4799998,2024-05-07,2024-05-17,516.57,10283,-2550002,97672171,-63323414,4.91439675278642,34.8784660474067,-0.531250638021099
508.42,520,3880,4074,5509600,4717692,2024-05-07,2024-07-19,516.57,194,-791908,117399288,-25407869,4.0185013728533,19.5537412458583,-0.167859198947282
509.47,520,4507,4474,5768960,4711122,2024-05-07,2024-06-28,516.57,-33,-1057838,83365113,-15781476,5.65119128429658,32.8489724472634,-0.224540565920391
457.75,465,6469,6469,5013475,4690025,2024-05-07,2024-12-20,516.57,0,-323450,537706253,-56832135,0.872228093653953,90.6753321687706,-0.0689655172413793
501.32,506,9244,9790,5749768,4581720,2024-05-07,2024-06-21,516.57,546,-1168048,348355461,-84761006,1.31524276577941,62.0004028012066,-0.254936574037698
509.86,515,4913,8894,3684750,4571516,2024-05-07,2024-05-31,516.57,3981,886766,66348411,-19082513,6.89016651807984,32.7567694123074,0.193976352702255
502.31,510,5749,5885,5461550,4525565,2024-05-07,2024-07-19,516.57,136,-935985,117399288,-25407869,3.85484876194479,23.4085900078031,-0.206821689667478
512.48,527,3045,3114,5307435,4521528,2024-05-07,2024-06-28,516.57,69,-785907,83365113,-15781476,5.42376521459282,38.2727376618562,-0.173814471568019
403.77,405,36613,36685,5015981,4512255,2024-05-07,2024-09-20,516.57,72,-503726.000000001,300792694,-48138153,1.50012120972593,89.6320610100989,-0.111635091545137
459.4,460,74864,75196,5839392,4511760,2024-05-07,2024-06-21,516.57,332,-1327632,348355461,-84761006,1.29515983100951,63.2955626322161,-0.294260332996436
494.05,497,19736,15208,7914136,4486360,2024-05-07,2024-06-21,516.57,-4528,-3427776,348355461,-84761006,1.28786842816281,64.5834310603789,-0.764043901960609
483.36,485,59274,27347,13277376,4484908,2024-05-07,2024-06-21,516.57,-31927,-8792468,348355461,-84761006,1.28745161253551,65.8708826729144,-1.96045671393928
508.8,511,18157,20039,7226486,4408580,2024-05-07,2024-05-17,516.57,1882,-2817906,97672171,-63323414,4.51365005493735,39.392116102344,-0.63918676762132
499.04,503,10639,10867,5830172,4303332,2024-05-07,2024-06-21,516.57,228,-1526840,348355461,-84761006,1.23532784232712,67.1062105152415,-0.354804137816929
502.61,505,16031,17993,5819253,4300327,2024-05-07,2024-05-31,516.57,1962,-1518926,66348411,-19082513,6.48143178590969,39.2382011982171,-0.353211744130156
437.82,440,19706,19725,4887088,4300050,2024-05-07,2024-09-20,516.57,19,-587038,300792694,-48138153,1.42957262120203,91.0616336313009,-0.136518877687469
511.83,523,3777,3774,5423772,4215558,2024-05-07,2024-06-21,516.57,-3,-1208214,348355461,-84761006,1.21013116541899,68.3163416806605,-0.286608320891327
498.38,500,23313,25987,5874876,4209894,2024-05-07,2024-05-31,516.57,2674,-1664982,66348411,-19082513,6.34513161136595,45.583332809583,-0.395492618103924
399.84,400,64227,262170,1348767,4194720,2024-05-07,2024-06-21,516.57,197943,2845953,348355461,-84761006,1.20414934445365,69.5204910251141,0.678460779265362
411.9,415,13510,13509,4660950,4187790,2024-05-07,2024-12-20,516.57,-1,-473160,537706253,-56832135,0.778824865181547,91.4541570339521,-0.112985608160868
490.59,493,17275,17346,5597100,4180386,2024-05-07,2024-06-21,516.57,71,-1416714,348355461,-84761006,1.20003458191804,70.7205256070322,-0.338895499123765
491.47,494,16334,16511,5814904,4177283,2024-05-07,2024-06-21,516.57,177,-1637621,348355461,-84761006,1.1991438251057,71.9196694321379,-0.392030178467679
504.94,511,3163,6824,2495607,4135344,2024-05-07,2024-06-21,516.57,3661,1639737,348355461,-84761006,1.18710468557862,73.1067741177165,0.396517677852193
514.07,520,6500,6559,5843500,3889487,2024-05-07,2024-05-17,516.57,59,-1954013,97672171,-63323414,3.98218546816165,43.3743015705057,-0.502383219175177
498.22,502,10170,10273,5186700,3883194,2024-05-07,2024-06-21,516.57,103,-1303506,348355461,-84761006,1.11472172385436,74.2214958415709,-0.335678825214501
489.37,495,6586,6528,4656302,3675264,2024-05-07,2024-08-16,516.57,-58,-981038,103324269,-17142661,3.55701911619622,63.6144147315477,-0.266929940270957
503.68,510,4681,5796,3786929,3663072,2024-05-07,2024-06-28,516.57,1115,-123857,83365113,-15781476,4.39401071764876,42.666748379505,-0.0338123301971678
408.72,410,28257,28101,4153779,3596928,2024-05-07,2024-09-20,516.57,-156,-556851,300792694,-48138153,1.19581627870257,92.2574499100035,-0.154812940375787
509.32,518,3986,4096,4599844,3555328,2024-05-07,2024-06-21,516.57,110,-1044516,348355461,-84761006,1.02060349213242,75.2420993337033,-0.293788927491359
387.59,390,14611,14611,3521251,3521251,2024-05-07,2024-12-20,516.57,0,0,537706253,-56832135,0.654865175986711,92.1090222099389,0
497.45,501,9719,9900,4713715,3514500,2024-05-07,2024-06-21,516.57,181,-1199215,348355461,-84761006,1.00888327971411,76.2509826134174,-0.341219234599516
505.72,512,5436,5518,4506444,3465304,2024-05-07,2024-06-21,516.57,82,-1041140,348355461,-84761006,0.99476092323984,77.2457435366572,-0.300446944914501
507.28,509,19876,19879,6479576,3419188,2024-05-07,2024-05-17,516.57,3,-3060388,97672171,-63323414,3.50067779285873,46.8749793633644,-0.895062804385135
486.52,490,9541,9755,4188499,3394740,2024-05-07,2024-07-19,516.57,214,-793759,117399288,-25407869,2.89161889976709,26.3002089075702,-0.233820263112934
398.87,400,29977,29986,3747125,3388418,2024-05-07,2024-09-20,516.57,9,-358707,300792694,-48138153,1.1264961109727,93.3839460209762,-0.105862676918845
507.3,519,2877,2888,4303992,3378960,2024-05-07,2024-07-19,516.57,11,-925032.000000001,117399288,-25407869,2.8781775916733,29.1783864992435,-0.273762341075361
505.05,514,3365,3774,3832735,3377730,2024-05-07,2024-07-19,516.57,409,-455005.000000001,117399288,-25407869,2.87712988514888,32.0555163843924,-0.134707333031356
418.49,420,22242,22364,3847866,3376964,2024-05-07,2024-09-20,516.57,122,-470902,300792694,-48138153,1.12268817273866,94.5066341937148,-0.13944537164151
454.49,455,65635,65668,4397545,3349068,2024-05-07,2024-06-21,516.57,33,-1048477,348355461,-84761006,0.961393856259942,78.2071373929172,-0.31306530652707
502.06,507,6667,6769,4473557,3343886,2024-05-07,2024-06-21,516.57,102,-1129671,348355461,-84761006,0.959906295253973,79.1670436881712,-0.33783179211253
402.37,405,12664,12664,3697888,3330632,2024-05-07,2024-12-20,516.57,0,-367256,537706253,-56832135,0.619414779243789,92.7284369891826,-0.110266159695817
505.57,515,3113,3480,3635984,3281640,2024-05-07,2024-07-19,516.57,367,-354344,117399288,-25407869,2.79528100715568,34.8507973915481,-0.107977718457844
498.74,505,5383,5220,4220272,3267720,2024-05-07,2024-07-19,516.57,-163,-952552.000000001,117399288,-25407869,2.78342403575735,37.6342214273054,-0.29150355599623
513.58,528,2215,2234,3987000,3221428,2024-05-07,2024-06-21,516.57,19,-765572,348355461,-84761006,0.924753121639738,80.0917968098109,-0.237649886944548
319.02,320,32696,32712,3465776,3205776,2024-05-07,2024-12-20,516.57,16,-260000,537706253,-56832135,0.596194666160968,93.3246316553436,-0.0811036079875824
506.91,514,3986,4519,3738868,3203971,2024-05-07,2024-06-21,516.57,533,-534897,348355461,-84761006,0.919741861029703,81.0115386708406,-0.166948140292156
511.96,526,2271,2271,5922768,3188484,2024-05-07,2024-06-28,516.57,0,-2734284,83365113,-15781476,3.82472221923336,46.4914705987384,-0.857549857549858
382.9,385,15180,15170,4053060,3185700,2024-05-07,2024-12-20,516.57,-10,-867360,537706253,-56832135,0.592461029089055,93.9170926844327,-0.272266691778887
467.29,470,11681,11691,3843049,3168261,2024-05-07,2024-08-16,516.57,10,-674788,103324269,-17142661,3.0663280085727,66.6807427401204,-0.212983715672415
407.09,410,10795,10792,3465195,3140472,2024-05-07,2024-12-20,516.57,-3,-324723,537706253,-56832135,0.584049745093814,94.5011424295265,-0.103399425309316
482.12,485,9452,10900,3497240,3139200,2024-05-07,2024-07-19,516.57,1448,-358040,117399288,-25407869,2.67395148086418,40.3081729081696,-0.114054536187564
508.9,525,1922,1926,3555700,3100860,2024-05-07,2024-08-16,516.57,4,-454840,103324269,-17142661,3.00109551222666,69.6818382523471,-0.146681888250356
468.25,470,17481,17471,3845820,3057425,2024-05-07,2024-07-19,516.57,-10,-788395.000000001,117399288,-25407869,2.60429603286862,42.9124689410382,-0.257862416903113
482.6,495,2347,2417,3220084,2997080,2024-05-07,2024-12-20,516.57,70,-223004,537706253,-56832135,0.557382396667052,95.0585248261935,-0.0744070895671787
502.97,511,3660,3679,3612420,2954237,2024-05-07,2024-07-19,516.57,19,-658183,117399288,-25407869,2.51640112161498,45.4288700626532,-0.222792890346983
477.57,480,11513,11862,3557517,2882466,2024-05-07,2024-07-19,516.57,349,-675051,117399288,-25407869,2.45526702001804,47.8841370826712,-0.234192181278114
449.56,450,64477,65005,3739666,2860220,2024-05-07,2024-06-21,516.57,528,-879446,348355461,-84761006,0.821063631897535,81.8326023027381,-0.307474949479411
448.32,450,16901,16965,3363299,2850120,2024-05-07,2024-08-16,516.57,64,-513179,103324269,-17142661,2.75842261221321,72.4402608645603,-0.180055225744881
508.6,532,1202,1202,2812680,2812680,2024-05-07,2024-07-19,516.57,0,0,117399288,-25407869,2.39582372935686,50.2799608120281,0
491.91,495,8888,9098,3644080,2811282,2024-05-07,2024-06-28,516.57,210,-832798,83365113,-15781476,3.37225237132468,49.863722970063,-0.296234244732474
475.86,477,24572,24543,3833232,2797902,2024-05-07,2024-06-21,516.57,-29,-1035330,348355461,-84761006,0.803174433369942,82.6357767361081,-0.370037978456715
506.48,508,18729,18153,5431410,2759256,2024-05-07,2024-05-17,516.57,-576,-2672154,97672171,-63323414,2.82501757844617,49.6999969418106,-0.968432794927328
506.24,513,4031,4070,3644024,2751320,2024-05-07,2024-06-21,516.57,39,-892704,348355461,-84761006,0.789802459850055,83.4255791959581,-0.324463893694663
348.64,350,20179,20192,3006671,2746112,2024-05-07,2024-12-20,516.57,13,-260559,537706253,-56832135,0.51070858571548,95.569233411909,-0.094882874405705
476.8,478,22549,22606,3810781,2712720,2024-05-07,2024-06-21,516.57,57,-1098061,348355461,-84761006,0.7787218240279,84.204301019986,-0.404782284939102
513,535,1189,1202,3175819,2644400,2024-05-07,2024-08-16,516.57,13,-531419,103324269,-17142661,2.55932127620472,74.999582140765,-0.200960142187264
495.49,501,4778,4781,3225150,2634331,2024-05-07,2024-07-19,516.57,3,-590819,117399288,-25407869,2.24390713510971,52.5238679471378,-0.224276675937838
429.71,430,90654,90627,3172890,2628183,2024-05-07,2024-06-21,516.57,-27,-544707,348355461,-84761006,0.754454370388068,84.9587553903741,-0.207256115727101
480.83,485,6247,6251,3167229,2606667,2024-05-07,2024-08-16,516.57,4,-560562,103324269,-17142661,2.52280226632912,77.5223844070941,-0.215049333113896
392.63,395,10835,10812,2806265,2562444,2024-05-07,2024-12-20,516.57,-23,-243821,537706253,-56832135,0.476550902226536,96.0457843141356,-0.0951517379501757
509.28,529,1297,1297,2557684,2557684,2024-05-07,2024-06-28,516.57,0,0,83365113,-15781476,3.06805078042658,52.9317737504896,0
433,435,12410,12408,2829480,2481600,2024-05-07,2024-09-20,516.57,-2,-347880,300792694,-48138153,0.825020038551867,95.3316542322667,-0.140183752417795
502.82,508,4456,4615,3141480,2390570,2024-05-07,2024-06-21,516.57,159,-750910.000000001,348355461,-84761006,0.686244445009576,85.6449998353837,-0.314113370451399
513.19,518,4799,4914,3896788,2363634,2024-05-07,2024-05-17,516.57,115,-1533154,97672171,-63323414,2.41996668631436,52.119963628125,-0.648642725565803
508.1,516,2755,2953,2873465,2332870,2024-05-07,2024-06-21,516.57,198,-540595,348355461,-84761006,0.669680903897183,86.3146807392809,-0.231729586303566
511.33,522,2190,2183,3052860,2329261,2024-05-07,2024-06-21,516.57,-7,-723599,348355461,-84761006,0.668644893154122,86.983325632435,-0.310656040692735
510.87,514,6206,7378,3301592,2309314,2024-05-07,2024-05-17,516.57,1172,-992278,97672171,-63323414,2.36435207322258,54.4843157013475,-0.429685179235046
471.87,475,7482,7304,2895534,2286152,2024-05-07,2024-08-16,516.57,-178,-609382,103324269,-17142661,2.21259924906897,79.7349836561631,-0.266553579989432
439.65,440,65236,65281,2870384,2284835,2024-05-07,2024-06-21,516.57,45,-585549,348355461,-84761006,0.655891827686892,87.6392174601219,-0.256276273779069
508.21,521,1778,1780,2782570,2276620,2024-05-07,2024-07-19,516.57,2,-505950.000000001,117399288,-25407869,1.93921107937213,54.4630790265099,-0.222237351863728
508.75,517,2626,2736,2851836,2257200,2024-05-07,2024-06-21,516.57,110,-594636,348355461,-84761006,0.6479588388023,88.2871762989242,-0.263439659755449
453.12,455,11987,11965,2733036,2249420,2024-05-07,2024-08-16,516.57,-22,-483616,103324269,-17142661,2.17704903385283,81.9120326900159,-0.214995865600911
505.78,509,6705,6966,3298860,2243052,2024-05-07,2024-05-31,516.57,261,-1055808,66348411,-19082513,3.38071698506841,48.9640497946515,-0.470701526313255
495.77,499,6623,6872,2953858,2219656,2024-05-07,2024-06-21,516.57,249,-734202,348355461,-84761006,0.637181341618181,88.9243576405423,-0.330772876517803
498.47,503,5192,4893,3167120,2216529,2024-05-07,2024-06-28,516.57,-299,-950591,83365113,-15781476,2.6588208427187,55.5905945932083,-0.428864679866584
419.04,420,23074,23072,2515066,2214912,2024-05-07,2024-08-16,516.57,-2,-300154.000000001,103324269,-17142661,2.14365126551246,84.0556839555284,-0.135515090441517
479.63,481,15535,15573,2889510,2133501,2024-05-07,2024-06-21,516.57,38,-756009,348355461,-84761006,0.612449419875752,89.5368070604181,-0.354351368947097
493.18,496,7479,7531,2842020,2123742,2024-05-07,2024-06-21,516.57,52,-718278,348355461,-84761006,0.609647971041855,90.14645503146,-0.338213398802679
373.15,375,11291,11291,2224327,2088835,2024-05-07,2024-12-20,516.57,0,-135492,537706253,-56832135,0.388471398341726,96.4342557124773,-0.0648648648648647
368.27,370,12011,12012,2258068,2078076,2024-05-07,2024-12-20,516.57,1,-179992,537706253,-56832135,0.386470491724038,96.8207262042013,-0.0866147340135781
514.55,540,1,811,2895,2063995,2024-05-07,2024-06-07,516.57,810,2061100,14143969,2013047,14.5927568138759,14.5927568138759,0.998597380323111
502.17,503,23481,24656,4015251,2046448,2024-05-07,2024-05-17,516.57,1175,-1968803,97672171,-63323414,2.09522116591429,56.5795368672618,-0.962058649914388
488.81,491,9456,9317,2827344,2040423,2024-05-07,2024-06-21,516.57,-139,-786921,348355461,-84761006,0.585730160262939,90.7321851917229,-0.385665619334814
509.24,514,3312,4284,2278656,2039184,2024-05-07,2024-05-31,516.57,972,-239472,66348411,-19082513,3.07344813427408,52.0374979289255,-0.117435209377869
462.59,465,8973,8421,2638062,2029461,2024-05-07,2024-08-16,516.57,-552,-608601,103324269,-17142661,1.96416681157454,86.0198507671029,-0.299883072401983
490.77,495,4698,4778,2508732,2021094,2024-05-07,2024-07-19,516.57,80,-487638,117399288,-25407869,1.72155558558413,56.1846346120941,-0.241274280167078
503.64,509,3770,3728,2729480,1998208,2024-05-07,2024-06-21,516.57,-42,-731272,348355461,-84761006,0.573611791319098,91.305796983042,-0.365963903657677
472.93,475,9287,9547,2461055,1976229,2024-05-07,2024-07-19,516.57,260,-484826,117399288,-25407869,1.68333985126043,57.8679744633545,-0.245328856119407
512.67,517,4475,4564,3329400,1976212,2024-05-07,2024-05-17,516.57,89,-1353188,97672171,-63323414,2.02331122546667,58.6028480927285,-0.68473827706744
470.99,473,9817,9817,3485035,1973217,2024-05-07,2024-07-19,516.57,0,-1511818,117399288,-25407869,1.68077424796648,59.548748711321,-0.766169154228856
510.23,513,6628,7114,3194696,1970578,2024-05-07,2024-05-17,516.57,486,-1224118,97672171,-63323414,2.01754294987464,60.6203910426031,-0.621197435473247
509.57,522,1668,1580,3542832,1963940,2024-05-07,2024-07-19,516.57,-88,-1578892,117399288,-25407869,1.67287215574936,61.2216208670703,-0.803941057262442
479.27,482,7105,7137,2472540,1948401,2024-05-07,2024-07-19,516.57,32,-524139,117399288,-25407869,1.65963612999084,62.8812569970612,-0.269009818820664
487.35,491,5307,5312,2515518,1938880,2024-05-07,2024-07-19,516.57,5,-576638,117399288,-25407869,1.65152620005668,64.5327831971179,-0.29740778181218
506.76,517,1845,1877,2387430,1922048,2024-05-07,2024-07-19,516.57,32,-465382,117399288,-25407869,1.63718880475664,66.1699720018745,-0.24212818826585
509.54,512,7130,7713,3108680,1897398,2024-05-07,2024-05-17,516.57,583,-1211282,97672171,-63323414,1.9426188448294,62.5630098874325,-0.638391101919576
464.28,465,25613,25566,2407622,1840752,2024-05-07,2024-06-21,516.57,-47,-566870,348355461,-84761006,0.528411983184039,91.834208966226,-0.307955661599172
506.92,515,1711,2275,1753775,1838200,2024-05-07,2024-06-28,516.57,564,84425,83365113,-15781476,2.20499911035927,57.7955937035676,0.0459280818191709
506.17,516,1739,1844,2154621,1812652,2024-05-07,2024-07-19,516.57,105,-341969.000000001,117399288,-25407869,1.5440059568334,67.7139779587079,-0.188656730580387
504.8,506,11310,15053,2657850,1806360,2024-05-07,2024-05-17,516.57,3743,-851490,97672171,-63323414,1.84941112858032,64.4124210160129,-0.47138444163954
512.32,535,789,794,2075070,1800792,2024-05-07,2024-09-20,516.57,5,-274278,300792694,-48138153,0.598682094319751,95.9303363265864,-0.152309650420482
434.68,435,55558,55559,2166762,1777888,2024-05-07,2024-06-21,516.57,1,-388874,348355461,-84761006,0.510366048201552,92.3445750144276,-0.218728063860041
507.1,510,9188,6104,4198916,1770160,2024-05-07,2024-05-24,516.57,-3084,-2428756,17630372,-8762837,10.0404007357304,10.0404007357304,-1.3720545035477
489.78,490,77601,79556,3336843,1750232,2024-05-07,2024-05-17,516.57,1955,-1586611,97672171,-63323414,1.79194542527369,66.2043664412865,-0.906514679196815
513.26,515,5894,10057,2534420,1749918,2024-05-07,2024-05-10,516.57,4163,-784502,11379310,-7506291,15.3780677387293,15.3780677387293,-0.448307863568464
476.5,479,6913,6937,2108465,1734250,2024-05-07,2024-07-19,516.57,24,-374215,117399288,-25407869,1.47722360973774,69.1912015684456,-0.215779155254433
511.02,530,897,896,1946490,1700608,2024-05-07,2024-08-16,516.57,-1,-245882,103324269,-17142661,1.64589405418392,87.6657448212869,-0.144584760273972
497.63,504,2990,2668,2338180,1699516,2024-05-07,2024-07-19,516.57,-322,-638664,117399288,-25407869,1.44763739964079,70.6388389680864,-0.37579169598874
328.93,330,15800,15809,1864400,1691563,2024-05-07,2024-12-20,516.57,9,-172837,537706253,-56832135,0.314588679332319,97.1353148835336,-0.102175916593115
358.46,360,10968,10964,1798752,1688456,2024-05-07,2024-12-20,516.57,-4,-110296,537706253,-56832135,0.314010854547381,97.449325738081,-0.0653235855716701
500.07,505,3242,3321,2107300,1637253,2024-05-07,2024-06-28,516.57,79,-470047,83365113,-15781476,1.96395463411655,59.7595483376841,-0.28709490836175
389.85,390,108769,108845,2066611,1632675,2024-05-07,2024-06-21,516.57,76,-433936,348355461,-84761006,0.468680753651225,92.8132557680788,-0.265782228551304
515.26,525,158,1672,210298,1628528,2024-05-07,2024-05-17,516.57,1514,1418230,97672171,-63323414,1.66734084368822,67.8717072849748,0.870866205554955
423.32,425,9541,9548,1831872,1604064,2024-05-07,2024-09-20,516.57,7,-227808,300792694,-48138153,0.533278910025654,96.4636152366121,-0.142019271051529
512.14,516,3571,4058,2431851,1566388,2024-05-07,2024-05-17,516.57,487,-865463,97672171,-63323414,1.60371985588403,69.4754271408588,-0.552521469776326
483.05,485,8081,7952,2198032,1550640,2024-05-07,2024-06-28,516.57,-129,-647392.000000001,83365113,-15781476,1.86005865547138,61.6196069931555,-0.417499871020998
507.49,518,1392,1463,1862496,1537613,2024-05-07,2024-07-19,516.57,71,-324883,117399288,-25407869,1.30972940823968,71.9485683763261,-0.211290487268253
503.07,504,16370,16506,3093930,1535058,2024-05-07,2024-05-17,516.57,136,-1558872,97672171,-63323414,1.57164316538024,71.047070306239,-1.01551342033982
484.19,489,871,3133,555698,1506973,2024-05-07,2024-08-16,516.57,2262,951275,103324269,-17142661,1.45848890544776,89.1242337267346,0.631248867763391
509.01,523,1066,1066,1700270,1491334,2024-05-07,2024-07-19,516.57,0,-208936,117399288,-25407869,1.27030923730986,73.218877613636,-0.140100071479628
499.8,504,2842,3500,1636992,1470000,2024-05-07,2024-06-21,516.57,658,-166992,348355461,-84761006,0.421982763175342,93.2352385312541,-0.1136
512.21,519,2024,2158,1983520,1465282,2024-05-07,2024-05-31,516.57,134,-518238,66348411,-19082513,2.20846585157857,54.2459637805041,-0.353677995089
473.65,475,10724,10757,1865976,1452195,2024-05-07,2024-06-28,516.57,33,-413781,83365113,-15781476,1.74196968940713,63.3615766825627,-0.284934874448679
498.85,500,11782,12412,2309272,1427380,2024-05-07,2024-05-24,516.57,630,-881892,17630372,-8762837,8.09614227084942,18.1365430065798,-0.617839678291695
359.92,360,0,175035,0,1400280,2024-05-07,2024-06-14,516.57,175035,1400280,17277101,14428074,8.1048319391083,72.0246527470089,1
491.73,492,52781,51312,2955736,1385424,2024-05-07,2024-05-17,516.57,-1469,-1570312,97672171,-63323414,1.41844292577463,72.4655132320137,-1.13345228608715
493.94,499,2432,2692,1551616,1362152,2024-05-07,2024-07-19,516.57,260,-189464,117399288,-25407869,1.16027279484012,74.3791504084761,-0.139091672588669
512.59,514,2272,9642,863360,1359522,2024-05-07,2024-05-10,516.57,7370,496162,11379310,-7506291,11.9473149074944,27.3253826462237,0.364953270340605
453.86,455,9990,11858,1428570,1351812,2024-05-07,2024-07-19,516.57,1868,-76758,117399288,-25407869,1.1514652456836,75.5306156541597,-0.0567815643003613
353.54,355,9245,9244,1460710,1349624,2024-05-07,2024-12-20,516.57,-1,-111086,537706253,-56832135,0.250996523189028,97.7003222612701,-0.0823088504650184
494.65,495,37952,38380,2694592,1343300,2024-05-07,2024-05-17,516.57,428,-1351292,97672171,-63323414,1.37531498096833,73.840828212982,-1.00594952728356
510.93,518,1888,1892,1784160,1337644,2024-05-07,2024-05-31,516.57,4,-446516,66348411,-19082513,2.0160904833124,56.2620542638165,-0.333807799384589
504.36,511,1169,2000,991312,1328000,2024-05-07,2024-06-28,516.57,831,336688,83365113,-15781476,1.59299250275112,64.9545691853138,0.253530120481928
374.17,375,15819,15867,1392072,1316961,2024-05-07,2024-09-20,516.57,48,-75111.0000000002,300792694,-48138153,0.437830115647689,96.9014453522598,-0.0570335795820835
511.33,521,1346,1349,1531748,1304483,2024-05-07,2024-05-31,516.57,3,-227265,66348411,-19082513,1.96611038657731,58.2281646503938,-0.1742184451618
449.86,450,91787,91772,1652166,1284808,2024-05-07,2024-05-31,516.57,-15,-367358,66348411,-19082513,1.93645632297057,60.1646209733644,-0.285924433845368
503.5,512,1339,1504,1380509,1278400,2024-05-07,2024-07-19,516.57,165,-102109,117399288,-25407869,1.08893335026018,76.6195490044199,-0.0798724968710889
495.7,497,9732,9824,2092380,1277120,2024-05-07,2024-05-31,516.57,92,-815260,66348411,-19082513,1.92486900703621,62.0894899804006,-0.638358180907041
329.56,330,12023,28983,565081,1275252,2024-05-07,2024-09-20,516.57,16960,710171,300792694,-48138153,0.423963754917531,97.3254091071773,0.556886795707829
338.74,340,10042,10042,1315502,1265292,2024-05-07,2024-12-20,516.57,0,-50210,537706253,-56832135,0.235312867005101,97.9356351282751,-0.0396825396825397
510.45,516,2017,2269,1613600,1259295,2024-05-07,2024-05-31,516.57,252,-354305,66348411,-19082513,1.89800325436581,63.9874932347664,-0.281351867513172
499.5,506,1496,1930,1241680,1254500,2024-05-07,2024-07-19,516.57,434,12820,117399288,-25407869,1.06857547551736,77.6881244799372,0.0102192108409725
490.36,497,1865,1866,1395020,1239024,2024-05-07,2024-08-16,516.57,1,-155996,103324269,-17142661,1.19916067347159,90.3233944002062,-0.125902323118842
459.23,460,15952,15951,1595200,1228227,2024-05-07,2024-06-28,516.57,-1,-366973,83365113,-15781476,1.47331054418411,66.4278797294979,-0.298782716875626
487.52,490,4738,4936,1563540,1224128,2024-05-07,2024-06-28,516.57,198,-339412,83365113,-15781476,1.46839361928292,67.8962733487808,-0.277268390233701
500.5,508,1442,1577,1267518,1182750,2024-05-07,2024-07-19,516.57,135,-84767.9999999998,117399288,-25407869,1.0074592615928,78.69558374153,-0.0716702599873175
510.3,525,811,800,1389243,1176000,2024-05-07,2024-07-19,516.57,-11,-213243,117399288,-25407869,1.00170965261731,79.6972933941473,-0.181329081632653
449.43,450,20538,20512,1499274,1169184,2024-05-07,2024-06-28,516.57,-26,-330090,83365113,-15781476,1.40248595356669,69.2987593023475,-0.282325108793826
510.11,530,587,587,1167543,1167543,2024-05-07,2024-06-28,516.57,0,0,83365113,-15781476,1.40051750424665,70.6992768065942,0
512.06,522,1155,1158,1345575,1151052,2024-05-07,2024-05-31,516.57,3,-194523,66348411,-19082513,1.73485993507817,65.7223531698446,-0.168995840326936
489.7,492,4616,4961,1440192,1141030,2024-05-07,2024-06-21,516.57,345,-299162,348355461,-84761006,0.327547613786368,93.5627861450405,-0.262185919739183
513.63,519,2133,2088,1874907,1121256,2024-05-07,2024-05-17,516.57,-45,-753651,97672171,-63323414,1.14797898779172,74.9888072007737,-0.672148911577731
509.41,510,12351,18997,2396094,1120823,2024-05-07,2024-05-10,516.57,6646,-1275271,11379310,-7506291,9.84965696514112,37.1750396113648,-1.13779874253116
494.26,495,15078,14980,1945062,1108520,2024-05-07,2024-05-24,516.57,-98,-836542,17630372,-8762837,6.28755876506746,24.4241017716472,-0.754647638292498
478.39,480,6580,6834,1394960,1100274,2024-05-07,2024-06-28,516.57,254,-294686,83365113,-15781476,1.31982547663553,72.0191022832297,-0.267829649705437
404.93,405,156047,156253,1248376,1093771,2024-05-07,2024-05-31,516.57,206,-154605,66348411,-19082513,1.64852629251362,67.3708794623582,-0.141350428928907
496.44,502,2093,1960,1557192,1089760,2024-05-07,2024-07-19,516.57,-133,-467432,117399288,-25407869,0.928250944758711,80.625544338906,-0.428931140801645
515.91,527,948,972,1474140,1077948,2024-05-07,2024-05-17,516.57,24,-396192,97672171,-63323414,1.10363882461464,76.0924460253883,-0.367542775718309
299.21,300,15108,13607,1269072,1074953,2024-05-07,2024-12-20,516.57,-1501,-194119,537706253,-56832135,0.199914543303628,98.1355496715788,-0.180583709241241
489.21,490,13595,13563,1644995,1071477,2024-05-07,2024-05-31,516.57,-32,-573518,66348411,-19082513,1.61492488493809,68.9858043472963,-0.535259272947529
488.86,490,8760,9389,1497960,1070346,2024-05-07,2024-06-07,516.57,629,-427614,14143969,2013047,7.56750810186306,22.160264915739,-0.399510064969645
363.05,365,5371,5371,1047345,1047345,2024-05-07,2024-12-20,516.57,0,0,537706253,-56832135,0.19478014141673,98.3303298129955,0
419.78,420,46922,47442,1407660,1043724,2024-05-07,2024-06-21,516.57,520,-363936,348355461,-84761006,0.299614651368993,93.8624007964095,-0.348689883532428
389.01,390,10487,10478,1143083,1037322,2024-05-07,2024-09-20,516.57,-9,-105761,300792694,-48138153,0.344862764519141,97.6702718716965,-0.101955805429751
490.78,494,3207,3220,1253937,1036840,2024-05-07,2024-06-28,516.57,13,-217097,83365113,-15781476,1.24373369469313,73.2628359779228,-0.209383318544809
479.87,480,80324,79543,1686804,1034059,2024-05-07,2024-05-17,516.57,-781,-652745,97672171,-63323414,1.05870381441608,77.1511498398044,-0.631245412495805
486.12,488,5400,5449,1398600,1024412,2024-05-07,2024-06-21,516.57,49,-374188,348355461,-84761006,0.294070888700665,94.1564716851102,-0.365271004244386
512.24,530,570,573,1165650,1017648,2024-05-07,2024-07-19,516.57,3,-148002,117399288,-25407869,0.866826381434273,81.4923707203403,-0.145435356822791
500.97,503,4256,5000,1344896,1015000,2024-05-07,2024-05-31,516.57,744,-329896,66348411,-19082513,1.52980302723452,70.5156073745308,-0.325020689655173
419.97,420,332028,331415,1992168,994245,2024-05-07,2024-05-17,516.57,-613,-997923,97672171,-63323414,1.0179409240325,78.1690907638369,-1.00369928941056
449.95,450,198597,198626,1588776,993130,2024-05-07,2024-05-17,516.57,29,-595646,97672171,-63323414,1.01679935014447,79.1858901139814,-0.599766395134574
510.83,526,660,646,1192620,979982,2024-05-07,2024-07-19,516.57,-14,-212638,117399288,-25407869,0.83474271155716,82.3271134318975,-0.216981536395566
487.77,488,42778,42464,1497230,976672,2024-05-07,2024-05-17,516.57,-314,-520558,97672171,-63323414,0.999949105257423,80.1858392192388,-0.532991628714655
507.58,512.5,1781,1983,1239576,975636,2024-05-07,2024-06-07,516.57,202,-263940,14143969,2013047,6.89789407768074,29.0581589934197,-0.270531222710109
488.08,492,2465,2488,1210315,975296,2024-05-07,2024-07-19,516.57,23,-235019,117399288,-25407869,0.830751205237292,83.1578646371348,-0.240971971586062
488.79,489,45992,46341,1839680,973161,2024-05-07,2024-05-17,516.57,349,-866519,97672171,-63323414,0.996354427301508,81.1821936465403,-0.890416899156461
354.91,355,7704,107711,92448,969399,2024-05-07,2024-06-21,516.57,100007,876951,348355461,-84761006,0.278278686149261,94.4347503712594,0.904633695722814
511.84,513,2447,8263,797722,958508,2024-05-07,2024-05-10,516.57,5816,160786,11379310,-7506291,8.42325237646219,45.598291987827,0.167746122098094
449,450,7289,9528,896547,952800,2024-05-07,2024-07-19,516.57,2239,56253.0000000001,117399288,-25407869,0.811589249161375,83.9694538862961,0.0590396725440807
483.72,487,2744,2860,1075648,938080,2024-05-07,2024-07-19,516.57,116,-137568,117399288,-25407869,0.799050842625212,84.7685047289214,-0.146648473477742
506.39,514,429,1226,433290,932986,2024-05-07,2024-06-28,516.57,797,499696,83365113,-15781476,1.11915640299078,74.3819923809136,0.535587886634955
501.27,502,8740,12739,1328480,929947,2024-05-07,2024-05-17,516.57,3999,-398533,97672171,-63323414,0.952110504434267,82.1343041509746,-0.428554530527009
481.5,483,6454,6178,1316616,926700,2024-05-07,2024-06-21,516.57,-276,-389916,348355461,-84761006,0.266021378662986,94.7007717499224,-0.420757526707672
429.96,430,230834,230818,1615838,923272,2024-05-07,2024-05-17,516.57,-16,-692566,97672171,-63323414,0.945276418602388,83.079580569577,-0.750121307696974
485.21,487,4880,5149,1190720,921671,2024-05-07,2024-06-21,516.57,269,-269049,348355461,-84761006,0.264577738311959,94.9653494882344,-0.291914359896319
500.11,502,4104,4692,1202472,886788,2024-05-07,2024-05-31,516.57,588,-315684,66348411,-19082513,1.33656252898054,71.8521699035113,-0.355985872609914
343.61,345,6349,6349,882511,882511,2024-05-07,2024-12-20,516.57,0,0,537706253,-56832135,0.164125113865842,98.4944549268613,0
472.03,473,8935,9062,1197290,879014,2024-05-07,2024-06-21,516.57,127,-318276,348355461,-84761006,0.252332487476061,95.2176819757104,-0.362082970237107
507.24,511,2309,2335,1290731,877960,2024-05-07,2024-05-31,516.57,26,-412771,66348411,-19082513,1.32325701063135,73.1754269141427,-0.47014784272632
484.44,485,18739,15473,1611554,866488,2024-05-07,2024-05-31,516.57,-3266,-745066,66348411,-19082513,1.30596646843585,74.4813933825785,-0.859868803722613
323.96,325,8312,8312,906008,864448,2024-05-07,2024-12-20,516.57,0,-41560,537706253,-56832135,0.16076584476692,98.6552207716283,-0.0480769230769231
511.03,517,1412,1442,1187492,860874,2024-05-07,2024-05-31,516.57,30,-326618,66348411,-19082513,1.29750507514038,75.7788984577189,-0.379402792975511
505.01,512,1164,1215,1041780,849285,2024-05-07,2024-06-28,516.57,51,-192495,83365113,-15781476,1.01875349224321,75.4007458731568,-0.226655363040675
515.01,530,27,557,50112,834943,2024-05-07,2024-05-17,516.57,530,784831,97672171,-63323414,0.85484226617631,83.9344228357533,0.93998153167342
333.84,335,7083,7080,977454,821280,2024-05-07,2024-12-20,516.57,-3,-156174,537706253,-56832135,0.152737669576627,98.8079584412049,-0.190159263588545
511.07,512,3721,8825,1004670,820725,2024-05-07,2024-05-10,516.57,5104,-183945,11379310,-7506291,7.21243203674036,52.8107240245674,-0.224125011422828
489.51,490,16610,16600,1428460,813400,2024-05-07,2024-05-24,516.57,-10,-615060,17630372,-8762837,4.61362925297322,29.0377310246205,-0.756159331202361
511.3,523,687,687,1035996,803790,2024-05-07,2024-06-28,516.57,0,-232206,83365113,-15781476,0.964180304055967,76.3649261772128,-0.288888888888889
514.61,525,752,769,1036256,798991,2024-05-07,2024-05-31,516.57,17,-237265,66348411,-19082513,1.2042353207223,76.9831337784412,-0.296955785484442
384.08,385,8670,8670,875670,797640,2024-05-07,2024-09-20,516.57,0,-78030.0000000001,300792694,-48138153,0.2651793131651,97.9354511848616,-0.0978260869565219
509.74,521,659,705,982569,793830,2024-05-07,2024-06-28,516.57,46,-188739,83365113,-15781476,0.952232860285333,77.3171590374981,-0.237757454366804
458.72,460,6198,6195,997878,792960,2024-05-07,2024-07-19,516.57,-3,-204918,117399288,-25407869,0.67543850862196,85.4439432375433,-0.258421610169492
505.66,507,4653,5907,1233045,791538,2024-05-07,2024-05-17,516.57,1254,-441507,97672171,-63323414,0.810402791190133,84.7448256269434,-0.557783707162511
444.87,445,60770,60761,1033090,789893,2024-05-07,2024-05-31,516.57,-9,-243197,66348411,-19082513,1.19052285969592,78.1736566381371,-0.30788600481331
484.77,488,2408,2441,1001728,788443,2024-05-07,2024-07-19,516.57,33,-213285,117399288,-25407869,0.67159095547496,86.1155341930183,-0.270514165259886
474.68,475,14710,24558,706080,785856,2024-05-07,2024-05-31,516.57,9848,79776,66348411,-19082513,1.1844383130743,79.3580949512114,0.101514781333985
443.53,445,5094,5266,901638,774102,2024-05-07,2024-08-16,516.57,172,-127536,103324269,-17142661,0.749196686791948,91.0725910869982,-0.164753482099258
399.93,400,108723,108746,761061,761222,2024-05-07,2024-05-31,516.57,23,161.000000000116,66348411,-19082513,1.14731006896307,80.5054050201745,0.000211502032258811
496.61,498,5113,5432,1104408,755048,2024-05-07,2024-05-31,516.57,319,-349360,66348411,-19082513,1.1380046464112,81.6434096665857,-0.4626990601922
508.58,513,1128,1708,744480,754936,2024-05-07,2024-05-31,516.57,580,10456.0000000001,66348411,-19082513,1.13783584055992,82.7812455071456,0.0138501806775675
484.84,485,42685,46862,1195180,749792,2024-05-07,2024-05-17,516.57,4177,-445388,97672171,-63323414,0.767661855289364,85.5124874822328,-0.594015406939525
497.22,503,1470,1294,1065750,747932,2024-05-07,2024-07-19,516.57,-176,-317818,117399288,-25407869,0.637083931888923,86.7526181249072,-0.424929004241027
492.46,497,1495,1643,879060,745922,2024-05-07,2024-07-19,516.57,148,-133138,117399288,-25407869,0.635371826105112,87.3879899510123,-0.178487831167334
502.33,504,4450,4450,1232650,743150,2024-05-07,2024-05-24,516.57,0,-489500,17630372,-8762837,4.21516914107088,33.2529001656913,-0.658682634730539
481.08,483,3821,3834,955250,736128,2024-05-07,2024-06-28,516.57,13,-219122,83365113,-15781476,0.883016856223778,78.2001758937219,-0.297668340288646
413.58,415,5171,5176,827360,734992,2024-05-07,2024-09-20,516.57,5,-92368,300792694,-48138153,0.244351679632219,98.1798028644938,-0.125672116159087
500.55,515,78,507,128934,732615,2024-05-07,2024-10-18,516.57,429,603681,1530129,786938,47.8792964514757,47.8792964514757,0.824008517434123
501.72,504,2928,3208,995520,731424,2024-05-07,2024-05-31,516.57,280,-264096,66348411,-19082513,1.1023986693517,83.8836441764973,-0.361071006693792
479.59,480,17317,17781,1108288,729021,2024-05-07,2024-05-31,516.57,464,-379267,66348411,-19082513,1.09877687952467,84.982421056022,-0.520241529393529
507.94,512,1608,1777,959976,721462,2024-05-07,2024-05-31,516.57,169,-238514,66348411,-19082513,1.0873839917583,86.0698050477803,-0.330598146541329
504.31,513,661,829,723795,720401,2024-05-07,2024-07-19,516.57,168,-3394.00000000012,117399288,-25407869,0.613633193414256,88.0016231444266,-0.00471126497603434
464.04,465,7409,7401,903898,710496,2024-05-07,2024-06-28,516.57,-8,-193402,83365113,-15781476,0.852270181652606,79.0524460753745,-0.272207021573661
444.47,445,13223,13224,846272,700872,2024-05-07,2024-06-28,516.57,1,-145400,83365113,-15781476,0.840725784177849,79.8931718595523,-0.207455854992067
486.62,492,1295,1294,826210,696172,2024-05-07,2024-08-16,516.57,-1,-130038,103324269,-17142661,0.673773941725153,91.7463650287233,-0.186790046138023
510.35,524,508,508,777240,693420,2024-05-07,2024-06-28,516.57,0,-83820,83365113,-15781476,0.831786793115725,80.7249586526681,-0.120879120879121
486.81,487,36493,36421,1204269,691999,2024-05-07,2024-05-17,516.57,-72,-512270,97672171,-63323414,0.708491469898831,86.2209789521316,-0.740275636236469
492.22,499,858,1013,672672,686814,2024-05-07,2024-08-16,516.57,155,14142,103324269,-17142661,0.664717018225408,92.4110820469487,0.0205907276205785
424.75,425,27477,27470,879264,686750,2024-05-07,2024-06-21,516.57,-7,-192514,348355461,-84761006,0.197140586809977,95.4148225625204,-0.280326174008009
509.92,524,481,478,803270,673024,2024-05-07,2024-07-19,516.57,-3,-130246,117399288,-25407869,0.573277752757751,88.5749008971843,-0.193523559338151
485.82,486,37194,37194,1153014,669492,2024-05-07,2024-05-17,516.57,0,-483522,97672171,-63323414,0.685448058690126,86.9064270108217,-0.722222222222222
509.88,514,1200,1612,786000,664144,2024-05-07,2024-05-24,516.57,412,-121856,17630372,-8762837,3.76704473393982,37.0199448996312,-0.183478281818401
503.46,506,2200,2595,855800,659130,2024-05-07,2024-05-31,516.57,395,-196670,66348411,-19082513,0.993437506739988,87.0632425545203,-0.298378165157101
490.17,496,954,1118,692604,651794,2024-05-07,2024-08-16,516.57,164,-40810,103324269,-17142661,0.630823722546733,93.0419057694955,-0.0626118067978533
509.22,513,889,1724,522732,651672,2024-05-07,2024-05-24,516.57,835,128940,17630372,-8762837,3.69630317499824,40.7162480746294,0.197860273266306
511.73,517,170,1233,138720,649791,2024-05-07,2024-05-24,516.57,1063,511071,17630372,-8762837,3.68563408645036,44.4018821610798,0.786515972058708
501.44,509,817,854,767980,645624,2024-05-07,2024-07-19,516.57,37,-122356,117399288,-25407869,0.549938599286906,89.1248394964712,-0.18951587921143
506.52,511,1152,1439,726912,644672,2024-05-07,2024-06-07,516.57,287,-82240,14143969,2013047,4.55792854183999,33.6160875352597,-0.127568748138588
508.55,512,1379,1845,739144,636525,2024-05-07,2024-05-24,516.57,466,-102619,17630372,-8762837,3.61038893563902,48.0122710967188,-0.161217548407368
349.43,350,11052,11047,696276,629679,2024-05-07,2024-09-20,516.57,-5,-66597.0000000001,300792694,-48138153,0.209339858500686,98.3891427229945,-0.105763412786515
497.53,498,13199,13332,1306701,626604,2024-05-07,2024-05-17,516.57,133,-680097,97672171,-63323414,0.641537905408082,87.5479649162298,-1.08536970718348
493.69,494,20074,20038,1244588,621178,2024-05-07,2024-05-17,516.57,-36,-623410,97672171,-63323414,0.635982587097404,88.1839475033272,-1.00359317297135
483.84,484,38148,37916,991848,606656,2024-05-07,2024-05-17,516.57,-232,-385192,97672171,-63323414,0.621114483059868,88.8050619863871,-0.634943031965397
454.94,455,100728,100543,805824,603258,2024-05-07,2024-05-17,516.57,-185,-202566,97672171,-63323414,0.617635498242381,89.4226974846295,-0.335786678336632
448.56,449,13676,13709,765856,603196,2024-05-07,2024-06-21,516.57,33,-162660,348355461,-84761006,0.173155316201574,95.587977878722,-0.269663591933634
482.43,484,3783,3804,839826,597228,2024-05-07,2024-06-21,516.57,21,-242598,348355461,-84761006,0.171442123595703,95.7594200023177,-0.40620667483775
269.45,270,10678,10681,619324,587455,2024-05-07,2024-12-20,516.57,3,-31869,537706253,-56832135,0.109252030587786,98.9172104717927,-0.0542492616455729
505.62,508,1267,2459,497931,585242,2024-05-07,2024-05-24,516.57,1192,87310.9999999999,17630372,-8762837,3.31951021793528,51.3317813146541,0.149187857330813
496.58,497,10153,13739,913770,577038,2024-05-07,2024-05-17,516.57,3586,-336732,97672171,-63323414,0.590790594794908,90.0134880794244,-0.583552556330779
450.51,451,11768,11776,717848,577024,2024-05-07,2024-06-21,516.57,8,-140824,348355461,-84761006,0.165642300638427,95.9250623029561,-0.244052240461402
508.16,517,473,648,545369,572832,2024-05-07,2024-06-28,516.57,175,27463,83365113,-15781476,0.687136356427658,81.4120950090957,0.0479425032121111
459.93,460,82871,81824,828710,572768,2024-05-07,2024-05-17,516.57,-1047,-255942,97672171,-63323414,0.586418827528672,90.5999069069531,-0.446851081065981
492.38,493,2307,9228,256077,572136,2024-05-07,2024-05-24,516.57,6921,316059,17630372,-8762837,3.24517259193396,54.576953906588,0.55241935483871
507.22,512,935,1181,628320,564518,2024-05-07,2024-06-07,516.57,246,-63802,14143969,2013047,3.99122763914429,37.607315174404,-0.113020311132683
499.26,501,2772,3237,753984,563238,2024-05-07,2024-05-31,516.57,465,-190746,66348411,-19082513,0.848909554141395,87.9121521086617,-0.338659678501806
429.35,430,8629,8614,664433,559910,2024-05-07,2024-07-19,516.57,-15,-104523,117399288,-25407869,0.476927935031429,89.6017674315027,-0.18667821614188
493.26,498,1198,1178,745156,558372,2024-05-07,2024-07-19,516.57,-20,-186784,117399288,-25407869,0.475617875978941,90.0773853074816,-0.334515341027129
409.8,410,27653,27636,691325,552720,2024-05-07,2024-06-21,516.57,-17,-138605,348355461,-84761006,0.158665518953929,96.08372782191,-0.250768924591113
498.49,499,10934,10805,1213674,551055,2024-05-07,2024-05-17,516.57,-129,-662619,97672171,-63323414,0.564188339788209,91.1640952467413,-1.20245529030678
393.96,395,5276,5284,622568,549536,2024-05-07,2024-09-20,516.57,8,-73031.9999999999,300792694,-48138153,0.182695926783381,98.5718386497778,-0.132897571769638
495.62,496,14363,14413,1134677,547694,2024-05-07,2024-05-17,516.57,50,-586983,97672171,-63323414,0.560747236794808,91.7248424835361,-1.07173531205381
505.02,508,1782,1830,800118,545340,2024-05-07,2024-05-31,516.57,48,-254778,66348411,-19082513,0.821933776228643,88.7340858848903,-0.467191110133128
507.6,516,323,647,356269,543480,2024-05-07,2024-06-28,516.57,324,187211,83365113,-15781476,0.651927383580707,82.0640223926764,0.34446713770516
503.84,527,232,232,537312,537312,2024-05-07,2024-07-19,516.57,0,0,117399288,-25407869,0.457679095975437,90.535064403457,0
399.59,400,12781,12878,600707,527998,2024-05-07,2024-07-19,516.57,97,-72709,117399288,-25407869,0.449745487383194,90.9848098908402,-0.137706961011216
434.27,435,7314,7232,636318,527936,2024-05-07,2024-07-19,516.57,-82,-108382,117399288,-25407869,0.449692676160012,91.4345025670002,-0.205293823493757
499.32,504,1121,1116,691657,522288,2024-05-07,2024-06-28,516.57,-5,-169369,83365113,-15781476,0.626506677919335,82.6905290705957,-0.324282771191373
484.29,486,3221,3003,760156,513513,2024-05-07,2024-06-21,516.57,-218,-246643,348355461,-84761006,0.147410635827523,96.2311384577376,-0.480305269778954
490.09,493,613,1754,232940,510414,2024-05-07,2024-06-28,516.57,1141,277474,83365113,-15781476,0.612263309713261,83.302792380309,0.543625370777447
452.53,453,10691,10735,705606,504545,2024-05-07,2024-06-21,516.57,44,-201061,348355461,-84761006,0.14483625390905,96.3759747116466,-0.398499638287962
513.87,516,350,2367,178150,504171,2024-05-07,2024-05-10,516.57,2017,326021,11379310,-7506291,4.43059377062405,57.2413177951915,0.646647665177093
515.93,530,336,357,608496,502299,2024-05-07,2024-05-31,516.57,21,-106197,66348411,-19082513,0.757062591898395,89.4911484767887,-0.21142188218571
505.78,510,797,1180,472621,497960,2024-05-07,2024-06-07,516.57,383,25338.9999999999,14143969,2013047,3.52065251274236,41.1279676871464,0.0508856133022732
508.23,518,271,509,327639,497293,2024-05-07,2024-06-28,516.57,238,169654,83365113,-15781476,0.596524111950763,83.8993164922598,0.34115501324169
491.62,496,773,1134,429015,496692,2024-05-07,2024-07-19,516.57,361,67677.0000000001,117399288,-25407869,0.42307922685187,91.8575817938521,0.136255466164142
289.29,290,6971,6971,564651,494941,2024-05-07,2024-12-20,516.57,0,-69710,537706253,-56832135,0.0920467257426519,99.0092571975353,-0.140845070422535
249.58,250,11783,11783,542018,494886,2024-05-07,2024-12-20,516.57,0,-47132.0000000001,537706253,-56832135,0.0920364971095101,99.1012936946449,-0.0952380952380954
399.97,400,162354,162195,649416,486585,2024-05-07,2024-05-17,516.57,-159,-162831,97672171,-63323414,0.49818182089963,92.2230243044357,-0.334640401985265
500.57,502,3381,3390,797916,484770,2024-05-07,2024-05-24,516.57,9,-313146,17630372,-8762837,2.74963001347901,57.326583920067,-0.645968191100935
470.09,471,5233,5233,627960,476203,2024-05-07,2024-06-21,516.57,0,-151757,348355461,-84761006,0.136700311409787,96.5126750230564,-0.318681318681319
510.27,511,3986,6523,920766,476179,2024-05-07,2024-05-10,516.57,2537,-444587,11379310,-7506291,4.1846034601395,61.425921255331,-0.933655201090346
394.84,395,29735,29729,564965,475664,2024-05-07,2024-06-21,516.57,-6,-89300.9999999999,348355461,-84761006,0.136545584396623,96.649220607453,-0.187739664973595
510.03,522,388,389,557556,465633,2024-05-07,2024-06-28,516.57,1,-91923,83365113,-15781476,0.558546594904754,84.4578630871645,-0.197415131659483
502.26,508,763,805,564620,462070,2024-05-07,2024-06-28,516.57,42,-102550,83365113,-15781476,0.554272624808893,85.0121357119734,-0.22193607029238
465.24,466,6093,6077,603207,461852,2024-05-07,2024-06-21,516.57,-16,-141355,348355461,-84761006,0.1325806688014,96.7818012762544,-0.30606124905814
479.33,481,2753,2758,624931,460586,2024-05-07,2024-06-28,516.57,5,-164345,83365113,-15781476,0.552492503668771,85.5646282156422,-0.356817185064244
274.38,275,7365,7365,456630,456630,2024-05-07,2024-12-20,516.57,0,0,537706253,-56832135,0.0849218318463557,99.1862155264912,0
404.83,405,26682,26693,613686,453781,2024-05-07,2024-06-21,516.57,11,-159905,348355461,-84761006,0.130263782487394,96.9120650587418,-0.35238363880374
502.62,507,11,1035,6479,453330,2024-05-07,2024-06-14,516.57,1024,446851,17277101,14428074,2.62387769800038,74.6485304450093,0.985707983146935
444.95,445,90476,90465,723808,452325,2024-05-07,2024-05-17,516.57,-11,-271483,97672171,-63323414,0.463105299461399,92.6861296038971,-0.6001945503786
504.24,507,1430,1630,624910,449880,2024-05-07,2024-05-31,516.57,200,-175030,66348411,-19082513,0.678056931913562,90.1692054087023,-0.389059304703477
468.2,471,1596,1603,555408,448840,2024-05-07,2024-08-16,516.57,7,-106568,103324269,-17142661,0.434399395557301,93.4763051650527,-0.237429819089208
504.8,507,2082,2027,797406,445940,2024-05-07,2024-05-24,516.57,-55,-351466,17630372,-8762837,2.52938508614566,59.8559690062127,-0.788146387406377
492.04,493,4228,4634,634200,444864,2024-05-07,2024-05-31,516.57,406,-189336,66348411,-19082513,0.670496841288332,90.8397022499906,-0.425604229607251
510.9,529,244,245,520452,443450,2024-05-07,2024-07-19,516.57,1,-77001.9999999999,117399288,-25407869,0.377728014841112,92.2353098086932,-0.173643026271282
502.04,505,1098,1489,477630,440744,2024-05-07,2024-06-07,516.57,391,-36886,14143969,2013047,3.11612673924837,44.2440944263947,-0.0836903054834553
414.79,415,20734,20727,539084,435267,2024-05-07,2024-06-21,516.57,-7,-103817,348355461,-84761006,0.124949096176219,97.0370141549181,-0.238513372251974
464.38,466,2675,2662,532325,431244,2024-05-07,2024-07-19,516.57,-13,-101081,117399288,-25407869,0.367331018225596,92.6026408269188,-0.234393985771396
509.26,519,321,442,646494,430508,2024-05-07,2024-06-28,516.57,121,-215986,83365113,-15781476,0.516412662932515,86.0810408785747,-0.501700316834995
487.29,488,6007,6057,684798,430047,2024-05-07,2024-05-31,516.57,50,-254751,66348411,-19082513,0.648164731480909,91.4878669814715,-0.592379437596356
509.15,515,159,735,128790,429975,2024-05-07,2024-06-07,516.57,576,301185,14143969,2013047,3.0399882805173,47.284082706912,0.700470957613815
497.84,500,1542,1983,487272,428328,2024-05-07,2024-06-07,516.57,441,-58944,14143969,2013047,3.02834374142081,50.3124264483329,-0.137614164845632
513.14,520,593,622,591221,426692,2024-05-07,2024-05-24,516.57,29,-164529,17630372,-8762837,2.42020985149945,62.2761788577121,-0.385591949228015
369.19,370,5256,5256,425736,425736,2024-05-07,2024-09-20,516.57,0,0,300792694,-48138153,0.141538012223129,98.713376662001,0
464.95,466,4051,4053,510426,425565,2024-05-07,2024-06-28,516.57,2,-84861,83365113,-15781476,0.510483324121446,86.5915242026962,-0.19940784603997
508.55,514,183,779,145119,424555,2024-05-07,2024-06-07,516.57,596,279436,14143969,2013047,3.00166806078266,53.3140945091155,0.65818562965929
502.64,509,636,667,492900,424212,2024-05-07,2024-06-28,516.57,31,-68688,83365113,-15781476,0.508860343055014,87.1003845457512,-0.16191904047976
504.35,508,925,1161,488400,423765,2024-05-07,2024-06-07,516.57,236,-64635.0000000001,14143969,2013047,2.99608264130104,56.3101771504166,-0.152525574315954
482.36,487,912,913,498864,423632,2024-05-07,2024-08-16,516.57,1,-75232,103324269,-17142661,0.410002416760384,93.8863075818131,-0.17758809532802
511.07,516,751,856,575266,422008,2024-05-07,2024-05-24,516.57,105,-153258,17630372,-8762837,2.39364206268592,64.6698209203981,-0.363163731493242
492.72,493,14769,15045,841833,421260,2024-05-07,2024-05-17,516.57,276,-420573,97672171,-63323414,0.43129992472472,93.1174295286218,-0.998369178179746
512.45,531,226,226,479346,419230,2024-05-07,2024-07-19,516.57,0,-60116,117399288,-25407869,0.35709756604316,92.959738392962,-0.143396226415094
507.62,508,8927,10997,1214072,417886,2024-05-07,2024-05-10,516.57,2070,-796186,11379310,-7506291,3.67233162643429,65.0982528817652,-1.90527081548556
468.91,470,3889,3823,548349,416707,2024-05-07,2024-06-28,516.57,-66,-131642,83365113,-15781476,0.499857776237885,87.6002423219891,-0.315910219890714
487.89,489,631,3736,106639,414696,2024-05-07,2024-06-07,516.57,3105,308057,14143969,2013047,2.93196343968231,59.2421405900989,0.742850184231341
344.92,345,50763,50563,507630,404504,2024-05-07,2024-06-21,516.57,-200,-103126,348355461,-84761006,0.116118173901686,97.1531323288197,-0.254944326879339
379.16,380,4781,4772,449414,400848,2024-05-07,2024-09-20,516.57,-9,-48565.9999999999,300792694,-48138153,0.133263875086009,98.846640537087,-0.121158144733166
474.91,476,3672,3633,558144,395997,2024-05-07,2024-06-21,516.57,-39,-162147,348355461,-84761006,0.113676128074249,97.266808456894,-0.409465223221388
497.16,500,1525,1389,594750,394476,2024-05-07,2024-06-14,516.57,-136,-200274,17277101,14428074,2.28323027109699,76.9317607161062,-0.507696285705594
515.3,523,504,512,598752,394240,2024-05-07,2024-05-17,516.57,8,-204512,97672171,-63323414,0.403635954810506,93.5210654834323,-0.51875
491.25,498,571,572,440812,386100,2024-05-07,2024-08-16,516.57,1,-54712,103324269,-17142661,0.373677940078144,94.2599855218913,-0.141704221704222
482.9,486,1243,1244,487256,385640,2024-05-07,2024-07-19,516.57,1,-101616,117399288,-25407869,0.328485808193317,93.2882242011553,-0.263499636967119
507.93,513,364,750,269360,380250,2024-05-07,2024-06-07,516.57,386,110890,14143969,2013047,2.68842500998129,61.9305656000802,0.291623931623932
454.3,455,5420,5430,466120,380100,2024-05-07,2024-06-28,516.57,10,-86020.0000000001,83365113,-15781476,0.455946122210618,88.0561884441997,-0.226308866087872
513.62,540,144,144,431712,379872,2024-05-07,2024-09-20,516.57,0,-51840,300792694,-48138153,0.126290301452601,98.9729308385396,-0.136467020470053
505.72,511,462,717,328020,378576,2024-05-07,2024-06-14,516.57,255,50556,17277101,14428074,2.19120094279706,79.1229616589033,0.133542538354254
438.66,440,2806,2815,460184,377210,2024-05-07,2024-08-16,516.57,9,-82973.9999999999,103324269,-17142661,0.36507395953607,94.6250594814274,-0.219967657273137
473.89,476,1730,1770,475750,373470,2024-05-07,2024-07-19,516.57,40,-102280,117399288,-25407869,0.318119476159004,93.6063436773143,-0.273864031916888
284.32,285,5459,5459,371212,371212,2024-05-07,2024-12-20,516.57,0,0,537706253,-56832135,0.0690362066516642,99.2552517331429,0
479.74,480,14490,14246,594090,370396,2024-05-07,2024-05-24,516.57,-244,-223694,17630372,-8762837,2.10089724709155,66.7707181674896,-0.603932007905053
504.8,505,14952,18383,1166256,367660,2024-05-07,2024-05-10,516.57,3431,-798596,11379310,-7506291,3.23095161305914,68.3292044948244,-2.1721046619159
444.11,445,3951,4089,434610,363921,2024-05-07,2024-07-19,516.57,138,-70689.0000000001,117399288,-25407869,0.309985695995022,93.9163293733093,-0.19424270652147
505.15,509,812,944,471772,363440,2024-05-07,2024-06-07,516.57,132,-108332,14143969,2013047,2.56957576759395,64.5001413676741,-0.298073959938367
470.06,472,1867,1873,455548,363362,2024-05-07,2024-07-19,516.57,6,-92186,117399288,-25407869,0.30950954319246,94.2258389165018,-0.253702918852274
490.75,491,14569,14524,670174,363100,2024-05-07,2024-05-17,516.57,-45,-307074,97672171,-63323414,0.37175379259257,93.8928192760249,-0.84570090884054
511.95,520,296,451,326488,363055,2024-05-07,2024-06-07,516.57,155,36567.0000000001,14143969,2013047,2.56685375936556,67.0669951270397,0.100720276542122
508.53,509,6487,7723,1063868,362981,2024-05-07,2024-05-10,516.57,1236,-700887,11379310,-7506291,3.18983312696464,71.519037621789,-1.9309192492169
489.94,494,877,894,464810,362964,2024-05-07,2024-07-19,516.57,17,-101846,117399288,-25407869,0.309170529211387,94.5350094457132,-0.280595320748063
471.81,474,1657,1657,430820,362883,2024-05-07,2024-07-19,516.57,0,-67937,117399288,-25407869,0.309101533903681,94.8441109796168,-0.187214611872146
496.9,501,868,885,482608,362850,2024-05-07,2024-06-28,516.57,17,-119758,83365113,-15781476,0.435254013270515,88.4914424574702,-0.330048229295852
503.19,505,2737,2002,829311,362362,2024-05-07,2024-05-24,516.57,-735,-466949,17630372,-8762837,2.05532815756809,68.8260463250577,-1.28862573890198
499.73,501,2796,2839,609528,360553,2024-05-07,2024-05-24,516.57,43,-248975,17630372,-8762837,2.04506745518472,70.8711137802424,-0.690536481460424
480.87,481,27622,27591,580062,358683,2024-05-07,2024-05-17,516.57,-31,-221379,97672171,-63323414,0.36723152186307,94.260050797888,-0.617199588494576
309.06,310,3814,3814,358516,358516,2024-05-07,2024-12-20,516.57,0,0,537706253,-56832135,0.0666750661722359,99.3219267993151,0
472.99,474,3399,3505,472461,354005,2024-05-07,2024-06-21,516.57,106,-118456,348355461,-84761006,0.101621774202644,97.3684302310966,-0.334616742701374
349.92,350,43692,43689,436920,349512,2024-05-07,2024-06-21,516.57,-3,-87408,348355461,-84761006,0.100331999675469,97.4687622307721,-0.250085833962782
469.91,470,42686,38741,597604,348669,2024-05-07,2024-05-17,516.57,-3945,-248935,97672171,-63323414,0.356978857365626,94.6170296552536,-0.713957937183977
264.5,265,6969,6970,404202,348500,2024-05-07,2024-12-20,516.57,1,-55701.9999999999,537706253,-56832135,0.0648123390895363,99.3867391384046,-0.159833572453371
514.91,522,458,489,490060,346701,2024-05-07,2024-05-17,516.57,31,-143359,97672171,-63323414,0.35496395385744,94.971993609111,-0.413494625051557
470.91,471,38235,38269,535290,344421,2024-05-07,2024-05-17,516.57,34,-190869,97672171,-63323414,0.352629614427225,95.3246232235383,-0.554173526004512
507.83,511,888,1084,438672,343628,2024-05-07,2024-05-24,516.57,196,-95044,17630372,-8762837,1.94906834637409,72.8201821266165,-0.276589800598321
500.79,506,653,657,459059,342297,2024-05-07,2024-06-28,516.57,4,-116762,83365113,-15781476,0.410599815296838,88.902042272767,-0.341113126904413
433.79,435,2821,2823,400582,341583,2024-05-07,2024-08-16,516.57,2,-58999,103324269,-17142661,0.330593192969989,94.9556526743974,-0.172722295898801
511.48,512.5,1399,3286,414104,335172,2024-05-07,2024-05-10,516.57,1887,-78932,11379310,-7506291,2.945450998347,74.464488620136,-0.235496998555965
294.25,295,4390,4431,351200,332325,2024-05-07,2024-12-20,516.57,41,-18875,537706253,-56832135,0.0618041910701009,99.4485433294747,-0.0567968103513127
477.77,479,2635,2696,447950,331608,2024-05-07,2024-06-21,516.57,61,-116342,348355461,-84761006,0.0951924218578563,97.56395465263,-0.350841957974476
508.32,515,55,496,49500,331328,2024-05-07,2024-06-14,516.57,441,281828,17277101,14428074,1.91772913754455,81.0406907964479,0.850601216920997
509,528,174,174,330600,330600,2024-05-07,2024-07-19,516.57,0,0,117399288,-25407869,0.281603070710276,95.1257140503271,0
501.17,507,572,565,420420,329395,2024-05-07,2024-06-28,516.57,-7,-91025,83365113,-15781476,0.395123317352188,89.2971655901192,-0.276339956587076
505.03,510,553,662,385441,329014,2024-05-07,2024-06-14,516.57,109,-56427,17277101,14428074,1.90433568687247,82.9450264833203,-0.171503340283392
467.16,468,3879,3912,430569,328608,2024-05-07,2024-06-21,516.57,33,-101961,348355461,-84761006,0.0943312325452535,97.6582858851752,-0.310281551270815
510.5,550,83,83,327850,327850,2024-05-07,2024-09-20,516.57,0,0,300792694,-48138153,0.108995333510328,99.0819261720499,0
481.84,482,20244,20285,445368,324560,2024-05-07,2024-05-17,516.57,41,-120808,97672171,-63323414,0.332295265557269,95.6569184890955,-0.372220852846931
314.06,315,3445,3444,341055,323736,2024-05-07,2024-12-20,516.57,-1,-17319.0000000001,537706253,-56832135,0.0602068505236445,99.5087501799984,-0.0534972940914821
503.95,507.5,870,910,440220,323050,2024-05-07,2024-06-07,516.57,40,-117170,14143969,2013047,2.28401235890718,69.3510074859468,-0.362699272558428
496.12,497,3809,3647,582777,320936,2024-05-07,2024-05-24,516.57,-162,-261841,17630372,-8762837,1.82035864019205,74.6405407668086,-0.815866714859037
384.86,385,22834,22834,411012,319676,2024-05-07,2024-06-21,516.57,0,-91336,348355461,-84761006,0.091767184898531,97.7500530700737,-0.285714285714286
469.92,473,1023,1034,379533,318472,2024-05-07,2024-08-16,516.57,11,-61061,103324269,-17142661,0.308225747041094,95.2638784214384,-0.191731141199226
389.98,390,157572,157566,315144,315132,2024-05-07,2024-05-17,516.57,-6,-12,97672171,-63323414,0.322642567246714,95.9795610563422,-3.80792810631735e-05
488.91,493,840,768,426720,314112,2024-05-07,2024-07-19,516.57,-72,-112608,117399288,-25407869,0.267558692519498,95.3932727428466,-0.358496332518337
503.59,507,854,913,431270,311333,2024-05-07,2024-06-07,516.57,59,-119937,14143969,2013047,2.20117139679817,71.552178882745,-0.385237029161701
469.11,472,983,1075,348965,310675,2024-05-07,2024-08-16,516.57,92,-38289.9999999999,103324269,-17142661,0.300679601227084,95.5645580226655,-0.123247766959041
497.52,499,2109,2076,493506,307248,2024-05-07,2024-05-31,516.57,-33,-186258,66348411,-19082513,0.463082680307144,91.9509496617786,-0.60621387283237
501.9,506,35,749,18865,307090,2024-05-07,2024-06-14,516.57,714,288225,17277101,14428074,1.77743939796381,84.7224658812841,0.938568497834511
359.96,360,76560,76661,306240,306644,2024-05-07,2024-05-31,516.57,101,404,66348411,-19082513,0.462172334466307,92.4131219962449,0.0013174886839462
469.1,471,1471,1611,347156,306090,2024-05-07,2024-07-19,516.57,140,-41066.0000000001,117399288,-25407869,0.260725601674859,95.6539983445215,-0.134163154627724
499.92,500,34466,38025,999514,304200,2024-05-07,2024-05-10,516.57,3559,-695314,11379310,-7506291,2.67327280828099,77.137761428417,-2.28571334648258
512.68,519,463,481,441702,303992,2024-05-07,2024-05-24,516.57,18,-137710,17630372,-8762837,1.72425176281022,76.3647925296188,-0.453005342245848
471.08,472,3305,3272,426345,301024,2024-05-07,2024-06-21,516.57,-33,-125321,348355461,-84761006,0.0864128838789756,97.8364659539527,-0.41631564260657
354.29,355,4205,4205,298555,298555,2024-05-07,2024-09-20,516.57,0,0,300792694,-48138153,0.0992560677022295,99.1811822397522,0
515.6,520,159,675,130539,297000,2024-05-07,2024-05-10,516.57,516,166461,11379310,-7506291,2.61000007909091,79.7477615075079,0.560474747474748
486.65,489,1249,1255,390937,294925,2024-05-07,2024-06-28,516.57,6,-96012,83365113,-15781476,0.353775085748399,89.6509406758676,-0.325547173010087
474.89,475,29626,26761,503642,294371,2024-05-07,2024-05-17,516.57,-2865,-209271,97672171,-63323414,0.301386768601673,96.2809478249439,-0.710909022967616
455.44,456,5245,5238,377640,293328,2024-05-07,2024-06-21,516.57,-7,-84312,348355461,-84761006,0.0842036462290453,97.9206696001818,-0.287432498772705
441.92,443,2714,2714,293112,293112,2024-05-07,2024-06-28,516.57,0,0,83365113,-15781476,0.351600315110231,90.0025409909778,0
497.05,498,1941,3039,322206,288705,2024-05-07,2024-05-24,516.57,1098,-33501,17630372,-8762837,1.63754343924224,78.002335968861,-0.11603886319946
510.57,515,362,651,257744,288393,2024-05-07,2024-05-24,516.57,289,30649,17630372,-8762837,1.63577376586268,79.6381097347237,0.106275117634617
441.53,442,6128,6128,367680,288016,2024-05-07,2024-06-28,516.57,0,-79664,83365113,-15781476,0.345487446289433,90.3480284372673,-0.276595744680851
474.8,475,14696,14306,455576,286120,2024-05-07,2024-05-24,516.57,-390,-169456,17630372,-8762837,1.62288124153024,81.2609909762539,-0.592254997902978
414.47,415,5385,5386,323100,285458,2024-05-07,2024-07-19,516.57,1,-37642,117399288,-25407869,0.243151389470096,95.8971497339916,-0.131865283158994
493.42,495,1318,1799,305776,284242,2024-05-07,2024-06-07,516.57,481,-21534,14143969,2013047,2.00963392948613,73.5618128122311,-0.0757593881270185
483.49,484,5716,5523,474428,281673,2024-05-07,2024-05-31,516.57,-193,-192755,66348411,-19082513,0.424536165606136,92.8376581618511,-0.684321890987067
364.28,365,3909,3908,300993,281376,2024-05-07,2024-09-20,516.57,-1,-19617,300792694,-48138153,0.0935448252609487,99.2747270650131,-0.0697180996247015
374.89,375,25393,25052,355502,275572,2024-05-07,2024-06-21,516.57,-341,-79930.0000000001,348355461,-84761006,0.0791065537508539,97.9997761539326,-0.29005123887768
279.39,280,4450,4479,311500,273219,2024-05-07,2024-12-20,516.57,29,-38281,537706253,-56832135,0.0508119439704563,99.5595621239688,-0.140111046449917
472.9,473,27020,27023,405300,270230,2024-05-07,2024-05-17,516.57,3,-135070,97672171,-63323414,0.276670414134646,96.5576182390786,-0.499833475187803
505.62,513,241,365,247025,269370,2024-05-07,2024-06-28,516.57,124,22345,83365113,-15781476,0.323120775953366,90.6711492132206,0.0829528158295282
470.78,472,2237,2199,353446,268278,2024-05-07,2024-06-28,516.57,-38,-85168,83365113,-15781476,0.321810875491766,90.9929600887124,-0.31746173745145
481.58,486,546,604,283374,266968,2024-05-07,2024-08-16,516.57,58,-16406,103324269,-17142661,0.258378793853359,95.8229368165189,-0.0614530580444098
502.86,503,17055,18950,886860,265300,2024-05-07,2024-05-10,516.57,1895,-621560,11379310,-7506291,2.33142431307346,82.0791858205814,-2.34285714285714
474.65,477,1169,1123,330827,263905,2024-05-07,2024-07-19,516.57,-46,-66922,117399288,-25407869,0.224792675062902,96.1219424090545,-0.253583675943995
468.12,469,2976,2974,339264,261712,2024-05-07,2024-06-21,516.57,-2,-77552,348355461,-84761006,0.0751278591266293,98.0749040130592,-0.296325732102464
329.94,330,43456,43545,304192,261270,2024-05-07,2024-06-21,516.57,89,-42922,348355461,-84761006,0.0750009772345725,98.1499049902938,-0.1642821602174
478.95,483,552,645,358248,261225,2024-05-07,2024-08-16,516.57,93,-97023,103324269,-17142661,0.252820564353569,96.0757573808725,-0.371415446454206
488.12,494,360,443,244440,260484,2024-05-07,2024-08-16,516.57,83,16044,103324269,-17142661,0.252103404670591,96.327860785543,0.0615930345049984
488.27,489,3617,3556,415955,259588,2024-05-07,2024-05-31,516.57,-61,-156367,66348411,-19082513,0.391249761806654,93.2289079236577,-0.602366056982603
439.21,440,3313,3277,321361,258883,2024-05-07,2024-07-19,516.57,-36,-62478,117399288,-25407869,0.220514965985143,96.3424573750396,-0.241336820107925
514.35,530,12,165,22800,258225,2024-05-07,2024-06-07,516.57,153,235425,14143969,2013047,1.82568980460859,75.3875026168397,0.91170490851002
438.11,439,2901,2901,258189,258189,2024-05-07,2024-06-28,516.57,0,0,83365113,-15781476,0.309708690732537,91.3026687794449,0
404.97,405,85582,85782,342328,257346,2024-05-07,2024-05-17,516.57,200,-84982,97672171,-63323414,0.263479348687765,96.8210975877663,-0.330224678059888
428.89,430,2313,2314,298377,256854,2024-05-07,2024-08-16,516.57,1,-41523,103324269,-17142661,0.248590193268147,96.5764509788112,-0.161659931322853
497,499,415,1281,126160,256200,2024-05-07,2024-06-07,516.57,866,130040,14143969,2013047,1.81137274834242,77.1988753651822,0.507572209211554
506.36,509,981,968,414963,255552,2024-05-07,2024-05-24,516.57,-13,-159411,17630372,-8762837,1.44949862657464,82.7104896028286,-0.623790852742299
473.57,477,734,735,299472,252105,2024-05-07,2024-08-16,516.57,1,-47367,103324269,-17142661,0.243993983639991,96.8204449624512,-0.187885999881002
459.68,461,1909,1907,326439,251724,2024-05-07,2024-07-19,516.57,-2,-74715,117399288,-25407869,0.214416973295443,96.5568743483351,-0.296813176335987
497.9,499,2344,2284,424264,251240,2024-05-07,2024-05-24,516.57,-60,-173024,17630372,-8762837,1.42504083294442,84.135530435773,-0.688680146473492
461.37,462,3939,3945,342693,248535,2024-05-07,2024-06-21,516.57,6,-94158,348355461,-84761006,0.0713452286025739,98.2212502188964,-0.378852073148651
483.3,488,426,528,261138,248160,2024-05-07,2024-08-16,516.57,102,-12978,103324269,-17142661,0.240175906785268,97.0606208692364,-0.0522969052224371
475.32,479,572,674,246532,248032,2024-05-07,2024-08-16,516.57,102,1500.00000000006,103324269,-17142661,0.240052024950692,97.3006728941871,0.00604760676041825
480.26,483,878,905,308178,247970,2024-05-07,2024-07-19,516.57,27,-60208,117399288,-25407869,0.211219338911153,96.7680936872462,-0.242803564947373
492.97,494,1964,2378,322096,244934,2024-05-07,2024-05-31,516.57,414,-77161.9999999999,66348411,-19082513,0.36916332480065,93.5980712484584,-0.315031804486106
119.95,120,48833,48881,292998,244405,2024-05-07,2024-12-20,516.57,48,-48593,537706253,-56832135,0.0454532560550305,99.6050153800239,-0.198821628035433
514.4,517,271,937,154741,243620,2024-05-07,2024-05-10,516.57,666,88879,11379310,-7506291,2.14090309517888,84.2200889157603,0.364826368935227
469.75,470,9737,9737,360269,243425,2024-05-07,2024-05-31,516.57,0,-116844,66348411,-19082513,0.366888967393658,93.9649602158521,-0.48
466.23,467,3070,3117,322350,240009,2024-05-07,2024-06-21,516.57,47,-82341,348355461,-84761006,0.0688977285761569,98.2901479474725,-0.343074634701199
424.4,425,4015,3966,289080,237960,2024-05-07,2024-07-19,516.57,-49,-51120,117399288,-25407869,0.202692881748993,96.9707865689952,-0.21482602118003
359.36,360,3654,3705,263088,237120,2024-05-07,2024-09-20,516.57,51,-25968,300792694,-48138153,0.078831701942867,99.353558766956,-0.109514170040486
464.92,465,29582,29574,325402,236592,2024-05-07,2024-05-17,516.57,-8,-88810,97672171,-63323414,0.242230716874308,97.0633283046406,-0.375371948332995
463.32,464,3414,3416,320916,232288,2024-05-07,2024-06-21,516.57,2,-88628,348355461,-84761006,0.0666813143486216,98.3568292618212,-0.381543601046976
509.74,516,19,366,16891,229116,2024-05-07,2024-06-07,516.57,347,212225,14143969,2013047,1.61988477208908,78.8187601372712,0.926277518811432
510.36,517,3,345,4350,229080,2024-05-07,2024-06-07,516.57,342,224730,14143969,2013047,1.61963024664435,80.4383903839156,0.981011000523834
512.5,524,198,198,284130,227700,2024-05-07,2024-05-31,516.57,0,-56430,66348411,-19082513,0.343188324434778,94.3081485402868,-0.247826086956522
500.36,501,4702,3546,644174,226944,2024-05-07,2024-05-17,516.57,-1156,-417230,97672171,-63323414,0.232352775285398,97.295681079926,-1.83847116469261
467.3,469,1321,1322,298546,224740,2024-05-07,2024-07-19,516.57,1,-73806,117399288,-25407869,0.191432166096271,97.1622187350915,-0.328406158227285
454.85,455,15097,14935,317037,224025,2024-05-07,2024-05-31,516.57,-162,-93012,66348411,-19082513,0.337649382439619,94.6457979227264,-0.415185805155675
501.47,503,1662,1459,453726,223227,2024-05-07,2024-05-24,516.57,-203,-230499,17630372,-8762837,1.26615025479893,85.4016806905719,-1.03257670443092
404.56,405,5058,5058,257958,222552,2024-05-07,2024-07-19,516.57,0,-35406,117399288,-25407869,0.189568440994293,97.3517871760858,-0.159090909090909
480.57,481,5008,5168,345552,222224,2024-05-07,2024-05-31,516.57,160,-123328,66348411,-19082513,0.334934924063215,94.9807328467896,-0.554971560227518
304.12,305,2516,2516,221408,221408,2024-05-07,2024-12-20,516.57,0,0,537706253,-56832135,0.0411763855757132,99.6461917655996,0
421.73,422,8141,8144,423332,219888,2024-05-07,2024-06-21,516.57,3,-203444,348355461,-84761006,0.0631217318565303,98.4199509936777,-0.925216473841228
416.71,417,7386,7542,332370,218718,2024-05-07,2024-06-28,516.57,156,-113652,83365113,-15781476,0.26236154684994,91.5650303262949,-0.519628014155214
500.98,504,713,724,298747,218648,2024-05-07,2024-06-07,516.57,11,-80099,14143969,2013047,1.54587442888202,81.9842648127976,-0.366337675167392
414.1,415,2416,2424,241600,218160,2024-05-07,2024-08-16,516.57,8,-23440,103324269,-17142661,0.211141101806392,97.5118139959935,-0.107444077741107
494.82,496,1258,1837,235246,216766,2024-05-07,2024-05-31,516.57,579,-18480,66348411,-19082513,0.326708653203466,95.3074414999931,-0.0852532223688217
476.39,478,1275,1338,280500,215418,2024-05-07,2024-06-28,516.57,63,-65082,83365113,-15781476,0.258403056444007,91.8234333827389,-0.302119600033423
458.39,459,3532,3521,271964,214781,2024-05-07,2024-06-21,516.57,-11,-57183,348355461,-84761006,0.0616557005833762,98.4816066942611,-0.266238633771144
460.39,461,3484,3485,289172,212585,2024-05-07,2024-06-21,516.57,1,-76587,348355461,-84761006,0.061025310006551,98.5426320042676,-0.360265305642449
334.52,335,4442,4420,226542,212160,2024-05-07,2024-09-20,516.57,-22,-14382,300792694,-48138153,0.0705336280541442,99.4240923950101,-0.0677884615384615
482.86,483,14982,14976,374550,209664,2024-05-07,2024-05-17,516.57,-6,-164886,97672171,-63323414,0.214660939603769,97.5103420195298,-0.786429716117216
446.43,447,3641,3641,276716,207537,2024-05-07,2024-06-28,516.57,0,-69179,83365113,-15781476,0.248949461629111,92.072382844368,-0.333333333333333
419.45,420,3757,3772,240448,207460,2024-05-07,2024-07-19,516.57,15,-32988,117399288,-25407869,0.176713167119037,97.5285003432048,-0.159008965583727
482.18,490,130,263,118950,205666,2024-05-07,2024-10-18,516.57,133,86716,1530129,786938,13.4410889539379,61.3203854054135,0.421635078233641
504,506,1264,1022,422176,204400,2024-05-07,2024-05-24,516.57,-242,-217776,17630372,-8762837,1.15936294480911,86.561043635381,-1.06544031311155
486.37,487,3160,3242,316000,204246,2024-05-07,2024-05-31,516.57,82,-111754,66348411,-19082513,0.307838570542405,95.6152800705355,-0.547153922231035
419.88,420,16991,17004,271856,204048,2024-05-07,2024-06-07,516.57,13,-67808,14143969,2013047,1.44265022074073,83.4269150335383,-0.332313965341488
474.22,475,579,2603,61374,203034,2024-05-07,2024-06-14,516.57,2024,141660,17277101,14428074,1.17516243031745,85.8976283116016,0.697715653535861
485.72,491,370,384,231620,202752,2024-05-07,2024-08-16,516.57,14,-28868,103324269,-17142661,0.196228825969241,97.7080428219628,-0.142380839646465
505.76,506,7049,8444,648508,202656,2024-05-07,2024-05-10,516.57,1395,-445852,11379310,-7506291,1.78091641760353,86.0010053333638,-2.20004342333807
483.92,486,886,973,245422,202384,2024-05-07,2024-06-28,516.57,87,-43038,83365113,-15781476,0.24276821888312,92.3151510632511,-0.212655150604791
379.7,380,6626,6636,238536,199080,2024-05-07,2024-07-19,516.57,10,-39456,117399288,-25407869,0.169575134050217,97.698075477255,-0.198191681735986
339.5,340,3962,3976,217910,198800,2024-05-07,2024-09-20,516.57,14,-19110,300792694,-48138153,0.0660920308124239,99.4901844258225,-0.0961267605633804
359.91,360,22071,22071,264852,198639,2024-05-07,2024-06-21,516.57,0,-66213,348355461,-84761006,0.0570219279553651,98.599653932223,-0.333333333333333
369.88,370,16531,16546,214903,198552,2024-05-07,2024-06-21,516.57,15,-16351,348355461,-84761006,0.0569969534652996,98.6566508856883,-0.0823512228534592
364.89,365,17915,17923,232895,197153,2024-05-07,2024-06-21,516.57,8,-35742,348355461,-84761006,0.0565953521825226,98.7132462378708,-0.181290672726258
475.88,476,16437,16419,279429,197028,2024-05-07,2024-05-17,516.57,-18,-82401.0000000001,97672171,-63323414,0.201723784761578,97.7120658042914,-0.418219745416895
493.33,494,2981,2939,357720,196913,2024-05-07,2024-05-24,516.57,-42,-160807,17630372,-8762837,1.11689645572992,87.677940091111,-0.816639835866601
488.55,489,3158,4350,249482,195750,2024-05-07,2024-05-24,516.57,1192,-53732,17630372,-8762837,1.11029988476704,88.788239975878,-0.274492975734355
443.57,444,4524,4524,221676,194532,2024-05-07,2024-06-21,516.57,0,-27144,348355461,-84761006,0.055842959786412,98.7690891976572,-0.13953488372093
511.93,518,292,318,254916,193026,2024-05-07,2024-05-24,516.57,26,-61890,17630372,-8762837,1.09484927487633,89.8830892507543,-0.320630381399397
463.03,464,1983,1975,230028,191575,2024-05-07,2024-06-28,516.57,-8,-38453,83365113,-15781476,0.229802363489869,92.544953426741,-0.200720344512593
504.3,509,300,404,198900,189880,2024-05-07,2024-06-14,516.57,104,-9019.99999999997,17277101,14428074,1.09902697217548,86.9966552837771,-0.0475036865388665
456.31,457,2741,2730,257654,188370,2024-05-07,2024-06-28,516.57,-11,-69284,83365113,-15781476,0.225957829625925,92.7709112563669,-0.367808037373255
495.22,497,1048,1051,289248,187078,2024-05-07,2024-06-07,516.57,3,-102170,14143969,2013047,1.32266975415458,84.7495847876929,-0.546135836389099
465.37,467,1150,1147,235750,186961,2024-05-07,2024-07-19,516.57,-3,-48789,117399288,-25407869,0.15925224350594,97.857327720761,-0.260958167746214
485.65,489,539,557,239855,186595,2024-05-07,2024-07-19,516.57,18,-53260,117399288,-25407869,0.158940486930381,98.0162682076914,-0.285431013692757
512.48,528,119,120,284410,186240,2024-05-07,2024-06-28,516.57,1,-98170,83365113,-15781476,0.223402804000278,92.9943140603672,-0.527115549828179
514.45,523,202,216,291890,184680,2024-05-07,2024-05-24,516.57,14,-107210,17630372,-8762837,1.04751051197332,90.9305997627276,-0.580517652155078
456.44,457,3261,3260,234792,182560,2024-05-07,2024-06-21,516.57,-1,-52232,348355461,-84761006,0.0524062403029186,98.8214954379601,-0.286108676599474
415.7,416,6023,6023,234897,180690,2024-05-07,2024-06-28,516.57,0,-54207,83365113,-15781476,0.216745342863027,93.2110594032302,-0.3
502.79,506,572,560,265408,179760,2024-05-07,2024-06-07,516.57,-12,-85648,14143969,2013047,1.27093038736157,86.0205151750545,-0.476457498887405
440.14,441,2088,2088,179568,179568,2024-05-07,2024-06-28,516.57,0,0,83365113,-15781476,0.21539945612501,93.4264588593552,0
439.53,440,3792,3809,219936,179023,2024-05-07,2024-06-28,516.57,17,-40913,83365113,-15781476,0.214745705436757,93.641204564792,-0.228534880992945
509.98,517.5,23,238,33741,178976,2024-05-07,2024-06-07,516.57,215,145235,14143969,2013047,1.2653873887874,87.2859025638419,0.81147751653853
441.59,442,4333,4349,203651,178309,2024-05-07,2024-06-21,516.57,16,-25342,348355461,-84761006,0.0511859350469605,98.8726813730071,-0.142124065526698
506.33,512,139,311,106196,176337,2024-05-07,2024-06-14,516.57,172,70141,17277101,14428074,1.02063997889461,88.0172952626717,0.397766776116187
374.7,375,5852,5851,187264,175530,2024-05-07,2024-07-19,516.57,-1,-11734,117399288,-25407869,0.149515387180202,98.1657835948715,-0.0668489716857517
488.96,492,493,575,185368,174800,2024-05-07,2024-06-28,516.57,82,-10568,83365113,-15781476,0.209680037259711,93.8508846020517,-0.06045766590389
477.21,482,364,364,174356,174356,2024-05-07,2024-08-16,516.57,0,0,103324269,-17142661,0.168746415229901,97.8767892371927,0
259.53,260,3702,3703,211014,174041,2024-05-07,2024-12-20,516.57,1,-36973,537706253,-56832135,0.0323673007388292,99.6785590663384,-0.212438448411581
409.5,410,3451,3450,200158,172500,2024-05-07,2024-07-19,516.57,-1,-27658,117399288,-25407869,0.146934451595652,98.3127180464672,-0.160336231884058
495.18,496,1859,2103,262119,172446,2024-05-07,2024-05-24,516.57,244,-89673,17630372,-8762837,0.978118896186649,91.9087186589143,-0.520006262830104
475.52,478,822,695,244956,172360,2024-05-07,2024-07-19,516.57,-127,-72596,117399288,-25407869,0.146815200446531,98.4595332469137,-0.421188210721745
491.41,492,1789,2885,178900,170215,2024-05-07,2024-05-24,516.57,1096,-8685,17630372,-8762837,0.965464597116839,92.8741832560311,-0.0510237053138678
462.32,463,2469,2471,222210,168028,2024-05-07,2024-06-21,516.57,2,-54182,348355461,-84761006,0.048234639272671,98.9209160122798,-0.322458161734949
466.27,468,962,960,287638,166080,2024-05-07,2024-07-19,516.57,-2,-121558,117399288,-25407869,0.141465934614527,98.6009991815283,-0.731924373795761
481.5,482,3562,3306,260026,165300,2024-05-07,2024-05-31,516.57,-256,-94726,66348411,-19082513,0.249139350149622,95.8644194206852,-0.573055051421657
219.69,220,5310,5310,164610,164610,2024-05-07,2024-12-20,516.57,0,0,537706253,-56832135,0.030613369117729,99.7091724354561,0
420.75,421,6492,6507,201252,162675,2024-05-07,2024-06-21,516.57,15,-38577,348355461,-84761006,0.0466979904758835,98.9676140027557,-0.237141539880129
490.16,491,1450,1935,191400,162540,2024-05-07,2024-05-31,516.57,485,-28860,66348411,-19082513,0.244979491671624,96.1093989123568,-0.177556293835364
423.98,425,1591,1590,190920,162180,2024-05-07,2024-08-16,516.57,-1,-28740,103324269,-17142661,0.156962155715808,98.0337513929085,-0.177210506844247
472.7,474,1225,1238,204575,160940,2024-05-07,2024-06-28,516.57,13,-43635,83365113,-15781476,0.193054377554793,94.0439389796065,-0.271125885423139
461.58,463,1136,1130,212432,160460,2024-05-07,2024-07-19,516.57,-6,-51972,117399288,-25407869,0.136678852771237,98.7376780342995,-0.323893805309735
472.45,476,449,450,195764,159750,2024-05-07,2024-08-16,516.57,1,-36014,103324269,-17142661,0.154610336512519,98.188361729421,-0.225439749608764
507.7,514,34,247,30566,155610,2024-05-07,2024-06-14,516.57,213,125044,17277101,14428074,0.900671935644759,88.9179671983164,0.803573035151983
503.83,504,6932,9151,429784,155567,2024-05-07,2024-05-10,516.57,2219,-274217,11379310,-7506291,1.36710398082133,87.3681093141851,-1.76269388752113
480.29,482,889,909,209804,155439,2024-05-07,2024-06-28,516.57,20,-54365,83365113,-15781476,0.186455694002358,94.2303946736089,-0.349751349403946
244.89,245,14002,14002,154022,154022,2024-05-07,2024-08-16,516.57,0,0,103324269,-17142661,0.149066624415218,98.3374283538362,0
379.87,380,11881,11835,201977,153855,2024-05-07,2024-06-21,516.57,-46,-48122,348355461,-84761006,0.0441660938968314,99.0117800966525,-0.312775015436613
491.11,492,1675,1728,236175,153792,2024-05-07,2024-05-31,516.57,53,-82383,66348411,-19082513,0.231794548930494,96.3411934612873,-0.535678058676654
515.1,530,108,103,201960,153470,2024-05-07,2024-05-24,516.57,-5,-48490,17630372,-8762837,0.870486453717483,93.7446697097486,-0.31595751612693
453.47,454,2886,2888,193362,153064,2024-05-07,2024-06-21,516.57,2,-40298,348355461,-84761006,0.0439390269814085,99.0557191236339,-0.263275492604401
354.97,355,50689,50690,405512,152070,2024-05-07,2024-05-31,516.57,1,-253442,66348411,-19082513,0.229199158967047,96.5703926202543,-1.66661405931479
189.83,190,8592,8897,154656,151249,2024-05-07,2024-12-20,516.57,305,-3407,537706253,-56832135,0.0281285551648588,99.737300990621,-0.0225257687654133
479.34,480,2089,2257,198455,148962,2024-05-07,2024-06-07,516.57,168,-49493,14143969,2013047,1.05318386939338,88.3390864332353,-0.332252520777111
503.51,508,263,330,159904,148170,2024-05-07,2024-06-14,516.57,67,-11734,17277101,14428074,0.857609155610076,89.7755763539265,-0.0791928190591888
447.54,448,3220,3219,183540,148074,2024-05-07,2024-06-21,516.57,-1,-35466,348355461,-84761006,0.042506582091446,99.0982257057254,-0.239515377446412
462.04,463,1538,1538,169180,147648,2024-05-07,2024-06-28,516.57,0,-21532,83365113,-15781476,0.177110058016715,94.4075047316256,-0.145833333333334
487.57,488,3372,3430,246156,147490,2024-05-07,2024-05-24,516.57,58,-98666,17630372,-8762837,0.836567713942735,94.5812374236913,-0.6689673876195
457.4,458,2466,2443,194814,146580,2024-05-07,2024-06-21,516.57,-23,-48234,348355461,-84761006,0.0420777098137698,99.1403034155391,-0.329062627916496
484.84,487,623,663,185654,143208,2024-05-07,2024-06-28,516.57,40,-42446,83365113,-15781476,0.171784089106915,94.5792888207325,-0.296394056197977
442.58,443,3386,3403,182844,142926,2024-05-07,2024-06-21,516.57,17,-39918,348355461,-84761006,0.0410287812310197,99.1813321967701,-0.279291381554091
464.8,465,7026,7054,203754,141080,2024-05-07,2024-05-31,516.57,28,-62674,66348411,-19082513,0.212635084810094,96.7830277050644,-0.444244400340232
309.5,310,2820,2820,141000,141000,2024-05-07,2024-09-20,516.57,0,0,300792694,-48138153,0.0468761385540834,99.5370605643766,0
492.54,496,413,405,181307,140130,2024-05-07,2024-06-28,516.57,-8,-41177,83365113,-15781476,0.168091897146472,94.747380717879,-0.293848569185756
414.92,415,17717,17516,159453,140128,2024-05-07,2024-05-31,516.57,-201,-19325,66348411,-19082513,0.211200235074205,96.9942279401386,-0.137909625485271
494.19,498,357,364,172788,138684,2024-05-07,2024-06-28,516.57,7,-34104,83365113,-15781476,0.166357358623145,94.9137380765021,-0.245911568746214
446.58,447,3278,3275,180290,137550,2024-05-07,2024-06-21,516.57,-3,-42740,348355461,-84761006,0.0394855299828356,99.220817726753,-0.310723373318793
445.6,446,3409,3423,197722,136920,2024-05-07,2024-06-21,516.57,14,-60802,348355461,-84761006,0.039304680227189,99.2601224069801,-0.444069529652352
433.66,434,4001,4000,160040,136000,2024-05-07,2024-06-21,516.57,-1,-24040,348355461,-84761006,0.0390405821713241,99.2991629891515,-0.176764705882353
417.7,418,4531,4531,222019,135930,2024-05-07,2024-06-28,516.57,0,-86089,83365113,-15781476,0.163053818448012,95.0767918949501,-0.633333333333333
462.54,464,927,927,177057,135342,2024-05-07,2024-07-19,516.57,0,-41715,117399288,-25407869,0.115283493031065,98.8529615273306,-0.308219178082192
514.91,518,116,437,77140,135033,2024-05-07,2024-05-10,516.57,321,57893,11379310,-7506291,1.18665367232284,88.554762986508,0.428732235823836
314.64,315,3735,3737,197955,134532,2024-05-07,2024-09-20,516.57,2,-63423,300792694,-48138153,0.0447258203684961,99.5817863847451,-0.471434305592722
469.43,475,216,240,139968,133680,2024-05-07,2024-10-18,516.57,24,-6287.99999999997,1530129,786938,8.73651829355564,70.0569036989692,-0.0470377019748651
440.61,441,3401,3417,166649,133263,2024-05-07,2024-06-21,516.57,16,-33386,348355461,-84761006,0.0382548904551262,99.3374178796066,-0.250527153073246
506.68,507,3794,4146,421134,132672,2024-05-07,2024-05-10,516.57,352,-288462,11379310,-7506291,1.16590548987592,89.7206684763839,-2.174249276411
495.31,499,346,355,174730,130995,2024-05-07,2024-06-28,516.57,9,-43735,83365113,-15781476,0.157134075977322,95.2339259709274,-0.333867704874232
451.54,452,2826,2830,175212,130180,2024-05-07,2024-06-21,516.57,4,-45032,348355461,-84761006,0.0373698749048748,99.3747877545115,-0.345921032416654
479.95,484,319,320,158224,129600,2024-05-07,2024-08-16,516.57,1,-28624,103324269,-17142661,0.125430357508748,98.462858711345,-0.220864197530864
319.57,320,2997,2997,128871,128871,2024-05-07,2024-09-20,516.57,0,0,300792694,-48138153,0.0428437932737821,99.6246301780189,0
514.7,539,1,53,3459,128790,2024-05-07,2024-07-19,516.57,52,125331,117399288,-25407869,0.109702539252197,98.9626640665828,0.973142324714652
394.79,395,6079,6078,158054,127638,2024-05-07,2024-06-28,516.57,-1,-30416,83365113,-15781476,0.153107211646195,95.3870331825736,-0.23829893918739
409.22,410,1589,1627,144599,126906,2024-05-07,2024-08-16,516.57,38,-17693,103324269,-17142661,0.122823032021644,98.5856817433666,-0.139418152018029
459.81,460,6700,6666,167500,126654,2024-05-07,2024-05-31,516.57,-34,-40846,66348411,-19082513,0.190892288287055,97.1851202284257,-0.322500671119744
466.98,468,750,1239,102750,126378,2024-05-07,2024-06-28,516.57,489,23628,83365113,-15781476,0.151595788036658,95.5386289706103,0.186962920761525
399.76,400,5258,5235,141966,125640,2024-05-07,2024-06-28,516.57,-23,-16326,83365113,-15781476,0.150710525636785,95.6893394962471,-0.129942693409742
199.79,200,5880,5979,129360,125559,2024-05-07,2024-12-20,516.57,99,-3801,537706253,-56832135,0.0233508536118883,99.7606518442329,-0.0302726208396053
422.75,423,4901,4911,151931,122775,2024-05-07,2024-06-21,516.57,10,-29156,348355461,-84761006,0.0352441726182671,99.4100319271297,-0.237475055996742
139.89,140,11118,11118,122298,122298,2024-05-07,2024-12-20,516.57,0,0,537706253,-56832135,0.0227443886541524,99.783396232887,0
469.87,471,1062,1076,160362,121588,2024-05-07,2024-06-28,516.57,14,-38774,83365113,-15781476,0.145849979235319,95.8351894754824,-0.31889660163832
500.4,503,393,464,151698,120640,2024-05-07,2024-06-07,516.57,71,-31058,14143969,2013047,0.852943045901755,89.192029479137,-0.257443633952255
477.24,481,318,318,143100,119568,2024-05-07,2024-08-16,516.57,0,-23532,103324269,-17142661,0.115721118723811,98.7014028620904,-0.196808510638298
430.68,431,3729,3727,238656,119264,2024-05-07,2024-06-21,516.57,-2,-119392,348355461,-84761006,0.0342362940594177,99.4442682211892,-1.00107324926214
476.89,477,10776,10811,204744,118921,2024-05-07,2024-05-17,516.57,35,-85823,97672171,-63323414,0.121755254114296,97.8338210584057,-0.721680779677265
499.55,502,375,481,139875,117845,2024-05-07,2024-06-07,516.57,106,-22030,14143969,2013047,0.833181973178816,90.0252114523158,-0.186940472654758
483.74,485,194,916,34144,115416,2024-05-07,2024-06-14,516.57,722,81272,17277101,14428074,0.668028739312226,90.4436050932387,0.704165800235669
507.1,513,25,195,20400,115050,2024-05-07,2024-06-14,516.57,170,94650,17277101,14428074,0.665910328358907,91.1095154215976,0.822685788787484
492.85,495,150,526,46650,113090,2024-05-07,2024-06-14,516.57,376,66440,17277101,14428074,0.654565832543319,91.764081254141,0.587496684056946
501.24,505,261,299,133110,112424,2024-05-07,2024-06-14,516.57,38,-20686,17277101,14428074,0.650711019169246,92.4147922733102,-0.183999857681634
239.62,240,2949,2951,120909,112138,2024-05-07,2024-12-20,516.57,2,-8770.99999999997,537706253,-56832135,0.0208548811501361,99.8042511140372,-0.0782161265583475
498.7,501,474,487,160686,112010,2024-05-07,2024-06-07,516.57,13,-48676,14143969,2013047,0.791927640678511,90.8171390929943,-0.434568342112312
449.89,450,9372,10126,121836,111386,2024-05-07,2024-05-24,516.57,754,-10450,17630372,-8762837,0.631784740560211,95.2130221642516,-0.0938178945289357
149.92,150,13219,13863,132190,110904,2024-05-07,2024-12-20,516.57,644,-21286,537706253,-56832135,0.0206253878174632,99.8248765018546,-0.191931760802135
129.94,130,17475,18475,122325,110850,2024-05-07,2024-12-20,516.57,1000,-11475,537706253,-56832135,0.0206153451594694,99.8454918470141,-0.103518267929635
508.9,516,33,156,31284,110760,2024-05-07,2024-06-14,516.57,123,79476,17277101,14428074,0.641079773742134,93.0558720470523,0.717551462621885
478.39,481,421,424,138930,110664,2024-05-07,2024-07-19,516.57,3,-28266,117399288,-25407869,0.0942629226167027,99.0569269891995,-0.25542181739319
493.59,497,337,324,154009,110484,2024-05-07,2024-06-28,516.57,-13,-43525,83365113,-15781476,0.132530258790629,95.967719734273,-0.393948445023714
452.29,453,1537,1547,126034,109837,2024-05-07,2024-06-28,516.57,10,-16197,83365113,-15781476,0.131754154762556,96.0994738890356,-0.14746396933638
399.29,400,1551,1546,122529,109766,2024-05-07,2024-08-16,516.57,-5,-12763,103324269,-17142661,0.106234480110379,98.8076373422008,-0.116274620556457
494.55,497,217,447,74214,109515,2024-05-07,2024-06-14,516.57,230,35301,17277101,14428074,0.633873703696008,93.6897457507484,0.322339405560882
404.22,405,1405,1395,118020,108810,2024-05-07,2024-08-16,516.57,-10,-9209.99999999998,103324269,-17142661,0.105309237658386,98.9129465798592,-0.0846429556106974
299.97,300,36203,36194,181015,108582,2024-05-07,2024-06-21,516.57,-9,-72433,348355461,-84761006,0.0311698859803435,99.4754381071695,-0.667081099998158
460.64,462,800,798,142400,108528,2024-05-07,2024-07-19,516.57,-2,-33872,117399288,-25407869,0.0924434907986836,99.1493704799981,-0.312103788883975
448.38,449,1746,1747,127458,108314,2024-05-07,2024-06-28,516.57,1,-19144,83365113,-15781476,0.129927251463091,96.2294011404987,-0.176745388407777
496.11,498,506,573,143198,108297,2024-05-07,2024-06-07,516.57,67,-34901,14143969,2013047,0.765676169114907,91.5828152621092,-0.322271161712697
501.88,502,7992,8919,335664,107028,2024-05-07,2024-05-10,516.57,927,-228636,11379310,-7506291,0.940549119410579,90.6612175957945,-2.13622603430878
481.04,484,339,355,123057,105080,2024-05-07,2024-07-19,516.57,16,-17977,117399288,-25407869,0.0895065053546151,99.2388769853528,-0.171079177769319
436.56,437,2387,2388,221991,105072,2024-05-07,2024-06-28,516.57,1,-116919,83365113,-15781476,0.126038334524899,96.3554394750236,-1.11275125628141
477.88,478,8706,8734,174120,104808,2024-05-07,2024-05-17,516.57,28,-69312,97672171,-63323414,0.107305897807882,97.9411269562136,-0.661323563086787
515.44,524,50,122,65500,104432,2024-05-07,2024-05-17,516.57,72,38932,97672171,-63323414,0.106920936568513,98.0480478927821,0.372797609927992
229.66,230,3054,3054,109944,103836,2024-05-07,2024-12-20,516.57,0,-6107.99999999999,537706253,-56832135,0.0193109154711653,99.8648027624853,-0.0588235294117646
514.52,521,128,158,131840,102384,2024-05-07,2024-05-17,516.57,30,-29456,97672171,-63323414,0.104824126413654,98.1528720191957,-0.287701203313018
484.65,485,2363,2910,134691,101850,2024-05-07,2024-05-24,516.57,547,-32841,17630372,-8762837,0.577696261882619,95.7907184261342,-0.322444771723122
398.55,399,2255,2255,101475,101475,2024-05-07,2024-06-28,516.57,0,0,83365113,-15781476,0.121723579982432,96.477163055006,0
514.62,517.5,198,351,132660,101088,2024-05-07,2024-05-10,516.57,153,-31572,11379310,-7506291,0.888349117828761,91.5495667136232,-0.312321937321937
511.4,555,23,23,100280,100280,2024-05-07,2024-12-20,516.57,0,0,537706253,-56832135,0.0186495878447595,99.88345235033,0
427.71,428,3417,3437,164016,99673,2024-05-07,2024-06-21,516.57,20,-64343,348355461,-84761006,0.0286124407850176,99.5040505479545,-0.645540918804491
324.49,325,1939,1939,98889,98889,2024-05-07,2024-09-20,516.57,0,0,300792694,-48138153,0.0328761309608138,99.6575063089797,0
299.71,300,3395,3394,112035,98426,2024-05-07,2024-09-20,516.57,-1,-13609,300792694,-48138153,0.0327222043498171,99.6902285133295,-0.138266311746896
413.73,414,3620,3620,97740,97740,2024-05-07,2024-06-21,516.57,0,0,348355461,-84761006,0.0280575478045972,99.5321080957591,0
334.94,335,16092,16092,144828,96552,2024-05-07,2024-06-21,516.57,0,-48276,348355461,-84761006,0.0277165168368065,99.5598246125959,-0.5
478.89,479,8783,8746,166877,96206,2024-05-07,2024-05-17,516.57,-37,-70671,97672171,-63323414,0.0984988856242379,98.25137090482,-0.73457996382762
455.93,456,13628,13619,136280,95333,2024-05-07,2024-05-17,516.57,-9,-40947,97672171,-63323414,0.0976050793424055,98.3489759841624,-0.429515487816391
477.38,479,585,584,121095,94608,2024-05-07,2024-06-28,516.57,-1,-26487,83365113,-15781476,0.11348632131045,96.5906493763165,-0.279965753424657
439.95,440,18857,18854,131999,94270,2024-05-07,2024-05-17,516.57,-3,-37729,97672171,-63323414,0.0965167447747219,98.4454927289371,-0.400222764400128
482.24,483,1045,1236,123310,93936,2024-05-07,2024-06-07,516.57,191,-29374,14143969,2013047,0.664141727120584,92.2469569892298,-0.312702265372168
499.97,502.5,355,367,139160,92851,2024-05-07,2024-06-07,516.57,12,-46309,14143969,2013047,0.656470613022413,92.9034276022522,-0.498745301612261
344.45,345,1674,1687,98766,92785,2024-05-07,2024-09-20,516.57,13,-5981,300792694,-48138153,0.0308468263527704,99.7210753396823,-0.0644608503529665
434.59,435,2293,2258,116943,92578,2024-05-07,2024-06-28,516.57,-35,-24365,83365113,-15781476,0.111051249939528,96.701700626256,-0.263183477716088
468.89,469,9983,8344,119796,91784,2024-05-07,2024-05-17,516.57,-1639,-28012,97672171,-63323414,0.0939714957293209,98.5394642246664,-0.305194805194805
462.79,463,4219,4247,118132,89187,2024-05-07,2024-05-31,516.57,28,-28945,66348411,-19082513,0.134422209448241,97.3195424378739,-0.324542814535751
474.57,476,625,620,115625,88660,2024-05-07,2024-06-28,516.57,-5,-26965,83365113,-15781476,0.106351442239393,96.8080520684954,-0.304139408978119
447.24,448,1145,1145,87020,87020,2024-05-07,2024-06-28,516.57,0,0,83365113,-15781476,0.1043841924619,96.9124362609573,0
474.44,478,173,243,97572,86508,2024-05-07,2024-08-16,516.57,70,-11064,103324269,-17142661,0.083724763637089,98.9966713434963,-0.12789568594812
354.99,355,83484,83484,166968,83484,2024-05-07,2024-05-17,516.57,0,-83484,97672171,-63323414,0.0854736811368716,98.6249379058033,-1
435.59,436,2004,2004,82164,82164,2024-05-07,2024-06-21,516.57,0,0,348355461,-84761006,0.0235862528935638,99.5834108654895,0
475.64,476,2307,2282,136113,82152,2024-05-07,2024-05-31,516.57,-25,-53961,66348411,-19082513,0.12381909191465,97.4433615297886,-0.65684341221151
349.65,350,2305,2308,89895,80780,2024-05-07,2024-08-16,516.57,3,-9115,103324269,-17142661,0.0781810515397888,99.0748523950361,-0.112837335974251
467.92,468,9245,10090,110940,80720,2024-05-07,2024-05-17,516.57,845,-30220,97672171,-63323414,0.0826438064942777,98.7075817122976,-0.374380574826561
516.34,540,24,34,69240,80444,2024-05-07,2024-05-17,516.57,10,11204,97672171,-63323414,0.0823612285632517,98.7899429408608,0.13927701258018
244.61,245,2060,2060,94760,80340,2024-05-07,2024-12-20,516.57,0,-14420,537706253,-56832135,0.0149412433929795,99.898393593723,-0.17948717948718
436.67,437,2412,2426,106128,80058,2024-05-07,2024-06-21,516.57,14,-26070,348355461,-84761006,0.0229816979961167,99.6063925634856,-0.325638911788953
497.12,510,45,62,66690,79856,2024-05-07,2024-10-18,516.57,17,13166,1530129,786938,5.21890637978889,75.2758100787581,0.164871769184532
339.93,340,11384,11394,102456,79758,2024-05-07,2024-06-21,516.57,10,-22698,348355461,-84761006,0.0228955790648564,99.6292881425505,-0.284585872263597
510.89,519,5,98,6035,79478,2024-05-07,2024-06-07,516.57,93,73443,14143969,2013047,0.561921480455734,93.465349082708,0.92406703741916
374.81,375,4131,4131,78489,78489,2024-05-07,2024-06-28,516.57,0,0,83365113,-15781476,0.0941508949912897,97.0065871559486,0
214.68,215,2442,2442,78144,78144,2024-05-07,2024-12-20,516.57,0,0,537706253,-56832135,0.0145328419678988,99.9129264356909,0
475.59,477,372,550,72168,77550,2024-05-07,2024-06-28,516.57,178,5382,83365113,-15781476,0.0930245245394197,97.099611680488,0.0694003868471954
486.61,487,1994,1988,131604,77532,2024-05-07,2024-05-24,516.57,-6,-54072,17630372,-8762837,0.439763834818687,96.2304822609529,-0.697415260795543
467.82,469,682,657,96844,77526,2024-05-07,2024-06-28,516.57,-25,-19318,83365113,-15781476,0.0929957355182857,97.1926074160063,-0.249180919949436
465.77,466,3340,3341,103540,76843,2024-05-07,2024-05-31,516.57,1,-26697,66348411,-19082513,0.115817393124908,97.5591789229135,-0.347422666996343
488.37,490,155,470,37045,76610,2024-05-07,2024-06-14,516.57,315,39565,17277101,14428074,0.443419298179712,94.133165048928,0.5164469390419
450.21,451,963,963,76077,76077,2024-05-07,2024-06-28,516.57,0,0,83365113,-15781476,0.091257598367317,97.2838650143736,0
359.61,360,1919,1942,84436,75738,2024-05-07,2024-08-16,516.57,23,-8698,103324269,-17142661,0.0733012686496722,99.1481536636857,-0.11484327550239
169.87,170,4183,5805,54379,75465,2024-05-07,2024-12-20,516.57,1622,21086,537706253,-56832135,0.0140346145463181,99.9269610502372,0.279414298018949
439.88,440,6644,6222,99660,74664,2024-05-07,2024-05-31,516.57,-422,-24996,66348411,-19082513,0.112533215000432,97.6717121379139,-0.33477981356477
497.93,498,13051,10599,247969,74193,2024-05-07,2024-05-10,516.57,-2452,-173776,11379310,-7506291,0.65199911066664,92.2015658242899,-2.34221557289771
473.73,480,57,118,41496,73986,2024-05-07,2024-10-18,516.57,61,32490,1530129,786938,4.83527859415775,80.1110886729158,0.439137134052388
490.06,492,36,379,9504,73526,2024-05-07,2024-06-14,516.57,343,64022,17277101,14428074,0.425569081294368,94.5587341302224,0.870739602317548
477.51,485,104,98,85176,73402,2024-05-07,2024-10-18,516.57,-6,-11774,1530129,786938,4.7971118774953,84.9082005504111,-0.16040434865535
466,467,578,732,74562,73200,2024-05-07,2024-06-28,516.57,154,-1362,83365113,-15781476,0.087806514458872,97.3716715288325,-0.0186065573770492
482.49,483,844,1426,65832,72726,2024-05-07,2024-05-31,516.57,582,6894,66348411,-19082513,0.109612270895229,97.7813244088091,0.0947941588977807
479.03,480,454,749,63106,72653,2024-05-07,2024-06-14,516.57,295,9547.00000000001,17277101,14428074,0.420516150249975,94.9792502804724,0.13140544781358
429.64,430,2010,2009,90450,72324,2024-05-07,2024-06-28,516.57,-1,-18126,83365113,-15781476,0.086755715187479,97.4584272440199,-0.250622200099552
304.61,305,1853,1853,72267,72267,2024-05-07,2024-09-20,516.57,0,0,300792694,-48138153,0.0240255170559429,99.7451008567382,0
512.23,523,66,67,86724,72159,2024-05-07,2024-05-31,516.57,1,-14565,66348411,-19082513,0.108757691273119,97.8900821000823,-0.201845923585416
470.98,474,233,237,90870,71574,2024-05-07,2024-08-16,516.57,4,-19296,103324269,-17142661,0.0692712377186041,99.2174249014043,-0.269595104367508
506.79,512.5,12,125,9744,71375,2024-05-07,2024-06-14,516.57,113,61631,17277101,14428074,0.413119075937566,95.39236935641,0.863481611208406
432.68,433,2183,2228,87320,71296,2024-05-07,2024-06-21,516.57,45,-16024,348355461,-84761006,0.0204664510771083,99.6497545936276,-0.224753141831239
482.11,484,426,377,107352,71253,2024-05-07,2024-06-28,516.57,-49,-36099,83365113,-15781476,0.0854710051193717,97.5438982491393,-0.506631299734748
457.18,458,867,865,83232,70930,2024-05-07,2024-06-28,516.57,-2,-12302,83365113,-15781476,0.0850835528766092,97.6289818020159,-0.173438601438037
515.73,580,7,11,47817,70697,2024-05-07,2024-06-21,516.57,4,22880,348355461,-84761006,0.0202945002776919,99.6700490939053,0.32363466625175
412.78,413,3173,3207,203072,70554,2024-05-07,2024-06-21,516.57,34,-132518,348355461,-84761006,0.0202534502537912,99.6903025441591,-1.87824928423619
485.42,486,1221,1216,114774,70528,2024-05-07,2024-05-31,516.57,-5,-44246,66348411,-19082513,0.106299456063839,97.9963815561461,-0.627353675136116
219.78,220,3205,3205,70510,70510,2024-05-07,2024-09-20,516.57,0,0,300792694,-48138153,0.0234413938258753,99.7685422505641,0
249.85,250,4683,4683,70245,70245,2024-05-07,2024-09-20,516.57,0,0,300792694,-48138153,0.0233532932817843,99.7918955438459,0
428.71,429,2406,2406,84210,69774,2024-05-07,2024-06-21,516.57,0,-14436,348355461,-84761006,0.0200295410325145,99.7103320851916,-0.206896551724138
438.62,439,1838,1834,79034,69692,2024-05-07,2024-06-21,516.57,-4,-9342,348355461,-84761006,0.02000600185797,99.7303380870495,-0.134046949434655
412.55,413,1517,1517,68265,68265,2024-05-07,2024-06-28,516.57,0,0,83365113,-15781476,0.0818867719881817,97.7108685740041,0
507.17,507.5,1786,2056,217892,67848,2024-05-07,2024-05-10,516.57,270,-150044,11379310,-7506291,0.596240018067879,92.7978058423578,-2.2114727036906
460.17,461,823,816,83946,67728,2024-05-07,2024-06-28,516.57,-7,-16218,83365113,-15781476,0.0812426176403072,97.7921111916444,-0.239457831325301
319.96,320,16631,16866,99786,67464,2024-05-07,2024-06-21,516.57,235,-32322,348355461,-84761006,0.0193664252618104,99.7497045123114,-0.479099964425471
349.79,350,3205,3207,76920,67347,2024-05-07,2024-07-19,516.57,2,-9573,117399288,-25407869,0.0573657652847094,99.2962427506375,-0.142144416232349
394.38,395,1081,1081,77832,67022,2024-05-07,2024-08-16,516.57,0,-10810,103324269,-17142661,0.0648656899764759,99.2822905913808,-0.161290322580645
458.15,459,785,787,78500,66895,2024-05-07,2024-06-28,516.57,2,-11605,83365113,-15781476,0.0802433986984459,97.8723545903429,-0.17348082816354
461.06,462,709,710,79408,66740,2024-05-07,2024-06-28,516.57,1,-12668,83365113,-15781476,0.0800574696036219,97.9524120599465,-0.189811207671561
471.8,473,556,556,92852,66720,2024-05-07,2024-06-28,516.57,0,-26132,83365113,-15781476,0.0800334787526768,98.0324455386991,-0.391666666666667
450.95,451,13184,13163,118656,65815,2024-05-07,2024-05-17,516.57,-21,-52841,97672171,-63323414,0.067383574385789,98.8573265152466,-0.802871685785915
513.94,533,33,34,100815,64804,2024-05-07,2024-07-19,516.57,1,-36011,117399288,-25407869,0.0551996533403167,99.3514424039778,-0.55569100672798
434.89,435,5849,5859,76037,64449,2024-05-07,2024-05-31,516.57,10,-11588,66348411,-19082513,0.0971372170465394,98.0935187731926,-0.179801083026889
418.76,419,2670,2644,80100,63456,2024-05-07,2024-06-21,516.57,-26,-16644,348355461,-84761006,0.0182158763401731,99.7679203886515,-0.262291981845689
509.51,517,35,84,34790,62916,2024-05-07,2024-06-14,516.57,49,28126,17277101,14428074,0.364158315680391,95.7565276720904,0.447040498442368
424.65,425,1818,1794,74538,62790,2024-05-07,2024-06-28,516.57,-24,-11748,83365113,-15781476,0.0753192765419751,98.1077648152411,-0.187099856665074
423.59,424,1530,1530,62730,62730,2024-05-07,2024-06-28,516.57,0,0,83365113,-15781476,0.0752473039891399,98.1830121192303,0
423.74,424,2393,2401,105292,62426,2024-05-07,2024-06-21,516.57,8,-42866,348355461,-84761006,0.0179202013428462,99.7858405899944,-0.68666901611508
453.93,454,8896,8903,88960,62321,2024-05-07,2024-05-17,516.57,7,-26639,97672171,-63323414,0.0638063015922929,98.9211328168389,-0.427448211678246
477.62,478,1637,1617,90035,61446,2024-05-07,2024-05-31,516.57,-20,-28589,66348411,-19082513,0.0926111101590662,98.1861298833517,-0.465270318653777
475.12,476,4,698,492,61424,2024-05-07,2024-06-14,516.57,694,60932,17277101,14428074,0.355522607641178,96.1120502797315,0.991990101588956
514.2,534,27,31,81108,61380,2024-05-07,2024-07-19,516.57,4,-19728,117399288,-25407869,0.0522831109503833,99.4037255149282,-0.321407624633431
463.91,464,6814,6813,74954,61317,2024-05-07,2024-05-17,516.57,-1,-13637,97672171,-63323414,0.0627783731765315,98.9839111900154,-0.222401617822138
389.33,390,912,912,61104,61104,2024-05-07,2024-08-16,516.57,0,0,103324269,-17142661,0.0591380907809762,99.3414286821618,0
224.9,225,6105,6105,61050,61050,2024-05-07,2024-09-20,516.57,0,0,300792694,-48138153,0.020296370629268,99.8121919144752,0
224.69,225,1968,1968,68880,61008,2024-05-07,2024-12-20,516.57,0,-7871.99999999999,537706253,-56832135,0.0113459718312035,99.9383070220684,-0.129032258064516
490.45,491,1001,1102,99099,60610,2024-05-07,2024-05-24,516.57,101,-38489,17630372,-8762837,0.343781742098238,96.5742640030511,-0.63502722323049
474.5,475,1233,1208,91242,60400,2024-05-07,2024-06-07,516.57,-25,-30842,14143969,2013047,0.427037135050282,93.8923862177583,-0.510629139072848
437.63,438,1625,1626,73125,60162,2024-05-07,2024-06-21,516.57,1,-12963,348355461,-84761006,0.0172702904749353,99.8031108804693,-0.215468235763439
329.84,330,3685,3749,66330,59984,2024-05-07,2024-07-19,516.57,64,-6346,117399288,-25407869,0.0510940066348614,99.454819521563,-0.105794878634302
489.97,490,21497,19863,150479,59589,2024-05-07,2024-05-10,516.57,-1634,-90890,11379310,-7506291,0.523660924959422,93.3214667673172,-1.5252815116884
249.91,250,6538,6538,58842,58842,2024-05-07,2024-08-16,516.57,0,0,103324269,-17142661,0.0569488664855688,99.3983775486474,0
511.17,520,3,66,3498,58278,2024-05-07,2024-06-14,516.57,63,54780,17277101,14428074,0.337313534255544,96.4493638139871,0.939977349943375
494.35,496,302,349,75198,57585,2024-05-07,2024-06-07,516.57,47,-17613,14143969,2013047,0.407134659302491,94.2995208770608,-0.305860901276374
443.43,444,1008,1008,64512,57456,2024-05-07,2024-06-28,516.57,0,-7056.00000000001,83365113,-15781476,0.068920916594931,98.2519330358252,-0.12280701754386
369.85,370,3816,3829,68688,57435,2024-05-07,2024-06-28,516.57,13,-11253,83365113,-15781476,0.0688957262014387,98.3208287620266,-0.195925829198224
487.11,493,96,97,67200,57133,2024-05-07,2024-08-16,516.57,1,-10067,103324269,-17142661,0.0552948504286055,99.453672399076,-0.176202894999388
437.53,438,1199,1198,112706,56306,2024-05-07,2024-06-28,516.57,-1,-56400,83365113,-15781476,0.0675414426655908,98.3883702046922,-1.0016694490818
401.43,402,982,982,55974,55974,2024-05-07,2024-06-28,516.57,0,0,83365113,-15781476,0.067143194539903,98.4555133992321,0
515.35,527,15,48,24600,55920,2024-05-07,2024-05-31,516.57,33,31320,66348411,-19082513,0.0842823500324673,98.2704122333842,0.560085836909871
435.56,436,1268,1269,90028,55836,2024-05-07,2024-06-28,516.57,1,-34192,83365113,-15781476,0.0669776576683822,98.5224910569005,-0.612364782577549
299.89,300,4972,4971,59664,54681,2024-05-07,2024-07-19,516.57,-1,-4982.99999999999,117399288,-25407869,0.0465769434649382,99.501396465028,-0.0911285455642726
416.78,417,2479,2480,109076,54560,2024-05-07,2024-06-21,516.57,1,-54516,348355461,-84761006,0.0156621629652018,99.8187730434345,-0.999193548387097
513.6,535,20,25,68680,53500,2024-05-07,2024-06-28,516.57,5,-15180,83365113,-15781476,0.0641755262780007,98.5866665831785,-0.283738317757009
491.99,494,57,266,15960,53466,2024-05-07,2024-06-14,516.57,209,37506,17277101,14428074,0.309461639426661,96.7588254534137,0.701492537313433
414.71,415,1740,1842,62640,53418,2024-05-07,2024-06-28,516.57,102,-9222.00000000001,83365113,-15781476,0.064077163789126,98.6507437469676,-0.172638436482085
354.58,355,1270,1270,53340,53340,2024-05-07,2024-08-16,516.57,0,0,103324269,-17142661,0.0516238832524429,99.5052962823284,0
448.94,449,8889,8884,71112,53304,2024-05-07,2024-05-17,516.57,-5,-17808,97672171,-63323414,0.054574398679026,99.0384855886945,-0.334083746060333
471.72,472,1932,1900,81144,53200,2024-05-07,2024-05-31,516.57,-32,-27944,66348411,-19082513,0.0801827793584989,98.3505950127427,-0.525263157894737
515.43,519,131,149,102704,53193,2024-05-07,2024-05-10,516.57,18,-49511,11379310,-7506291,0.467453650528898,93.7889204178461,-0.930780365837611
511.7,600,6,6,52980,52980,2024-05-07,2024-07-19,516.57,0,0,117399288,-25407869,0.0451280420031167,99.5465245070311,0
419.69,420,1698,1686,64524,52266,2024-05-07,2024-06-28,516.57,-12,-12258,83365113,-15781476,0.0626952907746913,98.7134390377423,-0.234531052691999
473.91,474,6921,5715,110736,51435,2024-05-07,2024-05-17,516.57,-1206,-59301,97672171,-63323414,0.0526608546460998,99.0911464433406,-1.15293088363955
514.55,535,21,25,52395,51125,2024-05-07,2024-07-19,516.57,4,-1269.99999999999,117399288,-25407869,0.0435479642772621,99.5900724713083,-0.0248410757946209
359.76,360,2137,2129,74795,51096,2024-05-07,2024-07-19,516.57,-8,-23699,117399288,-25407869,0.0435232622535155,99.6335957335619,-0.463813214341631
495.5,498,14,204,5026,51000,2024-05-07,2024-06-14,516.57,190,45974,17277101,14428074,0.295188411528068,97.0540138649418,0.901450980392157
500.9,501,4728,5098,160752,50980,2024-05-07,2024-05-10,516.57,370,-109772,11379310,-7506291,0.448006074182002,94.2369264920281,-2.15323656335818
384.8,385,2514,2510,55308,50200,2024-05-07,2024-06-28,516.57,-4,-5108.00000000001,83365113,-15781476,0.060217035872068,98.7736560736144,-0.101752988047809
404.96,405,12522,12521,87654,50084,2024-05-07,2024-05-24,516.57,-1,-37570,17630372,-8762837,0.284077953658607,96.8583419567097,-0.750139765194474
254.96,255,14935,12459,89610,49836,2024-05-07,2024-07-19,516.57,-2476,-39774,117399288,-25407869,0.0424500019114256,99.6760457354733,-0.798097760654948
516.04,526,42,50,70014,49800,2024-05-07,2024-05-17,516.57,8,-20214,97672171,-63323414,0.0509868875546956,99.1421333308953,-0.405903614457831
494.96,495,13681,12399,177853,49596,2024-05-07,2024-05-10,516.57,-1282,-128257,11379310,-7506291,0.43584364957102,94.6727701415991,-2.58603516412614
456.94,457,8332,8252,74988,49512,2024-05-07,2024-05-17,516.57,-80,-25476,97672171,-63323414,0.0506920236266684,99.1928253545219,-0.514541929229278
465.9,466,4860,4920,63180,49200,2024-05-07,2024-05-17,516.57,60,-13980,97672171,-63323414,0.050372587704639,99.2431979422266,-0.284146341463415
485.74,488,169,217,53066,49042,2024-05-07,2024-06-28,516.57,48,-4024.00000000001,83365113,-15781476,0.0588279656023497,98.8324840392167,-0.0820521185922272
324.96,325,12202,12228,73212,48912,2024-05-07,2024-06-21,516.57,26,-24300,348355461,-84761006,0.014040830552675,99.8328138739872,-0.496810598626104
462.92,463,7602,6103,76020,48824,2024-05-07,2024-05-17,516.57,-1499,-27196,97672171,-63323414,0.0499876264652702,99.2931855686918,-0.557021137145666
457.94,458,8119,8119,81190,48714,2024-05-07,2024-05-17,516.57,0,-32476,97672171,-63323414,0.0498750048260932,99.3430605735179,-0.666666666666667
409.72,410,1727,1727,56991,48356,2024-05-07,2024-06-28,516.57,0,-8635,83365113,-15781476,0.0580050794149346,98.8904891186317,-0.178571428571429
451.79,452,2295,2295,48195,48195,2024-05-07,2024-05-31,516.57,0,0,66348411,-19082513,0.0726392678793769,98.423234280622,0
488.42,491,179,186,63366,47988,2024-05-07,2024-06-28,516.57,7,-15378,83365113,-15781476,0.0575636477575458,98.9480527663892,-0.320455113778445
456.82,457,2623,2621,65575,47178,2024-05-07,2024-05-31,516.57,-2,-18397,66348411,-19082513,0.071106450461941,98.494340731084,-0.389948704904829
405.7,406,1548,1548,46440,46440,2024-05-07,2024-06-28,516.57,0,0,83365113,-15781476,0.0557067558943991,99.0037595222836,0
513.45,525,5,40,8440,46200,2024-05-07,2024-06-14,516.57,35,37760,17277101,14428074,0.267405972796015,97.3214198377378,0.817316017316017
411.78,412,2094,2085,60726,45870,2024-05-07,2024-06-21,516.57,-9,-14856,348355461,-84761006,0.0131675845896959,99.8459814585769,-0.323871811641596
495.63,497.5,239,245,68354,45815,2024-05-07,2024-06-07,516.57,6,-22539,14143969,2013047,0.323918979177627,94.6234398562384,-0.491956782713085
464.85,465,3156,3005,63120,45075,2024-05-07,2024-05-24,516.57,-151,-18045,17630372,-8762837,0.255666755074709,97.1140087117844,-0.400332778702163
289.75,290,1775,1776,49700,44400,2024-05-07,2024-09-20,516.57,1,-5300.00000000001,300792694,-48138153,0.0147609968212858,99.8269529112964,-0.11936936936937
509.71,522,36,36,44244,44244,2024-05-07,2024-05-24,516.57,0,0,17630372,-8762837,0.250953298092632,97.3649620098771,0
500.59,720,2,2,43882,43882,2024-05-07,2024-12-20,516.57,0,0,537706253,-56832135,0.00816096144598862,99.9464679835144,0
417.68,418,1365,1365,43680,43680,2024-05-07,2024-06-21,516.57,0,0,348355461,-84761006,0.0125389163914959,99.8585203749684,0
214.92,215,5419,5394,48771,43152,2024-05-07,2024-09-20,516.57,-25,-5619,300792694,-48138153,0.0143460931268497,99.8412990044233,-0.130214126807564
424.91,425,5111,4772,61332,42948,2024-05-07,2024-05-31,516.57,-339,-18384,66348411,-19082513,0.0647310151858799,98.5590717462699,-0.428052528639285
464.66,465,743,1249,34921,42466,2024-05-07,2024-06-07,516.57,506,7545,14143969,2013047,0.300241042666312,94.9236808989047,0.177671549003909
510.6,518,57,57,55005,42180,2024-05-07,2024-06-07,516.57,0,-12825,14143969,2013047,0.298218979410942,95.2218998783156,-0.304054054054054
460.93,461,6003,6001,60030,42007,2024-05-07,2024-05-17,516.57,-2,-18023,97672171,-63323414,0.0430081563355441,99.3860687298535,-0.429047539695765
484.15,485,460,494,58880,41990,2024-05-07,2024-06-07,516.57,34,-16890,14143969,2013047,0.296875650674857,95.5187755289905,-0.40223862824482
497.91,501,122,134,50142,41406,2024-05-07,2024-06-14,516.57,12,-8736,17277101,14428074,0.239658262112376,97.5610780998502,-0.210983915374583
477.4,478,579,689,51531,41340,2024-05-07,2024-06-07,516.57,110,-10191,14143969,2013047,0.292280052367196,95.8110555813577,-0.246516690856314
474.97,475,13797,13687,55188,41061,2024-05-07,2024-05-10,516.57,-110,-14127,11379310,-7506291,0.360839101843609,95.0336092434427,-0.344049097683934
469.83,470,2426,2412,58224,41004,2024-05-07,2024-05-24,516.57,-14,-17220,17630372,-8762837,0.232575920689592,97.5975379305666,-0.419959028387474
389.8,390,2044,2043,47012,40860,2024-05-07,2024-06-28,516.57,-1,-6152,83365113,-15781476,0.049013308480731,99.0527728307644,-0.150562897699462
492.52,494,261,275,60030,40700,2024-05-07,2024-06-07,516.57,14,-19330,14143969,2013047,0.287755155571961,96.0988107369296,-0.474938574938575
480.71,481,1403,1400,64538,40600,2024-05-07,2024-05-24,516.57,-3,-23938,17630372,-8762837,0.230284420544274,97.8278223511109,-0.589605911330049
489.3,491,32,233,8032,39610,2024-05-07,2024-06-14,516.57,201,31578,17277101,14428074,0.229262999620133,97.7903410994703,0.797222923504166
424.96,425,9570,9861,57420,39444,2024-05-07,2024-05-17,516.57,291,-17976,97672171,-63323414,0.0403840721427191,99.4264528019962,-0.455734712503803
500.85,550,8,8,39320,39320,2024-05-07,2024-05-10,516.57,0,0,11379310,-7506291,0.345539404410285,95.379148647853,0
489.74,491,183,312,34770,39312,2024-05-07,2024-06-07,516.57,129,4542,14143969,2013047,0.277941785647296,96.3767525225769,0.115537240537241
503.7,520,2,24,3780,39120,2024-05-07,2024-10-18,516.57,22,35340,1530129,786938,2.55664718464914,87.4648477350602,0.903374233128834
472.71,473,1367,1343,60148,38947,2024-05-07,2024-05-31,516.57,-24,-21201,66348411,-19082513,0.0587007275878845,98.6177724738577,-0.544355149305466
431.69,432,1255,1253,47690,38843,2024-05-07,2024-06-21,516.57,-2,-8847,348355461,-84761006,0.0111503921564761,99.8696707671249,-0.227763046108694
491.1,493,113,204,31866,38760,2024-05-07,2024-06-14,516.57,91,6894,17277101,14428074,0.224343192761332,98.0146842922317,0.177863777089783
514.3,540,12,15,35568,38550,2024-05-07,2024-08-16,516.57,3,2982,103324269,-17142661,0.0373097243978566,99.5426060067263,0.0773540856031128
492.96,505,31,32,40176,38528,2024-05-07,2024-10-18,516.57,1,-1648.00000000001,1530129,786938,2.51795763625158,89.9828053713118,-0.0427740863787377
394.62,395,959,1004,42196,38152,2024-05-07,2024-07-19,516.57,45,-4044,117399288,-25407869,0.0324976417233467,99.7085433771966,-0.105997064374083
425.74,426,1392,1416,47328,36816,2024-05-07,2024-06-21,516.57,24,-10512,348355461,-84761006,0.0105685152442608,99.8802392823691,-0.285528031290743
184.81,185,1936,1936,36784,36784,2024-05-07,2024-12-20,516.57,0,0,537706253,-56832135,0.00684090984524965,99.9533088933597,0
451.35,452,568,565,46008,36725,2024-05-07,2024-06-28,516.57,-3,-9283.00000000001,83365113,-15781476,0.0440532000478426,99.0968260308122,-0.252770592239619
481.28,482,371,510,39697,36720,2024-05-07,2024-06-07,516.57,139,-2977,14143969,2013047,0.259615953626595,96.6363684762035,-0.0810729847494553
199.94,200,6068,6084,42476,36504,2024-05-07,2024-09-20,516.57,16,-5972.00000000001,300792694,-48138153,0.0121359330622572,99.8534349374856,-0.163598509752356
364.52,365,759,759,36432,36432,2024-05-07,2024-08-16,516.57,0,0,103324269,-17142661,0.0352598671663479,99.5778658738926,0
491.58,493,168,256,34608,36352,2024-05-07,2024-06-07,516.57,88,1744,14143969,2013047,0.257014137969335,96.8933826141729,0.0479753521126761
427.62,428,947,947,67237,35986,2024-05-07,2024-06-28,516.57,0,-31251,83365113,-15781476,0.0431667381054231,99.1399927689176,-0.868421052631579
149.97,150,11972,11973,35916,35919,2024-05-07,2024-09-20,516.57,1,3,300792694,-48138153,0.0119414469554902,99.865376384441,8.35212561596926e-05
426.73,427,1326,1325,75582,35775,2024-05-07,2024-06-21,516.57,-1,-39807,348355461,-84761006,0.0102696825527877,99.8905089649219,-1.11270440251572
483.64,484,1023,993,58311,35748,2024-05-07,2024-05-24,516.57,-30,-22563,17630372,-8762837,0.202763730680215,98.0305860817911,-0.631168177240685
485.63,486,938,961,58156,35557,2024-05-07,2024-05-24,516.57,23,-22599,17630372,-8762837,0.201680372938245,98.2322664547294,-0.635571054925893
490.67,492,254,266,48768,35378,2024-05-07,2024-06-07,516.57,12,-13390,14143969,2013047,0.250127810659087,97.143510424832,-0.378483803493697
498.93,499,4331,4963,103944,34741,2024-05-07,2024-05-10,516.57,632,-69203,11379310,-7506291,0.305299706221203,95.6844483540742,-1.99196914308742
279.76,280,1430,1441,34320,34584,2024-05-07,2024-09-20,516.57,11,264,300792694,-48138153,0.0114976196862016,99.8768740041272,0.00763358778625954
459.71,460,1198,1189,46722,34481,2024-05-07,2024-06-07,516.57,-9,-12241,14143969,2013047,0.243785884994516,97.3872963098265,-0.355007105362374
234.65,235,980,982,41160,34370,2024-05-07,2024-12-20,516.57,2,-6790,537706253,-56832135,0.00639196583789774,99.9597008591976,-0.19755600814664
485.51,487,139,228,28356,33972,2024-05-07,2024-06-14,516.57,89,5616,17277101,14428074,0.196630210126109,98.2113145023578,0.165312610385023
471.91,472,3798,3758,56970,33822,2024-05-07,2024-05-17,516.57,-40,-23148,97672171,-63323414,0.034628082547689,99.4610808845439,-0.684406599254923
430.89,431,3054,3054,39702,33594,2024-05-07,2024-05-31,516.57,0,-6108.00000000001,66348411,-19082513,0.0506327122137107,98.6684051860715,-0.181818181818182
486.97,487,11156,11144,66936,33432,2024-05-07,2024-05-10,516.57,-12,-33504,11379310,-7506291,0.293796372539284,95.9782447266135,-1.0021536252692
159.88,160,2786,2786,33432,33432,2024-05-07,2024-12-20,516.57,0,0,537706253,-56832135,0.00621752114904269,99.9659183803466,0
514.75,528,1,25,2428,33125,2024-05-07,2024-05-31,516.57,24,30697,66348411,-19082513,0.0499258377114713,98.7183310237829,0.926701886792453
505.8,525,4,17,8460,32640,2024-05-07,2024-10-18,516.57,13,24180,1530129,786938,2.13315347921646,92.1159588505283,0.740808823529412
499.58,503,54,95,24948,32490,2024-05-07,2024-06-14,516.57,41,7542,17277101,14428074,0.188052382167587,98.3993668845254,0.23213296398892
364.74,365,1050,1245,30450,32370,2024-05-07,2024-07-19,516.57,195,1920,117399288,-25407869,0.027572569264645,99.7361159464613,0.0593141797961075
469.61,470,754,824,42978,32136,2024-05-07,2024-06-07,516.57,70,-10842,14143969,2013047,0.227206380330726,97.6145026901572,-0.337378640776699
490,500,32,32,37760,32000,2024-05-07,2024-10-18,516.57,0,-5760,1530129,786938,2.09132694040829,94.2072857909366,-0.18
500.2,504,72,84,36576,31920,2024-05-07,2024-06-14,516.57,12,-4656,17277101,14428074,0.184753217568156,98.5841201020935,-0.145864661654135
481.68,482,989,993,49450,31776,2024-05-07,2024-05-24,516.57,4,-17674,17630372,-8762837,0.180234427271302,98.4125008820007,-0.556205941591138
470.73,471,1192,1176,50064,31752,2024-05-07,2024-05-31,516.57,-16,-18312,66348411,-19082513,0.0478564588381778,98.7661874826211,-0.576719576719577
452.94,453,5281,5256,47529,31536,2024-05-07,2024-05-17,516.57,-25,-15993,97672171,-63323414,0.0322876001189735,99.4933684846628,-0.507134703196347
289.97,290,10351,10504,31053,31512,2024-05-07,2024-06-21,516.57,153,459.000000000004,348355461,-84761006,0.00904593253957916,99.8995548974615,0.0145658796648897
505.5,550,7,7,31150,31150,2024-05-07,2024-07-19,516.57,0,0,117399288,-25407869,0.0265333806794467,99.7626493271407,0
304.74,305,1192,1192,30992,30992,2024-05-07,2024-08-16,516.57,0,0,103324269,-17142661,0.0299948891968449,99.6078607630895,0
454.87,455,2480,2376,34720,30888,2024-05-07,2024-05-24,516.57,-104,-3832.00000000001,17630372,-8762837,0.175197664575654,98.5876985465763,-0.124061124061124
349.9,350,3060,3083,42840,30830,2024-05-07,2024-06-28,516.57,23,-12010,83365113,-15781476,0.03698189673179,99.1769746656494,-0.38955562763542
514.05,525,10,28,14700,30660,2024-05-07,2024-06-07,516.57,18,15960,14143969,2013047,0.216770837096716,97.8312735272539,0.520547945205479
269.81,270,1330,1611,27930,30609,2024-05-07,2024-09-20,516.57,281,2679,300792694,-48138153,0.0101761115248364,99.8870501156521,0.0875232774674116
487,488,215,306,32680,30600,2024-05-07,2024-06-07,516.57,91,-2080,14143969,2013047,0.216346628022163,98.0476201552761,-0.0679738562091503
514.46,545,0,10,0,30540,2024-05-07,2024-09-20,516.57,10,30540,300792694,-48138153,0.0101531721378844,99.89720328779,1
451.91,452,3387,3387,30483,30483,2024-05-07,2024-05-17,516.57,0,0,97672171,-63323414,0.0312095038821242,99.524577988545,0
488.96,489,7718,7609,54026,30436,2024-05-07,2024-05-10,516.57,-109,-23590,11379310,-7506291,0.267467886892966,96.2457126135065,-0.775068997240111
515.19,525,23,31,32223,30411,2024-05-07,2024-05-24,516.57,8,-1812,17630372,-8762837,0.172492106235762,98.7601906528121,-0.0595837032652659
515.35,523,2,39,2304,29835,2024-05-07,2024-05-10,516.57,37,27531,11379310,-7506291,0.262186371581405,96.5078989850879,0.922775263951735
379.84,380,1787,1840,37527,29440,2024-05-07,2024-06-28,516.57,53,-8087,83365113,-15781476,0.0353145325911092,99.2122891982405,-0.274694293478261
485.06,486,277,313,37949,29422,2024-05-07,2024-06-07,516.57,36,-8527.00000000001,14143969,2013047,0.208017989858434,98.2556381451345,-0.289817143634016
408.56,409,668,668,29392,29392,2024-05-07,2024-06-28,516.57,0,0,83365113,-15781476,0.0352569545488411,99.2475461527894,0
254.53,255,618,618,29046,29046,2024-05-07,2024-12-20,516.57,0,0,537706253,-56832135,0.0054018341497695,99.9713202144964,0
466.76,467,1206,1195,39798,28680,2024-05-07,2024-05-31,516.57,-11,-11118,66348411,-19082513,0.0432263554887547,98.8094138381098,-0.38765690376569
432.51,433,582,582,28518,28518,2024-05-07,2024-06-28,516.57,0,0,83365113,-15781476,0.0342085543625425,99.2817547071519,0
468.75,469,1138,1138,42106,28450,2024-05-07,2024-05-31,516.57,0,-13656,66348411,-19082513,0.0428797006155882,98.8522935387255,-0.48
279.89,280,2582,2582,28402,28402,2024-05-07,2024-07-19,516.57,0,0,117399288,-25407869,0.0241926509809838,99.7868419781217,0
452.84,453,1765,1764,37065,28224,2024-05-07,2024-05-31,516.57,-1,-8841,66348411,-19082513,0.0425390745228247,98.8948326132483,-0.313244047619048
422.64,423,784,782,40768,28152,2024-05-07,2024-06-28,516.57,-2,-12616,83365113,-15781476,0.0337695217902482,99.3155242289421,-0.448138675760159
483.2,484,275,350,33825,28000,2024-05-07,2024-06-07,516.57,75,-5825,14143969,2013047,0.197964234791521,98.453602379926,-0.208035714285714
467.76,468,1160,1162,40600,27888,2024-05-07,2024-05-31,516.57,2,-12712,66348411,-19082513,0.0420326569689815,98.9368652702173,-0.455823293172691
509.65,535,11,11,27885,27885,2024-05-07,2024-06-21,516.57,0,0,348355461,-84761006,0.00800475466064245,99.9075596521221,0
284.76,285,1161,1160,31347,27840,2024-05-07,2024-09-20,516.57,-1,-3507.00000000001,300792694,-48138153,0.00925554395280625,99.9064588317428,-0.125969827586207
299.83,300,1677,1633,31863,27761,2024-05-07,2024-08-16,516.57,-44,-4102,103324269,-17142661,0.0268678407006199,99.6347286037901,-0.147761247793667
254.91,255,2021,3071,18189,27639,2024-05-07,2024-08-16,516.57,1050,9450,103324269,-17142661,0.0267497658270391,99.6614783696171,0.341908173233474
461.91,462,3138,3060,31380,27540,2024-05-07,2024-05-17,516.57,-78,-3840,97672171,-63323414,0.0281963631175967,99.5527743516626,-0.139433551198257
269.98,270,13703,13753,41109,27506,2024-05-07,2024-06-21,516.57,50,-13603,348355461,-84761006,0.00789595774415031,99.9154556098663,-0.494546644368502
254.83,255,1612,1612,27404,27404,2024-05-07,2024-09-20,516.57,0,0,300792694,-48138153,0.00911059362366029,99.9155694253664,0
199.96,200,6742,6767,26968,27068,2024-05-07,2024-08-16,516.57,25,100,103324269,-17142661,0.0261971367056079,99.6876755063227,0.00369439929067534
289.99,290,26842,26842,26842,26842,2024-05-07,2024-05-17,516.57,0,0,97672171,-63323414,0.0274817276253642,99.5802560792879,0
359.84,360,1675,1675,26800,26800,2024-05-07,2024-06-28,516.57,0,0,83365113,-15781476,0.032147740266363,99.3476719692085,0
515.25,524,23,30,27577,26250,2024-05-07,2024-05-10,516.57,7,-1327,11379310,-7506291,0.230681825172177,96.73858081026,-0.050552380952381
379.48,380,504,504,29736,26208,2024-05-07,2024-08-16,516.57,0,-3528,103324269,-17142661,0.0253648056295467,99.7130403119523,-0.134615384615384
502.78,555,5,5,26110,26110,2024-05-07,2024-09-20,516.57,0,0,300792694,-48138153,0.00868039700458948,99.924249822371,0
453.85,454,1733,1729,38126,25935,2024-05-07,2024-05-31,516.57,-4,-12191,66348411,-19082513,0.0390891049372682,98.9759543751545,-0.470059764796607
429.9,430,2540,2550,30480,25500,2024-05-07,2024-05-31,516.57,10,-4980,66348411,-19082513,0.0384334750684534,99.014387850223,-0.195294117647059
459.88,460,2273,2115,40914,25380,2024-05-07,2024-05-24,516.57,-158,-15534,17630372,-8762837,0.143956122990485,98.9041467758026,-0.612056737588653
319.97,320,8406,8406,25218,25218,2024-05-07,2024-05-17,516.57,0,0,97672171,-63323414,0.0258190226978778,99.6060751019858,0
455.23,456,314,324,28260,24948,2024-05-07,2024-06-28,516.57,10,-3312,83365113,-15781476,0.0299261874688516,99.3775981566774,-0.132756132756133
482.69,483,765,795,38250,24645,2024-05-07,2024-05-24,516.57,30,-13605,17630372,-8762837,0.139787180894425,99.043933956697,-0.55203895313451
259.95,260,4922,4922,39376,24610,2024-05-07,2024-07-19,516.57,0,-14766,117399288,-25407869,0.0209626484276463,99.8078046265494,-0.6
194.8,195,1225,1225,24500,24500,2024-05-07,2024-12-20,516.57,0,0,537706253,-56832135,0.00455639112681102,99.9758766056232,0
438.88,439,2023,2033,64736,24396,2024-05-07,2024-05-31,516.57,10,-40340,66348411,-19082513,0.0367695316772545,99.0511573819002,-1.65354976225611
389.64,390,617,671,24680,24156,2024-05-07,2024-07-19,516.57,54,-524,117399288,-25407869,0.020575933986925,99.8283805605363,-0.021692333167743
404.74,405,906,924,27180,24024,2024-05-07,2024-06-28,516.57,18,-3156,83365113,-15781476,0.0288178101551905,99.4064159668326,-0.131368631368631
447.94,448,3990,3993,31920,23958,2024-05-07,2024-05-17,516.57,3,-7962,97672171,-63323414,0.024528993012759,99.6306040949986,-0.332331580265465
179.85,180,1595,1593,28710,23895,2024-05-07,2024-12-20,516.57,-2,-4815,537706253,-56832135,0.00444387616225099,99.9803204817854,-0.2015065913371
409.97,410,7848,7949,31392,23847,2024-05-07,2024-05-17,516.57,101,-7545,97672171,-63323414,0.0244153475404985,99.6550194425391,-0.316391998993584
441.88,442,1971,1972,31536,23664,2024-05-07,2024-05-31,516.57,1,-7872,66348411,-19082513,0.0356662648635248,99.0868236467638,-0.332657200811359
476.65,477,683,676,36199,23660,2024-05-07,2024-05-31,516.57,-7,-12539,66348411,-19082513,0.0356602360831219,99.1224838828469,-0.529966187658495
486.25,495,17,27,17561,23625,2024-05-07,2024-10-18,516.57,10,6064,1530129,786938,1.54398746772331,95.7512732586599,0.256677248677249
455.83,456,1387,1387,31901,23579,2024-05-07,2024-05-31,516.57,0,-8322,66348411,-19082513,0.0355381532799633,99.1580220361269,-0.352941176470588
402.61,403,600,600,23400,23400,2024-05-07,2024-06-28,516.57,0,0,83365113,-15781476,0.028069295605705,99.4344852624383,0
415.69,416,753,753,23343,23343,2024-05-07,2024-06-21,516.57,0,0,348355461,-84761006,0.00670091404136191,99.9221565239076,0
434.97,435,7751,7771,46506,23313,2024-05-07,2024-05-17,516.57,20,-23193,97672171,-63323414,0.0238686206739482,99.678888063213,-0.994852657315661
229.86,230,1656,1656,23184,23184,2024-05-07,2024-09-20,516.57,0,0,300792694,-48138153,0.00770763401587141,99.9319574563869,0
513.93,524,21,23,31017,23161,2024-05-07,2024-05-24,516.57,2,-7856,17630372,-8762837,0.131369888281427,99.1753038449784,-0.339190881222745
374.98,375,11490,11489,34470,22978,2024-05-07,2024-05-17,516.57,-1,-11492,97672171,-63323414,0.0235256365909999,99.702413699804,-0.500130559665767
514.18,560,0,5,0,22910,2024-05-07,2024-09-20,516.57,5,22910,300792694,-48138153,0.00761654137783014,99.9395739977647,1
400.73,401,845,845,22815,22815,2024-05-07,2024-06-28,516.57,0,0,83365113,-15781476,0.0273675632155624,99.4618528256538,0
264.9,265,1312,2279,15744,22790,2024-05-07,2024-08-16,516.57,967,7046,103324269,-17142661,0.02205677351562,99.7350970854679,0.30917068889864
513.66,521,10,31,10660,22754,2024-05-07,2024-05-24,516.57,21,12094,17630372,-8762837,0.129061372045922,99.3043652170243,0.531510943130878
446.86,447,1618,1622,29124,22708,2024-05-07,2024-05-31,516.57,4,-6416,66348411,-19082513,0.0342253863472329,99.1922474224741,-0.282543596970231
403.75,404,895,895,40275,22375,2024-05-07,2024-06-28,516.57,0,-17900,83365113,-15781476,0.0268397644947713,99.4886925901486,-0.8
478.57,479,516,519,31476,22317,2024-05-07,2024-05-31,516.57,3,-9159,66348411,-19082513,0.03363607306285,99.2258834955369,-0.410404624277457
505.4,550,5,5,22300,22300,2024-05-07,2024-06-07,516.57,0,0,14143969,2013047,0.157664372708962,98.611266752635,0
354.75,355,887,887,22175,22175,2024-05-07,2024-07-19,516.57,0,0,117399288,-25407869,0.0188885302268613,99.8472690907631,0
425.64,426,609,611,91959,21996,2024-05-07,2024-06-28,516.57,2,-69963,83365113,-15781476,0.0263851378693627,99.515077728018,-3.18071467539553
505.07,615,2,2,21986,21986,2024-05-07,2024-08-16,516.57,0,0,103324269,-17142661,0.0212786407421861,99.7563757262101,0
458.93,459,1801,3121,18010,21847,2024-05-07,2024-05-17,516.57,1320,3837,97672171,-63323414,0.0223676813736433,99.7247813811776,0.175630521353046
516.46,560,5,5,24350,21770,2024-05-07,2024-05-17,516.57,0,-2580,97672171,-63323414,0.0222888462262193,99.7470702274039,-0.118511713367019
487.97,488,6734,7250,47138,21750,2024-05-07,2024-05-10,516.57,516,-25388,11379310,-7506291,0.191136369428375,96.9297171796884,-1.16726436781609
339.89,340,1937,1946,32929,21406,2024-05-07,2024-06-28,516.57,9,-11523,83365113,-15781476,0.0256774077664838,99.5407551357845,-0.538307016724283
496.94,497,3200,3552,54400,21312,2024-05-07,2024-05-10,516.57,352,-33088,11379310,-7506291,0.187287278402645,97.1170044580911,-1.55255255255255
426.57,427,492,492,21156,21156,2024-05-07,2024-06-28,516.57,0,0,83365113,-15781476,0.0253775221296707,99.5661326579141,0
482.63,484,82,154,13776,21098,2024-05-07,2024-06-14,516.57,72,7322,17277101,14428074,0.122115394243513,98.706235496337,0.347047113470471
514.94,530,3,14,5643,21084,2024-05-07,2024-06-14,516.57,11,15441,17277101,14428074,0.122034362130545,98.8282698584676,0.732356289129197
406.93,407,2949,3005,26541,21035,2024-05-07,2024-05-31,516.57,56,-5505.99999999999,66348411,-19082513,0.0317038489437223,99.2575873444807,-0.261754219158545
406.57,407,488,488,20984,20984,2024-05-07,2024-06-28,516.57,0,0,83365113,-15781476,0.0251712008115433,99.5913038587257,0
495.96,496,5415,5217,81225,20868,2024-05-07,2024-05-10,516.57,-198,-60357,11379310,-7506291,0.18338546010259,97.3003899181936,-2.89232317423807
239.86,240,1489,1489,20846,20846,2024-05-07,2024-09-20,516.57,0,0,300792694,-48138153,0.00693035449857037,99.9465043522633,0
500.88,570,3,3,20736,20736,2024-05-07,2024-12-20,516.57,0,0,537706253,-56832135,0.00385638066961442,99.984176862455,0
374.32,375,304,304,20672,20672,2024-05-07,2024-08-16,516.57,0,0,103324269,-17142661,0.0200069162841113,99.7763826424942,0
513.34,534,2,10,4980,20660,2024-05-07,2024-06-28,516.57,8,15680,83365113,-15781476,0.0247825490262336,99.6160864077519,0.758954501452081
204.72,205,730,730,20440,20440,2024-05-07,2024-12-20,516.57,0,0,537706253,-56832135,0.00380133202579662,99.9879781944809,0
473.68,474,655,638,28820,20416,2024-05-07,2024-05-31,516.57,-17,-8404,66348411,-19082513,0.0307708951763743,99.288358239657,-0.411637931034483
493.96,494,5012,5101,55132,20404,2024-05-07,2024-05-10,516.57,89,-34728,11379310,-7506291,0.179307884221451,97.4796978024151,-1.70201921191923
369.72,370,710,710,31240,19880,2024-05-07,2024-07-19,516.57,0,-11360,117399288,-25407869,0.0169336631751975,99.8642027539383,-0.571428571428571
504.8,533,7,7,19740,19740,2024-05-07,2024-06-21,516.57,0,0,348355461,-84761006,0.00566662567692602,99.9278231495846,0
487.19,489,42,109,9282,19729,2024-05-07,2024-06-14,516.57,67,10447,17277101,14428074,0.114191611196809,98.9424614696644,0.529525064625678
419.91,420,2186,2184,21860,19656,2024-05-07,2024-05-31,516.57,-2,-2204,66348411,-19082513,0.0296254268998243,99.3179836665568,-0.112128612128612
294.69,295,633,633,19623,19623,2024-05-07,2024-09-20,516.57,0,0,300792694,-48138153,0.00652376217621828,99.9530281144395,0
299.95,300,3941,3924,19705,19620,2024-05-07,2024-06-28,516.57,-17,-85,83365113,-15781476,0.0235350247770911,99.639621432529,-0.00433231396534149
274.79,275,919,933,22975,19593,2024-05-07,2024-09-20,516.57,14,-3382,300792694,-48138153,0.00651378852971741,99.9595419029692,-0.172612667789517
329.73,330,723,724,20967,19548,2024-05-07,2024-08-16,516.57,1,-1419,103324269,-17142661,0.0189190789242361,99.7953017214184,-0.0725905463474524
469.98,470,9786,9770,29358,19540,2024-05-07,2024-05-10,516.57,-16,-9818,11379310,-7506291,0.171715156718641,97.6514129591337,-0.502456499488229
405.93,406,2759,2759,22072,19313,2024-05-07,2024-05-31,516.57,0,-2759,66348411,-19082513,0.0291084589802761,99.3470921255371,-0.142857142857143
469.33,470,258,288,22188,19296,2024-05-07,2024-06-14,516.57,30,-2892,17277101,14428074,0.111685403702855,99.0541468733672,-0.149875621890547
444.91,445,2035,2139,24420,19251,2024-05-07,2024-05-24,516.57,104,-5169,17630372,-8762837,0.1091922507364,99.4135574677608,-0.268505532180147
453.32,454,277,282,23268,19176,2024-05-07,2024-06-28,516.57,5,-4091.99999999999,83365113,-15781476,0.0230024278861111,99.6626238604151,-0.213391739674593
505.68,600,2,2,18864,18864,2024-05-07,2024-12-20,516.57,0,0,537706253,-56832135,0.00350823519249645,99.9914864296733,0
478.36,479,284,290,26696,18560,2024-05-07,2024-06-07,516.57,6,-8136,14143969,2013047,0.131222007061808,98.7424887596968,-0.438362068965517
463.76,464,783,772,23490,18528,2024-05-07,2024-05-31,516.57,-11,-4962,66348411,-19082513,0.027925310826208,99.3750174363633,-0.267810880829015
504.87,531,7,7,18291,18291,2024-05-07,2024-05-31,516.57,0,0,66348411,-19082513,0.0275681055873365,99.4025855419507,0
514.87,541,0,7,0,18291,2024-05-07,2024-06-28,516.57,7,18291,83365113,-15781476,0.0219408327317927,99.6845646931469,1
154.97,155,6058,6058,18174,18174,2024-05-07,2024-09-20,516.57,0,0,300792694,-48138153,0.00604203505022632,99.9655839380195,0
344.55,345,401,401,18045,18045,2024-05-07,2024-08-16,516.57,0,0,103324269,-17142661,0.0174644351947944,99.8127661566132,0
284.8,285,901,901,18020,18020,2024-05-07,2024-08-16,516.57,0,0,103324269,-17142661,0.0174402395239786,99.8302063961372,0
304.97,305,5992,5976,41944,17928,2024-05-07,2024-06-21,516.57,-16,-24016,348355461,-84761006,0.00514646733211396,99.9329696169167,-1.33958054439982
514.4,550,0,5,0,17800,2024-05-07,2024-06-28,516.57,5,17800,83365113,-15781476,0.0213518573410918,99.705916550488,1
433.56,434,402,402,28542,17688,2024-05-07,2024-06-28,516.57,0,-10854,83365113,-15781476,0.0212175085757996,99.7271340590638,-0.613636363636363
424.99,425,17565,17565,17565,17565,2024-05-07,2024-05-10,516.57,0,0,11379310,-7506291,0.154359095586639,97.8057720547204,0
511.44,529,10,10,17560,17560,2024-05-07,2024-05-17,516.57,0,0,97672171,-63323414,0.0179785089449891,99.7650487363489,0
480.98,481,8878,8762,44390,17524,2024-05-07,2024-05-10,516.57,-116,-26866,11379310,-7506291,0.153998792545418,97.9597708472658,-1.53309746633189
410.46,411,319,319,17226,17226,2024-05-07,2024-06-28,516.57,0,0,83365113,-15781476,0.020663319918969,99.7477973789827,0
516.07,522,19,29,23142,17197,2024-05-07,2024-05-10,516.57,10,-5945,11379310,-7506291,0.151125156094702,98.1108960033605,-0.345699831365936
478.04,479,173,179,23182,17184,2024-05-07,2024-06-14,516.57,6,-5998,17277101,14428074,0.0994611306607515,99.153608004028,-0.349045623836127
279.98,280,8576,8521,34304,17042,2024-05-07,2024-06-21,516.57,-55,-17262,348355461,-84761006,0.00489212942179196,99.9378617463385,-1.01290928294801
409.92,410,2184,2089,19656,16712,2024-05-07,2024-05-31,516.57,-95,-2944,66348411,-19082513,0.0251882445232939,99.427773786474,-0.176160842508377
449.78,450,697,758,19516,16676,2024-05-07,2024-06-07,516.57,61,-2840,14143969,2013047,0.117901842120836,98.8603906018177,-0.170304629407532
407.93,408,2353,2373,23530,16611,2024-05-07,2024-05-31,516.57,20,-6919,66348411,-19082513,0.0250360178181208,99.4528098042921,-0.416531214255614
484.98,485,10919,8300,65514,16600,2024-05-07,2024-05-10,516.57,-2619,-48914,11379310,-7506291,0.145878792299357,98.2567747956599,-2.9466265060241
479.98,480,7860,8294,31440,16588,2024-05-07,2024-05-10,516.57,434,-14852,11379310,-7506291,0.145773337750707,98.4025481334105,-0.895346033277068
510.96,526,11,11,16544,16544,2024-05-07,2024-05-24,516.57,0,0,17630372,-8762837,0.0938380653567605,99.5073955331175,0
446.58,450,37,48,14282,16416,2024-05-07,2024-10-18,516.57,11,2134,1530129,786938,1.07285072042945,96.8241239790894,0.129995126705653
466.92,467,2074,2049,26962,16392,2024-05-07,2024-05-17,516.57,-25,-10570,97672171,-63323414,0.0167826719035456,99.7818314082524,-0.644826744753538
482.98,483,7805,8195,39025,16390,2024-05-07,2024-05-10,516.57,390,-22635,11379310,-7506291,0.14403333769798,98.5465814711085,-1.3810250152532
496.33,499,35,60,13545,16020,2024-05-07,2024-06-14,516.57,25,2475,17277101,14428074,0.0927238892682285,99.2463318932962,0.154494382022472
414.97,415,5328,5330,21312,15990,2024-05-07,2024-05-17,516.57,2,-5322,97672171,-63323414,0.0163710910040077,99.7982024992564,-0.332833020637899
444.99,446,158,158,15958,15958,2024-05-07,2024-06-28,516.57,0,0,83365113,-15781476,0.019142299969053,99.7669396789518,0
279.87,280,1215,1213,20655,15769,2024-05-07,2024-08-16,516.57,-2,-4886,103324269,-17142661,0.0152616613237302,99.8454680574609,-0.309848436806392
294.82,295,867,867,15606,15606,2024-05-07,2024-08-16,516.57,0,0,103324269,-17142661,0.0151039055500117,99.860571963011,0
294.97,295,5188,5197,20752,15591,2024-05-07,2024-06-21,516.57,9,-5161,348355461,-84761006,0.00447560085759643,99.9423373471961,-0.331024308896158
430.63,431,419,419,18855,15503,2024-05-07,2024-06-28,516.57,0,-3352,83365113,-15781476,0.0185965081100532,99.7855361870618,-0.216216216216216
514.1,526,20,13,30460,15470,2024-05-07,2024-05-31,516.57,-7,-14990,66348411,-19082513,0.0233163082081951,99.4761261125003,-0.968972204266322
498.65,502,44,46,20064,15410,2024-05-07,2024-06-14,516.57,2,-4654,17277101,14428074,0.0891932043460301,99.3355250976423,-0.302011680726801
384.68,385,481,481,18759,15392,2024-05-07,2024-07-19,516.57,0,-3367,117399288,-25407869,0.0131108120519436,99.8773135659903,-0.21875
513.75,524,0,15,0,15375,2024-05-07,2024-06-07,516.57,15,15375,14143969,2013047,0.108703575354273,98.9690941771719,1
442.83,443,903,903,15351,15351,2024-05-07,2024-05-31,516.57,0,0,66348411,-19082513,0.023136951991209,99.4992630644915,0
374.96,375,3808,3810,19040,15240,2024-05-07,2024-05-31,516.57,2,-3800,66348411,-19082513,0.0229696533350286,99.5222327178265,-0.249343832020997
447.85,448,935,1015,24310,15225,2024-05-07,2024-05-31,516.57,80,-9085,66348411,-19082513,0.0229470454085178,99.545179763235,-0.596715927750411
319.73,320,550,550,14850,14850,2024-05-07,2024-08-16,516.57,0,0,103324269,-17142661,0.014372228464544,99.8749441914755,0
284.97,285,4944,4944,29664,14832,2024-05-07,2024-06-21,516.57,0,-14832,348355461,-84761006,0.00425771996150794,99.9465950671576,-1
407.56,408,329,329,14476,14476,2024-05-07,2024-06-28,516.57,0,0,83365113,-15781476,0.017364577914025,99.8029007649759,0
443.87,444,1109,1109,17744,14417,2024-05-07,2024-05-31,516.57,0,-3327,66348411,-19082513,0.0217292317671331,99.5669089950022,-0.230769230769231
421.66,422,424,424,16960,14416,2024-05-07,2024-06-28,516.57,0,-2544,83365113,-15781476,0.0172926053611899,99.8201933703371,-0.176470588235294
369.55,370,318,319,15900,14355,2024-05-07,2024-08-16,516.57,1,-1545,103324269,-17142661,0.0138931541823925,99.8888373456579,-0.107628004179728
512.91,560,1,3,5923,14127,2024-05-07,2024-12-20,516.57,2,8204,537706253,-56832135,0.00262727091626364,99.9941137005896,0.580731931761874
429.93,430,2000,2000,16000,14000,2024-05-07,2024-05-24,516.57,0,-2000,17630372,-8762837,0.079408420877336,99.5868039539948,-0.142857142857143
334.83,335,819,819,23751,13923,2024-05-07,2024-07-19,516.57,0,-9828,117399288,-25407869,0.0118595267800943,99.8891730927704,-0.705882352941176
309.97,310,4627,4623,23135,13869,2024-05-07,2024-06-21,516.57,-4,-9266,348355461,-84761006,0.00398127819216246,99.9505763453497,-0.6681087317038
486.41,488,62,87,13330,13833,2024-05-07,2024-06-14,516.57,25,503.000000000004,17277101,14428074,0.0800655156209366,99.4155906132632,0.0363623219836625
512.4,521,5,16,6390,13760,2024-05-07,2024-06-07,516.57,11,7370,14143969,2013047,0.0972852810975477,99.0663794582695,0.535610465116279
259.99,260,13735,13642,41205,13642,2024-05-07,2024-06-21,516.57,-93,-27563,348355461,-84761006,0.00391611486750885,99.9544924602172,-2.02045154669403
259.83,260,806,802,14508,13634,2024-05-07,2024-09-20,516.57,-4,-873.999999999998,300792694,-48138153,0.00453268987976151,99.9701166278992,-0.0641044447704268
329.99,330,13599,13599,13599,13599,2024-05-07,2024-05-17,516.57,0,0,97672171,-63323414,0.0139231061015322,99.8121256053579,0
174.96,175,3389,3389,13556,13556,2024-05-07,2024-09-20,516.57,0,0,300792694,-48138153,0.00450675839885925,99.9746233862981,0
274.98,275,5675,6673,17025,13346,2024-05-07,2024-06-21,516.57,998,-3679,348355461,-84761006,0.00383114418866538,99.9583236044059,-0.275663120035966
234.88,235,1109,1109,13308,13308,2024-05-07,2024-09-20,516.57,0,0,300792694,-48138153,0.0044243095877854,99.9790476958859,0
249.99,250,13297,13297,13297,13297,2024-05-07,2024-05-17,516.57,0,0,97672171,-63323414,0.0136139085103371,99.8257395138683,0
249.98,250,6580,6580,13160,13160,2024-05-07,2024-06-21,516.57,0,0,348355461,-84761006,0.00377775045128401,99.9621013548572,0
514.42,529,1,9,2414,13122,2024-05-07,2024-05-31,516.57,8,10708,66348411,-19082513,0.0197774141116959,99.5866864091139,0.816034141137022
504.46,635,1,1,13054,13054,2024-05-07,2024-07-19,516.57,0,0,117399288,-25407869,0.0111193178616211,99.900292410632,0
314.96,315,3207,3215,19242,12860,2024-05-07,2024-06-21,516.57,8,-6382,348355461,-84761006,0.00369163152002374,99.9657929863772,-0.496267496111975
515.76,580,2,2,13660,12848,2024-05-07,2024-05-17,516.57,0,-812.000000000002,97672171,-63323414,0.0131542074558781,99.8388937213242,-0.0632004981320051
439.82,440,591,711,14184,12798,2024-05-07,2024-06-07,516.57,120,-1386,14143969,2013047,0.0904837956022104,99.1568632538717,-0.108298171589311
424.93,425,1823,1824,14584,12768,2024-05-07,2024-05-24,516.57,1,-1816,17630372,-8762837,0.0724204798401304,99.659224433835,-0.142230576441103
509.3,522,10,10,12700,12700,2024-05-07,2024-06-07,516.57,0,0,14143969,2013047,0.0897909207804401,99.2466541746521,0
249.96,250,3131,3173,12524,12692,2024-05-07,2024-07-19,516.57,42,168,117399288,-25407869,0.0108109684617508,99.9111033790938,0.0132366845256855
319.92,320,1579,1580,14211,12640,2024-05-07,2024-06-28,516.57,1,-1571,83365113,-15781476,0.0151622177972697,99.8353555881343,-0.124287974683544
324.84,325,783,785,13311,12560,2024-05-07,2024-07-19,516.57,2,-751.000000000002,117399288,-25407869,0.010698531664008,99.9218019107578,-0.0597929936305734
510.9,536,5,5,12550,12550,2024-05-07,2024-07-19,516.57,0,0,117399288,-25407869,0.0106900137247851,99.9324919244825,0
514.1,535,2,6,4800,12540,2024-05-07,2024-06-07,516.57,4,7740,14143969,2013047,0.0886596965816314,99.3353138712337,0.617224880382775
324.71,325,428,428,12412,12412,2024-05-07,2024-08-16,516.57,0,0,103324269,-17142661,0.0120126666465939,99.9008500123045,0
491.18,492.5,86,94,18060,12408,2024-05-07,2024-06-07,516.57,8,-5652,14143969,2013047,0.0877264366176142,99.4230403078514,-0.455512572533849
428.88,429,1030,1030,12360,12360,2024-05-07,2024-05-31,516.57,0,0,66348411,-19082513,0.0186289314449445,99.6053153405588,0
428.59,429,301,300,21070,12300,2024-05-07,2024-06-28,516.57,-1,-8770,83365113,-15781476,0.0147543733312039,99.8501099614655,-0.713008130081301
450.84,451,785,767,15700,12272,2024-05-07,2024-05-31,516.57,-18,-3428,66348411,-19082513,0.0184962982760808,99.6238116388349,-0.279335071707953
209.71,210,420,420,12180,12180,2024-05-07,2024-12-20,516.57,0,0,537706253,-56832135,0.00226517730304319,99.9963788778927,0
457.82,458,674,673,16176,12114,2024-05-07,2024-05-31,516.57,-1,-4062,66348411,-19082513,0.0182581614501665,99.6420698002851,-0.33531451213472
269.8,270,600,600,12000,12000,2024-05-07,2024-08-16,516.57,0,0,103324269,-17142661,0.0116139219915507,99.912463934296,0
501.24,620,1,1,11876,11876,2024-05-07,2024-12-20,516.57,0,0,537706253,-56832135,0.00220864085804113,99.9985875187507,0
510.5,540,4,4,11800,11800,2024-05-07,2024-06-28,516.57,0,0,83365113,-15781476,0.0141546020575777,99.8642645635231,0
364.86,365,800,826,20000,11564,2024-05-07,2024-06-28,516.57,26,-8436,83365113,-15781476,0.0138715100164262,99.8781360735395,-0.72950536146662
309.99,310,11522,11522,11522,11522,2024-05-07,2024-05-17,516.57,0,0,97672171,-63323414,0.0117966047872531,99.8506903261114,0
259.9,260,1147,1147,11470,11470,2024-05-07,2024-08-16,516.57,0,0,103324269,-17142661,0.0111009737702572,99.9235649080663,0
515.88,521,9,22,8676,11264,2024-05-07,2024-05-10,516.57,13,2588,11379310,-7506291,0.0989866696662627,98.6455681407748,0.229758522727273
214.98,215,5608,5608,11216,11216,2024-05-07,2024-06-21,516.57,0,0,348355461,-84761006,0.00321969977671744,99.9690126861539,0
284.92,285,1384,1384,11072,11072,2024-05-07,2024-07-19,516.57,0,0,117399288,-25407869,0.00943106230763512,99.9419229867902,0
289.84,290,690,689,11730,11024,2024-05-07,2024-08-16,516.57,-1,-706.000000000002,103324269,-17142661,0.0106693230029046,99.9342342310692,-0.0640420899854864
324.94,325,1831,1831,16479,10986,2024-05-07,2024-06-28,516.57,0,-5493,83365113,-15781476,0.0131781744241143,99.8913142479637,-0.5
461.77,462,477,471,13356,10833,2024-05-07,2024-05-31,516.57,-6,-2523,66348411,-19082513,0.0163274445261394,99.6583972448112,-0.232899473829964
274.99,275,10798,10798,10798,10798,2024-05-07,2024-05-17,516.57,0,0,97672171,-63323414,0.0110553496348515,99.8617456757463,0
454.75,455,437,431,14421,10775,2024-05-07,2024-06-07,516.57,-6,-3646,14143969,2013047,0.076180879638523,99.4992211874899,-0.338375870069606
264.81,265,567,562,14175,10678,2024-05-07,2024-09-20,516.57,-5,-3497,300792694,-48138153,0.00354995324454257,99.9825976491304,-0.327495785727664
354.88,355,888,888,13320,10656,2024-05-07,2024-06-28,516.57,0,-2664,83365113,-15781476,0.012782325383521,99.9040965733472,-0.25
464.95,470,17,21,9894,10605,2024-05-07,2024-10-18,516.57,4,711,1530129,786938,0.693078818844686,97.517202797934,0.0670438472418671
344.83,345,623,623,10591,10591,2024-05-07,2024-06-28,516.57,0,0,83365113,-15781476,0.0127043551179496,99.9168009284651,0
339.69,340,339,339,14577,10509,2024-05-07,2024-08-16,516.57,0,-4068,103324269,-17142661,0.0101708921841005,99.9444051232533,-0.387096774193549
259.99,260,10444,10444,10444,10444,2024-05-07,2024-05-17,516.57,0,0,97672171,-63323414,0.0106929127233181,99.8724385884696,0
516.38,525,1,12,2220,10344,2024-05-07,2024-05-10,516.57,11,8124,11379310,-7506291,0.0909018209364188,98.7364699617112,0.78538283062645
389.94,390,1724,1724,10344,10344,2024-05-07,2024-05-31,516.57,0,0,66348411,-19082513,0.0155904261218856,99.6739876709331,0
434.91,435,1147,1147,10323,10323,2024-05-07,2024-05-24,516.57,0,0,17630372,-8762837,0.05855236633691,99.7177768001719,0
314.98,315,5097,5097,10194,10194,2024-05-07,2024-05-17,516.57,0,0,97672171,-63323414,0.0104369544524612,99.8828755429221,0
344.7,345,338,338,10140,10140,2024-05-07,2024-07-19,516.57,0,0,117399288,-25407869,0.00863719037205745,99.9505601771622,0
239.99,240,10119,10119,10119,10119,2024-05-07,2024-05-17,516.57,0,0,97672171,-63323414,0.0103601669712041,99.8932357098933,0
414.95,415,1854,1995,14832,9975,2024-05-07,2024-05-24,516.57,141,-4857,17630372,-8762837,0.0565784998751019,99.774355300047,-0.486917293233083
485.97,486,3150,3316,18900,9948,2024-05-07,2024-05-10,516.57,166,-8952,11379310,-7506291,0.0874218208309643,98.8238917825422,-0.899879372738239
379.98,380,5927,4973,11854,9946,2024-05-07,2024-05-17,516.57,-954,-1908,97672171,-63323414,0.0101830438477711,99.903418753741,-0.19183591393525
420.74,421,382,382,9932,9932,2024-05-07,2024-05-31,516.57,0,0,66348411,-19082513,0.0149694617403874,99.6889571326735,0
444.82,445,552,551,14352,9918,2024-05-07,2024-06-07,516.57,-1,-4434,14143969,2013047,0.0701217600236539,99.5693429475135,-0.447065940713854
204.98,205,4921,4921,9842,9842,2024-05-07,2024-06-21,516.57,0,0,348355461,-84761006,0.00282527507154538,99.9718379612255,0
394.98,395,4917,4920,14751,9840,2024-05-07,2024-05-17,516.57,3,-4911,97672171,-63323414,0.0100745175409278,99.913493271282,-0.499085365853659
475.46,476,130,180,10660,9720,2024-05-07,2024-06-07,516.57,50,-940,14143969,2013047,0.0687218700776281,99.6380648175912,-0.0967078189300411
420.43,421,166,166,9462,9462,2024-05-07,2024-06-28,516.57,0,0,83365113,-15781476,0.0113500715821017,99.9281510000472,0
511.79,527.5,6,6,9426,9426,2024-05-07,2024-05-10,516.57,0,0,11379310,-7506291,0.0828345479646833,98.9067263305069,0
234.98,235,3256,4710,3256,9420,2024-05-07,2024-06-21,516.57,1454,6164,348355461,-84761006,0.0027041344415726,99.974542095667,0.654352441613588
510.35,526,6,6,9390,9390,2024-05-07,2024-05-10,516.57,0,0,11379310,-7506291,0.0825181843187329,98.9892445148256,0
344.98,345,4660,4660,9320,9320,2024-05-07,2024-05-10,516.57,0,0,11379310,-7506291,0.0819030327849404,99.0711475476105,0
459.55,460,201,206,11457,9270,2024-05-07,2024-06-14,516.57,5,-2187,17277101,14428074,0.0536548348012783,99.4692454480645,-0.235922330097087
204.92,205,1155,1155,9240,9240,2024-05-07,2024-09-20,516.57,0,0,300792694,-48138153,0.00307188312226759,99.9856695322527,0
319.86,320,626,634,9390,8876,2024-05-07,2024-07-19,516.57,8,-514,117399288,-25407869,0.0075605228542783,99.9581207000165,-0.0579089680036052
515.5,530,3,6,5430,8700,2024-05-07,2024-05-10,516.57,3,3270,11379310,-7506291,0.0764545477713499,99.1476020953819,0.375862068965517
314.67,315,263,263,8679,8679,2024-05-07,2024-08-16,516.57,0,0,103324269,-17142661,0.00839976908038904,99.9528048923337,0
431.5,432,173,173,8650,8650,2024-05-07,2024-06-28,516.57,0,0,83365113,-15781476,0.0103760430337328,99.938527043081,0
416.91,417,954,954,9540,8586,2024-05-07,2024-05-31,516.57,0,-954,66348411,-19082513,0.0129407771348134,99.7018979098083,-0.111111111111111
515.73,600,1,1,8831,8427,2024-05-07,2024-06-21,516.57,0,-404,348355461,-84761006,0.00241908077910109,99.9769611764462,-0.0479411415687671
499.29,502.5,13,26,6097,8346,2024-05-07,2024-06-14,516.57,13,2249,17277101,14428074,0.048306715345358,99.5175521634098,0.269470404984424
334.9,335,840,830,13440,8300,2024-05-07,2024-06-28,516.57,-10,-5140,83365113,-15781476,0.00995620314219451,99.9484832462232,-0.619277108433735
516.18,528,6,7,10770,8274,2024-05-07,2024-05-17,516.57,1,-2496,97672171,-63323414,0.00847119493228015,99.9219644662142,-0.301667875271936
384.43,385,144,145,8928,8265,2024-05-07,2024-08-16,516.57,1,-663,103324269,-17142661,0.00799908877168054,99.9608039811054,-0.0802177858439201
515.55,532,3,5,8046,8225,2024-05-07,2024-05-31,516.57,2,178.999999999999,66348411,-19082513,0.0123966797034521,99.7142945895117,0.0217629179331306
493.78,496,19,37,6118,8214,2024-05-07,2024-06-14,516.57,18,2096,17277101,14428074,0.0475426982802265,99.56509486169,0.255174093011931
413.66,414,240,240,8160,8160,2024-05-07,2024-06-28,516.57,0,0,83365113,-15781476,0.00978826718557918,99.9582715134087,0
412.93,413,1158,1156,10422,8092,2024-05-07,2024-05-31,516.57,-2,-2330,66348411,-19082513,0.0121962227550559,99.7264908122668,-0.287938704893722
514.99,595,0,1,0,8001,2024-05-07,2024-06-14,516.57,1,8001,17277101,14428074,0.0463098525614917,99.6114047142515,1
491.97,492,2450,2664,24500,7992,2024-05-07,2024-05-10,516.57,214,-16508,11379310,-7506291,0.0702327294009918,99.2178348247829,-2.06556556556557
184.95,185,1589,1589,9534,7945,2024-05-07,2024-09-20,516.57,0,-1589,300792694,-48138153,0.00264135404831342,99.988310886301,-0.2
274.88,275,621,656,8694,7872,2024-05-07,2024-08-16,516.57,35,-822.000000000002,103324269,-17142661,0.00761873282645726,99.9684227139318,-0.104420731707317
483.98,484,1502,3929,7510,7858,2024-05-07,2024-05-10,516.57,2427,347.999999999999,11379310,-7506291,0.0690551536077319,99.2868899783906,0.0442860778824127
224.94,225,1308,1308,7848,7848,2024-05-07,2024-08-16,516.57,0,0,103324269,-17142661,0.00759550498247416,99.9760182189143,0
294.89,295,711,711,7821,7821,2024-05-07,2024-07-19,516.57,0,0,117399288,-25407869,0.00666188026625851,99.9647825802828,0
414.88,415,647,647,12293,7764,2024-05-07,2024-06-07,516.57,0,-4529,14143969,2013047,0.0548926542471919,99.6929574718384,-0.583333333333333
513.37,523,4,8,8324,7704,2024-05-07,2024-06-07,516.57,4,-619.999999999999,14143969,2013047,0.0544684451726386,99.747425917011,-0.0804776739356177
334.56,335,175,175,7700,7700,2024-05-07,2024-08-16,516.57,0,0,103324269,-17142661,0.00745226661124503,99.9834704855255,0
364.97,365,2565,2564,10260,7692,2024-05-07,2024-05-31,516.57,-1,-2568,66348411,-19082513,0.0115933447147664,99.7380841569816,-0.333853354134165
421.92,422,961,961,11532,7688,2024-05-07,2024-05-31,516.57,0,-3844,66348411,-19082513,0.0115873159343635,99.7496714729159,-0.5
504.05,580,1,1,7595,7595,2024-05-07,2024-12-20,516.57,0,0,537706253,-56832135,0.00141248124931142,100,0
379.95,380,1504,1507,7520,7535,2024-05-07,2024-05-31,516.57,3,15.0000000000009,66348411,-19082513,0.0113567150839528,99.7610281879999,0.00199071001990722
314.85,315,502,502,7530,7530,2024-05-07,2024-07-19,516.57,0,0,117399288,-25407869,0.00641400823487107,99.9711965885177,0
514.96,540,0,3,0,7512,2024-05-07,2024-06-21,516.57,3,7512,348355461,-84761006,0.00215641803875726,99.9791175944849,1
409.92,410,937,937,7496,7496,2024-05-07,2024-05-24,516.57,0,0,17630372,-8762837,0.0425175373497508,99.8168728373967,0
516.45,535,1,4,3157,7420,2024-05-07,2024-05-31,516.57,3,4263,66348411,-19082513,0.0111833876473696,99.7722115756472,0.574528301886793
423.89,424,665,665,7315,7315,2024-05-07,2024-05-31,516.57,0,0,66348411,-19082513,0.0110251321617936,99.783236707809,0
515.89,528,0,6,0,7266,2024-05-07,2024-05-24,516.57,6,7266,17630372,-8762837,0.0412129704353374,99.8580858078321,1
490.97,491,2422,2366,19376,7098,2024-05-07,2024-05-10,516.57,-56,-12278,11379310,-7506291,0.0623763655265565,99.3492663439172,-1.72978303747535
480.32,481,89,103,9078,7004,2024-05-07,2024-06-07,516.57,14,-2074,14143969,2013047,0.0495193393028506,99.7969452563138,-0.296116504854369
515.1,550,2,2,9874,6980,2024-05-07,2024-05-17,516.57,0,-2894,97672171,-63323414,0.00714635492232481,99.9291108211366,-0.414613180515759
179.99,180,6974,6974,6974,6974,2024-05-07,2024-06-21,516.57,0,0,348355461,-84761006,0.00200197808869717,99.9811195725736,0
304.94,305,1179,1159,7074,6954,2024-05-07,2024-06-28,516.57,-20,-120,83365113,-15781476,0.00834161887359284,99.9666131322823,-0.0172562553925798
464.44,465,109,124,7739,6944,2024-05-07,2024-06-14,516.57,15,-794.999999999999,17277101,14428074,0.0401919280323707,99.6515966422839,-0.11448732718894
460.79,461,324,330,10044,6930,2024-05-07,2024-05-31,516.57,6,-3114,66348411,-19082513,0.010444862048015,99.7936815698571,-0.449350649350649
284.99,285,6891,6891,6891,6891,2024-05-07,2024-05-17,516.57,0,0,97672171,-63323414,0.00705523377789975,99.9361660549145,0
264.99,265,6889,6889,6889,6889,2024-05-07,2024-05-17,516.57,0,0,97672171,-63323414,0.00705318611173289,99.9432192410262,0
219.99,220,6645,6845,6645,6845,2024-05-07,2024-06-21,516.57,200,200,348355461,-84761006,0.00196494694825525,99.9830845195219,0.029218407596786
419.94,420,1134,1133,9072,6798,2024-05-07,2024-05-24,516.57,-1,-2274,17630372,-8762837,0.0385584603660093,99.8966442681981,-0.334510150044131
485.94,487,51,64,7344,6784,2024-05-07,2024-06-07,516.57,13,-560,14143969,2013047,0.0479639060294886,99.8449091623433,-0.0825471698113208
289.88,290,563,563,6756,6756,2024-05-07,2024-07-19,516.57,0,0,117399288,-25407869,0.00575471973901579,99.9769513082567,0
492.96,493,1689,1684,18579,6736,2024-05-07,2024-05-10,516.57,-5,-11843,11379310,-7506291,0.059195153308944,99.4084614972261,-1.75816508313539
279.99,280,6724,6723,6724,6723,2024-05-07,2024-05-17,516.57,-1,-0.999999999999091,97672171,-63323414,0.00688322981988391,99.9501024708461,-0.000148743120630536
503.5,537,2,2,6700,6700,2024-05-07,2024-05-31,516.57,0,0,66348411,-19082513,0.0100982071748485,99.8037797770319,0
437.13,440,22,23,7084,6601,2024-05-07,2024-10-18,516.57,1,-482.999999999999,1530129,786938,0.431401535426098,97.9486043333601,-0.0731707317073169
349.98,350,3286,3286,13144,6572,2024-05-07,2024-05-31,516.57,0,-6572,66348411,-19082513,0.00990528620195592,99.8136850632338,-1
309.77,310,284,284,6532,6532,2024-05-07,2024-08-16,516.57,0,0,103324269,-17142661,0.0063218448707341,99.9897923303963,0
169.96,170,1617,1617,6468,6468,2024-05-07,2024-09-20,516.57,0,0,300792694,-48138153,0.00215031818558731,99.9904612044866,0
209.9,210,639,639,6390,6390,2024-05-07,2024-09-20,516.57,0,0,300792694,-48138153,0.00212438670468506,99.9925855911913,0
448.86,449,453,453,14496,6342,2024-05-07,2024-05-31,516.57,0,-8154,66348411,-19082513,0.00955863132878947,99.8232436945626,-1.28571428571429
410.93,411,894,891,8046,6237,2024-05-07,2024-05-31,516.57,-3,-1809,66348411,-19082513,0.00940037584321349,99.8326440704059,-0.29004329004329
229.99,230,1648,6214,1648,6214,2024-05-07,2024-06-21,516.57,4566,4566,348355461,-84761006,0.00178381012950447,99.9848683296514,0.734792404248471
264.98,265,3063,3084,9189,6168,2024-05-07,2024-06-21,516.57,21,-3021,348355461,-84761006,0.00177060522671123,99.9866389348781,-0.489785992217899
504.77,535,2,2,6046,6046,2024-05-07,2024-05-24,516.57,0,0,17630372,-8762837,0.0342930937588838,99.930937361957,0
304.89,305,547,547,8205,6017,2024-05-07,2024-07-19,516.57,0,-2188,117399288,-25407869,0.0051252440304408,99.9820765522871,-0.363636363636364
495.06,497.5,21,24,7497,5856,2024-05-07,2024-06-14,516.57,3,-1641,17277101,14428074,0.0338945752531053,99.685491217537,-0.280225409836066
199.99,200,5727,5728,5727,5728,2024-05-07,2024-06-21,516.57,1,1,348355461,-84761006,0.00164429746086283,99.9882832323389,0.000174581005586592
511.4,540,1,2,3098,5720,2024-05-07,2024-10-18,516.57,1,2622,1530129,786938,0.373824690597982,98.3224290239581,0.458391608391608
413.92,414,697,697,15334,5576,2024-05-07,2024-05-31,516.57,0,-9758,66348411,-19082513,0.00840411988163515,99.8410481902875,-1.75
481.98,482,2385,2781,11925,5562,2024-05-07,2024-05-10,516.57,396,-6363,11379310,-7506291,0.0488781832993389,99.4573396805255,-1.14401294498382
425.9,426,541,555,6492,5550,2024-05-07,2024-05-31,516.57,14,-942,66348411,-19082513,0.00836493280901633,99.8494131230965,-0.16972972972973
324.99,325,5487,5487,5487,5487,2024-05-07,2024-05-10,516.57,0,0,11379310,-7506291,0.0482190923702755,99.5055587728957,0
324.99,325,5470,5470,5470,5470,2024-05-07,2024-05-17,516.57,0,0,97672171,-63323414,0.00560036696634909,99.9557028378124,0
476.45,477,158,98,13114,5390,2024-05-07,2024-06-07,516.57,-60,-7724,14143969,2013047,0.0381081151973679,99.8830172775407,-1.4330241187384
501.28,555,1,1,5372,5372,2024-05-07,2024-06-28,516.57,0,0,83365113,-15781476,0.00644394256383963,99.9730570748462,0
476.99,478,45,53,5895,5353,2024-05-07,2024-06-14,516.57,8,-542,17277101,14428074,0.0309832071943088,99.7164744247313,-0.101251634597422
501.73,555,1,1,5327,5327,2024-05-07,2024-06-21,516.57,0,0,348355461,-84761006,0.00152918515607826,99.989812417495,0
511.38,538,2,2,5324,5324,2024-05-07,2024-05-31,516.57,0,0,66348411,-19082513,0.00802430671625278,99.8574374298128,0
484.57,486,17,37,3247,5291,2024-05-07,2024-06-14,516.57,20,2044,17277101,14428074,0.0306243506940198,99.7470987754254,0.386316386316386
510.63,537,2,2,5274,5274,2024-05-07,2024-07-19,516.57,0,0,117399288,-25407869,0.00449236114617663,99.9865689134333,0
415.84,416,328,328,5248,5248,2024-05-07,2024-05-31,516.57,0,0,66348411,-19082513,0.00790975988859779,99.8653471897014,0
458.8,459,199,262,4975,5240,2024-05-07,2024-05-31,516.57,63,265.000000000001,66348411,-19082513,0.007897702327792,99.8732448920291,0.0505725190839696
514.28,565,1,1,6782,5072,2024-05-07,2024-09-20,516.57,0,-1710,300792694,-48138153,0.00168621116841355,99.9942718023597,-0.337145110410094
369.97,370,1733,1688,8665,5064,2024-05-07,2024-05-31,516.57,-45,-3601,66348411,-19082513,0.00763243599006463,99.8808773280192,-0.71109794628752
244.83,245,297,297,5049,5049,2024-05-07,2024-09-20,516.57,0,0,300792694,-48138153,0.00167856470609622,99.9959503670658,0
432.88,433,418,418,5016,5016,2024-05-07,2024-05-31,516.57,0,0,66348411,-19082513,0.0075600906252299,99.8884374186444,0
437.68,441,15,15,4980,4980,2024-05-07,2024-10-18,516.57,0,0,1530129,786938,0.325462755101041,98.6478917790592,0
502.5,550,1,1,4750,4750,2024-05-07,2024-06-21,516.57,0,0,348355461,-84761006,0.00136354974495434,99.99117596724,0
159.97,160,1578,1578,4734,4734,2024-05-07,2024-09-20,516.57,0,0,300792694,-48138153,0.0015738414178371,99.9975242084836,0
418.89,419,429,429,4719,4719,2024-05-07,2024-05-31,516.57,0,0,66348411,-19082513,0.00711245368031497,99.8955498723248,0
454.6,455,118,115,5900,4600,2024-05-07,2024-06-14,516.57,-3,-1300,17277101,14428074,0.0266248371182179,99.7737236125436,-0.282608695652174
422.91,423,326,506,3586,4554,2024-05-07,2024-05-31,516.57,180,968,66348411,-19082513,0.00686376648869556,99.9024136388135,0.21256038647343
508.96,518,1,5,1107,4520,2024-05-07,2024-06-14,516.57,4,3413,17277101,14428074,0.0261617964726837,99.7998854090162,0.755088495575221
339.99,340,4508,4508,4508,4508,2024-05-07,2024-05-17,516.57,0,0,97672171,-63323414,0.00461543954009172,99.9603182773525,0
239.8,240,222,222,4440,4440,2024-05-07,2024-08-16,516.57,0,0,103324269,-17142661,0.00429715113687376,99.9940894815331,0
449.98,450,2193,2183,4386,4366,2024-05-07,2024-05-10,516.57,-10,-20,11379310,-7506291,0.0383678799505418,99.5439266528463,-0.00458085203847916
459.99,460,4207,4260,8414,4260,2024-05-07,2024-05-10,516.57,53,-4154,11379310,-7506291,0.0374363647707989,99.5813630176171,-0.975117370892019
436.78,437,193,193,4246,4246,2024-05-07,2024-05-31,516.57,0,0,66348411,-19082513,0.00639955039767267,99.9088131892111,0
299.99,300,4228,4228,4228,4228,2024-05-07,2024-05-17,516.57,0,0,97672171,-63323414,0.00432876627673199,99.9646470436292,0
189.99,190,4141,4141,4141,4141,2024-05-07,2024-06-21,516.57,0,0,348355461,-84761006,0.00118872831449598,99.9923646955545,0
244.98,245,2048,2048,4096,4096,2024-05-07,2024-06-21,516.57,0,0,348355461,-84761006,0.00117581047480694,99.9935405060293,0
490.65,492.5,6,22,1644,4070,2024-05-07,2024-06-14,516.57,16,2426,17277101,14428074,0.0235571928415537,99.8234426018578,0.596068796068796
502.57,543,1,1,4043,4043,2024-05-07,2024-05-31,516.57,0,0,66348411,-19082513,0.00609358979222577,99.9149067790034,0
510.83,531,2,2,4034,4034,2024-05-07,2024-06-21,516.57,0,0,348355461,-84761006,0.00115801256234648,99.9946985185916,0
299.99,300,3743,4025,7486,4025,2024-05-07,2024-05-31,516.57,282,-3461,66348411,-19082513,0.00606646028041275,99.9209732392838,-0.859875776397516
439.92,440,592,500,5920,4000,2024-05-07,2024-05-24,516.57,-92,-1920,17630372,-8762837,0.0226881202506674,99.9536254822076,-0.48
455.57,460,6,9,2760,3987,2024-05-07,2024-10-18,516.57,3,1227,1530129,786938,0.260566265981496,98.9084580450407,0.307750188111362
431.88,432,331,331,3972,3972,2024-05-07,2024-05-31,516.57,0,0,66348411,-19082513,0.00598657894007439,99.9269598182238,0
505.35,545,1,1,3965,3965,2024-05-07,2024-06-28,516.57,0,0,83365113,-15781476,0.00475618619985557,99.977813261046,0
505.81,545,1,1,3919,3919,2024-05-07,2024-07-19,516.57,0,0,117399288,-25407869,0.00333818038146875,99.9899070938148,0
514.45,534,0,2,0,3910,2024-05-07,2024-05-17,516.57,2,3910,97672171,-63323414,0.004003187356202,99.9686502309854,1
349.99,350,3889,3889,3889,3889,2024-05-07,2024-05-10,516.57,0,0,11379310,-7506291,0.0341760616416988,99.6155390792588,0
417.9,418,381,381,3810,3810,2024-05-07,2024-05-31,516.57,0,0,66348411,-19082513,0.00574241333375716,99.9327022315576,0
444.98,445,1866,1866,3732,3732,2024-05-07,2024-05-10,516.57,0,0,11379310,-7506291,0.0327963646301929,99.648335443889,0
408.91,409,412,412,3708,3708,2024-05-07,2024-05-31,516.57,0,0,66348411,-19082513,0.00558867943348334,99.9382909109911,0
304.99,305,3645,3645,3645,3645,2024-05-07,2024-05-17,516.57,0,0,97672171,-63323414,0.00373187158909368,99.9723821025746,0
184.99,185,3611,3611,3611,3611,2024-05-07,2024-06-21,516.57,0,0,348355461,-84761006,0.0010365848692695,99.9957351034609,0
364.99,365,3590,3600,7180,3600,2024-05-07,2024-05-17,516.57,10,-3580,97672171,-63323414,0.00368579910033944,99.9760679016749,-0.994444444444444
394.94,395,590,598,4130,3588,2024-05-07,2024-05-31,516.57,8,-542,66348411,-19082513,0.0054078160213965,99.9436987270125,-0.151059085841695
424.87,425,98,273,1666,3549,2024-05-07,2024-06-07,516.57,175,1883,14143969,2013047,0.0250919667598253,99.9081092443005,0.530571992110454
514.32,532,1,2,2702,3536,2024-05-07,2024-06-21,516.57,1,834,348355461,-84761006,0.00101505513645443,99.9967501585973,0.235859728506787
502.47,507.5,6,7,3660,3521,2024-05-07,2024-06-14,516.57,1,-139,17277101,14428074,0.0203795764115751,99.8438221782694,-0.0394774211871626
359.99,360,3498,3497,10494,3497,2024-05-07,2024-05-17,516.57,-1,-6997,97672171,-63323414,0.0035803442927464,99.9796482459676,-2.0008578781813
329.92,330,437,437,4370,3496,2024-05-07,2024-06-28,516.57,0,-874,83365113,-15781476,0.00419360074519422,99.9820068617912,-0.25
434.86,435,255,246,5355,3444,2024-05-07,2024-06-07,516.57,-9,-1911,14143969,2013047,0.0243496008793571,99.9324588451799,-0.554878048780488
219.95,220,680,680,4080,3400,2024-05-07,2024-08-16,516.57,0,-680,103324269,-17142661,0.00329061123093936,99.9973800927641,-0.2
516.16,550,0,1,0,3384,2024-05-07,2024-06-14,516.57,1,3384,17277101,14428074,0.0195866193060977,99.8634087975755,1
429.99,430,3319,3331,6638,3331,2024-05-07,2024-05-10,516.57,12,-3307,11379310,-7506291,0.0292724251294674,99.6776078690184,-0.992794956469529
239.99,240,3310,3310,3310,3310,2024-05-07,2024-06-21,516.57,0,0,348355461,-84761006,0.000950178874905021,99.9977003374723,0
411.71,412,114,114,5130,3306,2024-05-07,2024-06-28,516.57,0,-1824,83365113,-15781476,0.00396568766121627,99.9859725494524,-0.551724137931035
514.51,531,0,2,0,3298,2024-05-07,2024-05-24,516.57,2,3298,17630372,-8762837,0.0187063551466753,99.9723318373543,1
433.87,434,249,249,3237,3237,2024-05-07,2024-05-31,516.57,0,0,66348411,-19082513,0.0048787905410425,99.9485775175535,0
344.99,345,3216,3216,3216,3216,2024-05-07,2024-05-17,516.57,0,0,97672171,-63323414,0.00329264719630323,99.9829408931639,0
379.93,380,254,459,3556,3213,2024-05-07,2024-06-07,516.57,205,-343,14143969,2013047,0.0227163959423271,99.9551752411222,-0.106753812636165
440.89,441,282,288,4230,3168,2024-05-07,2024-05-31,516.57,6,-1062,66348411,-19082513,0.00477479407909256,99.9533523116326,-0.335227272727273
379.98,380,1576,1576,3152,3152,2024-05-07,2024-05-10,516.57,0,0,11379310,-7506291,0.0276993947787695,99.7053072637972,0
314.94,315,523,521,3661,3126,2024-05-07,2024-06-28,516.57,-2,-535.000000000001,83365113,-15781476,0.00374977000271085,99.9897223194552,-0.171145233525272
349.99,350,3105,3105,6210,3105,2024-05-07,2024-05-17,516.57,0,-3105,97672171,-63323414,0.00317900172404277,99.986119894888,-1
411.92,412,380,384,8740,3072,2024-05-07,2024-05-31,516.57,4,-5668,66348411,-19082513,0.00463010334942309,99.957982414982,-1.84505208333333
464.98,465,1513,1532,3026,3064,2024-05-07,2024-05-10,516.57,19,38,11379310,-7506291,0.0269260614220019,99.7322333252192,0.012402088772846
254.99,255,3009,3009,3009,3009,2024-05-07,2024-05-17,516.57,0,0,97672171,-63323414,0.00308071374803372,99.989200608636,0
509.44,524,2,2,2912,2912,2024-05-07,2024-06-14,516.57,0,0,17277101,14428074,0.0168546794974458,99.8802634770729,0
505.18,534,1,1,2882,2882,2024-05-07,2024-05-31,516.57,0,0,66348411,-19082513,0.0043437362802856,99.9623261512623,0
481.87,483,5,25,815,2825,2024-05-07,2024-06-14,516.57,20,2010,17277101,14428074,0.0163511227954273,99.8966145998683,0.711504424778761
369.99,370,2623,2740,5246,2740,2024-05-07,2024-05-17,516.57,117,-2506,97672171,-63323414,0.00280530264859169,99.9920059112846,-0.914598540145985
515.07,542,0,1,0,2693,2024-05-07,2024-06-28,516.57,1,2693,83365113,-15781476,0.00323036807975058,99.9929526875349,1
329.99,330,2689,2689,2689,2689,2024-05-07,2024-05-10,516.57,0,0,11379310,-7506291,0.0236306067766851,99.7558639319959,0
384.95,385,533,534,3731,2670,2024-05-07,2024-05-31,516.57,1,-1061,66348411,-19082513,0.00402421091893218,99.9663503621812,-0.397378277153558
513.65,540,0,1,0,2635,2024-05-07,2024-07-19,516.57,1,2635,117399288,-25407869,0.00224447698524373,99.9921515708,1
189.94,190,426,436,4260,2616,2024-05-07,2024-09-20,516.57,10,-1644,300792694,-48138153,0.00086970197487576,99.9983939104585,-0.628440366972477
339.8,340,128,128,2560,2560,2024-05-07,2024-07-19,516.57,0,0,117399288,-25407869,0.0021805924410717,99.9943321632411,0
264.95,265,506,508,5060,2540,2024-05-07,2024-07-19,516.57,2,-2520,117399288,-25407869,0.00216355656262583,99.9964957198037,-0.992125984251969
294.99,295,2523,2523,2523,2523,2024-05-07,2024-05-17,516.57,0,0,97672171,-63323414,0.00258313086948789,99.9945890421541,0
510.6,519,0,3,0,2520,2024-05-07,2024-06-14,516.57,3,2520,17277101,14428074,0.0145857803343281,99.9112003802027,1
514.85,540,0,1,0,2515,2024-05-07,2024-06-14,516.57,1,2515,17277101,14428074,0.0145568402939822,99.9257572204966,1
510.25,535,0,1,0,2475,2024-05-07,2024-10-18,516.57,1,2475,1530129,786938,0.161751068047204,99.0702091130879,1
503.3,527,1,1,2370,2370,2024-05-07,2024-05-10,516.57,0,0,11379310,-7506291,0.0208272733584022,99.7766912053543,0
516.4,540,3,1,8748,2360,2024-05-07,2024-05-31,516.57,-2,-6388,66348411,-19082513,0.00355698043770785,99.969907342619,-2.70677966101695
209.99,210,2348,2348,2348,2348,2024-05-07,2024-06-21,516.57,0,0,348355461,-84761006,0.000674024168663743,99.9983743616409,0
514.7,538,0,1,0,2330,2024-05-07,2024-06-28,516.57,1,2330,83365113,-15781476,0.00279493413509798,99.99574762167,1
384.99,385,2261,2261,2261,2261,2024-05-07,2024-05-10,516.57,0,0,11379310,-7506291,0.0198693945414968,99.7965605998958,0
254.98,255,1115,1115,2230,2230,2024-05-07,2024-06-21,516.57,0,0,348355461,-84761006,0.000640150722368035,99.9990145123633,0
508.24,530,0,1,0,2176,2024-05-07,2024-10-18,516.57,1,2176,1530129,786938,0.142210231947764,99.2124193450356,1
435.8,436,107,107,2140,2140,2024-05-07,2024-05-31,516.57,0,0,66348411,-19082513,0.00322539751554864,99.9731327401345,0
511.64,533,1,1,2136,2136,2024-05-07,2024-05-31,516.57,0,0,66348411,-19082513,0.00321936873514574,99.9763521088697,0
194.94,195,355,355,2130,2130,2024-05-07,2024-09-20,516.57,0,0,300792694,-48138153,0.000708128901561685,99.99910203936,0
419.99,420,1971,2068,3942,2068,2024-05-07,2024-05-10,516.57,97,-1874,11379310,-7506291,0.0181733338840404,99.8147339337798,-0.906189555125725
309.82,310,114,114,2052,2052,2024-05-07,2024-07-19,516.57,0,0,117399288,-25407869,0.00174788112854654,99.9982436009322,0
409.99,410,2041,2041,2041,2041,2024-05-07,2024-05-10,516.57,0,0,11379310,-7506291,0.0179360611495776,99.8326699949294,0
514.66,535,0,1,0,2034,2024-05-07,2024-06-14,516.57,1,2034,17277101,14428074,0.0117728084127077,99.9375300289094,1
309.98,310,1011,1011,2022,2022,2024-05-07,2024-05-31,516.57,0,0,66348411,-19082513,0.00304754849366325,99.9793996573633,0
422.52,425,8,8,1984,1984,2024-05-07,2024-10-18,516.57,0,0,1530129,786938,0.129662270305314,99.3420816153409,0
511.26,531,1,1,1974,1974,2024-05-07,2024-05-10,516.57,0,0,11379310,-7506291,0.0173472732529477,99.8500172681823,0
445.86,446,132,140,3432,1960,2024-05-07,2024-05-31,516.57,8,-1472,66348411,-19082513,0.00295410239741838,99.9823537597607,-0.751020408163265
399.95,400,391,391,1955,1955,2024-05-07,2024-05-24,516.57,0,0,17630372,-8762837,0.0110888187725137,99.9834206561268,0
244.99,245,1951,1951,1951,1951,2024-05-07,2024-05-17,516.57,0,0,97672171,-63323414,0.00199749834576729,99.9965865404999,0
224.99,225,1542,1939,1542,1939,2024-05-07,2024-06-21,516.57,397,397,348355461,-84761006,0.00055661535904557,99.9995711277223,0.204744713769985
309.93,310,275,275,1925,1925,2024-05-07,2024-06-28,516.57,0,0,83365113,-15781476,0.00230911940346077,99.9980567410735,0
441.82,445,6,6,2118,1908,2024-05-07,2024-10-18,516.57,0,-210,1530129,786938,0.124695368821844,99.4667769841628,-0.110062893081761
516.17,522.5,2,3,3900,1899,2024-05-07,2024-05-10,516.57,1,-2001,11379310,-7506291,0.0166881823238843,99.8667054505062,-1.05371248025276
514.09,533,0,1,0,1891,2024-05-07,2024-05-24,516.57,1,1891,17630372,-8762837,0.010725808848503,99.9941464649753,1
339.99,340,1805,1805,1805,1805,2024-05-07,2024-05-10,516.57,0,0,11379310,-7506291,0.0158621216927916,99.882567572199,0
334.99,335,1784,1784,1784,1784,2024-05-07,2024-05-10,516.57,0,0,11379310,-7506291,0.0156775762326538,99.8982451484317,0
269.94,270,309,292,3090,1752,2024-05-07,2024-07-19,516.57,-17,-1338,117399288,-25407869,0.00149234295185845,99.9997359438841,-0.763698630136986
479.76,481,11,14,1617,1736,2024-05-07,2024-06-14,516.57,3,119,17277101,14428074,0.0100479820080927,99.9475780109175,0.0685483870967743
329.97,330,570,570,1710,1710,2024-05-07,2024-05-31,516.57,0,0,66348411,-19082513,0.00257730362223746,99.984931063383,0
269.99,270,1700,1700,1700,1700,2024-05-07,2024-05-17,516.57,0,0,97672171,-63323414,0.00174051624182696,99.9983270567417,0
438.63,442,5,5,1685,1685,2024-05-07,2024-10-18,516.57,0,0,1530129,786938,0.110121434205874,99.5768984183687,0
179.96,180,403,419,2015,1676,2024-05-07,2024-09-20,516.57,16,-339,300792694,-48138153,0.000557194384515204,99.9996592337446,-0.202267303102625
515.5,532,0,1,0,1650,2024-05-07,2024-05-10,516.57,1,1650,11379310,-7506291,0.014500000439394,99.9127451488711,1
418.7,419,56,54,2856,1620,2024-05-07,2024-06-28,516.57,-2,-1236,83365113,-15781476,0.00194325892654881,100,-0.762962962962963
339.98,340,631,796,1893,1592,2024-05-07,2024-05-31,516.57,165,-301,66348411,-19082513,0.00239945460035207,99.9873305179833,-0.189070351758794
304.99,305,1537,1537,1537,1537,2024-05-07,2024-05-31,516.57,0,0,66348411,-19082513,0.00231655886981227,99.9896470768531,0
194.99,195,1494,1494,1494,1494,2024-05-07,2024-06-21,516.57,0,0,348355461,-84761006,0.000428872277676164,100,0
319.98,320,726,726,1452,1452,2024-05-07,2024-05-31,516.57,0,0,66348411,-19082513,0.00218844728625076,99.9918355241394,0
427.88,428,119,119,1428,1428,2024-05-07,2024-05-31,516.57,0,0,66348411,-19082513,0.00215227460383339,99.9939877987432,0
480.83,482,13,12,2041,1404,2024-05-07,2024-06-14,516.57,-1,-637,17277101,14428074,0.00812636332912564,99.9557043742466,-0.453703703703704
209.96,210,269,319,1076,1276,2024-05-07,2024-08-16,516.57,50,200,103324269,-17142661,0.00123494703843489,99.9986150398025,0.156739811912226
369.99,370,1270,1270,1270,1270,2024-05-07,2024-05-10,516.57,0,0,11379310,-7506291,0.0111606063988063,99.9239057552699,0
516.21,528,0,1,0,1179,2024-05-07,2024-05-10,516.57,1,1179,11379310,-7506291,0.010360909404876,99.9342666646748,1
511.21,523,0,1,0,1179,2024-05-07,2024-06-14,516.57,1,1179,17277101,14428074,0.00682406151356064,99.9625284357601,1
409.89,410,52,100,676,1100,2024-05-07,2024-06-07,516.57,48,424,14143969,2013047,0.00777716636680977,99.962952407489,0.385454545454545
449.62,455,2,2,1076,1076,2024-05-07,2024-10-18,516.57,0,0,1530129,786938,0.0703208683712288,99.6472192867399,0
314.98,315,530,530,1060,1060,2024-05-07,2024-05-31,516.57,0,0,66348411,-19082513,0.00159762680676708,99.99558542555,0
454.99,455,1064,1058,3192,1058,2024-05-07,2024-05-10,516.57,-6,-2134,11379310,-7506291,0.00929757603932049,99.9435642407141,-2.01701323251418
511.58,522,0,1,0,1042,2024-05-07,2024-06-14,516.57,1,1042,17277101,14428074,0.00603110440808328,99.9685595401682,1
394.96,395,131,258,655,1032,2024-05-07,2024-05-24,516.57,127,377,17630372,-8762837,0.0058535350246722,100,0.36531007751938
164.95,165,205,205,1025,1025,2024-05-07,2024-09-20,516.57,0,0,300792694,-48138153,0.000340766255446351,100,0
399.9,400,54,102,648,1020,2024-05-07,2024-06-07,516.57,48,372,14143969,2013047,0.00721155426740542,99.9701639617564,0.364705882352941
510.81,521,0,1,0,1019,2024-05-07,2024-06-14,516.57,1,1019,17277101,14428074,0.00589798022249219,99.9744575203907,1
476.08,477,8,11,984,1012,2024-05-07,2024-06-14,516.57,3,28.0000000000001,17277101,14428074,0.00585746416600795,99.9803149845567,0.0276679841897234
399.99,400,993,993,993,993,2024-05-07,2024-05-10,516.57,0,0,11379310,-7506291,0.00872636390079891,99.9522906046149,0
394.99,395,992,992,992,992,2024-05-07,2024-05-10,516.57,0,0,11379310,-7506291,0.00871757602174473,99.9610081806366,0
384.87,385,75,75,975,975,2024-05-07,2024-06-14,516.57,0,0,17277101,14428074,0.00564330786744836,99.9859582924242,0
429.84,430,50,57,950,912,2024-05-07,2024-06-07,516.57,7,-37.9999999999999,14143969,2013047,0.00644797793320956,99.9766119396896,-0.0416666666666665
432.05,435,3,3,885,885,2024-05-07,2024-10-18,516.57,0,0,1530129,786938,0.0578382606956668,99.7050575474356,0
437.85,438,58,58,870,870,2024-05-07,2024-05-31,516.57,0,0,66348411,-19082513,0.00131125973762959,99.9968966852876,0
374.94,375,72,140,576,840,2024-05-07,2024-06-07,516.57,68,264,14143969,2013047,0.00593892704374564,99.9825508667334,0.314285714285714
426.91,427,93,93,1116,837,2024-05-07,2024-05-31,516.57,0,-279,66348411,-19082513,0.00126152229930571,99.9981582075869,-0.333333333333334
334.99,335,827,827,827,827,2024-05-07,2024-05-17,516.57,0,0,97672171,-63323414,0.000846709959994644,99.9991737667017,0
427.3,430,3,3,810,810,2024-05-07,2024-10-18,516.57,0,0,1530129,786938,0.0529367131790849,99.7579942606146,0
384.99,385,809,807,3236,807,2024-05-07,2024-05-17,516.57,-2,-2429,97672171,-63323414,0.000826233298326091,100,-3.00991325898389
439.99,440,736,738,1472,738,2024-05-07,2024-05-10,516.57,2,-734,11379310,-7506291,0.00648545474198348,99.9674936353786,-0.994579945799458
457.97,465,1,1,703,703,2024-05-07,2024-10-18,516.57,0,0,1530129,786938,0.0459438387220947,99.8039380993367,0
440.55,444,2,2,690,690,2024-05-07,2024-10-18,516.57,0,0,1530129,786938,0.0450942371525538,99.8490323364893,0
417.73,420,3,3,681,681,2024-05-07,2024-10-18,516.57,0,0,1530129,786938,0.044506051450564,99.8935383879398,0
439.61,443,2,2,678,678,2024-05-07,2024-10-18,516.57,0,0,1530129,786938,0.0443099895499007,99.9378483774898,0
434.99,435,668,672,1336,672,2024-05-07,2024-05-10,516.57,4,-664,11379310,-7506291,0.00590545472440772,99.973399090103,-0.988095238095238
414.99,415,640,642,1920,642,2024-05-07,2024-05-10,516.57,2,-1278,11379310,-7506291,0.00564181835278238,99.9790409084558,-1.99065420560748
374.98,375,304,304,608,608,2024-05-07,2024-05-10,516.57,0,0,11379310,-7506291,0.00534303046494032,99.9843839389207,0
229.94,230,42,101,420,606,2024-05-07,2024-08-16,516.57,59,186,103324269,-17142661,0.00058650306057331,99.9992015428631,0.306930693069307
439.72,440,17,21,578,588,2024-05-07,2024-06-14,516.57,4,10.0000000000001,17277101,14428074,0.00340334874467655,99.9893616411688,0.0170068027210886
389.98,390,294,294,588,588,2024-05-07,2024-05-10,516.57,0,0,11379310,-7506291,0.00516727288385675,99.9895512118046,0
349.96,350,126,146,504,584,2024-05-07,2024-06-07,516.57,20,80,14143969,2013047,0.00412896832565173,99.986679835059,0.136986301369863
404.92,405,64,66,768,528,2024-05-07,2024-06-07,516.57,2,-240,14143969,2013047,0.00373303985606869,99.9904128749151,-0.454545454545455
344.98,345,200,250,800,500,2024-05-07,2024-05-31,516.57,50,-300,66348411,-19082513,0.000753597550361832,99.9989118051373,-0.6
398.47,400,2,3,340,459,2024-05-07,2024-10-18,516.57,1,119,1530129,786938,0.0299974708014814,99.9678458482912,0.259259259259259
334.98,335,269,219,538,438,2024-05-07,2024-05-31,516.57,-50,-100,66348411,-19082513,0.000660151454116965,99.9995719565914,-0.228310502283105
354.96,355,101,109,606,436,2024-05-07,2024-06-07,516.57,8,-170,14143969,2013047,0.00308258594175369,99.9934954608569,-0.389908256880734
354.99,355,433,433,433,433,2024-05-07,2024-05-10,516.57,0,0,11379310,-7506291,0.00380515163045914,99.993356363435,0
364.95,365,70,84,490,420,2024-05-07,2024-06-07,516.57,14,-70.0000000000001,14143969,2013047,0.00296946352187282,99.9964649243787,-0.166666666666667
204.96,205,105,105,420,420,2024-05-07,2024-08-16,516.57,0,0,103324269,-17142661,0.000406487269704274,99.9996080301328,0
404.99,405,397,397,397,397,2024-05-07,2024-05-10,516.57,0,0,11379310,-7506291,0.00348878798450873,99.9968451514196,0
399.88,400,11,33,187,396,2024-05-07,2024-06-14,516.57,22,209,17277101,14428074,0.00229205119539441,99.9916536923642,0.527777777777778
444.72,445,7,14,273,392,2024-05-07,2024-06-14,516.57,7,119,17277101,14428074,0.0022688991631177,99.9939225915274,0.303571428571429
433.89,437,1,1,311,311,2024-05-07,2024-10-18,516.57,0,0,1530129,786938,0.0203250837020931,99.9881709319933,0
274.95,275,50,62,500,310,2024-05-07,2024-07-19,516.57,12,-190,117399288,-25407869,0.000264056115911027,100,-0.612903225806452
359.99,360,303,303,303,303,2024-05-07,2024-05-10,516.57,0,0,11379310,-7506291,0.00266272735341598,99.999507878773,0
324.99,325,303,284,606,284,2024-05-07,2024-05-31,516.57,-19,-322,66348411,-19082513,0.00042804340860552,100,-1.13380281690141
434.75,435,6,11,192,275,2024-05-07,2024-06-14,516.57,5,83,17277101,14428074,0.0015917022190239,99.9955142937464,0.301818181818182
234.93,235,35,35,245,245,2024-05-07,2024-08-16,516.57,0,0,103324269,-17142661,0.00023711757399416,99.9998451477068,0
384.92,385,7,27,91,216,2024-05-07,2024-06-07,516.57,20,125,14143969,2013047,0.00152715266839174,99.9979920770471,0.578703703703704
429.77,430,2,8,54,184,2024-05-07,2024-06-14,516.57,6,130,17277101,14428074,0.00106499348472872,99.9965792872311,0.706521739130435
403.19,405,1,1,181,181,2024-05-07,2024-10-18,516.57,0,0,1530129,786938,0.0118290680066844,100,0
419.81,420,0,9,0,171,2024-05-07,2024-06-14,516.57,9,171,17277101,14428074,0.000989749379829405,99.9975690366109,1
424.79,425,7,8,189,168,2024-05-07,2024-06-14,516.57,1,-21,17277101,14428074,0.000972385355621872,99.9985414219666,-0.125
214.95,215,53,32,265,160,2024-05-07,2024-08-16,516.57,-21,-105,103324269,-17142661,0.000154852293220676,100,-0.65625
389.92,390,14,14,126,112,2024-05-07,2024-06-07,516.57,0,-14,14143969,2013047,0.000791856939166086,99.9987839339863,-0.125
374.9,375,0,10,0,100,2024-05-07,2024-06-14,516.57,10,100,17277101,14428074,0.000578800806917781,99.9991202227735,1
369.94,370,14,15,98,90,2024-05-07,2024-06-07,516.57,1,-8.00000000000003,14143969,2013047,0.00063631361182989,99.9994202475981,-0.0888888888888892
364.99,365,56,56,56,56,2024-05-07,2024-05-10,516.57,0,0,11379310,-7506291,0.000492121227033977,100,0
369.91,370,5,6,50,54,2024-05-07,2024-06-14,516.57,1,4,17277101,14428074,0.000312552435735602,99.9994327752092,0.0740740740740741
359.96,360,5,12,50,48,2024-05-07,2024-06-07,516.57,7,-2,14143969,2013047,0.000339367259642608,99.9997596148578,-0.0416666666666667
409.84,410,0,3,0,48,2024-05-07,2024-06-14,516.57,3,48,17277101,14428074,0.000277824387320535,99.9997105995966,1
394.83,395,2,2,34,34,2024-05-07,2024-06-07,516.57,0,0,14143969,2013047,0.000240385142246847,100,0
389.88,390,0,2,0,24,2024-05-07,2024-06-14,516.57,2,24,17277101,14428074,0.000138912193660267,99.9998495117902,1
354.93,355,0,2,0,14,2024-05-07,2024-06-14,516.57,2,14,17277101,14428074,8.10321129684894e-05,99.9999305439032,1
349.94,350,1,2,7,12,2024-05-07,2024-06-14,516.57,1,5,17277101,14428074,6.94560968301337e-05,100,0.416666666666667
500.39,529,0,0,0,0,2024-05-07,2024-05-10,516.57,0,0,11379310,-7506291,0,100,
510.52,532.5,0,0,0,0,2024-05-07,2024-05-10,516.57,0,0,11379310,-7506291,0,100,
512.62,533,0,0,0,0,2024-05-07,2024-05-10,516.57,0,0,11379310,-7506291,0,100,
514.67,534,0,0,0,0,2024-05-07,2024-05-10,516.57,0,0,11379310,-7506291,0,100,
500,535,0,0,0,0,2024-05-07,2024-05-10,516.57,0,0,11379310,-7506291,0,100,
512.21,536,0,0,0,0,2024-05-07,2024-05-10,516.57,0,0,11379310,-7506291,0,100,
537,537,0,0,0,0,2024-05-07,2024-05-10,516.57,0,0,11379310,-7506291,0,100,
514.54,538,0,0,0,0,2024-05-07,2024-05-10,516.57,0,0,11379310,-7506291,0,100,
539,539,0,0,0,0,2024-05-07,2024-05-10,516.57,0,0,11379310,-7506291,0,100,
503.18,540,0,0,0,0,2024-05-07,2024-05-10,516.57,0,0,11379310,-7506291,0,100,
522.91,545,0,0,0,0,2024-05-07,2024-05-10,516.57,0,0,11379310,-7506291,0,100,
500.84,555,0,0,0,0,2024-05-07,2024-05-10,516.57,0,0,11379310,-7506291,0,100,
500.83,560,0,0,0,0,2024-05-07,2024-05-10,516.57,0,0,11379310,-7506291,0,100,
512.76,565,0,0,0,0,2024-05-07,2024-05-10,516.57,0,0,11379310,-7506291,0,100,
570,570,0,0,0,0,2024-05-07,2024-05-10,516.57,0,0,11379310,-7506291,0,100,
511.87,575,0,0,0,0,2024-05-07,2024-05-10,516.57,0,0,11379310,-7506291,0,100,
580,580,0,0,0,0,2024-05-07,2024-05-10,516.57,0,0,11379310,-7506291,0,100,
585,585,0,0,0,0,2024-05-07,2024-05-10,516.57,0,0,11379310,-7506291,0,100,
590,590,0,0,0,0,2024-05-07,2024-05-10,516.57,0,0,11379310,-7506291,0,100,
499.97,595,0,0,0,0,2024-05-07,2024-05-10,516.57,0,0,11379310,-7506291,0,100,
499.99,600,0,0,0,0,2024-05-07,2024-05-10,516.57,0,0,11379310,-7506291,0,100,
506.47,531,0,0,0,0,2024-05-07,2024-05-17,516.57,0,0,97672171,-63323414,0,100,
510.04,532,0,0,0,0,2024-05-07,2024-05-17,516.57,0,0,97672171,-63323414,0,100,
510.09,533,0,0,0,0,2024-05-07,2024-05-17,516.57,0,0,97672171,-63323414,0,100,
514,535,0,0,0,0,2024-05-07,2024-05-17,516.57,0,0,97672171,-63323414,0,100,
510.13,536,0,0,0,0,2024-05-07,2024-05-17,516.57,0,0,97672171,-63323414,0,100,
512.65,537,0,0,0,0,2024-05-07,2024-05-17,516.57,0,0,97672171,-63323414,0,100,
503.61,538,0,0,0,0,2024-05-07,2024-05-17,516.57,0,0,97672171,-63323414,0,100,
501.64,539,0,0,0,0,2024-05-07,2024-05-17,516.57,0,0,97672171,-63323414,0,100,
516.33,545,0,0,0,0,2024-05-07,2024-05-17,516.57,0,0,97672171,-63323414,0,100,
516.32,555,0,0,0,0,2024-05-07,2024-05-17,516.57,0,0,97672171,-63323414,0,100,
516.45,565,0,0,0,0,2024-05-07,2024-05-17,516.57,0,0,97672171,-63323414,0,100,
516.44,570,0,0,0,0,2024-05-07,2024-05-17,516.57,0,0,97672171,-63323414,0,100,
510.45,575,0,0,0,0,2024-05-07,2024-05-17,516.57,0,0,97672171,-63323414,0,100,
515.74,585,2,0,14664,0,2024-05-07,2024-05-17,516.57,-2,-14664,97672171,-63323414,0,100,-Inf
505.14,590,0,0,0,0,2024-05-07,2024-05-17,516.57,0,0,97672171,-63323414,0,100,
522.4,595,0,0,0,0,2024-05-07,2024-05-17,516.57,0,0,97672171,-63323414,0,100,
515.4,600,0,0,0,0,2024-05-07,2024-05-17,516.57,0,0,97672171,-63323414,0,100,
605,605,0,0,0,0,2024-05-07,2024-05-17,516.57,0,0,97672171,-63323414,0,100,
494.78,610,0,0,0,0,2024-05-07,2024-05-17,516.57,0,0,97672171,-63323414,0,100,
494.96,615,0,0,0,0,2024-05-07,2024-05-17,516.57,0,0,97672171,-63323414,0,100,
500,527,0,0,0,0,2024-05-07,2024-05-24,516.57,0,0,17630372,-8762837,0,100,
504.3,529,0,0,0,0,2024-05-07,2024-05-24,516.57,0,0,17630372,-8762837,0,100,
503.52,532,0,0,0,0,2024-05-07,2024-05-24,516.57,0,0,17630372,-8762837,0,100,
510.11,534,0,0,0,0,2024-05-07,2024-05-24,516.57,0,0,17630372,-8762837,0,100,
503.66,536,0,0,0,0,2024-05-07,2024-05-24,516.57,0,0,17630372,-8762837,0,100,
499.99,537,0,0,0,0,2024-05-07,2024-05-24,516.57,0,0,17630372,-8762837,0,100,
501.09,538,0,0,0,0,2024-05-07,2024-05-24,516.57,0,0,17630372,-8762837,0,100,
513.7,539,0,0,0,0,2024-05-07,2024-05-24,516.57,0,0,17630372,-8762837,0,100,
503.45,540,0,0,0,0,2024-05-07,2024-05-24,516.57,0,0,17630372,-8762837,0,100,
514.55,545,0,0,0,0,2024-05-07,2024-05-24,516.57,0,0,17630372,-8762837,0,100,
515.7,550,0,0,0,0,2024-05-07,2024-05-24,516.57,0,0,17630372,-8762837,0,100,
514.2,555,0,0,0,0,2024-05-07,2024-05-24,516.57,0,0,17630372,-8762837,0,100,
560,560,0,0,0,0,2024-05-07,2024-05-24,516.57,0,0,17630372,-8762837,0,100,
518.96,565,0,0,0,0,2024-05-07,2024-05-24,516.57,0,0,17630372,-8762837,0,100,
570,570,0,0,0,0,2024-05-07,2024-05-24,516.57,0,0,17630372,-8762837,0,100,
575,575,0,0,0,0,2024-05-07,2024-05-24,516.57,0,0,17630372,-8762837,0,100,
580,580,0,0,0,0,2024-05-07,2024-05-24,516.57,0,0,17630372,-8762837,0,100,
585,585,0,0,0,0,2024-05-07,2024-05-24,516.57,0,0,17630372,-8762837,0,100,
590,590,0,0,0,0,2024-05-07,2024-05-24,516.57,0,0,17630372,-8762837,0,100,
595,595,0,0,0,0,2024-05-07,2024-05-24,516.57,0,0,17630372,-8762837,0,100,
600,600,0,0,0,0,2024-05-07,2024-05-24,516.57,0,0,17630372,-8762837,0,100,
504.32,536,0,0,0,0,2024-05-07,2024-05-31,516.57,0,0,66348411,-19082513,0,100,
500.56,539,0,0,0,0,2024-05-07,2024-05-31,516.57,0,0,66348411,-19082513,0,100,
506.68,541,0,0,0,0,2024-05-07,2024-05-31,516.57,0,0,66348411,-19082513,0,100,
513.24,542,0,0,0,0,2024-05-07,2024-05-31,516.57,0,0,66348411,-19082513,0,100,
514.96,544,0,0,0,0,2024-05-07,2024-05-31,516.57,0,0,66348411,-19082513,0,100,
517.2,545,0,0,0,0,2024-05-07,2024-05-31,516.57,0,0,66348411,-19082513,0,100,
503.96,550,0,0,0,0,2024-05-07,2024-05-31,516.57,0,0,66348411,-19082513,0,100,
517,555,0,0,0,0,2024-05-07,2024-05-31,516.57,0,0,66348411,-19082513,0,100,
508.93,560,0,0,0,0,2024-05-07,2024-05-31,516.57,0,0,66348411,-19082513,0,100,
508.91,565,0,0,0,0,2024-05-07,2024-05-31,516.57,0,0,66348411,-19082513,0,100,
520.23,570,0,0,0,0,2024-05-07,2024-05-31,516.57,0,0,66348411,-19082513,0,100,
520.21,575,0,0,0,0,2024-05-07,2024-05-31,516.57,0,0,66348411,-19082513,0,100,
509.61,580,0,0,0,0,2024-05-07,2024-05-31,516.57,0,0,66348411,-19082513,0,100,
505.13,585,0,0,0,0,2024-05-07,2024-05-31,516.57,0,0,66348411,-19082513,0,100,
590,590,0,0,0,0,2024-05-07,2024-05-31,516.57,0,0,66348411,-19082513,0,100,
595,595,0,0,0,0,2024-05-07,2024-05-31,516.57,0,0,66348411,-19082513,0,100,
522.23,600,0,0,0,0,2024-05-07,2024-05-31,516.57,0,0,66348411,-19082513,0,100,
545,545,0,0,0,0,2024-05-07,2024-06-07,516.57,0,0,14143969,2013047,0,100,
510.48,555,0,0,0,0,2024-05-07,2024-06-07,516.57,0,0,14143969,2013047,0,100,
560,560,0,0,0,0,2024-05-07,2024-06-07,516.57,0,0,14143969,2013047,0,100,
565,565,0,0,0,0,2024-05-07,2024-06-07,516.57,0,0,14143969,2013047,0,100,
570,570,0,0,0,0,2024-05-07,2024-06-07,516.57,0,0,14143969,2013047,0,100,
575,575,0,0,0,0,2024-05-07,2024-06-07,516.57,0,0,14143969,2013047,0,100,
580,580,0,0,0,0,2024-05-07,2024-06-07,516.57,0,0,14143969,2013047,0,100,
585,585,0,0,0,0,2024-05-07,2024-06-07,516.57,0,0,14143969,2013047,0,100,
590,590,0,0,0,0,2024-05-07,2024-06-07,516.57,0,0,14143969,2013047,0,100,
595,595,0,0,0,0,2024-05-07,2024-06-07,516.57,0,0,14143969,2013047,0,100,
600,600,0,0,0,0,2024-05-07,2024-06-07,516.57,0,0,14143969,2013047,0,100,
365,365,0,0,0,0,2024-05-07,2024-06-14,516.57,0,0,17277101,14428074,0,100,
380,380,0,0,0,0,2024-05-07,2024-06-14,516.57,0,0,17277101,14428074,0,100,
395,395,0,0,0,0,2024-05-07,2024-06-14,516.57,0,0,17277101,14428074,0,100,
415,415,0,0,0,0,2024-05-07,2024-06-14,516.57,0,0,17277101,14428074,0,100,
505.47,545,0,0,0,0,2024-05-07,2024-06-14,516.57,0,0,17277101,14428074,0,100,
555,555,0,0,0,0,2024-05-07,2024-06-14,516.57,0,0,17277101,14428074,0,100,
560,560,0,0,0,0,2024-05-07,2024-06-14,516.57,0,0,17277101,14428074,0,100,
565,565,0,0,0,0,2024-05-07,2024-06-14,516.57,0,0,17277101,14428074,0,100,
570,570,0,0,0,0,2024-05-07,2024-06-14,516.57,0,0,17277101,14428074,0,100,
575,575,0,0,0,0,2024-05-07,2024-06-14,516.57,0,0,17277101,14428074,0,100,
580,580,0,0,0,0,2024-05-07,2024-06-14,516.57,0,0,17277101,14428074,0,100,
585,585,0,0,0,0,2024-05-07,2024-06-14,516.57,0,0,17277101,14428074,0,100,
590,590,0,0,0,0,2024-05-07,2024-06-14,516.57,0,0,17277101,14428074,0,100,
515.04,600,0,0,0,0,2024-05-07,2024-06-14,516.57,0,0,17277101,14428074,0,100,
505.14,534,0,0,0,0,2024-05-07,2024-06-21,516.57,0,0,348355461,-84761006,0,100,
504.47,536,0,0,0,0,2024-05-07,2024-06-21,516.57,0,0,348355461,-84761006,0,100,
503.1,537,0,0,0,0,2024-05-07,2024-06-21,516.57,0,0,348355461,-84761006,0,100,
505.18,538,0,0,0,0,2024-05-07,2024-06-21,516.57,0,0,348355461,-84761006,0,100,
505.11,539,0,0,0,0,2024-05-07,2024-06-21,516.57,0,0,348355461,-84761006,0,100,
501.33,541,0,0,0,0,2024-05-07,2024-06-21,516.57,0,0,348355461,-84761006,0,100,
500.69,542,0,0,0,0,2024-05-07,2024-06-21,516.57,0,0,348355461,-84761006,0,100,
508.68,543,0,0,0,0,2024-05-07,2024-06-21,516.57,0,0,348355461,-84761006,0,100,
500.39,544,0,0,0,0,2024-05-07,2024-06-21,516.57,0,0,348355461,-84761006,0,100,
500.71,545,0,0,0,0,2024-05-07,2024-06-21,516.57,0,0,348355461,-84761006,0,100,
513.93,546,0,0,0,0,2024-05-07,2024-06-21,516.57,0,0,348355461,-84761006,0,100,
514.02,547,0,0,0,0,2024-05-07,2024-06-21,516.57,0,0,348355461,-84761006,0,100,
513.31,548,0,0,0,0,2024-05-07,2024-06-21,516.57,0,0,348355461,-84761006,0,100,
514.1,549,0,0,0,0,2024-05-07,2024-06-21,516.57,0,0,348355461,-84761006,0,100,
523.9,551,0,0,0,0,2024-05-07,2024-06-21,516.57,0,0,348355461,-84761006,0,100,
495.8,552,0,0,0,0,2024-05-07,2024-06-21,516.57,0,0,348355461,-84761006,0,100,
503.09,560,0,0,0,0,2024-05-07,2024-06-21,516.57,0,0,348355461,-84761006,0,100,
523.4,565,0,0,0,0,2024-05-07,2024-06-21,516.57,0,0,348355461,-84761006,0,100,
513.69,570,0,0,0,0,2024-05-07,2024-06-21,516.57,0,0,348355461,-84761006,0,100,
524.26,575,0,0,0,0,2024-05-07,2024-06-21,516.57,0,0,348355461,-84761006,0,100,
515.73,585,5,0,36665,0,2024-05-07,2024-06-21,516.57,-5,-36665,348355461,-84761006,0,100,-Inf
503.78,590,0,0,0,0,2024-05-07,2024-06-21,516.57,0,0,348355461,-84761006,0,100,
503.9,595,0,0,0,0,2024-05-07,2024-06-21,516.57,0,0,348355461,-84761006,0,100,
515.71,605,1,0,9333,0,2024-05-07,2024-06-21,516.57,-1,-9333,348355461,-84761006,0,100,-Inf
505.13,610,0,0,0,0,2024-05-07,2024-06-21,516.57,0,0,348355461,-84761006,0,100,
519.19,615,0,0,0,0,2024-05-07,2024-06-21,516.57,0,0,348355461,-84761006,0,100,
519.04,620,0,0,0,0,2024-05-07,2024-06-21,516.57,0,0,348355461,-84761006,0,100,
434.09,625,0,0,0,0,2024-05-07,2024-06-21,516.57,0,0,348355461,-84761006,0,100,
509.24,630,0,0,0,0,2024-05-07,2024-06-21,516.57,0,0,348355461,-84761006,0,100,
499.11,635,0,0,0,0,2024-05-07,2024-06-21,516.57,0,0,348355461,-84761006,0,100,
499.02,640,0,0,0,0,2024-05-07,2024-06-21,516.57,0,0,348355461,-84761006,0,100,
433.93,645,0,0,0,0,2024-05-07,2024-06-21,516.57,0,0,348355461,-84761006,0,100,
508.54,650,0,0,0,0,2024-05-07,2024-06-21,516.57,0,0,348355461,-84761006,0,100,
434.02,655,0,0,0,0,2024-05-07,2024-06-21,516.57,0,0,348355461,-84761006,0,100,
433.52,660,0,0,0,0,2024-05-07,2024-06-21,516.57,0,0,348355461,-84761006,0,100,
433.78,665,0,0,0,0,2024-05-07,2024-06-21,516.57,0,0,348355461,-84761006,0,100,
433.8,670,0,0,0,0,2024-05-07,2024-06-21,516.57,0,0,348355461,-84761006,0,100,
510.44,675,0,0,0,0,2024-05-07,2024-06-21,516.57,0,0,348355461,-84761006,0,100,
510.07,680,0,0,0,0,2024-05-07,2024-06-21,516.57,0,0,348355461,-84761006,0,100,
512.65,531,8,0,21136,0,2024-05-07,2024-06-28,516.57,-8,-21136,83365113,-15781476,0,100,-Inf
513,532,8,0,21952,0,2024-05-07,2024-06-28,516.57,-8,-21952,83365113,-15781476,0,100,-Inf
504.43,533,0,0,0,0,2024-05-07,2024-06-28,516.57,0,0,83365113,-15781476,0,100,
517.34,536,0,0,0,0,2024-05-07,2024-06-28,516.57,0,0,83365113,-15781476,0,100,
517.85,537,0,0,0,0,2024-05-07,2024-06-28,516.57,0,0,83365113,-15781476,0,100,
509.83,539,0,0,0,0,2024-05-07,2024-06-28,516.57,0,0,83365113,-15781476,0,100,
506.35,543,0,0,0,0,2024-05-07,2024-06-28,516.57,0,0,83365113,-15781476,0,100,
544,544,0,0,0,0,2024-05-07,2024-06-28,516.57,0,0,83365113,-15781476,0,100,
520.14,546,0,0,0,0,2024-05-07,2024-06-28,516.57,0,0,83365113,-15781476,0,100,
547,547,0,0,0,0,2024-05-07,2024-06-28,516.57,0,0,83365113,-15781476,0,100,
548,548,0,0,0,0,2024-05-07,2024-06-28,516.57,0,0,83365113,-15781476,0,100,
516.7,549,0,0,0,0,2024-05-07,2024-06-28,516.57,0,0,83365113,-15781476,0,100,
517.95,551,0,0,0,0,2024-05-07,2024-06-28,516.57,0,0,83365113,-15781476,0,100,
552,552,0,0,0,0,2024-05-07,2024-06-28,516.57,0,0,83365113,-15781476,0,100,
553,553,0,0,0,0,2024-05-07,2024-06-28,516.57,0,0,83365113,-15781476,0,100,
554,554,0,0,0,0,2024-05-07,2024-06-28,516.57,0,0,83365113,-15781476,0,100,
501.26,556,0,0,0,0,2024-05-07,2024-06-28,516.57,0,0,83365113,-15781476,0,100,
557,557,0,0,0,0,2024-05-07,2024-06-28,516.57,0,0,83365113,-15781476,0,100,
558,558,0,0,0,0,2024-05-07,2024-06-28,516.57,0,0,83365113,-15781476,0,100,
559,559,0,0,0,0,2024-05-07,2024-06-28,516.57,0,0,83365113,-15781476,0,100,
499.23,560,0,0,0,0,2024-05-07,2024-06-28,516.57,0,0,83365113,-15781476,0,100,
561,561,0,0,0,0,2024-05-07,2024-06-28,516.57,0,0,83365113,-15781476,0,100,
562,562,0,0,0,0,2024-05-07,2024-06-28,516.57,0,0,83365113,-15781476,0,100,
563,563,0,0,0,0,2024-05-07,2024-06-28,516.57,0,0,83365113,-15781476,0,100,
564,564,0,0,0,0,2024-05-07,2024-06-28,516.57,0,0,83365113,-15781476,0,100,
565,565,0,0,0,0,2024-05-07,2024-06-28,516.57,0,0,83365113,-15781476,0,100,
566,566,0,0,0,0,2024-05-07,2024-06-28,516.57,0,0,83365113,-15781476,0,100,
567,567,0,0,0,0,2024-05-07,2024-06-28,516.57,0,0,83365113,-15781476,0,100,
568,568,0,0,0,0,2024-05-07,2024-06-28,516.57,0,0,83365113,-15781476,0,100,
569,569,0,0,0,0,2024-05-07,2024-06-28,516.57,0,0,83365113,-15781476,0,100,
516.8,570,0,0,0,0,2024-05-07,2024-06-28,516.57,0,0,83365113,-15781476,0,100,
575,575,0,0,0,0,2024-05-07,2024-06-28,516.57,0,0,83365113,-15781476,0,100,
580,580,0,0,0,0,2024-05-07,2024-06-28,516.57,0,0,83365113,-15781476,0,100,
585,585,0,0,0,0,2024-05-07,2024-06-28,516.57,0,0,83365113,-15781476,0,100,
590,590,0,0,0,0,2024-05-07,2024-06-28,516.57,0,0,83365113,-15781476,0,100,
595,595,0,0,0,0,2024-05-07,2024-06-28,516.57,0,0,83365113,-15781476,0,100,
499.77,600,0,0,0,0,2024-05-07,2024-06-28,516.57,0,0,83365113,-15781476,0,100,
504.32,538,0,0,0,0,2024-05-07,2024-07-19,516.57,0,0,117399288,-25407869,0,100,
520.1,555,0,0,0,0,2024-05-07,2024-07-19,516.57,0,0,117399288,-25407869,0,100,
512.24,560,0,0,0,0,2024-05-07,2024-07-19,516.57,0,0,117399288,-25407869,0,100,
501.11,565,0,0,0,0,2024-05-07,2024-07-19,516.57,0,0,117399288,-25407869,0,100,
570,570,0,0,0,0,2024-05-07,2024-07-19,516.57,0,0,117399288,-25407869,0,100,
495.5,575,0,0,0,0,2024-05-07,2024-07-19,516.57,0,0,117399288,-25407869,0,100,
501.64,580,0,0,0,0,2024-05-07,2024-07-19,516.57,0,0,117399288,-25407869,0,100,
585,585,0,0,0,0,2024-05-07,2024-07-19,516.57,0,0,117399288,-25407869,0,100,
511,590,0,0,0,0,2024-05-07,2024-07-19,516.57,0,0,117399288,-25407869,0,100,
513.9,595,0,0,0,0,2024-05-07,2024-07-19,516.57,0,0,117399288,-25407869,0,100,
511.68,605,3,0,27996,0,2024-05-07,2024-07-19,516.57,-3,-27996,117399288,-25407869,0,100,-Inf
610,610,0,0,0,0,2024-05-07,2024-07-19,516.57,0,0,117399288,-25407869,0,100,
523.73,615,0,0,0,0,2024-05-07,2024-07-19,516.57,0,0,117399288,-25407869,0,100,
620,620,0,0,0,0,2024-05-07,2024-07-19,516.57,0,0,117399288,-25407869,0,100,
625,625,0,0,0,0,2024-05-07,2024-07-19,516.57,0,0,117399288,-25407869,0,100,
630,630,0,0,0,0,2024-05-07,2024-07-19,516.57,0,0,117399288,-25407869,0,100,
504.44,640,0,0,0,0,2024-05-07,2024-07-19,516.57,0,0,117399288,-25407869,0,100,
645,645,0,0,0,0,2024-05-07,2024-07-19,516.57,0,0,117399288,-25407869,0,100,
650,650,0,0,0,0,2024-05-07,2024-07-19,516.57,0,0,117399288,-25407869,0,100,
497.72,545,0,0,0,0,2024-05-07,2024-08-16,516.57,0,0,103324269,-17142661,0,100,
500.74,550,0,0,0,0,2024-05-07,2024-08-16,516.57,0,0,103324269,-17142661,0,100,
518.38,555,0,0,0,0,2024-05-07,2024-08-16,516.57,0,0,103324269,-17142661,0,100,
515.6,560,0,0,0,0,2024-05-07,2024-08-16,516.57,0,0,103324269,-17142661,0,100,
509.71,565,0,0,0,0,2024-05-07,2024-08-16,516.57,0,0,103324269,-17142661,0,100,
510.48,570,0,0,0,0,2024-05-07,2024-08-16,516.57,0,0,103324269,-17142661,0,100,
514.41,575,0,0,0,0,2024-05-07,2024-08-16,516.57,0,0,103324269,-17142661,0,100,
520.79,580,0,0,0,0,2024-05-07,2024-08-16,516.57,0,0,103324269,-17142661,0,100,
585,585,0,0,0,0,2024-05-07,2024-08-16,516.57,0,0,103324269,-17142661,0,100,
590,590,0,0,0,0,2024-05-07,2024-08-16,516.57,0,0,103324269,-17142661,0,100,
595,595,0,0,0,0,2024-05-07,2024-08-16,516.57,0,0,103324269,-17142661,0,100,
515.34,600,0,0,0,0,2024-05-07,2024-08-16,516.57,0,0,103324269,-17142661,0,100,
507.56,605,0,0,0,0,2024-05-07,2024-08-16,516.57,0,0,103324269,-17142661,0,100,
610,610,0,0,0,0,2024-05-07,2024-08-16,516.57,0,0,103324269,-17142661,0,100,
505.04,620,0,0,0,0,2024-05-07,2024-08-16,516.57,0,0,103324269,-17142661,0,100,
519.07,625,0,0,0,0,2024-05-07,2024-08-16,516.57,0,0,103324269,-17142661,0,100,
514.22,630,0,0,0,0,2024-05-07,2024-08-16,516.57,0,0,103324269,-17142661,0,100,
504.99,635,0,0,0,0,2024-05-07,2024-08-16,516.57,0,0,103324269,-17142661,0,100,
512.31,640,0,0,0,0,2024-05-07,2024-08-16,516.57,0,0,103324269,-17142661,0,100,
645,645,0,0,0,0,2024-05-07,2024-08-16,516.57,0,0,103324269,-17142661,0,100,
650,650,0,0,0,0,2024-05-07,2024-08-16,516.57,0,0,103324269,-17142661,0,100,
505.05,570,0,0,0,0,2024-05-07,2024-09-20,516.57,0,0,300792694,-48138153,0,100,
522.01,575,0,0,0,0,2024-05-07,2024-09-20,516.57,0,0,300792694,-48138153,0,100,
580,580,0,0,0,0,2024-05-07,2024-09-20,516.57,0,0,300792694,-48138153,0,100,
518.8,585,0,0,0,0,2024-05-07,2024-09-20,516.57,0,0,300792694,-48138153,0,100,
590,590,0,0,0,0,2024-05-07,2024-09-20,516.57,0,0,300792694,-48138153,0,100,
595,595,0,0,0,0,2024-05-07,2024-09-20,516.57,0,0,300792694,-48138153,0,100,
503.9,600,0,0,0,0,2024-05-07,2024-09-20,516.57,0,0,300792694,-48138153,0,100,
504.79,605,0,0,0,0,2024-05-07,2024-09-20,516.57,0,0,300792694,-48138153,0,100,
610,610,0,0,0,0,2024-05-07,2024-09-20,516.57,0,0,300792694,-48138153,0,100,
615,615,0,0,0,0,2024-05-07,2024-09-20,516.57,0,0,300792694,-48138153,0,100,
620,620,0,0,0,0,2024-05-07,2024-09-20,516.57,0,0,300792694,-48138153,0,100,
498,625,0,0,0,0,2024-05-07,2024-09-20,516.57,0,0,300792694,-48138153,0,100,
630,630,0,0,0,0,2024-05-07,2024-09-20,516.57,0,0,300792694,-48138153,0,100,
635,635,0,0,0,0,2024-05-07,2024-09-20,516.57,0,0,300792694,-48138153,0,100,
435.01,640,0,0,0,0,2024-05-07,2024-09-20,516.57,0,0,300792694,-48138153,0,100,
645,645,0,0,0,0,2024-05-07,2024-09-20,516.57,0,0,300792694,-48138153,0,100,
434.57,650,0,0,0,0,2024-05-07,2024-09-20,516.57,0,0,300792694,-48138153,0,100,
434.75,655,0,0,0,0,2024-05-07,2024-09-20,516.57,0,0,300792694,-48138153,0,100,
660,660,0,0,0,0,2024-05-07,2024-09-20,516.57,0,0,300792694,-48138153,0,100,
435,665,0,0,0,0,2024-05-07,2024-09-20,516.57,0,0,300792694,-48138153,0,100,
434.73,670,0,0,0,0,2024-05-07,2024-09-20,516.57,0,0,300792694,-48138153,0,100,
434.51,675,0,0,0,0,2024-05-07,2024-09-20,516.57,0,0,300792694,-48138153,0,100,
434.79,680,0,0,0,0,2024-05-07,2024-09-20,516.57,0,0,300792694,-48138153,0,100,
450.5,685,0,0,0,0,2024-05-07,2024-09-20,516.57,0,0,300792694,-48138153,0,100,
434.75,690,0,0,0,0,2024-05-07,2024-09-20,516.57,0,0,300792694,-48138153,0,100,
434.68,695,0,0,0,0,2024-05-07,2024-09-20,516.57,0,0,300792694,-48138153,0,100,
509.3,700,0,0,0,0,2024-05-07,2024-09-20,516.57,0,0,300792694,-48138153,0,100,
401,401,0,0,0,0,2024-05-07,2024-10-18,516.57,0,0,1530129,786938,0,100,
402,402,0,0,0,0,2024-05-07,2024-10-18,516.57,0,0,1530129,786938,0,100,
403,403,0,0,0,0,2024-05-07,2024-10-18,516.57,0,0,1530129,786938,0,100,
404,404,0,0,0,0,2024-05-07,2024-10-18,516.57,0,0,1530129,786938,0,100,
404.14,406,0,0,0,0,2024-05-07,2024-10-18,516.57,0,0,1530129,786938,0,100,
407,407,0,0,0,0,2024-05-07,2024-10-18,516.57,0,0,1530129,786938,0,100,
408,408,0,0,0,0,2024-05-07,2024-10-18,516.57,0,0,1530129,786938,0,100,
409,409,0,0,0,0,2024-05-07,2024-10-18,516.57,0,0,1530129,786938,0,100,
410,410,0,0,0,0,2024-05-07,2024-10-18,516.57,0,0,1530129,786938,0,100,
411,411,0,0,0,0,2024-05-07,2024-10-18,516.57,0,0,1530129,786938,0,100,
412,412,0,0,0,0,2024-05-07,2024-10-18,516.57,0,0,1530129,786938,0,100,
413,413,0,0,0,0,2024-05-07,2024-10-18,516.57,0,0,1530129,786938,0,100,
414,414,0,0,0,0,2024-05-07,2024-10-18,516.57,0,0,1530129,786938,0,100,
415,415,0,0,0,0,2024-05-07,2024-10-18,516.57,0,0,1530129,786938,0,100,
416,416,0,0,0,0,2024-05-07,2024-10-18,516.57,0,0,1530129,786938,0,100,
417,417,0,0,0,0,2024-05-07,2024-10-18,516.57,0,0,1530129,786938,0,100,
418,418,0,0,0,0,2024-05-07,2024-10-18,516.57,0,0,1530129,786938,0,100,
419,419,0,0,0,0,2024-05-07,2024-10-18,516.57,0,0,1530129,786938,0,100,
421,421,0,0,0,0,2024-05-07,2024-10-18,516.57,0,0,1530129,786938,0,100,
422,422,0,0,0,0,2024-05-07,2024-10-18,516.57,0,0,1530129,786938,0,100,
423,423,0,0,0,0,2024-05-07,2024-10-18,516.57,0,0,1530129,786938,0,100,
424,424,0,0,0,0,2024-05-07,2024-10-18,516.57,0,0,1530129,786938,0,100,
426,426,0,0,0,0,2024-05-07,2024-10-18,516.57,0,0,1530129,786938,0,100,
427,427,0,0,0,0,2024-05-07,2024-10-18,516.57,0,0,1530129,786938,0,100,
428,428,0,0,0,0,2024-05-07,2024-10-18,516.57,0,0,1530129,786938,0,100,
429,429,0,0,0,0,2024-05-07,2024-10-18,516.57,0,0,1530129,786938,0,100,
431,431,0,0,0,0,2024-05-07,2024-10-18,516.57,0,0,1530129,786938,0,100,
432,432,0,0,0,0,2024-05-07,2024-10-18,516.57,0,0,1530129,786938,0,100,
433,433,0,0,0,0,2024-05-07,2024-10-18,516.57,0,0,1530129,786938,0,100,
434,434,0,0,0,0,2024-05-07,2024-10-18,516.57,0,0,1530129,786938,0,100,
436,436,0,0,0,0,2024-05-07,2024-10-18,516.57,0,0,1530129,786938,0,100,
438,438,0,0,0,0,2024-05-07,2024-10-18,516.57,0,0,1530129,786938,0,100,
439,439,0,0,0,0,2024-05-07,2024-10-18,516.57,0,0,1530129,786938,0,100,
545,545,0,0,0,0,2024-05-07,2024-10-18,516.57,0,0,1530129,786938,0,100,
550,550,0,0,0,0,2024-05-07,2024-10-18,516.57,0,0,1530129,786938,0,100,
500.7,565,0,0,0,0,2024-05-07,2024-12-20,516.57,0,0,537706253,-56832135,0,100,
500.86,575,0,0,0,0,2024-05-07,2024-12-20,516.57,0,0,537706253,-56832135,0,100,
505.75,585,0,0,0,0,2024-05-07,2024-12-20,516.57,0,0,537706253,-56832135,0,100,
513.3,590,0,0,0,0,2024-05-07,2024-12-20,516.57,0,0,537706253,-56832135,0,100,
595,595,0,0,0,0,2024-05-07,2024-12-20,516.57,0,0,537706253,-56832135,0,100,
505.66,605,0,0,0,0,2024-05-07,2024-12-20,516.57,0,0,537706253,-56832135,0,100,
513.01,610,0,0,0,0,2024-05-07,2024-12-20,516.57,0,0,537706253,-56832135,0,100,
519.93,615,0,0,0,0,2024-05-07,2024-12-20,516.57,0,0,537706253,-56832135,0,100,
501.22,625,0,0,0,0,2024-05-07,2024-12-20,516.57,0,0,537706253,-56832135,0,100,
501.25,630,0,0,0,0,2024-05-07,2024-12-20,516.57,0,0,537706253,-56832135,0,100,
514.35,635,0,0,0,0,2024-05-07,2024-12-20,516.57,0,0,537706253,-56832135,0,100,
484.92,640,0,0,0,0,2024-05-07,2024-12-20,516.57,0,0,537706253,-56832135,0,100,
493.79,645,0,0,0,0,2024-05-07,2024-12-20,516.57,0,0,537706253,-56832135,0,100,
497.5,650,0,0,0,0,2024-05-07,2024-12-20,516.57,0,0,537706253,-56832135,0,100,
453.98,655,0,0,0,0,2024-05-07,2024-12-20,516.57,0,0,537706253,-56832135,0,100,
418.16,660,0,0,0,0,2024-05-07,2024-12-20,516.57,0,0,537706253,-56832135,0,100,
665,665,0,0,0,0,2024-05-07,2024-12-20,516.57,0,0,537706253,-56832135,0,100,
670,670,0,0,0,0,2024-05-07,2024-12-20,516.57,0,0,537706253,-56832135,0,100,
675,675,0,0,0,0,2024-05-07,2024-12-20,516.57,0,0,537706253,-56832135,0,100,
680,680,0,0,0,0,2024-05-07,2024-12-20,516.57,0,0,537706253,-56832135,0,100,
685,685,0,0,0,0,2024-05-07,2024-12-20,516.57,0,0,537706253,-56832135,0,100,
690,690,0,0,0,0,2024-05-07,2024-12-20,516.57,0,0,537706253,-56832135,0,100,
493.35,695,0,0,0,0,2024-05-07,2024-12-20,516.57,0,0,537706253,-56832135,0,100,
498.41,700,0,0,0,0,2024-05-07,2024-12-20,516.57,0,0,537706253,-56832135,0,100,
705,705,0,0,0,0,2024-05-07,2024-12-20,516.57,0,0,537706253,-56832135,0,100,
418.57,710,0,0,0,0,2024-05-07,2024-12-20,516.57,0,0,537706253,-56832135,0,100,
494.27,715,0,0,0,0,2024-05-07,2024-12-20,516.57,0,0,537706253,-56832135,0,100,
500.56,725,0,0,0,0,2024-05-07,2024-12-20,516.57,0,0,537706253,-56832135,0,100,
730,730,0,0,0,0,2024-05-07,2024-12-20,516.57,0,0,537706253,-56832135,0,100,
735,735,0,0,0,0,2024-05-07,2024-12-20,516.57,0,0,537706253,-56832135,0,100,
740,740,0,0,0,0,2024-05-07,2024-12-20,516.57,0,0,537706253,-56832135,0,100,
512.87,745,0,0,0,0,2024-05-07,2024-12-20,516.57,0,0,537706253,-56832135,0,100,
750,750,0,0,0,0,2024-05-07,2024-12-20,516.57,0,0,537706253,-56832135,0,100,
755,755,0,0,0,0,2024-05-07,2024-12-20,516.57,0,0,537706253,-56832135,0,100,
760,760,0,0,0,0,2024-05-07,2024-12-20,516.57,0,0,537706253,-56832135,0,100,
765,765,0,0,0,0,2024-05-07,2024-12-20,516.57,0,0,537706253,-56832135,0,100,
770,770,0,0,0,0,2024-05-07,2024-12-20,516.57,0,0,537706253,-56832135,0,100,
