Watch,strike,open_interest.yt,open_interest.td,OI_Dollar.yt,OI_Dollar.td,Date.td,expiry,stkClose,diff_oi,diff_oi_d,totalOI,totalOIdiff,OI_pct,cum_sep_OI,pct
455.52,460,138073,138260,72764471,61940480,2024-05-16,2024-12-20,529.78,187,-10823991,392218823,-61081925,15.7923272336167,15.7923272336167,-0.174748258327995
464.62,470,59555,61287,37102765,32972406,2024-05-16,2024-12-20,529.78,1732,-4130359,392218823,-61081925,8.40663529297267,24.1989625265894,-0.125267140044315
518.25,540,12558,12591,31583370,27385425,2024-05-16,2024-12-20,529.78,33,-4197945,392218823,-61081925,6.98218019995435,31.1811427265438,-0.153291212387611
517.8,530,15783,15984,24479433,19500480,2024-05-16,2024-09-20,529.78,201,-4978953,207805543,-46765032,9.38400377510623,9.38400377510623,-0.255324638162753
482.25,490,23760,24178,21502800,18737950,2024-05-16,2024-12-20,529.78,418,-2764850,392218823,-61081925,4.77742242370657,35.9585651502503,-0.147553494379054
512.7,530,10574,10316,21348906,17846680,2024-05-16,2024-12-20,529.78,-258,-3502226,392218823,-61081925,4.55018447699538,40.5087496272457,-0.196239636727952
490.53,500,18268,17889,20094800,16940883,2024-05-16,2024-12-20,529.78,-379,-3153917,392218823,-61081925,4.31924273047956,44.8279923577253,-0.186171936846503
503.26,510,27566,25120,23348402,16930880,2024-05-16,2024-09-20,529.78,-2446,-6417522,207805543,-46765032,8.14746313095219,17.5314669060584,-0.379042436069478
505.7,520,11616,11449,19282560,16372070,2024-05-16,2024-12-20,529.78,-167,-2910490,392218823,-61081925,4.17421832913919,49.0022106868645,-0.177771656241391
515.53,535,8450,8397,20609550,16348959,2024-05-16,2024-12-20,529.78,-53,-4260591,392218823,-61081925,4.16832595512633,53.1705366419908,-0.260603198038481
494.92,500,26698,31479,17166814,15991332,2024-05-16,2024-09-20,529.78,4781,-1175482,207805543,-46765032,7.69533467160691,25.2268015776653,-0.0735074476597697
508.13,510,100793,83204,31951381,15559148,2024-05-16,2024-06-21,529.78,-17589,-16392233,168672803,-78039132,9.22445570552355,9.22445570552355,-1.05354309888948
511.06,520,15503,15685,17719929,14022390,2024-05-16,2024-09-20,529.78,182,-3697539,207805543,-46765032,6.74784214009152,31.9746437177568,-0.263688215774914
398.06,400,67398,67392,14692764,13074048,2024-05-16,2024-12-20,529.78,-6,-1618716,392218823,-61081925,3.33335557431929,56.5038922163101,-0.123811385731489
467.51,470,49326,49388,15291060,12297612,2024-05-16,2024-09-20,529.78,62,-2993448,207805543,-46765032,5.91784599316487,37.8924897109217,-0.243417014620399
507.21,515,14651,15349,14387282,11956871,2024-05-16,2024-09-20,529.78,698,-2430411,207805543,-46765032,5.75387490987187,43.6463646207936,-0.203264800632206
516.58,520,24456,33238,14062200,11367396,2024-05-16,2024-06-21,529.78,8782,-2694804,168672803,-78039132,6.73931765988379,15.9637733654073,-0.237064319743941
512,515,3452,37569,1670768,11270700,2024-05-16,2024-06-28,529.78,34117,9599932,71313964,4291035,15.8043381237369,15.8043381237369,0.85176005039616
500.42,503,2415,43501,903210,11223258,2024-05-16,2024-07-19,529.78,41086,10320048,106722520,-20817707,10.5162977785757,10.5162977785757,0.919523368348121
473.62,480,16179,16391,12085713,10457458,2024-05-16,2024-12-20,529.78,212,-1628255,392218823,-61081925,2.6662305291758,59.1701227454859,-0.155702753001733
472.27,475,38451,37850,13073340,10333050,2024-05-16,2024-09-20,529.78,-601,-2740290,207805543,-46765032,4.97246120138383,48.6188258221774,-0.26519662635911
514.72,525,9791,9996,12845792,10275888,2024-05-16,2024-09-20,529.78,205,-2569904,207805543,-46765032,4.94495375419317,53.5637795763706,-0.250090697757703
522.84,550,3750,3757,11587500,10204012,2024-05-16,2024-12-20,529.78,7,-1383488,392218823,-61081925,2.60161200881478,61.7717347543007,-0.135582749216681
469.2,475,15809,17131,10908210,9935980,2024-05-16,2024-12-20,529.78,1322,-972230,392218823,-61081925,2.53327464602585,64.3050094003265,-0.0978494320640742
450.82,455,22696,23384,11030256,9774512,2024-05-16,2024-12-20,529.78,688,-1255744,392218823,-61081925,2.49210681048829,66.7971162108148,-0.12847127304156
509.44,525,5919,6174,10873203,9606744,2024-05-16,2024-12-20,529.78,255,-1266459,392218823,-61081925,2.44933272873546,69.2464489395503,-0.131830201783247
520.96,545,3932,3932,11052852,9452528,2024-05-16,2024-12-20,529.78,0,-1600324,392218823,-61081925,2.41001386106347,71.6564628006137,-0.169301164725458
498.92,500,86381,86583,15634961,9350964,2024-05-16,2024-06-21,529.78,202,-6283997,168672803,-78039132,5.54384810928885,21.5076214746962,-0.672015954718679
505.11,510,17212,18933,11325496,9258237,2024-05-16,2024-08-16,529.78,1721,-2067259,85913959,-15086717,10.7761731711141,10.7761731711141,-0.223288623957239
478.04,480,46326,46389,11952108,9092244,2024-05-16,2024-08-16,529.78,63,-2859864,85913959,-15086717,10.5829647543073,21.3591379254214,-0.314538853114809
486.06,490,22960,22203,11204480,8747982,2024-05-16,2024-09-20,529.78,-757,-2456498,207805543,-46765032,4.20969617735365,57.7734757537242,-0.28080739077881
520.13,525,6819,17200,5271087,8376400,2024-05-16,2024-06-21,529.78,10381,3105313,168672803,-78039132,4.96606438679981,26.473685861496,0.370721670407335
457.99,460,41198,41173,10175906,8275773,2024-05-16,2024-09-20,529.78,-25,-1900133,207805543,-46765032,3.98246017913006,61.7559359328543,-0.229601875256849
446.15,450,21116,21305,9375504,8202425,2024-05-16,2024-12-20,529.78,189,-1173079,392218823,-61081925,2.09128795432646,73.7477507549402,-0.143016120232736
476.96,480,26845,26899,10442705,8177296,2024-05-16,2024-09-20,529.78,54,-2265409,207805543,-46765032,3.93507116410268,65.691007096957,-0.27703644334264
499.2,505,13299,13472,9615177,7813760,2024-05-16,2024-09-20,529.78,173,-1801417,207805543,-46765032,3.76013069102781,69.4511377879848,-0.230544193832419
481.48,485,21490,21588,9348150,7598976,2024-05-16,2024-09-20,529.78,98,-1749174,207805543,-46765032,3.65677252410923,73.107910312094,-0.230185488149982
490.56,495,16812,16832,9280224,7473408,2024-05-16,2024-09-20,529.78,20,-1806816,207805543,-46765032,3.5963468019715,76.7042571140655,-0.241766005549276
497.68,500,27069,29202,8905701,6774864,2024-05-16,2024-07-19,529.78,2133,-2130837,106722520,-20817707,6.34811097039313,16.8644087489688,-0.314520999978745
494.55,505,6483,6360,7896294,6646200,2024-05-16,2024-12-20,529.78,-123,-1250094,392218823,-61081925,1.69451326919106,75.4422640241313,-0.188091541030965
441.46,445,18060,18058,7386540,6392532,2024-05-16,2024-12-20,529.78,-2,-994007.999999999,392218823,-61081925,1.62983814777293,77.0721021719042,-0.155495193453861
502.27,515,5378,4834,8072378,6153682,2024-05-16,2024-12-20,529.78,-544,-1918696,392218823,-61081925,1.568941019437,78.6410431913412,-0.311796417169428
436.73,440,18053,18089,6896246,5915103,2024-05-16,2024-12-20,529.78,36,-981142.999999999,392218823,-61081925,1.50811298518429,80.1491561765255,-0.165870822536818
509.89,514,12686,14281,7345194,5869491,2024-05-16,2024-07-19,529.78,1595,-1475703,106722520,-20817707,5.49976799648284,22.3641767454517,-0.251419245723352
498.66,510,5228,5114,6995064,5799276,2024-05-16,2024-12-20,529.78,-114,-1195788,392218823,-61081925,1.47858176607705,81.6277379426025,-0.206196083787011
490.36,492,34931,34959,8418371,5733276,2024-05-16,2024-07-19,529.78,28,-2685095,106722520,-20817707,5.37213326671821,27.7363100121699,-0.46833520660788
417.5,420,21900,21814,6241500,5453500,2024-05-16,2024-12-20,529.78,-86,-788000,392218823,-61081925,1.39042281507229,83.0181607576748,-0.144494361419272
487.42,490,21152,20468,7107072,5280744,2024-05-16,2024-08-16,529.78,-684,-1826328,85913959,-15086717,6.14654947981154,27.505687405233,-0.34584672159832
495.87,498,43124,24759,13066572,5273667,2024-05-16,2024-07-19,529.78,-18365,-7792905,106722520,-20817707,4.94147533247903,32.6777853446489,-1.47770137932486
516.44,525,4901,6142,5498922,5257552,2024-05-16,2024-08-16,529.78,1241,-241370,85913959,-15086717,6.11955503063245,33.6252424358654,-0.0459091988058321
519.48,530,935,4839,1264120,5090628,2024-05-16,2024-08-16,529.78,3904,3826508,85913959,-15086717,5.92526297152713,39.5505054073925,0.751677003308826
431.96,435,16376,16574,5780728,5038496,2024-05-16,2024-12-20,529.78,198,-742232,392218823,-61081925,1.28461351279921,84.302774270474,-0.147312213803484
512.47,515,18710,19785,7951750,5005605,2024-05-16,2024-06-21,529.78,1075,-2946145,168672803,-78039132,2.96764203296011,29.4413278944561,-0.588569213911206
506.57,510,13707,14454,6853500,4957722,2024-05-16,2024-07-19,529.78,747,-1895778,106722520,-20817707,4.64543191071575,37.3232172553647,-0.382388927818058
514.55,520,7033,8821,5436509,4807445,2024-05-16,2024-07-19,529.78,1788,-629064,106722520,-20817707,4.50462095535225,41.8278382107169,-0.130852043029093
489.31,490,71857,69296,7976127,4781424,2024-05-16,2024-06-21,529.78,-2561,-3194703,168672803,-78039132,2.83473323200777,32.2760611264639,-0.668148861092428
492.03,495,15944,15831,6377600,4701807,2024-05-16,2024-08-16,529.78,-113,-1675793,85913959,-15086717,5.47269274367859,45.0231981510711,-0.356414672061188
443.45,445,29938,29938,5688220,4640390,2024-05-16,2024-09-20,529.78,0,-1047830,207805543,-46765032,2.23304438034167,78.9373014944072,-0.225806451612903
459.61,460,17288,116525,898976,4544475,2024-05-16,2024-06-28,529.78,99237,3645499,71313964,4291035,6.37248968518985,22.1768278089267,0.802182650361153
496.5,500,11807,12943,5537483,4530050,2024-05-16,2024-08-16,529.78,1136,-1007433,85913959,-15086717,5.27277528905402,50.2959734401251,-0.222388936104458
500.89,505,10834,10949,5904530,4500039,2024-05-16,2024-08-16,529.78,115,-1404491,85913959,-15086717,5.237843829313,55.5338172694381,-0.312106406188924
448.28,450,22933,25738,4792997,4426936,2024-05-16,2024-09-20,529.78,2805,-366060.999999999,207805543,-46765032,2.13032623484928,81.0676277292565,-0.0826894719056248
519.53,525,7686,7964,6410124,4356308,2024-05-16,2024-06-28,529.78,278,-2053816,71313964,4291035,6.10863252532141,28.2854603342481,-0.471457940990399
510.68,515,4683,9993,2912826,4316976,2024-05-16,2024-07-19,529.78,5310,1404150,106722520,-20817707,4.04504691231054,45.8728851230275,0.325262405906357
378.43,380,27477,27482,4918383,4314674,2024-05-16,2024-12-20,529.78,5,-603708.999999999,392218823,-61081925,1.1000680607315,85.4028423312055,-0.139919956872755
422.35,425,15733,15731,4767099,4168715,2024-05-16,2024-12-20,529.78,-2,-598384,392218823,-61081925,1.06285439544037,86.4656967266459,-0.143541594951922
428.74,430,32484,32475,4840116,4091850,2024-05-16,2024-09-20,529.78,-9,-748266,207805543,-46765032,1.96907644566536,83.0367041749218,-0.182867407163019
494.16,495,43283,48221,6059620,4050564,2024-05-16,2024-06-21,529.78,4938,-2009056,168672803,-78039132,2.40143279056079,34.6774939170247,-0.495994138100275
479.53,480,84785,85588,6104520,4022636,2024-05-16,2024-06-21,529.78,803,-2081884,168672803,-78039132,2.38487529017941,37.0623692072041,-0.517542228528756
503.58,505,29204,28299,6921348,4018458,2024-05-16,2024-06-21,529.78,-905,-2902890,168672803,-78039132,2.38239830519684,39.4447675124009,-0.722389035794327
462.75,465,17879,17649,4988241,3971025,2024-05-16,2024-09-20,529.78,-230,-1017216,207805543,-46765032,1.9109331458016,84.9476373207235,-0.256159555782197
427.15,430,13737,13733,4450788,3913905,2024-05-16,2024-12-20,529.78,-4,-536883,392218823,-61081925,0.997888110025765,87.4635848366716,-0.137173232360009
448.95,450,36514,36620,4637278,3845100,2024-05-16,2024-08-16,529.78,106,-792178,85913959,-15086717,4.47552416947751,60.0093414389157,-0.206022730228082
512.94,520,6364,5444,6026708,3843464,2024-05-16,2024-08-16,529.78,-920,-2183244,85913959,-15086717,4.47361993875757,64.4829613776732,-0.568040704947412
478,485,5332,5395,4361576,3776500,2024-05-16,2024-12-20,529.78,63,-585076,392218823,-61081925,0.962855370151371,88.426440206823,-0.154925460082087
519.52,524,6550,8222,4781500,3683456,2024-05-16,2024-06-21,529.78,1672,-1098044,168672803,-78039132,2.18378774437038,41.6285552567713,-0.298101565486326
438.54,440,25041,25038,4407216,3655548,2024-05-16,2024-09-20,529.78,-3,-751668.000000001,207805543,-46765032,1.75911958229141,86.7067569030149,-0.205623890043299
460.08,465,6541,7332,3826485,3607344,2024-05-16,2024-12-20,529.78,791,-219141,392218823,-61081925,0.919727404311751,89.3461676111348,-0.060748572911261
523.2,530,4083,5173,4234071,3517640,2024-05-16,2024-06-21,529.78,1090,-716431,168672803,-78039132,2.08548143947071,43.714036696242,-0.203668084283781
509.25,515,5075,6059,3999100,3483925,2024-05-16,2024-08-16,529.78,984,-515175,85913959,-15086717,4.05513264730357,68.5380940249768,-0.147872012170182
512.79,525,1498,2844,2209550,3472524,2024-05-16,2024-10-18,529.78,1346,1262974,21699053,7078243,16.0031131312505,16.0031131312505,0.363704901679585
409.83,410,1734,201835,36414,3431195,2024-05-16,2024-06-28,529.78,200101,3394781,71313964,4291035,4.81139289915226,33.0968532334004,0.989387370872247
515.9,520,6167,8334,3916045,3416940,2024-05-16,2024-06-28,529.78,2167,-499105,71313964,4291035,4.7914038266054,37.8882570600058,-0.14606782676898
520.79,526,5202,6549,4151196,3412029,2024-05-16,2024-06-21,529.78,1347,-739167,168672803,-78039132,2.02286850002724,45.7369051962693,-0.216635614761774
473.3,475,8049,19915,1819074,3385550,2024-05-16,2024-08-16,529.78,11866,1566476,85913959,-15086717,3.94062855373712,72.4787225787139,0.462694687716915
488.4,490,10361,20996,2320864,3359360,2024-05-16,2024-07-19,529.78,10635,1038496,106722520,-20817707,3.14775175848546,49.0206368815129,0.309135073347304
458.74,460,26503,26524,4266983,3342024,2024-05-16,2024-08-16,529.78,21,-924959,85913959,-15086717,3.8899662393628,76.3686888180767,-0.276766115383971
486.5,495,3872,3896,3852640,3311600,2024-05-16,2024-12-20,529.78,24,-541040,392218823,-61081925,0.844324597853377,90.1904922089881,-0.16337721947095
404.1,405,36731,36693,3820024,3302370,2024-05-16,2024-09-20,529.78,-38,-517654,207805543,-46765032,1.58916357683491,88.2959204798498,-0.156752271853245
453.12,455,18410,17028,4160660,3201264,2024-05-16,2024-09-20,529.78,-1382,-959396,207805543,-46765032,1.5405094367478,89.8364299165976,-0.29969287131583
412.63,415,13392,13393,3722976,3174141,2024-05-16,2024-12-20,529.78,1,-548835,392218823,-61081925,0.809278090154281,90.9997702991424,-0.172908197839982
500.44,502,11864,19922,2906680,3107832,2024-05-16,2024-06-28,529.78,8058,201152,71313964,4291035,4.35795715969456,42.2462142197004,0.0647242193271707
503.95,507,9877,9899,4296495,3019195,2024-05-16,2024-07-19,529.78,22,-1277300,106722520,-20817707,2.82901397005993,51.8496508515729,-0.423059789115973
449.83,450,175992,175994,3519840,2991898,2024-05-16,2024-06-14,529.78,2,-527942,24055258,-5534803,12.4376051173511,12.4376051173511,-0.17645721879556
509.22,513,6568,7728,3625536,2921184,2024-05-16,2024-07-19,529.78,1160,-704352,106722520,-20817707,2.73717674582647,54.5868275973993,-0.241118669690098
399.89,400,260557,259696,3387241,2856656,2024-05-16,2024-06-21,529.78,-861,-530585.000000001,168672803,-78039132,1.69360794935032,47.4305131456196,-0.185736399482472
469.11,470,21832,31556,2641672,2808484,2024-05-16,2024-07-19,529.78,9724,166812,106722520,-20817707,2.63157579112637,57.2184033885257,0.0593957451778256
404.92,405,350475,350525,3504750,2804200,2024-05-16,2024-06-14,529.78,50,-700550,24055258,-5534803,11.6573266435139,24.0949317608649,-0.249821696027388
469.64,470,81460,77698,4154460,2797128,2024-05-16,2024-06-21,529.78,-3762,-1357332,168672803,-78039132,1.65831595269096,49.0888290983105,-0.485259165830094
319.15,320,32712,32713,2911368,2780605,2024-05-16,2024-12-20,529.78,1,-130763,392218823,-61081925,0.708942263079505,91.7087125622219,-0.0470268161065667
498.6,500,19303,19580,4285266,2741200,2024-05-16,2024-06-28,529.78,277,-1544066,71313964,4291035,3.84384746863882,46.0900616883392,-0.563281044797899
518.82,523,4727,6534,3261630,2731212,2024-05-16,2024-06-21,529.78,1807,-530418.000000001,168672803,-78039132,1.61923674203719,50.7080658403477,-0.194206088725445
409.03,410,28064,28006,3115104,2716582,2024-05-16,2024-09-20,529.78,-58,-398522.000000001,207805543,-46765032,1.30727119247247,91.14370110907,-0.146699786717279
501.83,510,3139,3321,3129583,2713257,2024-05-16,2024-10-18,529.78,182,-416326,21699053,7078243,12.5040341622282,28.5071472934787,-0.15344141745511
489.13,490,7789,31046,1082671,2701002,2024-05-16,2024-06-28,529.78,23257,1618331,71313964,4291035,3.78747982653159,49.8775415148708,0.599159497105148
464.2,465,33412,33426,3474848,2674080,2024-05-16,2024-07-19,529.78,14,-800768,106722520,-20817707,2.50563798530994,59.7240413738356,-0.299455513671992
388.29,390,15519,15510,3026205,2652210,2024-05-16,2024-12-20,529.78,-9,-373995,392218823,-61081925,0.676206710252659,92.3849192724746,-0.141012589500831
444.71,445,91469,91432,3384353,2651528,2024-05-16,2024-06-28,529.78,-37,-732825,71313964,4291035,3.71810491420727,53.5956464290781,-0.276378375035074
474.6,475,71862,66110,4311720,2644400,2024-05-16,2024-06-21,529.78,-5752,-1667320,168672803,-78039132,1.56776904928769,52.2758348896354,-0.630509756466495
402.94,405,12497,12507,2899304,2576442,2024-05-16,2024-12-20,529.78,10,-322862,392218823,-61081925,0.656888922437055,93.0418081949117,-0.125313125620526
444.8,445,129399,128060,3364374,2561200,2024-05-16,2024-06-21,529.78,-1339,-803174,168672803,-78039132,1.51844278060643,53.7942776702418,-0.313592847102921
383.32,385,15245,15245,2896550,2561160,2024-05-16,2024-12-20,529.78,0,-335390,392218823,-61081925,0.652992628046309,93.694800822958,-0.130952380952381
399.15,400,29988,29989,2878848,2549065,2024-05-16,2024-09-20,529.78,1,-329783,207805543,-46765032,1.22665880957757,92.3703599186476,-0.129374103838074
517.31,521,6864,6897,4056624,2544993,2024-05-16,2024-06-21,529.78,33,-1511631,168672803,-78039132,1.50883423689829,55.3031119071401,-0.593962733885712
521.48,527,4056,4592,3419208,2534784,2024-05-16,2024-06-21,529.78,536,-884424.000000001,168672803,-78039132,1.50278169030012,56.8058935974403,-0.348914937130738
418.91,420,22842,22796,2855250,2484764,2024-05-16,2024-09-20,529.78,-46,-370486,207805543,-46765032,1.19571593910755,93.5660758577552,-0.149103093895436
514.27,515,28771,33833,5581574,2469809,2024-05-16,2024-05-31,529.78,5062,-3111765,27053797,-21589374,9.12925087742767,9.12925087742767,-1.25992131375341
488.35,489,36018,37854,3781890,2460510,2024-05-16,2024-06-21,529.78,1836,-1321380,168672803,-78039132,1.45874732395358,58.2646409213938,-0.537035004938001
468.46,470,15331,15924,3081531,2452296,2024-05-16,2024-08-16,529.78,593,-629235,85913959,-15086717,2.85436270024525,79.223051518322,-0.256590150618033
522.67,529,3300,3837,3168000,2428821,2024-05-16,2024-06-21,529.78,537,-739179,168672803,-78039132,1.43996006279685,59.7046009841907,-0.304336548473519
407.79,410,10779,10929,2694750,2415309,2024-05-16,2024-12-20,529.78,150,-279441,392218823,-61081925,0.615806498404591,94.3106073213626,-0.115695755698339
348.86,350,20214,20235,2506536,2306790,2024-05-16,2024-12-20,529.78,21,-199746,392218823,-61081925,0.588138524907052,94.8987458462696,-0.0865904568686356
480.5,485,2407,4990,1307001,2245500,2024-05-16,2024-10-18,529.78,2583,938499,21699053,7078243,10.3483778762142,38.8555251696929,0.417946559786239
509.55,510,38580,49171,4436700,2212695,2024-05-16,2024-05-31,529.78,10591,-2224005,27053797,-21589374,8.17887041881774,17.3081212962454,-1.00511141390928
394.86,395,156277,156285,2656709,2187990,2024-05-16,2024-06-28,529.78,8,-468719,71313964,4291035,3.06810879283053,56.6637552219086,-0.214223556780424
393.03,395,10824,10824,2240568,2132328,2024-05-16,2024-12-20,529.78,0,-108240,392218823,-61081925,0.543657742810574,95.4424035890802,-0.0507614213197967
520.98,527,3543,3484,3298533,2097368,2024-05-16,2024-06-28,529.78,-59,-1201165,71313964,4291035,2.94103410097916,59.6047893228877,-0.572701118735482
518.01,522,5081,5178,3287407,2066022,2024-05-16,2024-06-21,529.78,97,-1221385,168672803,-78039132,1.22486966674764,60.9294706509383,-0.591177151066155
514.18,517,6893,7308,3322426,2060856,2024-05-16,2024-06-21,529.78,415,-1261570,168672803,-78039132,1.22180693232447,62.1512775832628,-0.612158248805351
459.72,460,73284,73151,2858076,2048228,2024-05-16,2024-06-21,529.78,-133,-809848,168672803,-78039132,1.21432024817896,63.3655978314418,-0.395389575769885
497.02,498,19558,20843,3187954,2042614,2024-05-16,2024-06-21,529.78,1285,-1145340,168672803,-78039132,1.21099191077058,64.5765897422123,-0.560722681818493
523.96,531,932,2886,1169660,2031744,2024-05-16,2024-06-21,529.78,1954,862084,168672803,-78039132,1.20454748119648,65.7811372234088,0.424307393057393
481.49,482,37425,37340,2919150,1904340,2024-05-16,2024-06-21,529.78,-85,-1014810,168672803,-78039132,1.12901426082307,66.9101514842319,-0.532893285862819
515.91,530,74,1328,129574,1871152,2024-05-16,2024-10-18,529.78,1254,1741578,21699053,7078243,8.6231965975658,47.4787217672587,0.930751750793094
509.4,520,361,1740,463885,1844400,2024-05-16,2024-10-18,529.78,1379,1380515,21699053,7078243,8.49991011128458,55.9786318785433,0.748490023855997
483.69,485,13936,13948,2578160,1827188,2024-05-16,2024-07-19,529.78,12,-750972,106722520,-20817707,1.71209225569261,61.4361336295282,-0.410998758748416
501.74,503,14150,14205,2999800,1789830,2024-05-16,2024-06-21,529.78,55,-1209970,168672803,-78039132,1.06112542636764,67.9712769105995,-0.676025097355615
466.6,470,5087,5179,2029713,1760860,2024-05-16,2024-10-18,529.78,92,-268853,21699053,7078243,8.11491635141865,64.0935482299619,-0.152682780005225
482.75,485,7053,7772,2052423,1748700,2024-05-16,2024-08-16,529.78,719,-303723,85913959,-15086717,2.03540847186428,81.2584599901862,-0.173685023160062
368.59,370,12343,12346,1900822,1740786,2024-05-16,2024-12-20,529.78,3,-160036,392218823,-61081925,0.443830305410916,95.8862338944911,-0.0919331842052958
511.66,514,4880,7401,1956880,1731834,2024-05-16,2024-06-21,529.78,2521,-225046,168672803,-78039132,1.02674169705948,68.998018607659,-0.129946634608167
507.71,510,6700,7556,2412000,1730324,2024-05-16,2024-06-28,529.78,856,-681676,71313964,4291035,2.42634668295819,62.0311360058459,-0.393958588102575
522.07,528,2013,2882,1857999,1709026,2024-05-16,2024-06-21,529.78,869,-148973.000000001,168672803,-78039132,1.01321965936619,70.0112382670252,-0.0871683637346655
433.63,435,12402,12386,1971918,1696882,2024-05-16,2024-09-20,529.78,-16,-275036,207805543,-46765032,0.816572058426757,94.3826479161819,-0.162083161940547
373.53,375,11262,11266,1846968,1656102,2024-05-16,2024-12-20,529.78,4,-190866,392218823,-61081925,0.422239296761135,96.3084731912522,-0.115250147635834
515.73,519,6394,5061,3478336,1654947,2024-05-16,2024-06-21,529.78,-1333,-1823389,168672803,-78039132,0.981158177587172,70.9923964446124,-1.10178090295339
512.44,517,3650,3611,2492950,1646616,2024-05-16,2024-07-19,529.78,-39,-846334,106722520,-20817707,1.54289460181413,62.9790282313424,-0.513983831081442
419.32,420,23308,23309,1794716,1585012,2024-05-16,2024-08-16,529.78,1,-209704,85913959,-15086717,1.84488297181137,83.1033429619976,-0.132304361102629
484.44,485,28312,28264,2491456,1582784,2024-05-16,2024-06-21,529.78,-48,-908672,168672803,-78039132,0.938375346735656,71.930771791348,-0.574097286806033
454.75,455,62502,62669,2062566,1566725,2024-05-16,2024-06-21,529.78,167,-495841,168672803,-78039132,0.928854546870843,72.8596263382189,-0.316482471397342
505.45,507,11091,10062,2861478,1559610,2024-05-16,2024-06-21,529.78,-1029,-1301868,168672803,-78039132,0.924636320889266,73.7842626591081,-0.834739454094293
496.06,497,16415,16353,2544325,1537182,2024-05-16,2024-06-21,529.78,-62,-1007143,168672803,-78039132,0.91133957144235,74.6956022305505,-0.655187869751272
492.22,493,18179,19187,2290554,1496586,2024-05-16,2024-06-21,529.78,1008,-793968,168672803,-78039132,0.887271672363209,75.5828739029137,-0.530519462296186
522.65,532,1215,1592,1618380,1488520,2024-05-16,2024-07-19,529.78,377,-129860,106722520,-20817707,1.39475717027671,64.3737854016191,-0.0872410179238438
478.82,480,12613,12602,1992854,1487036,2024-05-16,2024-07-19,529.78,-11,-505818,106722520,-20817707,1.39336664838874,65.7671520500078,-0.340151818785827
504.56,506,10860,10291,2725860,1481904,2024-05-16,2024-06-21,529.78,-569,-1243956,168672803,-78039132,0.878567245959623,76.4614411488733,-0.839430894308943
502.33,505,5747,5537,2321788,1478379,2024-05-16,2024-07-19,529.78,-210,-843409,106722520,-20817707,1.38525495837242,67.1524070083802,-0.570495793027363
522.5,535,1214,1177,2069870,1471250,2024-05-16,2024-08-16,529.78,-37,-598620,85913959,-15086717,1.71246909946264,84.8158120614602,-0.406878504672897
513.86,519,3105,2820,2300805,1449480,2024-05-16,2024-07-19,529.78,-285,-851325,106722520,-20817707,1.35817632492186,68.5105833333021,-0.587331318817783
329.09,330,15804,15806,1596204,1438346,2024-05-16,2024-12-20,529.78,2,-157858,392218823,-61081925,0.366720288689459,96.6751934799417,-0.109749670802436
494.83,495,84361,84365,2699552,1434205,2024-05-16,2024-05-31,529.78,4,-1265347,27053797,-21589374,5.30130761312359,22.609428909369,-0.882263693126157
514.98,518,5568,4695,2822976,1417890,2024-05-16,2024-06-21,529.78,-873,-1405086,168672803,-78039132,0.840615662265362,77.3020568111387,-0.9909696802996
499.79,500,74518,67285,3353310,1412985,2024-05-16,2024-05-31,529.78,-7233,-1940325,27053797,-21589374,5.22287130342554,27.8323002127945,-1.37320990668691
498.52,501,5642,5645,1884428,1399960,2024-05-16,2024-07-19,529.78,3,-484468,106722520,-20817707,1.3117756214902,69.8223589547923,-0.346058458813109
358.74,360,10981,10951,1493416,1379826,2024-05-16,2024-12-20,529.78,-30,-113590,392218823,-61081925,0.351800046067651,97.0269935260093,-0.0823219739300464
518.73,520,10303,10853,3327869,1378331,2024-05-16,2024-05-31,529.78,550,-1949538,27053797,-21589374,5.0947783780591,32.9270785908536,-1.41441932307987
510,512,6896,6858,2454976,1371600,2024-05-16,2024-06-21,529.78,-38,-1083376,168672803,-78039132,0.813171996673346,78.115228807812,-0.789862933799942
500.81,502,11854,11469,2382654,1364811,2024-05-16,2024-06-21,529.78,-385,-1017843,168672803,-78039132,0.809147044292612,78.9243758521046,-0.745775788735583
463.63,465,9969,9956,1764513,1363972,2024-05-16,2024-08-16,529.78,-13,-400541,85913959,-15086717,1.58760231268123,86.4034143741415,-0.293657787696522
522.58,526,1174,3970,727880,1357740,2024-05-16,2024-06-07,529.78,2796,629860,14949825,-8379167,9.08197922049255,9.08197922049255,0.463903250990617
473.59,474,33721,33111,1989539,1357551,2024-05-16,2024-06-21,529.78,-610,-631988,168672803,-78039132,0.804842853059127,79.7292187051638,-0.465535364785559
449.78,450,61572,61398,1908732,1350756,2024-05-16,2024-06-21,529.78,-174,-557976,168672803,-78039132,0.800814343495555,80.5300330486593,-0.413084228387659
520.3,526,1682,2364,1451566,1347480,2024-05-16,2024-06-28,529.78,682,-104086,71313964,4291035,1.88950371627077,63.9206397221167,-0.0772449312791286
453.88,455,12005,11991,1716715,1342992,2024-05-16,2024-08-16,529.78,-14,-373723,85913959,-15086717,1.56318253242177,87.9665969065632,-0.278276415645067
429.85,430,90089,88597,1801780,1328955,2024-05-16,2024-06-21,529.78,-1492,-472825,168672803,-78039132,0.787889319655167,81.3179223683145,-0.355787065777246
499.9,501,12052,12004,2313984,1320440,2024-05-16,2024-06-21,529.78,-48,-993544,168672803,-78039132,0.782841084344819,82.1007634526593,-0.752434037139135
506.33,508,7455,7883,2102310,1316461,2024-05-16,2024-06-21,529.78,428,-785849,168672803,-78039132,0.780482079259689,82.881245531919,-0.596940585402834
509.03,511,6477,6634,2182749,1306898,2024-05-16,2024-06-21,529.78,157,-875851,168672803,-78039132,0.774812522680375,83.6560580545994,-0.67017548423825
507.5,511,3735,3717,1916055,1300950,2024-05-16,2024-07-19,529.78,-18,-615105,106722520,-20817707,1.21900232490762,71.0413612796999,-0.472812175717745
520.96,525,2754,3177,1897506,1283508,2024-05-16,2024-06-14,529.78,423,-613998,24055258,-5534803,5.33566507580172,29.4305968366666,-0.478374891313494
484.98,490,1345,2517,820450,1263534,2024-05-16,2024-10-18,529.78,1172,443084,21699053,7078243,5.82299144575572,69.9165396757176,0.350670421215416
493.21,494,15753,15658,2079396,1236982,2024-05-16,2024-06-21,529.78,-95,-842414,168672803,-78039132,0.733361856801538,84.3894199114009,-0.681023652728981
528.68,540,842,1085,1401930,1228220,2024-05-16,2024-06-07,529.78,243,-173710,14949825,-8379167,8.21561456405008,17.2975937845426,-0.141432316685936
520.55,535,809,845,1449728,1221025,2024-05-16,2024-09-20,529.78,36,-228703,207805543,-46765032,0.587580572862775,94.9702284890447,-0.187304109252472
528.14,530,2330,6536,1649640,1215696,2024-05-16,2024-05-17,529.78,4206,-433944,12246418,-21476147,9.92695170130564,9.92695170130564,-0.356951079875232
353.69,355,9266,9266,1213846,1213846,2024-05-16,2024-12-20,529.78,0,0,392218823,-61081925,0.309481832288299,97.3364753582976,0
510.92,513,4192,5787,1584576,1203696,2024-05-16,2024-06-21,529.78,1595,-380880,168672803,-78039132,0.713627792146195,85.1030477035471,-0.316425409738007
513.08,518,2462,2420,1716014,1190640,2024-05-16,2024-07-19,529.78,-42,-525374,106722520,-20817707,1.11564082257428,72.1570021022742,-0.441253443526171
499.24,500,12970,15563,1763920,1182788,2024-05-16,2024-06-14,529.78,2593,-581132,24055258,-5534803,4.91696243706885,34.3475592737355,-0.49132388898095
511.6,516,2772,2663,1793484,1171720,2024-05-16,2024-07-19,529.78,-109,-621764,106722520,-20817707,1.09791260551194,73.2549147077862,-0.530642132932783
515.42,521,2003,2066,1632445,1152828,2024-05-16,2024-07-19,529.78,63,-479617,106722520,-20817707,1.08021062471164,74.3351253324978,-0.416035176106063
513.31,516,3359,4273,1504832,1149437,2024-05-16,2024-06-21,529.78,914,-355395,168672803,-78039132,0.681459594882051,85.7845072984291,-0.309190499348812
439.82,440,64217,62685,1541208,1128330,2024-05-16,2024-06-21,529.78,-1532,-412878,168672803,-78039132,0.668946018523211,86.4534533169524,-0.365919544814017
524.1,526,1753,5927,867735,1126130,2024-05-16,2024-05-24,529.78,4174,258395,11385857,-4974638,9.89060375516749,9.89060375516749,0.229453970678341
518.08,525,1105,1620,1079585,1121040,2024-05-16,2024-07-19,529.78,515,41455,106722520,-20817707,1.05042497122444,75.3855503037222,0.0369790551630629
423.82,425,9450,9445,1294650,1114510,2024-05-16,2024-09-20,529.78,-5,-180140,207805543,-46765032,0.536323518569473,95.5065520076142,-0.161631569030337
522.7,525,1513,4814,797351,1107220,2024-05-16,2024-05-31,529.78,3301,309869,27053797,-21589374,4.09266026502675,37.0197388558804,0.279862177345063
471.34,475,2309,3015,1029814,1103490,2024-05-16,2024-10-18,529.78,706,73676,21699053,7078243,5.08542930421895,75.0019689799366,0.0667663503973756
520.62,523,4249,4507,2154243,1072666,2024-05-16,2024-06-07,529.78,258,-1081577,14949825,-8379167,7.17510740092275,24.4727011854654,-1.00830733891071
413.96,415,10308,10312,1195728,1072448,2024-05-16,2024-09-20,529.78,4,-123280,207805543,-46765032,0.516082480052036,96.0226344876662,-0.114951960374769
493.89,495,9643,9617,1677882,1067487,2024-05-16,2024-06-28,529.78,-26,-610395,71313964,4291035,1.49688355565258,65.4175232777693,-0.571805558287829
527.01,528,275,10747,151250,1063953,2024-05-16,2024-05-17,529.78,10472,912703,12246418,-21476147,8.68787101665156,18.6148227179572,0.857841464801547
518.8,526,1133,1456,1149995,1048320,2024-05-16,2024-07-19,529.78,323,-101675,106722520,-20817707,0.982285650676165,76.3678359543984,-0.0969885149572648
338.97,340,10128,10124,1144464,1042772,2024-05-16,2024-12-20,529.78,-4,-101692,392218823,-61081925,0.265864853712031,97.6023402120097,-0.0975208386876516
507.23,509,5408,5819,1611584,1029963,2024-05-16,2024-06-21,529.78,411,-581621,168672803,-78039132,0.610627784492323,87.0640811014447,-0.564700867895255
519.27,520,4801,14055,1248260,1026015,2024-05-16,2024-05-24,529.78,9254,-222245,11385857,-4974638,9.01131113801974,18.9019148931872,-0.21660989361754
517.87,519,8066,9051,2371404,1022763,2024-05-16,2024-05-31,529.78,985,-1348641,27053797,-21589374,3.7804785775542,40.8002174334346,-1.31862513602858
493.77,497,3084,3157,1286028,1019711,2024-05-16,2024-08-16,529.78,73,-266317,85913959,-15086717,1.18689792889186,89.1534948354551,-0.261169095949735
477.55,478,22640,22548,1516880,1014660,2024-05-16,2024-06-21,529.78,-92,-502220,168672803,-78039132,0.601555189665046,87.6656362911097,-0.494963830248556
493.12,495,5136,5361,1381584,1007868,2024-05-16,2024-07-19,529.78,225,-373716,106722520,-20817707,0.944381748107148,77.3122177025055,-0.370798556953887
329.66,330,29438,29453,1089206,1001402,2024-05-16,2024-09-20,529.78,15,-87804,207805543,-46765032,0.481893786634941,96.5045282743012,-0.0876810711382642
521.93,525,2126,3254,1258592,998978,2024-05-16,2024-06-07,529.78,1128,-259614,14949825,-8379167,6.6822053100956,31.154906495561,-0.259879596948081
476.56,477,22132,22090,1438580,971960,2024-05-16,2024-06-21,529.78,-42,-466620,168672803,-78039132,0.576239905137522,88.2418761962473,-0.480081484834767
503.2,505,5383,5382,1534155,968760,2024-05-16,2024-06-28,529.78,-1,-565395,71313964,4291035,1.35844362823528,66.7759669060046,-0.583627523844915
374.39,375,15734,15735,1101380,959835,2024-05-16,2024-09-20,529.78,1,-141545,207805543,-46765032,0.461890951580632,96.9664192258818,-0.147468054405184
472.01,473,9628,9628,1261268,953172,2024-05-16,2024-07-19,529.78,0,-308096,106722520,-20817707,0.893131084236017,78.2053487867415,-0.323232323232323
473.97,475,9405,9232,1297890,950896,2024-05-16,2024-07-19,529.78,-173,-346994,106722520,-20817707,0.890998450936129,79.0963472376777,-0.36491267183793
489.35,491,5691,5714,1308930,942810,2024-05-16,2024-07-19,529.78,23,-366120,106722520,-20817707,0.883421793263502,79.9797690309412,-0.388328507334458
434.83,435,55079,55063,1266817,936071,2024-05-16,2024-06-21,529.78,-16,-330746,168672803,-78039132,0.554962615994471,88.7968388122417,-0.353334309042797
520.3,524,2326,2529,1449098,935730,2024-05-16,2024-06-14,529.78,203,-513368,24055258,-5534803,3.88991878615478,38.2374780598903,-0.548628343646137
526.03,529,27,3117,19062,925749,2024-05-16,2024-05-24,529.78,3090,906687,11385857,-4974638,8.13069231415782,27.032607207345,0.979409105491877
518.25,523,1840,1944,1376320,923400,2024-05-16,2024-06-28,529.78,104,-452920,71313964,4291035,1.29483757206373,68.0708044780683,-0.490491661251895
299.33,300,13578,13692,991194,917364,2024-05-16,2024-12-20,529.78,114,-73829.9999999999,392218823,-61081925,0.233890865558994,97.8362310775687,-0.0804805943987336
359.91,360,1682,101670,18502,915030,2024-05-16,2024-06-28,529.78,99988,896528,71313964,4291035,1.28310074027017,69.3539052183385,0.979779897926844
526.28,527,1505,12506,725410,900432,2024-05-16,2024-05-17,529.78,11001,175022,12246418,-21476147,7.352615270849,25.9674379888062,0.194375588606358
504.71,505,30355,30881,2124850,895549,2024-05-16,2024-05-31,529.78,526,-1229301,27053797,-21589374,3.31025253128054,44.1104699647151,-1.37267865856586
517.43,522,1999,1939,1421289,886123,2024-05-16,2024-06-28,529.78,-60,-535166,71313964,4291035,1.24256590195996,70.5964711202984,-0.603940987876401
359.95,360,175065,175065,875325,875325,2024-05-16,2024-06-14,529.78,0,0,24055258,-5534803,3.63880944448819,41.8762875043785,0
488.32,491,3245,3255,1145485,872340,2024-05-16,2024-08-16,529.78,10,-273145,85913959,-15086717,1.01536468596448,90.1688595214196,-0.313117591764679
389.92,390,108762,108869,1196382,870952,2024-05-16,2024-06-21,529.78,107,-325430,168672803,-78039132,0.516355917794287,89.313194730036,-0.37364860520442
518.09,520,4546,4558,1804762,870578,2024-05-16,2024-06-07,529.78,12,-934184,14949825,-8379167,5.82333238014492,36.9782388757059,-1.07306180491582
486.4,489,3298,3313,1226856,861380,2024-05-16,2024-08-16,529.78,15,-365476,85913959,-15086717,1.00260773688709,91.1714672583066,-0.424291253569853
454.34,455,13010,12979,1079830,856614,2024-05-16,2024-07-19,529.78,-31,-223216,106722520,-20817707,0.80265533460042,80.7824243655416,-0.260579444183728
516.95,523,1525,1404,1360300,849420,2024-05-16,2024-07-19,529.78,-121,-510880,106722520,-20817707,0.795914489275553,81.5783388548172,-0.601445692354784
517.23,520,3007,3062,1473430,848174,2024-05-16,2024-06-14,529.78,55,-625256,24055258,-5534803,3.52594014996638,45.4022276543449,-0.73717892790866
480.77,482,7269,6881,1235730,846363,2024-05-16,2024-07-19,529.78,-388,-389367,106722520,-20817707,0.793050051666696,82.3713889064839,-0.460047284675724
518.85,524,1166,1638,923472,843570,2024-05-16,2024-06-28,529.78,472,-79901.9999999998,71313964,4291035,1.18289596130149,71.7793670815999,-0.0947188733596498
484.23,485,11041,10872,1247633,837144,2024-05-16,2024-06-28,529.78,-169,-410489,71313964,4291035,1.17388510334386,72.9532521849438,-0.490344552430645
516.1,522,1432,1409,1222928,831310,2024-05-16,2024-07-19,529.78,-23,-391618,106722520,-20817707,0.778945249793577,83.1503341562774,-0.471085395339885
522.98,531,4,1032,4944,827664,2024-05-16,2024-06-28,529.78,1028,822720,71313964,4291035,1.16059177414398,74.1138439590877,0.994026561503219
494.44,495,14638,14722,1507714,824432,2024-05-16,2024-06-14,529.78,84,-683282,24055258,-5534803,3.42724239332623,48.8294700476711,-0.828791216255555
521.85,526,1349,1986,983421,824190,2024-05-16,2024-06-14,529.78,637,-159231,24055258,-5534803,3.42623637626335,52.2557064239344,-0.193196957012339
477.83,479,6994,6967,1133028,815139,2024-05-16,2024-07-19,529.78,-27,-317889,106722520,-20817707,0.763792871457683,83.9141270277351,-0.389981340605713
521.46,524,2335,3180,1293590,807720,2024-05-16,2024-06-07,529.78,845,-485870,14949825,-8379167,5.40287260887669,42.3811114845826,-0.601532709354727
526.69,535,122,968,152378,804408,2024-05-16,2024-06-14,529.78,846,652030,24055258,-5534803,3.3440007170158,55.5997071409502,0.81057125239928
523.4,525,893,4994,418817,799040,2024-05-16,2024-05-24,529.78,4101,380223,11385857,-4974638,7.01782922444924,34.0504364317943,0.475849769723668
515.2,519,1965,2074,1188825,788120,2024-05-16,2024-06-28,529.78,109,-400705,71313964,4291035,1.10514120348155,75.2189851625693,-0.508431457138507
464.69,465,25184,25163,1108096,780053,2024-05-16,2024-06-21,529.78,-21,-328043,168672803,-78039132,0.462465190668587,89.7756599207046,-0.420539373606665
389.26,390,10499,10499,881916,776926,2024-05-16,2024-09-20,529.78,0,-104990,207805543,-46765032,0.373871644030208,97.340290869912,-0.135135135135135
520.42,522,4031,4915,1584183,776570,2024-05-16,2024-05-31,529.78,884,-807613,27053797,-21589374,2.87046583516539,46.9809357998805,-1.03997450326435
501.46,503,4937,4991,1278683,768614,2024-05-16,2024-06-28,529.78,54,-510069,71313964,4291035,1.07778891662789,76.2967740791972,-0.663621791952788
528.48,540,11,651,18216,749952,2024-05-16,2024-06-14,529.78,640,731736,24055258,-5534803,3.11762193529581,58.7173290762461,0.97571044546851
324.1,325,8315,8320,806555,748800,2024-05-16,2024-12-20,529.78,5,-57755,392218823,-61081925,0.190913835871666,98.0271449134403,-0.0771300747863248
480.51,481,15090,15103,1131750,740047,2024-05-16,2024-06-21,529.78,13,-391703,168672803,-78039132,0.438747081235141,90.2144070019397,-0.529294761008423
508.4,512,2069,2051,1098639,738360,2024-05-16,2024-07-19,529.78,-18,-360279,106722520,-20817707,0.691850229923356,84.6059772576585,-0.487944904924427
527.11,531,2,1898,2056,738322,2024-05-16,2024-05-24,529.78,1896,736266,11385857,-4974638,6.48455360013743,40.5349900319317,0.997215307142412
501.44,504,2873,2864,1106105,733184,2024-05-16,2024-07-19,529.78,-9,-372921,106722520,-20817707,0.687000269483892,85.2929775271424,-0.508632212377793
475.96,480,726,1814,355014,732856,2024-05-16,2024-10-18,529.78,1088,377842,21699053,7078243,3.3773639798935,78.3793329598301,0.515574683157401
363.64,365,5368,5366,772992,729776,2024-05-16,2024-12-20,529.78,-2,-43216,392218823,-61081925,0.186063482220995,98.2132083956613,-0.0592181710552279
522.57,530,723,975,785178,724425,2024-05-16,2024-06-28,529.78,252,-60753,71313964,4291035,1.0158248951075,77.3125989743047,-0.0838637540118025
525.25,533,20,930,24280,720750,2024-05-16,2024-06-21,529.78,910,696470,168672803,-78039132,0.427306588365642,90.6417135903054,0.966312868539715
517.64,524,1021,1114,953614,708504,2024-05-16,2024-07-19,529.78,93,-245110,106722520,-20817707,0.663874878516737,85.9568524056591,-0.345954292424602
499.49,502,3119,2801,1088531,703051,2024-05-16,2024-07-19,529.78,-318,-385480,106722520,-20817707,0.658765366484974,86.6156177721441,-0.548295927322485
505.75,509,1386,2153,658350,699725,2024-05-16,2024-07-19,529.78,767,41375,106722520,-20817707,0.655648873358688,87.2712666455028,0.0591303726463968
525.84,531,4,1352,4476,697632,2024-05-16,2024-06-07,529.78,1348,693156,14949825,-8379167,4.66648940706664,47.0476008916492,0.993584009907802
459.28,460,9653,9666,897729,695952,2024-05-16,2024-07-19,529.78,13,-201777,106722520,-20817707,0.652113537049163,87.9233801825519,-0.289929477895027
519.74,523,1792,2130,1078784,694380,2024-05-16,2024-06-14,529.78,338,-384404,24055258,-5534803,2.88660383521973,61.6039329114658,-0.553593133442784
334.02,335,7079,7080,771611,693840,2024-05-16,2024-12-20,529.78,1,-77771,392218823,-61081925,0.176901249841342,98.3901096455027,-0.112087801222184
525.84,530,724,1662,588612,691392,2024-05-16,2024-05-31,529.78,938,102780,27053797,-21589374,2.55561908740573,49.5365548872863,0.148656623160233
497.98,499,6774,6718,1144806,685236,2024-05-16,2024-06-21,529.78,-56,-459570,168672803,-78039132,0.40625162314994,91.0479652134553,-0.67067404514649
343.92,345,6299,6300,762179,680400,2024-05-16,2024-12-20,529.78,1,-81779,392218823,-61081925,0.173474591248773,98.5635842367514,-0.120192533803645
508.61,510,4648,4861,1166648,675679,2024-05-16,2024-06-14,529.78,213,-490969,24055258,-5534803,2.80886199599273,64.4127949074585,-0.726630544977719
527.62,529,62,4875,38936,672750,2024-05-16,2024-05-17,529.78,4813,633814,12246418,-21476147,5.49344306228972,31.4608810510959,0.942124117428465
518.85,522,507,2129,282399,670635,2024-05-16,2024-06-14,529.78,1622,388236,24055258,-5534803,2.78789360729367,67.2006885147522,0.578908049833367
522.07,529,1300,947,1355900,656271,2024-05-16,2024-06-28,529.78,-353,-699629,71313964,4291035,0.920255954359794,78.2328549286645,-1.06606721918232
524.64,525,4096,18118,1462272,652248,2024-05-16,2024-05-17,529.78,14022,-810024,12246418,-21476147,5.32603084428443,36.7869118953804,-1.24189572064613
490.27,491,8979,8902,1032585,649846,2024-05-16,2024-06-21,529.78,-77,-382739,168672803,-78039132,0.385270173046214,91.4332353865015,-0.588968771062682
474.44,475,11250,11574,911250,648144,2024-05-16,2024-06-28,529.78,324,-263106,71313964,4291035,0.908859869295724,79.1417147979602,-0.405937569429016
419.86,420,46331,46293,787627,648102,2024-05-16,2024-06-21,529.78,-38,-139525,168672803,-78039132,0.384236218568088,91.8174716050696,-0.215282470969076
527.31,535,22,826,27170,635194,2024-05-16,2024-06-07,529.78,804,608024,14949825,-8379167,4.24883903323283,51.2964399248821,0.957225666489293
518.02,521,2089,2123,1092547,632654,2024-05-16,2024-06-14,529.78,34,-459893,24055258,-5534803,2.6300029706603,69.8306914854125,-0.726926566496063
523.39,526,62,2421,35836,631881,2024-05-16,2024-05-31,529.78,2359,596045,27053797,-21589374,2.33564626806359,51.8722011553498,0.943286789759464
503.1,506,2086,2120,869862,614800,2024-05-16,2024-07-19,529.78,34,-255062,106722520,-20817707,0.576073353590226,88.4994535361422,-0.414869876382563
449.4,450,10151,10240,751174,614400,2024-05-16,2024-07-19,529.78,89,-136774,106722520,-20817707,0.575698549846837,89.075152085989,-0.222613932291667
524.72,531,30,971,30540,609788,2024-05-16,2024-06-14,529.78,941,579248,24055258,-5534803,2.53494682950397,72.3656383149164,0.949917020341496
384.29,385,8649,8579,674622,609109,2024-05-16,2024-09-20,529.78,-70,-65513,207805543,-46765032,0.293114895400071,97.6334057653121,-0.107555462158661
449.7,450,20280,20246,851760,607380,2024-05-16,2024-06-28,529.78,-34,-244380,71313964,4291035,0.851698553736264,79.9934133516965,-0.40235108169515
525.48,526,831,11619,347358,604188,2024-05-16,2024-05-17,529.78,10788,256830,12246418,-21476147,4.93358956063724,41.7205014560176,0.425082921209954
502.69,504,4338,4550,971712,596050,2024-05-16,2024-06-21,529.78,212,-375662,168672803,-78039132,0.353376471724372,92.170848076794,-0.630252495596007
521.22,530,603,674,730836,591772,2024-05-16,2024-07-19,529.78,71,-139064,106722520,-20817707,0.554495902083272,89.6296479880723,-0.234995910587186
515.2,516,5320,7343,1143800,587440,2024-05-16,2024-05-31,529.78,2023,-556360,27053797,-21589374,2.17137727469457,54.0435784300444,-0.947092469018112
504.73,508,1755,1778,786240,581406,2024-05-16,2024-07-19,529.78,23,-204834,106722520,-20817707,0.544782863073323,90.1744308511456,-0.352308025716969
496.87,499,2710,2725,834680,580425,2024-05-16,2024-07-19,529.78,15,-254255,106722520,-20817707,0.54386365689266,90.7182945080382,-0.438049704957574
414.37,415,8977,9004,691229,567252,2024-05-16,2024-08-16,529.78,27,-123977,85913959,-15086717,0.66025591952991,91.8317231778366,-0.218557184461227
516.85,521,1423,1365,951987,566475,2024-05-16,2024-06-28,529.78,-58,-385512,71313964,4291035,0.794339520938705,80.7877528726352,-0.680545478617768
521.2,523,3070,3106,1338520,559080,2024-05-16,2024-05-31,529.78,36,-779440,27053797,-21589374,2.0665491058427,56.1101275358871,-1.39414752808185
528.44,531,24,2170,18024,555520,2024-05-16,2024-05-17,529.78,2146,537496,12246418,-21476147,4.53618355996015,46.2566850159777,0.967554723502304
464.56,465,12547,12531,715179,551364,2024-05-16,2024-06-28,529.78,-16,-163815,71313964,4291035,0.773150122464094,81.5609029950993,-0.29710862515507
449.94,450,91774,91715,642418,550290,2024-05-16,2024-05-31,529.78,-59,-92128,27053797,-21589374,2.03405828764073,58.1441858235279,-0.167417180032347
511.15,514,1866,1896,860226,540360,2024-05-16,2024-06-28,529.78,30,-319866,71313964,4291035,0.757719764392847,82.3186227594921,-0.591949811236953
269.52,270,11095,11238,554750,539424,2024-05-16,2024-12-20,529.78,143,-15326,392218823,-61081925,0.137531390226012,98.7011156269774,-0.0284117873880287
520.67,529,517,644,604890,536452,2024-05-16,2024-07-19,529.78,127,-68438,106722520,-20817707,0.502660544372453,91.2209550524107,-0.127575253703966
354.95,355,106616,106616,746312,533080,2024-05-16,2024-06-21,529.78,0,-213232,168672803,-78039132,0.316043837843852,92.4868919146378,-0.4
505.7,515,434,561,493024,521730,2024-05-16,2024-10-18,529.78,127,28706,21699053,7078243,2.404390643223,80.7837236030531,0.0550207961972668
479.36,480,7603,8029,714682,513856,2024-05-16,2024-06-28,529.78,426,-200826,71313964,4291035,0.720554532629823,83.0391772921219,-0.39082155311994
514.43,518,1387,1433,786429,511581,2024-05-16,2024-06-28,529.78,46,-274848,71313964,4291035,0.717364414071836,83.7565417061938,-0.53725216534625
439.11,440,5729,5743,624461,511127,2024-05-16,2024-08-16,529.78,14,-113334,85913959,-15086717,0.594928933492635,92.4266521113292,-0.221733541761636
520.34,528,360,660,399240,505560,2024-05-16,2024-07-19,529.78,300,106320,106722520,-20817707,0.473714451270454,91.6946695036811,0.210301447899359
508.66,511,2124,2154,826236,504036,2024-05-16,2024-06-28,529.78,30,-322200,71313964,4291035,0.706784438458645,84.4633261446524,-0.639240054281837
349.55,350,11190,11168,548310,502560,2024-05-16,2024-09-20,529.78,-22,-45749.9999999999,207805543,-46765032,0.241841479656777,97.8752472449688,-0.0910339063992358
524.36,532,18,652,20250,498128,2024-05-16,2024-06-21,529.78,634,477878,168672803,-78039132,0.295322062087271,92.7822139767251,0.959347798156297
444.05,445,5253,5238,609348,497610,2024-05-16,2024-08-16,529.78,-15,-111738,85913959,-15086717,0.579195750948923,93.0058478622781,-0.224549345873274
525.25,529,14,1314,10388,492750,2024-05-16,2024-05-31,529.78,1300,482362,27053797,-21589374,1.82137095210702,59.9655567756349,0.97891831557585
508.6,509,12703,12301,1333815,492040,2024-05-16,2024-05-31,529.78,-402,-841775,27053797,-21589374,1.81874655154691,61.7843033271818,-1.71078570847899
524.1,527,63,1695,38619,491550,2024-05-16,2024-05-31,529.78,1632,452931,27053797,-21589374,1.81693534552654,63.6012386727083,0.921434238632896
522.31,527,667,1044,520927,489636,2024-05-16,2024-06-14,529.78,377,-31290.9999999999,24055258,-5534803,2.03546351487895,74.4011018297954,-0.063906657190239
429.23,430,2341,6345,213031,488565,2024-05-16,2024-08-16,529.78,4004,275534,85913959,-15086717,0.568667776094453,93.5745156383726,0.563965900136113
495.17,496,8151,5832,1198197,484056,2024-05-16,2024-06-21,529.78,-2319,-714141,168672803,-78039132,0.286979282605507,93.0691932593306,-1.47532723486539
519.6,521,3541,3380,1260596,473200,2024-05-16,2024-05-31,529.78,-161,-787396,27053797,-21589374,1.74910752823347,65.3503462009418,-1.66398140321217
404.97,405,157366,157549,472098,472647,2024-05-16,2024-05-31,529.78,183,549.000000000058,27053797,-21589374,1.74706345286763,67.0974096538094,0.00116154339284933
511.97,513,4542,4570,1003782,470710,2024-05-16,2024-06-07,529.78,28,-533072,14949825,-8379167,3.14859872941657,54.4450386542986,-1.13248496951414
516.12,517,5559,5332,1334160,469216,2024-05-16,2024-05-31,529.78,-227,-864944,27053797,-21589374,1.7343813143863,68.8317909681957,-1.84338129987042
521.42,528,296,710,287120,467180,2024-05-16,2024-06-28,529.78,414,180060,71313964,4291035,0.655103115569343,85.1184292602217,0.385418896356865
493.68,500,648,728,498960,460096,2024-05-16,2024-10-18,529.78,80,-38864.0000000001,21699053,7078243,2.12035059778876,82.9040742008418,-0.0844693281402143
447.71,450,139,2004,38086,458916,2024-05-16,2024-10-18,529.78,1865,420830,21699053,7078243,2.11491257245189,85.0189867732938,0.917008777205415
519.68,522,2045,1966,957060,456112,2024-05-16,2024-06-07,529.78,-79,-500948,14949825,-8379167,3.050952101446,57.4959907557446,-1.09830041744133
344.94,345,75674,75624,605392,453744,2024-05-16,2024-06-28,529.78,-50,-151648,71313964,4291035,0.636262485703361,85.7546917459251,-0.334214887689975
525.45,528,60,1773,39780,452115,2024-05-16,2024-05-24,529.78,1713,412335,11385857,-4974638,3.97084734157473,44.5058373735064,0.912013536379019
486.49,488,2653,2986,546518,450886,2024-05-16,2024-07-19,529.78,333,-95632.0000000001,106722520,-20817707,0.422484401605209,92.1171539052864,-0.212097958242217
249.63,250,11793,12094,459927,447478,2024-05-16,2024-12-20,529.78,301,-12449.0000000001,392218823,-61081925,0.11408886411349,98.8152044910909,-0.0278203621183613
520.98,522,1945,4356,639905,444312,2024-05-16,2024-05-24,529.78,2411,-195593,11385857,-4974638,3.90231495090796,48.4081523244144,-0.440215434199391
444.93,445,62700,62983,438900,440881,2024-05-16,2024-05-31,529.78,283,1981.00000000006,27053797,-21589374,1.62964555400486,70.4614365222006,0.00449327596335532
394.19,395,5433,5438,483537,440478,2024-05-16,2024-09-20,529.78,5,-43058.9999999999,207805543,-46765032,0.211966434408345,98.0872136793772,-0.0977551659787775
509.81,510,21842,23097,1572624,438843,2024-05-16,2024-05-24,529.78,1255,-1133781,11385857,-4974638,3.85428167594236,52.2624340003568,-2.58356861109782
524.19,530,166,754,156870,438074,2024-05-16,2024-06-14,529.78,588,281204,24055258,-5534803,1.82111536696052,76.2222171967559,0.641909814323607
523.7,532,9,525,11700,435750,2024-05-16,2024-06-28,529.78,516,424050,71313964,4291035,0.61103040072208,86.3657221466472,0.973149741824441
524.67,528,234,1280,162162,426240,2024-05-16,2024-05-31,529.78,1046,264078,27053797,-21589374,1.57552745738426,72.0369639795848,0.619552364864865
526.57,530,166,1242,123836,426006,2024-05-16,2024-05-24,529.78,1076,302170,11385857,-4974638,3.74153653958591,56.0039705399427,0.709309258555044
289.4,290,7060,7056,465960,423360,2024-05-16,2024-12-20,529.78,-4,-42600.0000000001,392218823,-61081925,0.107939745665903,98.9231442367569,-0.10062358276644
513.35,514,6154,6509,1064642,423085,2024-05-16,2024-05-31,529.78,355,-641557,27053797,-21589374,1.56386550841643,73.6008294880013,-1.51637850550126
524.78,527,49,1898,28077,421356,2024-05-16,2024-05-24,529.78,1849,393279,11385857,-4974638,3.70069639905016,59.7046669389928,0.93336513541993
491.26,492,5772,5673,692640,419802,2024-05-16,2024-06-21,529.78,-99,-272838,168672803,-78039132,0.248885411597743,93.3180786709284,-0.649920676890534
424.85,425,27508,27335,550160,410025,2024-05-16,2024-06-21,529.78,-173,-140135,168672803,-78039132,0.243088982163888,93.5611676530922,-0.341771843180294
529.01,540,122,373,198860,409927,2024-05-16,2024-05-31,529.78,251,211067,27053797,-21589374,1.51522908226154,75.1160585702628,0.514889236376233
493.97,496,1303,1989,364840,403767,2024-05-16,2024-07-19,529.78,686,38927,106722520,-20817707,0.378333457643242,92.4954873629296,0.0964095629410031
485.57,487,2780,2769,569900,395967,2024-05-16,2024-07-19,529.78,-11,-173933,106722520,-20817707,0.371024784647139,92.8665121475767,-0.439261352587463
525.02,530,322,787,274022,391926,2024-05-16,2024-06-07,529.78,465,117904,14949825,-8379167,2.62160928305181,60.1176000387964,0.300832299974995
524.58,533,5,465,6150,391530,2024-05-16,2024-06-28,529.78,460,385380,71313964,4291035,0.549022909454311,86.9147450561015,0.984292391387633
274.47,275,7364,7364,390292,390292,2024-05-16,2024-12-20,529.78,0,0,392218823,-61081925,0.0995087377537717,99.0226529745106,0
517.02,518,4224,3971,1110912,389158,2024-05-16,2024-05-31,529.78,-253,-721754,27053797,-21589374,1.43845982136999,76.5545183916328,-1.85465543558143
512.41,513,6082,6586,954874,388574,2024-05-16,2024-05-31,529.78,504,-566300,27053797,-21589374,1.43630115950083,77.9908195511336,-1.45738006145548
429.57,430,8886,8870,470958,381410,2024-05-16,2024-07-19,529.78,-16,-89548,106722520,-20817707,0.357384739415823,93.2238968869926,-0.234781468760651
509.54,512,1535,1543,635490,379578,2024-05-16,2024-06-28,529.78,8,-255912,71313964,4291035,0.532263218463077,87.4470082745646,-0.674201349920175
399.72,400,13375,13355,454750,373940,2024-05-16,2024-07-19,529.78,-20,-80809.9999999999,106722520,-20817707,0.350385279508018,93.5742821665006,-0.216104187837621
513.63,517,1111,1107,599940,373059,2024-05-16,2024-06-28,529.78,-4,-226881,71313964,4291035,0.52312195126329,87.9701302258279,-0.608163856119273
495.59,499,1096,1082,554576,368962,2024-05-16,2024-08-16,529.78,-14,-185614,85913959,-15086717,0.429455241377015,94.0039708797496,-0.503070776936378
489.27,492,1329,1350,503691,368550,2024-05-16,2024-08-16,529.78,21,-135141,85913959,-15086717,0.428975691831405,94.432946571581,-0.366682946682947
461.97,465,1114,1212,434460,367236,2024-05-16,2024-10-18,529.78,98,-67224,21699053,7078243,1.69240565475369,86.7113924280474,-0.183053948959252
513.75,515,2677,2881,704051,360125,2024-05-16,2024-06-07,529.78,204,-343926,14949825,-8379167,2.40889107397578,62.5264911127722,-0.955018396390142
486.38,487,4907,5763,471072,357306,2024-05-16,2024-06-21,529.78,856,-113766,168672803,-78039132,0.211833795161393,93.7730014482536,-0.318399355174556
414.83,415,20665,20665,351305,351305,2024-05-16,2024-06-21,529.78,0,0,168672803,-78039132,0.208276019459996,93.9812774677136,0
482.48,483,6821,6697,552501,348244,2024-05-16,2024-06-21,529.78,-124,-204257,168672803,-78039132,0.206461263349018,94.1877387310627,-0.586534154213712
516.55,517,7647,7655,1368813,344475,2024-05-16,2024-05-24,529.78,8,-1024338,11385857,-4974638,3.02546395936643,62.7301308983593,-2.97362072719356
264.51,265,6978,6978,341922,341922,2024-05-16,2024-12-20,529.78,0,0,392218823,-61081925,0.0871763362565595,99.1098293107672,0
512.84,516,1103,1072,566942,338752,2024-05-16,2024-06-28,529.78,-31,-228190,71313964,4291035,0.475014963408849,88.4451451892367,-0.673619639146042
525.4,534,1,390,1765,335400,2024-05-16,2024-06-21,529.78,389,333635,168672803,-78039132,0.198846520621348,94.386585251684,0.994737626714371
487.37,488,5722,5309,577922,334467,2024-05-16,2024-06-21,529.78,-413,-243455,168672803,-78039132,0.198293378690102,94.5848786303741,-0.727889447987395
284.41,285,5663,5663,334117,334117,2024-05-16,2024-12-20,529.78,0,0,392218823,-61081925,0.0851863756676461,99.1950156864348,0
399.97,400,110675,110615,442700,331845,2024-05-16,2024-05-31,529.78,-60,-110855,27053797,-21589374,1.22661155474775,79.2174311058814,-0.334056562551794
419.99,420,331353,331357,331353,331357,2024-05-16,2024-05-17,529.78,4,4,12246418,-21476147,2.70574628434208,48.9624313003198,1.20715723524778e-05
519.9,520,27875,33022,4181250,330220,2024-05-16,2024-05-17,529.78,5147,-3851030,12246418,-21476147,2.69646193687003,51.6588932371899,-11.662013203319
472.63,473,8967,8921,502152,330077,2024-05-16,2024-06-21,529.78,-46,-172075,168672803,-78039132,0.195690706580598,94.7805693369547,-0.52131775313033
521.96,524,1594,1617,760338,329868,2024-05-16,2024-05-31,529.78,23,-430470,27053797,-21589374,1.21930389290642,80.4367349987878,-1.30497653606897
492.94,496,1064,1068,439432,326808,2024-05-16,2024-08-16,529.78,4,-112624,85913959,-15086717,0.38038987354779,94.8133364451288,-0.344618246799344
519.4,527,278,430,298294,326800,2024-05-16,2024-07-19,529.78,152,28506,106722520,-20817707,0.306214658349522,93.8804968248501,0.0872276621787026
409.87,410,30185,24992,452775,324896,2024-05-16,2024-06-21,529.78,-5193,-127879,168672803,-78039132,0.192619079200338,94.973188416155,-0.393599798089235
299.76,300,13479,13489,350454,323736,2024-05-16,2024-09-20,529.78,10,-26718.0000000001,207805543,-46765032,0.155787952201063,98.2430016315782,-0.0825302098005784
515.61,517,2207,2323,684170,322897,2024-05-16,2024-06-07,529.78,116,-361273,14949825,-8379167,2.15987143662217,64.6863625493944,-1.11884904474182
522.98,528,12,639,9960,320778,2024-05-16,2024-06-14,529.78,627,310818,24055258,-5534803,1.33350471651562,77.5557219132715,0.968950489123319
434.53,435,6836,6817,382816,320399,2024-05-16,2024-07-19,529.78,-19,-62417.0000000001,106722520,-20817707,0.300216861445925,94.180713686296,-0.194810221005684
379.34,380,4877,4802,351144,316932,2024-05-16,2024-09-20,529.78,-75,-34212,207805543,-46765032,0.152513737326054,98.3955153689043,-0.107947446139866
448.77,449,13688,13660,396952,314180,2024-05-16,2024-06-21,529.78,-28,-82772,168672803,-78039132,0.1862659506524,95.1594543668074,-0.263454070914762
394.9,395,31133,31112,435862,311120,2024-05-16,2024-06-21,529.78,-21,-124742,168672803,-78039132,0.184451787405229,95.3439061542127,-0.400944973000772
369.41,370,5252,5247,346632,309573,2024-05-16,2024-09-20,529.78,-5,-37059,207805543,-46765032,0.14897244584087,98.5444878147452,-0.119710052233237
516.49,519,893,1219,412566,305969,2024-05-16,2024-06-14,529.78,326,-106597,24055258,-5534803,1.27194229220073,78.8276642054723,-0.348391503714429
518.39,519,4839,4991,1112970,304451,2024-05-16,2024-05-24,529.78,152,-808519,11385857,-4974638,2.67394013467761,65.4040710330369,-2.65566215909949
522.9,540,176,177,365728,302670,2024-05-16,2024-09-20,529.78,1,-63058,207805543,-46765032,0.145650590273234,98.6901384050184,-0.208339115207982
494.98,497,1442,1468,415296,296536,2024-05-16,2024-07-19,529.78,26,-118760,106722520,-20817707,0.277857007124644,94.4585706934207,-0.400491002778752
404.89,405,26653,26654,399795,293194,2024-05-16,2024-06-21,529.78,1,-106601,168672803,-78039132,0.173824110814119,95.5177302650268,-0.363585202971411
482.26,483,3881,3880,415267,287120,2024-05-16,2024-06-28,529.78,-1,-128147,71313964,4291035,0.402613995766664,88.8477591850034,-0.44631861242686
309.26,310,3782,3842,298778,284308,2024-05-16,2024-12-20,529.78,60,-14470,392218823,-61081925,0.0724870871380898,99.2675027735729,-0.0508955076888445
314.21,315,3554,3567,298536,281793,2024-05-16,2024-12-20,529.78,13,-16742.9999999999,392218823,-61081925,0.0718458634505667,99.3393486370235,-0.0594159542643002
518.91,521,1386,1343,598752,280687,2024-05-16,2024-06-07,529.78,-43,-318065,14949825,-8379167,1.87752699446315,66.5638895438575,-1.13316612454442
517.46,518,4633,5162,940499,278748,2024-05-16,2024-05-24,529.78,529,-661751,11385857,-4974638,2.44819516001299,67.8522661930499,-2.37401165210154
294.37,295,4422,4423,305118,278649,2024-05-16,2024-12-20,529.78,1,-26469,392218823,-61081925,0.0710442701012338,99.4103929071247,-0.0949904718839831
516.41,518,1528,1744,511880,277296,2024-05-16,2024-06-07,529.78,216,-234584,14949825,-8379167,1.85484445470097,68.4187339985585,-0.845969649760545
499.98,500,135910,138558,815460,277116,2024-05-16,2024-05-17,529.78,2648,-538344,12246418,-21476147,2.26283309944181,53.9217263366317,-1.94266660892911
526.29,531,78,582,69420,274122,2024-05-16,2024-05-31,529.78,504,204702,27053797,-21589374,1.01324778921051,81.4499827879983,0.746755094446998
434.17,435,2764,3298,273636,273734,2024-05-16,2024-08-16,529.78,534,97.9999999999418,85913959,-15086717,0.318614114849486,95.1319505599783,0.00035801179246985
502.75,503,10607,10901,636420,272525,2024-05-16,2024-05-31,529.78,294,-363895,27053797,-21589374,1.00734473611967,82.457327524118,-1.3352719933951
450.77,451,11765,11790,352950,271170,2024-05-16,2024-06-21,529.78,25,-81780,168672803,-78039132,0.160766878344934,95.6784971433717,-0.301582033410776
501.77,502,11962,11785,633986,271055,2024-05-16,2024-05-31,529.78,-177,-362931,27053797,-21589374,1.00191111805859,83.4592386421766,-1.33895703823947
503.72,504,9690,9667,639540,270676,2024-05-16,2024-05-31,529.78,-23,-368864,27053797,-21589374,1.00051020564692,84.4597488478235,-1.36275103814154
523.72,524,4848,9663,1468944,270564,2024-05-16,2024-05-17,529.78,4815,-1198380,12246418,-21476147,2.20933174092212,56.1310580775538,-4.42919235374994
528.93,532,57,878,49647,269546,2024-05-16,2024-05-17,529.78,821,219899,12246418,-21476147,2.20101910615823,58.332077183712,0.815812514376025
511.96,512,53363,66358,1440801,265432,2024-05-16,2024-05-17,529.78,12995,-1175369,12246418,-21476147,2.16742560967623,60.4995027933882,-4.42813601977154
469.39,471,1649,1647,367727,265167,2024-05-16,2024-08-16,529.78,-2,-102560,85913959,-15086717,0.308642510584339,95.4405930705626,-0.38677512661832
489.38,495,352,471,245696,264702,2024-05-16,2024-10-18,529.78,119,19006,21699053,7078243,1.21987812094841,87.9312705489959,0.0718014975330749
510.39,513,851,1014,366781,264654,2024-05-16,2024-06-28,529.78,163,-102127,71313964,4291035,0.371111049162826,89.2188702341662,-0.385888745305191
517.24,519,1715,1488,627690,261888,2024-05-16,2024-06-07,529.78,-227,-365802,14949825,-8379167,1.75177970310689,70.1705137016654,-1.3967879398827
514.75,517,815,1160,323555,261000,2024-05-16,2024-06-14,529.78,345,-62555,24055258,-5534803,1.08500187360285,79.9126660790751,-0.239674329501916
489.51,490,5100,5294,392700,259406,2024-05-16,2024-06-14,529.78,194,-133294,24055258,-5534803,1.0783754636928,80.9910415427679,-0.513843164768741
522.63,524,481,1891,201539,259067,2024-05-16,2024-05-24,529.78,1410,57528,11385857,-4974638,2.27534036304865,70.1276065560985,0.222058386440573
452.76,453,10728,10789,332568,258936,2024-05-16,2024-06-21,529.78,61,-73632,168672803,-78039132,0.153513782539085,95.8320109259108,-0.284363703772361
504.43,505,11949,4490,1398033,255930,2024-05-16,2024-06-07,529.78,-7459,-1142103,14949825,-8379167,1.71192639378722,71.8824400954526,-4.46256007502051
457.18,460,771,904,252888,254928,2024-05-16,2024-10-18,529.78,133,2040,21699053,7078243,1.17483468057339,89.1061052295692,0.00800225946149501
521.85,522,11494,16954,2494198,254310,2024-05-16,2024-05-17,529.78,5460,-2239888,12246418,-21476147,2.07660721690212,62.5761100102904,-8.80770712909441
484.61,487,1019,1055,322004,252145,2024-05-16,2024-08-16,529.78,36,-69859,85913959,-15086717,0.293485485868484,95.7340785564311,-0.277058835194035
513.08,515,1068,1308,372732,251136,2024-05-16,2024-06-14,529.78,240,-121596,24055258,-5534803,1.04399628555221,82.0350378283201,-0.484183868501529
527.95,540,106,208,191754,250640,2024-05-16,2024-06-21,529.78,102,58886,168672803,-78039132,0.148595384402309,95.9806063103131,0.234942547079477
512.26,514,2382,1434,764622,249516,2024-05-16,2024-06-14,529.78,-948,-515106,24055258,-5534803,1.03726179116433,83.0722996194844,-2.06442071851104
518.95,535,47,155,93765,248775,2024-05-16,2024-10-18,529.78,108,155010,21699053,7078243,1.14647860438886,90.2525838339581,0.623093156466687
264.86,265,793,17697,12688,247758,2024-05-16,2024-09-20,529.78,16904,235070,207805543,-46765032,0.119225886096792,98.8093642911152,0.948788737396976
489.75,490,9766,9730,429704,243250,2024-05-16,2024-06-07,529.78,-36,-186454,14949825,-8379167,1.62710934743383,73.5095494428865,-0.766511819116136
520.16,521,2528,2890,745760,242760,2024-05-16,2024-05-24,529.78,362,-503000,11385857,-4974638,2.13211882074402,72.2597253768425,-2.07200527269731
484.58,486,1702,1686,342102,239412,2024-05-16,2024-07-19,529.78,-16,-102690,106722520,-20817707,0.224331284531137,94.6829019779518,-0.428925868377525
465.17,466,2752,2873,302720,238459,2024-05-16,2024-07-19,529.78,121,-64261,106722520,-20817707,0.223438314612511,94.9063402925643,-0.269484481608998
279.46,280,4409,4407,255722,237978,2024-05-16,2024-12-20,529.78,-2,-17743.9999999999,392218823,-61081925,0.0606748034629638,99.4710677105877,-0.0745615140895374
414.57,415,5497,5497,236371,236371,2024-05-16,2024-07-19,529.78,0,0,106722520,-20817707,0.221481839072016,95.1278221316363,0
444.45,445,4357,4282,296276,235510,2024-05-16,2024-07-19,529.78,-75,-60766,106722520,-20817707,0.220675074014369,95.3484972056507,-0.258018767780561
522.79,523,6869,11078,1785940,232638,2024-05-16,2024-05-17,529.78,4209,-1553302,12246418,-21476147,1.89964118487545,64.4757511951658,-6.67690575056526
511.54,512,5816,5041,820056,231886,2024-05-16,2024-05-31,529.78,-775,-588170,27053797,-21589374,0.857129222933106,85.3168780707566,-2.53646188213174
398.86,400,117,2026,16497,230964,2024-05-16,2024-10-18,529.78,1909,214467,21699053,7078243,1.06439668127452,91.3169805152326,0.928573284148179
525.69,535,62,248,81530,230888,2024-05-16,2024-06-21,529.78,186,149358,168672803,-78039132,0.136885138500959,96.1174914488141,0.646885069817401
429.99,430,230436,230434,230436,230434,2024-05-16,2024-05-17,529.78,-2,-2,12246418,-21476147,1.88164408564202,66.3573952808078,-8.67927475980107e-06
488.12,489,1595,2605,215325,229240,2024-05-16,2024-06-28,529.78,1010,13915,71313964,4291035,0.321451770651818,89.540322004818,0.060700575815739
511.51,512.5,2383,2309,505196,228591,2024-05-16,2024-06-07,529.78,-74,-276605,14949825,-8379167,1.52905468793113,75.0386041308176,-1.21004326504543
515.63,518,655,960,282305,227520,2024-05-16,2024-06-14,529.78,305,-54785,24055258,-5534803,0.945822322920004,84.0181219424045,-0.240792018284107
527.13,550,88,99,276760,226413,2024-05-16,2024-09-20,529.78,11,-50347,207805543,-46765032,0.108954264035199,98.9183185551504,-0.222367973570422
496.81,497,11913,11896,416955,226024,2024-05-16,2024-05-31,529.78,-17,-190931,27053797,-21589374,0.835461284787492,86.1523393555441,-0.844737726967048
470.65,471,5514,6456,281214,225960,2024-05-16,2024-06-21,529.78,942,-55254,168672803,-78039132,0.133963505663684,96.2514549544778,-0.244530005310674
523.44,527,320,633,223680,225348,2024-05-16,2024-06-07,529.78,313,1667.99999999997,14949825,-8379167,1.50736212631252,76.5459662571301,0.00740188508440266
491.23,493,905,1271,225345,224967,2024-05-16,2024-07-19,529.78,366,-378.000000000029,106722520,-20817707,0.210796184347971,95.5592933899987,-0.0016802464361441
469.52,470,4373,4674,297364,224352,2024-05-16,2024-06-28,529.78,301,-73012.0000000001,71313964,4291035,0.314597573064372,89.8549195778824,-0.325435030666096
521.37,531,227,230,328015,221490,2024-05-16,2024-07-19,529.78,3,-106525,106722520,-20817707,0.207538202808554,95.7668315928072,-0.480947221093503
521.82,523,1213,1877,448810,221486,2024-05-16,2024-05-24,529.78,664,-227324,11385857,-4974638,1.94527298208646,74.204998358929,-1.02635832513116
429.88,430,18454,18442,258356,221304,2024-05-16,2024-06-14,529.78,-12,-37052,24055258,-5534803,0.919981818527991,84.9381037609324,-0.16742580341973
489.86,490,17059,15743,409416,220402,2024-05-16,2024-05-31,529.78,-1316,-189014,27053797,-21589374,0.814680467957973,86.967019823502,-0.857587499205996
470.41,472,1389,1382,290301,219738,2024-05-16,2024-08-16,529.78,-7,-70563,85913959,-15086717,0.255765189449598,95.9898437458807,-0.32112333779319
513.69,514,6809,7068,810271,219108,2024-05-16,2024-05-24,529.78,259,-591163,11385857,-4974638,1.92438742204474,76.1293857809737,-2.69804388703288
409.61,410,5589,5589,217971,217971,2024-05-16,2024-07-19,529.78,0,0,106722520,-20817707,0.204240866876082,95.9710724596833,0
492.92,494,2030,2015,334950,217620,2024-05-16,2024-06-28,529.78,-15,-117330,71313964,4291035,0.305157626632563,90.160077204515,-0.539150813344362
497.83,505,68,303,59840,217251,2024-05-16,2024-10-18,529.78,235,157411,21699053,7078243,1.00120037496567,92.3181808901983,0.724558229881566
483.71,486,862,948,258600,217092,2024-05-16,2024-08-16,529.78,86,-41508,85913959,-15086717,0.252685363969783,96.2425291098505,-0.191200044220883
349.95,350,43369,43278,260214,216390,2024-05-16,2024-06-21,529.78,-91,-43824,168672803,-78039132,0.128289799037726,96.3797447535155,-0.202523221960349
504,505,805,2155,146510,215500,2024-05-16,2024-06-14,529.78,1350,68990,24055258,-5534803,0.895854037400056,85.8339577983325,0.320139211136891
364.45,365,3911,3912,234660,215160,2024-05-16,2024-09-20,529.78,1,-19500,207805543,-46765032,0.103539105306734,99.0218576604571,-0.0906302286670383
464.8,465,10697,10702,331607,214040,2024-05-16,2024-06-14,529.78,5,-117567,24055258,-5534803,0.889784678260362,86.7237424765929,-0.549275836292282
492.01,493,1625,2150,261625,212850,2024-05-16,2024-06-28,529.78,525,-48775,71313964,4291035,0.298468894535157,90.4585460990501,-0.229151984965938
507.85,508,15103,14154,785356,212310,2024-05-16,2024-05-24,529.78,-949,-573046,11385857,-4974638,1.86468177142924,77.994067552403,-2.69910037209741
514.65,515,5746,6048,781456,211680,2024-05-16,2024-05-24,529.78,302,-569776,11385857,-4974638,1.85914859109859,79.8532161435016,-2.69168556311414
501.18,502,2581,2580,384569,211560,2024-05-16,2024-06-14,529.78,-1,-173009,24055258,-5534803,0.879475081913484,87.6032175585064,-0.817777462658347
384.91,385,23006,23476,230060,211284,2024-05-16,2024-06-21,529.78,470,-18776,168672803,-78039132,0.125262636442936,96.5050073899584,-0.0888661706518241
521.5,540,47,114,104387,210900,2024-05-16,2024-10-18,529.78,67,106513,21699053,7078243,0.971931816563608,93.2901127067619,0.505040303461356
528.7,539,0,203,0,209090,2024-05-16,2024-05-24,529.78,203,209090,11385857,-4974638,1.83640107196147,81.689617215463,1
441.66,442,6119,6119,208046,208046,2024-05-16,2024-06-28,529.78,0,0,71313964,4291035,0.291732485940622,90.7502785849907,0
354.53,355,4396,4394,241780,206518,2024-05-16,2024-09-20,529.78,-2,-35262.0000000001,207805543,-46765032,0.0993804096938839,99.121238070151,-0.170745407180004
388.98,390,469,2021,54404,206142,2024-05-16,2024-10-18,529.78,1552,151738,21699053,7078243,0.950004592366312,94.2401172991282,0.736084834725578
511.1,512,2435,2280,494305,205200,2024-05-16,2024-06-07,529.78,-155,-289105,14949825,-8379167,1.37259131795857,77.9185575750887,-1.40889376218324
510.13,511,2065,2346,388220,204102,2024-05-16,2024-06-07,529.78,281,-184118,14949825,-8379167,1.36524675038002,79.2838043254687,-0.902088171600474
344.96,345,50837,50824,305022,203296,2024-05-16,2024-06-21,529.78,-13,-101726,168672803,-78039132,0.12052684035849,96.6255342303169,-0.500383677002991
119.96,120,48986,50770,146958,203080,2024-05-16,2024-12-20,529.78,1784,56122,392218823,-61081925,0.0517772192692547,99.5228449298569,0.276354146149301
509.97,510,74679,67617,1269543,202851,2024-05-16,2024-05-17,529.78,-7062,-1066692,12246418,-21476147,1.65641087867489,68.0138061594827,-5.25850008134049
465.54,466,4399,4399,303531,202354,2024-05-16,2024-06-28,529.78,0,-101177,71313964,4291035,0.283750879421035,91.0340294644118,-0.5
502.37,504,1228,1233,324192,200979,2024-05-16,2024-06-28,529.78,5,-123213,71313964,4291035,0.281822785787087,91.3158522501989,-0.613064051468064
449.99,450,197621,198085,395242,198085,2024-05-16,2024-05-17,529.78,464,-197157,12246418,-21476147,1.61749337643056,69.6312995359133,-0.995315142489335
483.46,484,3615,3664,300045,197856,2024-05-16,2024-06-21,529.78,49,-102189,168672803,-78039132,0.117301661252407,96.7428358915693,-0.516481683648714
522.95,534,106,178,170024,196690,2024-05-16,2024-07-19,529.78,72,26666,106722520,-20817707,0.184300370718383,96.1553728304017,0.135573745487823
494.64,498,574,585,249116,196560,2024-05-16,2024-08-16,529.78,11,-52556,85913959,-15086717,0.228787035643416,96.4713161454939,-0.267378917378917
491.17,494,578,688,220218,194704,2024-05-16,2024-08-16,529.78,110,-25514,85913959,-15086717,0.226626734777756,96.6979428802717,-0.131039937546224
523.9,528,237,472,172062,193520,2024-05-16,2024-06-07,529.78,235,21458,14949825,-8379167,1.29446331311571,80.5782676385844,0.110882596114097
339.61,340,4961,4961,218284,193479,2024-05-16,2024-09-20,529.78,0,-24805,207805543,-46765032,0.0931057936216841,99.2143438637727,-0.128205128205128
399.83,401,0,1639,0,191763,2024-05-16,2024-10-18,529.78,1639,191763,21699053,7078243,0.883739027689365,95.1238563268176,1
359.49,360,3725,3723,204875,189873,2024-05-16,2024-09-20,529.78,-2,-15002,207805543,-46765032,0.0913705174842232,99.3057143812569,-0.0790107071568891
514.08,516,982,988,358430,189696,2024-05-16,2024-06-14,529.78,6,-168734,24055258,-5534803,0.788584350248914,88.3918019087553,-0.889496879217274
512.97,514,2167,1819,522247,187357,2024-05-16,2024-06-07,529.78,-348,-334890,14949825,-8379167,1.25323875028637,81.8315063888708,-1.78744322336502
480.32,481,2749,2731,269402,185708,2024-05-16,2024-06-28,529.78,-18,-83694,71313964,4291035,0.260409027325981,91.5762612775248,-0.450675253623969
304.28,305,2517,2567,196326,184824,2024-05-16,2024-12-20,529.78,50,-11502,392218823,-61081925,0.047122674681016,99.5699676045379,-0.0622321776392676
509.19,510,3044,2255,532700,182655,2024-05-16,2024-06-07,529.78,-789,-350045,14949825,-8379167,1.22178687710391,83.0532932659747,-1.91642714406942
505.93,508,819,879,271089,181953,2024-05-16,2024-06-28,529.78,60,-89136,71313964,4291035,0.255143578892908,91.8314048564178,-0.489884750457536
492.09,494,1022,948,264698,181068,2024-05-16,2024-07-19,529.78,-74,-83630,106722520,-20817707,0.169662410520291,96.325035240922,-0.461870678419158
415.7,416,6023,6023,180690,180690,2024-05-16,2024-06-28,529.78,0,0,71313964,4291035,0.253372537249507,92.0847773936673,0
465.68,466,5770,5642,253880,180544,2024-05-16,2024-06-21,529.78,-128,-73336,168672803,-78039132,0.107038003038344,96.8498738946077,-0.406194611839773
480.83,483,830,829,260620,179893,2024-05-16,2024-08-16,529.78,-1,-80727.0000000001,85913959,-15086717,0.209387394195162,96.9073302744668,-0.448750090331475
485.24,486,2085,2367,243945,179892,2024-05-16,2024-06-28,529.78,282,-64053,71313964,4291035,0.252253541816859,92.3370309354841,-0.35606363818291
485.44,486,3263,3183,300196,178248,2024-05-16,2024-06-21,529.78,-80,-121948,168672803,-78039132,0.105676787739159,96.9555506823468,-0.684147928728513
522.78,527.5,235,376,211030,177472,2024-05-16,2024-06-14,529.78,141,-33558.0000000001,24055258,-5534803,0.73776801728753,89.1295699260428,-0.189088983050848
374.93,375,24935,24925,249350,174475,2024-05-16,2024-06-21,529.78,-10,-74875,168672803,-78039132,0.103439912598121,97.0589905949449,-0.429144576586903
471.03,472,2136,1793,264864,173921,2024-05-16,2024-07-19,529.78,-343,-90943,106722520,-20817707,0.162965604635273,96.4880008455572,-0.522898327401521
454.65,455,4981,4960,239088,173600,2024-05-16,2024-06-28,529.78,-21,-65488,71313964,4291035,0.243430585347913,92.580461520832,-0.377235023041475
490.18,493,586,609,243776,171738,2024-05-16,2024-08-16,529.78,23,-72038,85913959,-15086717,0.199895339475626,97.1072256139424,-0.419464533184269
472.97,474,1662,1655,227694,170465,2024-05-16,2024-07-19,529.78,-7,-57229,106722520,-20817707,0.159727300292384,96.6477281458496,-0.335722875663626
506.83,509,810,784,283500,170128,2024-05-16,2024-06-28,529.78,-26,-113372,71313964,4291035,0.238561973640955,92.819023494473,-0.666392363396972
439.5,440,3334,3392,203374,169600,2024-05-16,2024-07-19,529.78,58,-33774,106722520,-20817707,0.158916787197304,96.806644933047,-0.199139150943396
504.2,506,853,940,254194,169200,2024-05-16,2024-06-28,529.78,87,-84994,71313964,4291035,0.237260685719279,93.0562841801923,-0.502328605200946
419.94,420,28193,28185,197351,169110,2024-05-16,2024-06-07,529.78,-8,-28241,14949825,-8379167,1.13118380984393,84.1844770758186,-0.166997812074981
499.89,500,14480,15336,347520,168696,2024-05-16,2024-05-24,529.78,856,-178824,11385857,-4974638,1.48162760168163,83.1712448171446,-1.06003698961445
334.62,335,4419,4417,185598,167846,2024-05-16,2024-09-20,529.78,-2,-17752,207805543,-46765032,0.0807707039845419,99.3864850852415,-0.105763616648595
526.59,560,17,50,64430,167050,2024-05-16,2024-12-20,529.78,33,102620,392218823,-61081925,0.042591020676231,99.6125586252142,0.614307093684526
514.96,515,48483,41621,2472633,166484,2024-05-16,2024-05-17,529.78,-6862,-2306149,12246418,-21476147,1.35945057567037,70.9907501115837,-13.8520758751592
479.9,480,16949,16642,254235,166420,2024-05-16,2024-05-31,529.78,-307,-87815,27053797,-21589374,0.615144705935363,87.5821645294374,-0.527670953010456
474.76,476,1342,1341,217404,166284,2024-05-16,2024-07-19,529.78,-1,-51120,106722520,-20817707,0.155809664164602,96.9624545972115,-0.307425849751028
509.52,511,706,1116,183560,165168,2024-05-16,2024-06-14,529.78,410,-18392,24055258,-5534803,0.686619116702053,89.8161890427448,-0.111353288772644
484.88,485,13888,13712,263872,164544,2024-05-16,2024-05-31,529.78,-176,-99328,27053797,-21589374,0.608210374314556,88.190374903752,-0.603656164916375
471.33,473,1020,985,240720,164495,2024-05-16,2024-08-16,529.78,-35,-76225,85913959,-15086717,0.191464811905595,97.298690425848,-0.463387944922338
474.91,475,18015,18072,216180,162648,2024-05-16,2024-05-31,529.78,57,-53532,27053797,-21589374,0.601202115917407,88.7915770196694,-0.32912793271359
399.99,400,162404,162402,162404,162402,2024-05-16,2024-05-17,529.78,-2,-2,12246418,-21476147,1.32611838008469,72.3168684916683,-1.23151192719301e-05
489.98,490,72327,81164,216981,162328,2024-05-16,2024-05-17,529.78,8837,-54653,12246418,-21476147,1.32551412176197,73.6423826134303,-0.336682519343551
502.54,503,3523,3527,355823,162242,2024-05-16,2024-06-07,529.78,4,-193581,14949825,-8379167,1.08524347274968,85.2697205485683,-1.19316206654257
416.79,417,7628,7627,167816,160167,2024-05-16,2024-06-28,529.78,-1,-7649.00000000003,71313964,4291035,0.224594162231677,93.2808783424239,-0.0477564042530611
505,506,1300,1599,247000,159900,2024-05-16,2024-06-14,529.78,299,-87100,24055258,-5534803,0.664719538655541,90.4809085814004,-0.544715447154472
494.7,495,5522,5266,325798,157980,2024-05-16,2024-06-07,529.78,-256,-167818,14949825,-8379167,1.05673477783185,86.3264553264001,-1.06227370553235
505.69,506,5009,5094,390702,157914,2024-05-16,2024-05-31,529.78,85,-232788,27053797,-21589374,0.583703647957438,89.3752806676268,-1.47414415441316
389.99,390,157609,157609,157609,157609,2024-05-16,2024-05-17,529.78,0,0,12246418,-21476147,1.2869804052091,74.9293630186394,0
399.48,400,2534,3022,149506,157144,2024-05-16,2024-08-16,529.78,488,7638,85913959,-15086717,0.182908577173123,97.4815990030212,0.0486051010538105
514.77,516,1284,1273,364656,156579,2024-05-16,2024-06-07,529.78,-11,-208077,14949825,-8379167,1.04736343067561,87.3738187570758,-1.32889467936313
510.46,512,1276,1016,359832,156464,2024-05-16,2024-06-14,529.78,-260,-203368,24055258,-5534803,0.650435759200754,91.1313443406011,-1.29977502812148
404.7,405,5190,5203,197220,156090,2024-05-16,2024-07-19,529.78,13,-41130,106722520,-20817707,0.146257790764311,97.1087123879759,-0.263501825869691
491.01,492,1366,1573,206266,155727,2024-05-16,2024-06-28,529.78,207,-50539,71313964,4291035,0.21836817260642,93.4992465150304,-0.324535886519358
475.58,476,3697,3704,229214,155568,2024-05-16,2024-06-21,529.78,7,-73646,168672803,-78039132,0.0922306366130644,97.151221231558,-0.473400699372622
424.59,425,3787,3787,177989,155267,2024-05-16,2024-07-19,529.78,0,-22722,106722520,-20817707,0.145486632062286,97.2541990200381,-0.146341463414634
510.52,511,3709,3227,471043,154896,2024-05-16,2024-05-31,529.78,-482,-316147,27053797,-21589374,0.572548097407547,89.9478287650343,-2.04102752814792
359.98,360,76917,76917,153834,153834,2024-05-16,2024-05-31,529.78,0,0,27053797,-21589374,0.568622585583828,90.5164513506182,0
259.59,260,3732,3733,160476,153053,2024-05-16,2024-12-20,529.78,1,-7423,392218823,-61081925,0.0390223495214558,99.6515809747356,-0.0484995393752491
516.11,517.5,1026,1097,327294,152483,2024-05-16,2024-06-07,529.78,71,-174811,14949825,-8379167,1.01996511664852,88.3937838737243,-1.14642943803572
507.63,508,3259,4118,312864,152366,2024-05-16,2024-05-31,529.78,859,-160498,27053797,-21589374,0.563196360200382,91.0796477108186,-1.05337148707717
529.15,533,52,388,48464,149380,2024-05-16,2024-05-17,529.78,336,100916,12246418,-21476147,1.21978524659211,76.1491482652315,0.67556567144196
329.97,330,49212,49214,295272,147642,2024-05-16,2024-06-21,529.78,2,-147630,168672803,-78039132,0.0875315980846064,97.2387528296426,-0.999918722314789
189.85,190,9784,9784,146760,146760,2024-05-16,2024-12-20,529.78,0,0,392218823,-61081925,0.0374178880242063,99.6889988627598,0
525.66,550,58,60,176842,146040,2024-05-16,2024-10-18,529.78,2,-30802,21699053,7078243,0.673024762877901,95.7968810896955,-0.210914817858121
506.79,508,893,1195,196460,144595,2024-05-16,2024-06-14,529.78,302,-51865,24055258,-5534803,0.601095195071281,91.7324395356724,-0.358691517687334
520.87,521,10385,11087,1890070,144131,2024-05-16,2024-05-17,529.78,702,-1745939,12246418,-21476147,1.17692373394408,77.3260719991756,-12.1135564174258
523.64,529,2,268,2058,143648,2024-05-16,2024-06-14,529.78,266,141590,24055258,-5534803,0.597158425821083,92.3295979614935,0.985673312541769
470.06,471,1530,1522,189720,143068,2024-05-16,2024-07-19,529.78,-8,-46652,106722520,-20817707,0.134056054898254,97.3882550749364,-0.326082701931949
467.65,468,3988,4049,191424,141715,2024-05-16,2024-06-21,529.78,61,-49709,168672803,-78039132,0.0840176943048726,97.3227705239475,-0.350767385245034
379.79,380,6637,6644,172562,139524,2024-05-16,2024-07-19,529.78,7,-33038,106722520,-20817707,0.13073529373182,97.5189903686682,-0.236790803015969
485.41,488,537,538,172377,139342,2024-05-16,2024-08-16,529.78,1,-33035,85913959,-15086717,0.162187846564026,97.6437868495852,-0.237078554922421
505.9,507,1029,1249,209916,137390,2024-05-16,2024-06-14,529.78,220,-72526,24055258,-5534803,0.571143323426421,92.9007412849199,-0.527884125482204
500.78,501,6095,6187,304750,136114,2024-05-16,2024-05-31,529.78,92,-168636,27053797,-21589374,0.503123461745499,91.5827711725641,-1.23893207164583
397.85,399,192,1181,25728,135815,2024-05-16,2024-10-18,529.78,989,110087,21699053,7078243,0.625902890785142,96.4227839804806,0.810565843242646
420.84,421,8456,8461,152208,135376,2024-05-16,2024-06-21,529.78,5,-16832,168672803,-78039132,0.0802595306369575,97.4030300545844,-0.124335184966316
499.6,500,3578,3383,293396,135320,2024-05-16,2024-06-07,529.78,-195,-158076,14949825,-8379167,0.905161097203479,89.2989449709278,-1.1681643511676
460.25,461,1829,1800,175584,135000,2024-05-16,2024-07-19,529.78,-29,-40584,106722520,-20817707,0.12649626339408,97.6454866320623,-0.300622222222222
478.53,479,2859,2866,200130,134702,2024-05-16,2024-06-21,529.78,7,-65428,168672803,-78039132,0.0798599404315348,97.482889995016,-0.485724042701667
486.17,487,1618,1620,199014,134460,2024-05-16,2024-06-28,529.78,2,-64554,71313964,4291035,0.188546523651385,93.6877930386817,-0.480098170459616
507.77,509,803,1091,187902,134193,2024-05-16,2024-06-14,529.78,288,-53709,24055258,-5534803,0.557853089748611,93.4585943746685,-0.400236972122242
269.85,270,1570,8927,28260,133905,2024-05-16,2024-09-20,529.78,7357,105645,207805543,-46765032,0.0644376459197722,99.4509227311612,0.788954856054666
419.63,420,3667,3603,172349,133311,2024-05-16,2024-07-19,529.78,-64,-39038,106722520,-20817707,0.124913654587617,97.7704002866499,-0.292834049703325
477.09,479,709,696,175123,132936,2024-05-16,2024-08-16,529.78,-13,-42187,85913959,-15086717,0.154731549502916,97.7985183990881,-0.317348197628934
432.73,435,583,583,132341,132341,2024-05-16,2024-10-18,529.78,0,0,21699053,7078243,0.609892975513724,97.0326769559944,0
478.96,481,674,646,175914,131784,2024-05-16,2024-08-16,529.78,-28,-44130,85913959,-15086717,0.153390673103541,97.9519090721917,-0.334866144600255
359.94,360,21445,21350,171560,128100,2024-05-16,2024-06-21,529.78,-95,-43460,168672803,-78039132,0.0759458535825719,97.5588358485986,-0.339266198282592
455.75,456,5137,5110,179795,127750,2024-05-16,2024-06-21,529.78,-27,-52045,168672803,-78039132,0.0757383512503791,97.6345741998489,-0.407397260273972
468.12,469,1441,1441,174361,126808,2024-05-16,2024-07-19,529.78,0,-47553,106722520,-20817707,0.118820282729456,97.8892205693794,-0.375
499.55,501,850,859,198050,124555,2024-05-16,2024-06-28,529.78,9,-73495,71313964,4291035,0.174657238237381,93.8624502769191,-0.59006061579222
467.55,468,2751,2761,173313,124245,2024-05-16,2024-06-28,529.78,10,-49068,71313964,4291035,0.174222540763545,94.0366728176827,-0.394929373415429
461.7,462,3933,4076,173052,122280,2024-05-16,2024-06-21,529.78,143,-50772,168672803,-78039132,0.0724953862301085,97.707069586079,-0.415210991167812
219.77,220,5306,5307,143262,122061,2024-05-16,2024-12-20,529.78,1,-21201,392218823,-61081925,0.0311206379812118,99.720119500741,-0.173691842603288
527.55,532,6,274,5568,121930,2024-05-16,2024-05-24,529.78,268,116362,11385857,-4974638,1.07088996462893,84.2421347817736,0.95433445419503
505.01,507,646,602,204136,119798,2024-05-16,2024-06-28,529.78,-44,-84338,71313964,4291035,0.167986735388878,94.2046595530715,-0.704001736256031
483.29,484,1093,1677,120230,119067,2024-05-16,2024-06-28,529.78,584,-1163.00000000003,71313964,4291035,0.166961690700576,94.3716212437721,-0.00976760983311941
481.76,484,531,531,167796,118944,2024-05-16,2024-08-16,529.78,0,-48852,85913959,-15086717,0.138445488235503,98.0903545604271,-0.410714285714286
466.04,467,1235,1235,150670,118560,2024-05-16,2024-07-19,529.78,0,-32110,106722520,-20817707,0.111091829540757,98.0003123989201,-0.270833333333334
524.58,529,4,268,3192,118456,2024-05-16,2024-06-07,529.78,264,115264,14949825,-8379167,0.792357101170081,90.0913020720978,0.973053285608158
468.66,469,3476,3475,170324,118150,2024-05-16,2024-06-21,529.78,-1,-52174,168672803,-78039132,0.0700468587102332,97.7771164447893,-0.441591197630131
515.6,516,2828,2944,441168,117760,2024-05-16,2024-05-24,529.78,116,-323408,11385857,-4974638,1.03426558053557,85.2764003623091,-2.74633152173913
456.62,457,2834,3085,144534,117230,2024-05-16,2024-06-28,529.78,251,-27304,71313964,4291035,0.164385757605621,94.5360070013778,-0.23290966476158
374.8,375,5854,5814,134642,116280,2024-05-16,2024-07-19,529.78,-40,-18362,106722520,-20817707,0.108955448203434,98.1092678471236,-0.157911936704506
369.93,370,16522,16520,165220,115640,2024-05-16,2024-06-21,529.78,-2,-49580,168672803,-78039132,0.0685587705565076,97.8456752153458,-0.428744379107575
475.9,477,1053,1051,159003,115610,2024-05-16,2024-07-19,529.78,-2,-43393,106722520,-20817707,0.108327651933256,98.2175954990568,-0.375339503503157
441.8,442,5739,5766,149214,115320,2024-05-16,2024-06-21,529.78,27,-33894,168672803,-78039132,0.0683690541385027,97.9140442694843,-0.293912591050989
466.67,467,3509,3494,161414,115302,2024-05-16,2024-06-21,529.78,-15,-46112,168672803,-78039132,0.0683583825899899,97.9824026520743,-0.399923678687273
522.47,533,44,109,68332,114777,2024-05-16,2024-07-19,529.78,65,46445,106722520,-20817707,0.107547123137647,98.3251426221945,0.404654242574732
481.73,483,931,903,171304,114681,2024-05-16,2024-07-19,529.78,-28,-56623,106722520,-20817707,0.107457170239233,98.4325997924337,-0.493743514618812
463.68,464,3568,3569,160560,114208,2024-05-16,2024-06-21,529.78,1,-46352,168672803,-78039132,0.0677097895859358,98.0501124416602,-0.405855982067806
421.86,422,8148,8148,138516,114072,2024-05-16,2024-06-21,529.78,0,-24444,168672803,-78039132,0.0676291601082837,98.1177416017685,-0.214285714285714
471.63,472,3062,3046,168410,112702,2024-05-16,2024-06-21,529.78,-16,-55708,168672803,-78039132,0.0668169366937004,98.1845585384622,-0.494294688647939
487.13,488,853,1292,109184,112404,2024-05-16,2024-06-28,529.78,439,3220.00000000001,71313964,4291035,0.157618499512943,94.6936255008907,0.0286466673783852
503.5,504,2182,2224,231292,111200,2024-05-16,2024-06-07,529.78,42,-120092,14949825,-8379167,0.743821415969752,90.8351234880676,-1.07996402877698
495.84,497,624,953,117936,110548,2024-05-16,2024-06-28,529.78,329,-7387.99999999999,71313964,4291035,0.155015923669592,94.8486414245603,-0.0668306979773491
475.17,477,747,602,183762,110166,2024-05-16,2024-08-16,529.78,-145,-73596,85913959,-15086717,0.128228289421513,98.2185828498487,-0.668046402701378
446.7,447,3641,3642,182050,109260,2024-05-16,2024-06-28,529.78,1,-72790,71313964,4291035,0.153209825778301,95.0018512503386,-0.666209042650559
471.48,472,2099,2098,149029,109096,2024-05-16,2024-06-28,529.78,-1,-39933,71313964,4291035,0.152979856792142,95.1548311071307,-0.366035418347144
442.6,443,2716,2716,108640,108640,2024-05-16,2024-06-28,529.78,0,0,71313964,4291035,0.15234043083063,95.3071715379614,0
527.69,534,12,172,16320,108532,2024-05-16,2024-05-31,529.78,160,92212,27053797,-21589374,0.401171044493311,91.9839422170574,0.849629602329267
454.99,455,108457,108456,216914,108456,2024-05-16,2024-05-17,529.78,-1,-108458,12246418,-21476147,0.885614062822288,78.2116860619979,-1.00001844065796
391.94,393,0,1023,0,108438,2024-05-16,2024-10-18,529.78,1023,108438,21699053,7078243,0.4997360944738,97.5324130504682,1
462.21,463,1353,1371,150183,108309,2024-05-16,2024-07-19,529.78,18,-41874,106722520,-20817707,0.101486546607033,98.5340863390407,-0.386616070686647
523.84,535,41,97,61500,108252,2024-05-16,2024-07-19,529.78,56,46752,106722520,-20817707,0.1014331370736,98.6355194761143,0.431881166167831
364.94,365,17896,17896,161064,107376,2024-05-16,2024-06-21,529.78,0,-53688,168672803,-78039132,0.063659344061532,98.2482178825237,-0.5
314.72,315,3768,3768,120576,105504,2024-05-16,2024-09-20,529.78,0,-15072,207805543,-46765032,0.0507705417655775,99.5016932729268,-0.142857142857143
497.82,498,5966,5836,226708,105048,2024-05-16,2024-05-31,529.78,-130,-121660,27053797,-21589374,0.388293000054669,92.372235217112,-1.15813723250324
199.83,200,6128,6178,110304,105026,2024-05-16,2024-12-20,529.78,50,-5278,392218823,-61081925,0.0267773992070748,99.7468968999481,-0.050254222763887
507.31,508,1541,1485,228068,102465,2024-05-16,2024-06-07,529.78,-56,-125603,14949825,-8379167,0.685392638375366,91.520516126443,-1.22581369248036
424.27,425,1663,1403,139692,102419,2024-05-16,2024-08-16,529.78,-260,-37273,85913959,-15086717,0.119211128426755,98.3377939782754,-0.363926615178824
474.17,476,573,558,136947,102114,2024-05-16,2024-08-16,529.78,-15,-34833,85913959,-15086717,0.118856122088379,98.4566501003638,-0.341118749632763
487.98,488,47978,50537,143934,101074,2024-05-16,2024-05-17,529.78,2559,-42860,12246418,-21476147,0.825335212304529,79.0370212743024,-0.424045748659398
506.39,507,1708,1645,233996,100345,2024-05-16,2024-06-07,529.78,-63,-133651,14949825,-8379167,0.671211870373065,92.191727996816,-1.33191489361702
319.67,320,2996,2996,98868,98868,2024-05-16,2024-09-20,529.78,0,0,207805543,-46765032,0.0475771717022967,99.5492704446291,0
399.85,400,6586,6585,118548,98775,2024-05-16,2024-06-28,529.78,-1,-19773,71313964,4291035,0.13850723541325,95.4456787733746,-0.200182232346241
458.73,459,3610,3631,133570,98037,2024-05-16,2024-06-21,529.78,21,-35533,168672803,-78039132,0.0581225889748213,98.3063404714986,-0.362444791252282
439.74,440,3784,3760,124872,97760,2024-05-16,2024-06-28,529.78,-24,-27112,71313964,4291035,0.137083951748917,95.5827627251235,-0.277332242225859
491.98,492,48577,48601,145731,97202,2024-05-16,2024-05-17,529.78,24,-48529,12246418,-21476147,0.793717803850889,79.8307390781533,-0.499259274500525
149.93,150,13863,13865,110904,97055,2024-05-16,2024-12-20,529.78,2,-13849,392218823,-61081925,0.0247451153051877,99.7716420152533,-0.142692287878007
460.72,461,3463,3462,145446,96936,2024-05-16,2024-06-21,529.78,-1,-48510,168672803,-78039132,0.0574698459241233,98.3638103174227,-0.500433275563258
517.93,518,10941,13832,1094100,96824,2024-05-16,2024-05-17,529.78,2891,-997276,12246418,-21476147,0.790631187013215,80.6213702651665,-10.2998843262001
463.56,464,2187,2187,142155,96228,2024-05-16,2024-06-28,529.78,0,-45927,71313964,4291035,0.13493570487822,95.7176984300017,-0.477272727272727
379.92,380,11946,11951,119460,95608,2024-05-16,2024-06-21,529.78,5,-23852,168672803,-78039132,0.0566825227894031,98.4204928402121,-0.249477031210778
508.26,509,1183,1287,189280,95238,2024-05-16,2024-06-07,529.78,104,-94042,14949825,-8379167,0.637050935378842,92.8287789321949,-0.987441987441988
488.75,489,3804,3801,155964,95025,2024-05-16,2024-06-07,529.78,-3,-60939,14949825,-8379167,0.635626169537102,93.464405101732,-0.641294396211523
487.47,489,641,621,157686,95013,2024-05-16,2024-07-19,529.78,-20,-62673,106722520,-20817707,0.0890280701767537,98.7245475462911,-0.659625524928168
526.79,532,18,180,17442,93780,2024-05-16,2024-05-31,529.78,162,76338,27053797,-21589374,0.346642654264021,92.7188778713761,0.814011516314779
239.69,240,3021,3022,102714,93682,2024-05-16,2024-12-20,529.78,1,-9032.00000000001,392218823,-61081925,0.0238851361807284,99.7955271514341,-0.0964112636365579
502.09,503,926,1024,159272,93184,2024-05-16,2024-06-14,529.78,98,-66088,24055258,-5534803,0.387374768543326,93.8459691432118,-0.709220467032967
409.42,410,1578,1606,110460,93148,2024-05-16,2024-08-16,529.78,28,-17312,85913959,-15086717,0.108420099695324,98.5650702000591,-0.185854768755099
528.59,535,73,145,88476,92945,2024-05-16,2024-05-31,529.78,72,4469,27053797,-21589374,0.343556211351774,93.0624340827278,0.048082199150035
364.82,365,5366,5135,112686,92430,2024-05-16,2024-07-19,529.78,-231,-20256,106722520,-20817707,0.0866077750038136,98.8111553212949,-0.219149626744563
495.9,496,8698,9179,147866,91790,2024-05-16,2024-05-24,529.78,481,-56076,11385857,-4974638,0.806175591349865,86.082575953659,-0.610916221810655
444.99,445,91522,91519,183044,91519,2024-05-16,2024-05-17,529.78,-3,-91525,12246418,-21476147,0.747312397796646,81.3686826629632,-1.00006556015691
489.94,490,15363,15193,184356,91158,2024-05-16,2024-05-24,529.78,-170,-93198,11385857,-4974638,0.800624845367371,86.8832007990264,-1.02237872704535
491.51,492,1882,1859,161852,91091,2024-05-16,2024-06-14,529.78,-23,-70761,24055258,-5534803,0.378673968077998,94.2246431112899,-0.776816590003403
528.52,535,6,140,7782,90720,2024-05-16,2024-05-24,529.78,134,82938,11385857,-4974638,0.796777967613681,87.6799787666401,0.914219576719577
511.75,512,6414,3604,596502,90100,2024-05-16,2024-05-24,529.78,-2810,-506402,11385857,-4974638,0.791332615542247,88.4713113821823,-5.62044395116537
425.97,428,443,443,89929,89929,2024-05-16,2024-10-18,529.78,0,0,21699053,7078243,0.414437441117822,97.946850491586,0
484.61,485,2350,2304,145700,89856,2024-05-16,2024-06-14,529.78,-46,-55844,24055258,-5534803,0.373539955381065,94.5981830666709,-0.621483262108262
438.81,439,4716,4716,117900,89604,2024-05-16,2024-06-21,529.78,0,-28296,168672803,-78039132,0.0531229684965869,98.4736158087087,-0.315789473684211
490.72,491,3157,3179,142065,89012,2024-05-16,2024-06-07,529.78,22,-53053,14949825,-8379167,0.595404962934349,94.0598100646663,-0.596020761245675
443.8,444,4502,4432,117052,88640,2024-05-16,2024-06-21,529.78,-70,-28412,168672803,-78039132,0.0525514477873472,98.526167256496,-0.320532490974729
477.38,478,1430,1424,125840,88288,2024-05-16,2024-06-28,529.78,-6,-37552,71313964,4291035,0.123801840548367,95.8415002705501,-0.42533526640087
454.94,455,14611,14600,116888,87600,2024-05-16,2024-05-31,529.78,-11,-29288,27053797,-21589374,0.323799280374581,93.3862333631024,-0.334337899543379
524.76,545,18,43,43272,87032,2024-05-16,2024-09-20,529.78,25,43760,207805543,-46765032,0.041881462228368,99.5911519068575,0.502803566504274
524.74,540,44,57,85624,86982,2024-05-16,2024-08-16,529.78,13,1358,85913959,-15086717,0.101243151884084,98.6663133519432,0.0156124255593111
422.84,423,5403,5402,102657,86432,2024-05-16,2024-06-21,529.78,-1,-16225,168672803,-78039132,0.0512424045031136,98.5774096609991,-0.187719825990374
492.84,493,5405,5385,151340,86160,2024-05-16,2024-05-31,529.78,-20,-65180,27053797,-21589374,0.318476552478013,93.7047099155804,-0.756499535747447
442.8,443,4309,4304,116343,86080,2024-05-16,2024-06-21,529.78,-5,-30263,168672803,-78039132,0.0510337164433083,98.6284433774424,-0.351568308550186
404.99,405,85380,85380,85380,85380,2024-05-16,2024-05-17,529.78,0,0,12246418,-21476147,0.697183453969969,82.0658661169331,0
404.45,405,1547,1547,102102,85085,2024-05-16,2024-08-16,529.78,0,-17017,85913959,-15086717,0.0990351288549047,98.7653484807981,-0.2
526.1,540,34,61,67286,84790,2024-05-16,2024-07-19,529.78,27,17504,106722520,-20817707,0.0794490235050672,98.8906043448,0.206439438613044
244.94,245,14006,14006,98042,84036,2024-05-16,2024-08-16,529.78,0,-14006,85913959,-15086717,0.0978141398419319,98.86316262064,-0.166666666666667
354.99,355,83484,83484,83484,83484,2024-05-16,2024-05-17,529.78,0,0,12246418,-21476147,0.681701375863538,82.7475674927967,0
523,555,26,26,89960,83200,2024-05-16,2024-12-20,529.78,0,-6760,392218823,-61081925,0.0212126484301851,99.8167397998642,-0.08125
229.73,230,3066,3073,91980,82971,2024-05-16,2024-12-20,529.78,7,-9009,392218823,-61081925,0.0211542626550588,99.8378940625193,-0.108580106302202
417.82,418,4591,4586,105593,82548,2024-05-16,2024-06-28,529.78,-5,-23045,71313964,4291035,0.115752926032831,95.9572531965829,-0.279170906624025
169.89,170,7504,7504,82544,82544,2024-05-16,2024-12-20,529.78,0,0,392218823,-61081925,0.021045394856024,99.8589394573753,0
469.91,470,9176,9150,100936,82350,2024-05-16,2024-05-31,529.78,-26,-18586,27053797,-21589374,0.304393501585009,94.0091034171654,-0.225695203400121
494.93,495,11803,11712,188848,81984,2024-05-16,2024-05-24,529.78,-91,-106864,11385857,-4974638,0.720051200361993,89.1913625825443,-1.30347384855582
467.14,468,950,950,119700,81700,2024-05-16,2024-07-19,529.78,0,-38000,106722520,-20817707,0.0765536645873804,98.9671580093873,-0.465116279069768
459.99,460,80266,80425,80266,80425,2024-05-16,2024-05-17,529.78,159,159,12246418,-21476147,0.656722643306802,83.4042901361035,0.00197699720236245
334.95,335,16074,16074,80370,80370,2024-05-16,2024-06-21,529.78,0,0,168672803,-78039132,0.047648464109534,98.676091841552,0
470.48,471,1552,1537,107088,79924,2024-05-16,2024-06-28,529.78,-15,-27164,71313964,4291035,0.112073422254301,96.0693266188373,-0.339872879235273
487.88,488,6678,6609,133560,79308,2024-05-16,2024-05-31,529.78,-69,-54252,27053797,-21589374,0.293149238903508,94.3022526560689,-0.684067181116659
506.82,507.5,1170,1159,164970,78812,2024-05-16,2024-06-07,529.78,-11,-86158,14949825,-8379167,0.527176739527051,94.5869868041934,-1.0932091559661
462.54,463,1713,1713,106206,78798,2024-05-16,2024-06-28,529.78,0,-27408,71313964,4291035,0.110494488849337,96.1798211076866,-0.347826086956522
527.7,546,3,43,6828,78690,2024-05-16,2024-06-21,529.78,40,71862,168672803,-78039132,0.0466524529150085,98.722744294467,0.91322912695387
476.91,478,720,721,108000,78589,2024-05-16,2024-07-19,529.78,1,-29411,106722520,-20817707,0.0736386284731658,99.0407966378605,-0.374238124928425
453.75,454,3113,3120,99616,78000,2024-05-16,2024-06-21,529.78,7,-21616,168672803,-78039132,0.0462433768886855,98.7689876713556,-0.277128205128205
512.73,513,2750,2872,291500,77544,2024-05-16,2024-05-24,529.78,122,-213956,11385857,-4974638,0.681055453269789,89.8724180358141,-2.75915609202517
496.35,497,1201,1186,134512,77090,2024-05-16,2024-06-14,529.78,-15,-57422,24055258,-5534803,0.320470476766452,94.9186535434374,-0.744869632896614
490.04,491,680,803,99280,77088,2024-05-16,2024-06-28,529.78,123,-22192,71313964,4291035,0.108096641493663,96.2879177491802,-0.287878787878788
479.95,480,14449,15374,115592,76870,2024-05-16,2024-05-24,529.78,925,-38722,11385857,-4974638,0.675135828598585,90.5475538644127,-0.503733576167556
470.98,471,38313,38312,76626,76624,2024-05-16,2024-05-17,529.78,-1,-2,12246418,-21476147,0.625684996216853,84.0299751323203,-2.61014825642096e-05
463.19,464,943,945,99015,76545,2024-05-16,2024-07-19,529.78,2,-22470,106722520,-20817707,0.0717233813444435,99.112520019205,-0.293552812071331
479.9,482,369,364,101106,76440,2024-05-16,2024-08-16,529.78,-5,-24666,85913959,-15086717,0.0889727360835508,98.9521353567236,-0.322684458398744
483.87,484,5839,5842,99263,75946,2024-05-16,2024-05-31,529.78,3,-23317,27053797,-21589374,0.280722147800547,94.5829748038695,-0.307020777921155
438.74,439,2920,2920,99280,75920,2024-05-16,2024-06-28,529.78,0,-23360,71313964,4291035,0.106458813592244,96.3943765627725,-0.307692307692308
505.44,506,1299,1353,161076,75768,2024-05-16,2024-06-07,529.78,54,-85308,14949825,-8379167,0.50681529716903,95.0938021013624,-1.12591067469116
349.86,350,5253,5390,84048,75460,2024-05-16,2024-07-19,529.78,137,-8588,106722520,-20817707,0.0707067261904985,99.1832267453955,-0.113808640339253
474.73,475,2777,2775,113857,74925,2024-05-16,2024-06-14,529.78,-2,-38932,24055258,-5534803,0.31147036543944,95.2301239088768,-0.519612946279613
481.3,482,1050,1070,106050,74900,2024-05-16,2024-06-28,529.78,20,-31150,71313964,4291035,0.105028518678333,96.4994050814508,-0.41588785046729
451.76,452,3124,3109,99968,74616,2024-05-16,2024-06-21,529.78,-15,-25352,168672803,-78039132,0.0442371257682841,98.813224797124,-0.339766269968907
488.55,489,1505,1649,111370,74205,2024-05-16,2024-06-14,529.78,144,-37165,24055258,-5534803,0.308477256822604,95.5386011656994,-0.500842261303147
462.7,463,2474,2468,103908,74040,2024-05-16,2024-06-21,529.78,-6,-29868,168672803,-78039132,0.0438956362158753,98.8571204333398,-0.403403565640194
473.42,474,1227,1276,94479,74008,2024-05-16,2024-06-28,529.78,49,-20471,71313964,4291035,0.10377771175362,96.6031827932044,-0.276605231866825
529.26,545,0,47,0,73978,2024-05-16,2024-06-14,529.78,47,73978,24055258,-5534803,0.307533596189241,95.8461347618887,1
309.74,310,2829,2830,82041,73580,2024-05-16,2024-09-20,529.78,1,-8461,207805543,-46765032,0.0354081026606687,99.6265600095181,-0.114990486545257
456.74,457,2833,2819,99155,73294,2024-05-16,2024-06-21,529.78,-14,-25861,168672803,-78039132,0.0434533598164015,98.9005737931562,-0.352839250143259
440.65,441,2091,2091,73185,73185,2024-05-16,2024-06-28,529.78,0,0,71313964,4291035,0.102623660073082,96.7058064532775,0
452.53,453,1546,1546,72662,72662,2024-05-16,2024-06-28,529.78,0,0,71313964,4291035,0.101890283367224,96.8076967366447,0
485.98,486,36169,36138,108507,72276,2024-05-16,2024-05-17,529.78,-31,-36231,12246418,-21476147,0.590180736930587,84.6201558692509,-0.501286734185622
525.7,539,53,54,100223,71820,2024-05-16,2024-07-19,529.78,1,-28403,106722520,-20817707,0.0672960121256507,99.2505227575211,-0.395474798106377
479.99,480,71499,71212,214497,71212,2024-05-16,2024-05-17,529.78,-287,-143285,12246418,-21476147,0.581492482128244,85.2016483513792,-2.01209065887772
344.58,345,1692,1686,79524,70812,2024-05-16,2024-09-20,529.78,-6,-8712,207805543,-46765032,0.0340760881436161,99.6606360976617,-0.123029994916116
461.2,462,883,885,89183,70800,2024-05-16,2024-07-19,529.78,2,-18383,106722520,-20817707,0.0663402625800065,99.3168630201011,-0.259646892655367
299.98,300,35280,35255,105840,70510,2024-05-16,2024-06-21,529.78,-25,-35330,168672803,-78039132,0.0418028269797592,98.942376620136,-0.501063678910793
414.96,415,17623,17623,88115,70492,2024-05-16,2024-05-31,529.78,0,-17623,27053797,-21589374,0.260562315892294,94.8435371197618,-0.25
447.78,448,3221,3201,93409,70422,2024-05-16,2024-06-21,529.78,-20,-22987,168672803,-78039132,0.0417506549648078,98.9841272751008,-0.326417880775894
446.78,447,3204,3199,86508,70378,2024-05-16,2024-06-21,529.78,-5,-16130,168672803,-78039132,0.0417245689573321,99.0258518440581,-0.229190940350678
494.79,496,629,576,115736,69696,2024-05-16,2024-06-28,529.78,-53,-46040,71313964,4291035,0.0977312101175584,96.9054279467623,-0.660583103764922
324.64,325,1935,1935,69660,69660,2024-05-16,2024-09-20,529.78,0,0,207805543,-46765032,0.0335217237203341,99.6941578213821,0
474.95,475,13901,13882,83406,69410,2024-05-16,2024-05-24,529.78,-19,-13996,11385857,-4974638,0.609615947222945,91.1571698116356,-0.20164241463766
497.65,499,383,509,79664,68715,2024-05-16,2024-06-28,529.78,126,-10949,71313964,4291035,0.0963556029503563,97.0017835497127,-0.159339300007276
244.67,245,2077,2077,78926,68541,2024-05-16,2024-12-20,529.78,0,-10385,392218823,-61081925,0.0174751939429485,99.8764146513183,-0.151515151515151
525.79,536,35,67,55860,68407,2024-05-16,2024-06-21,529.78,32,12547,168672803,-78039132,0.0405560343951834,99.0664078784533,0.183416901779058
412.55,413,1517,1517,68265,68265,2024-05-16,2024-06-28,529.78,0,0,71313964,4291035,0.0957245904883369,97.097508140201,0
445.8,446,3435,3410,96180,68200,2024-05-16,2024-06-21,529.78,-25,-27980,168672803,-78039132,0.0404333115872865,99.1068411900406,-0.410263929618768
510.97,511,22584,22395,496848,67185,2024-05-16,2024-05-17,529.78,-189,-429663,12246418,-21476147,0.548609397458098,85.7502577488373,-6.39522214780085
483.98,484,42660,33528,127980,67056,2024-05-16,2024-05-17,529.78,-9132,-60924,12246418,-21476147,0.547556028219844,86.2978137770571,-0.908554044380816
529.8,565,7,19,28840,66880,2024-05-16,2024-06-21,529.78,12,38040,168672803,-78039132,0.0396507313630165,99.1464919214036,0.56877990430622
139.94,140,11109,11109,66654,66654,2024-05-16,2024-12-20,529.78,0,0,392218823,-61081925,0.0169940849575187,99.8934087362758,0
479.81,481,562,557,100036,66283,2024-05-16,2024-07-19,529.78,-5,-33753,106722520,-20817707,0.0621077913077765,99.3789708114089,-0.50922559328938
492.93,493,9487,9435,132818,66045,2024-05-16,2024-05-24,529.78,-52,-66773,11385857,-4974638,0.580061737996534,91.7372315496321,-1.01102278749338
529.18,560,3,21,10950,64722,2024-05-16,2024-09-20,529.78,18,53772,207805543,-46765032,0.0311454637184534,99.7253032851005,0.830814869750626
433.84,434,4038,4035,88836,64560,2024-05-16,2024-06-21,529.78,-3,-24276,168672803,-78039132,0.0382752873324812,99.1847672087361,-0.376022304832714
506.66,507,2667,1898,226695,64532,2024-05-16,2024-05-31,529.78,-769,-162163,27053797,-21589374,0.238532136542608,95.0820692563044,-2.51290832455216
349.73,350,2366,2368,66248,63936,2024-05-16,2024-08-16,529.78,2,-2312,85913959,-15086717,0.074418640165331,99.0265539968889,-0.0361611611611612
482.68,484,481,481,87542,63492,2024-05-16,2024-07-19,529.78,0,-24050,106722520,-20817707,0.0594925981882737,99.4384634095972,-0.378787878787879
479.68,480,1956,1983,99756,63456,2024-05-16,2024-06-14,529.78,27,-36300,24055258,-5534803,0.263792639430431,96.1099274013191,-0.572049924357035
359.69,360,2041,2041,73476,63271,2024-05-16,2024-08-16,529.78,0,-10205,85913959,-15086717,0.0736446099521499,99.1001986068411,-0.161290322580645
525.27,535,31,65,42470,63245,2024-05-16,2024-06-28,529.78,34,20775,71313964,4291035,0.0886852959120321,97.186193436113,0.328484465175113
457.74,458,2425,2417,87300,62842,2024-05-16,2024-06-21,529.78,-8,-24458,168672803,-78039132,0.0372567473133176,99.2220239560494,-0.389198306864835
457.51,458,1264,1264,61936,61936,2024-05-16,2024-06-28,529.78,0,0,71313964,4291035,0.0868497507725135,97.2730431868855,0
523.6,527.5,101,158,71811,61620,2024-05-16,2024-06-07,529.78,57,-10191,14949825,-8379167,0.412178737878203,95.5059808392406,-0.165384615384616
479.83,480,3589,3607,100492,61319,2024-05-16,2024-06-07,529.78,18,-39173,14949825,-8379167,0.410165336383536,95.9161461756241,-0.638839511407557
480.89,481,5554,5568,88864,61248,2024-05-16,2024-05-31,529.78,14,-27616,27053797,-21589374,0.226393359867378,95.3084626161718,-0.450888192267503
500.23,501,765,794,110160,61138,2024-05-16,2024-06-14,529.78,29,-49022,24055258,-5534803,0.254156492522342,96.3640838938414,-0.801825378651575
518.91,519,7988,6742,974536,60678,2024-05-16,2024-05-17,529.78,-1246,-913858,12246418,-21476147,0.495475493323844,86.7932892703809,-15.0607798543129
480.98,481,30340,30308,91020,60616,2024-05-16,2024-05-17,529.78,-32,-30404,12246418,-21476147,0.494969222837241,87.2882584932182,-0.501583740266596
436.75,437,2388,2413,105072,60325,2024-05-16,2024-06-28,529.78,25,-44747,71313964,4291035,0.0845907261584842,97.357633913044,-0.741765437215085
129.97,130,19464,19463,77856,58389,2024-05-16,2024-12-20,529.78,-1,-19467,392218823,-61081925,0.0148868428989192,99.9082955791747,-0.333401839387556
491.83,492,3439,3430,85975,58310,2024-05-16,2024-05-31,529.78,-9,-27665,27053797,-21589374,0.215533516422852,95.5239961325946,-0.474446921625793
413.84,414,3625,3625,58000,58000,2024-05-16,2024-06-21,529.78,0,0,168672803,-78039132,0.0343861007633815,99.2564100568128,0
523.05,545,29,26,80620,57070,2024-05-16,2024-10-18,529.78,-3,-23550,21699053,7078243,0.263006869470294,98.2098573610563,-0.412651130190994
319.97,320,17896,18991,71584,56973,2024-05-16,2024-06-21,529.78,1095,-14611,168672803,-78039132,0.0337772296343472,99.2901872864471,-0.256454811928457
430.83,431,3765,3344,75300,56848,2024-05-16,2024-06-21,529.78,-421,-18452,168672803,-78039132,0.033703121658564,99.3238904081057,-0.324584857866592
527.95,533,2,112,2834,56560,2024-05-16,2024-05-24,529.78,110,53726,11385857,-4974638,0.496756634129517,92.2339881837617,0.949893917963225
474.84,475,3556,3531,74676,56496,2024-05-16,2024-06-07,529.78,-25,-18180,14949825,-8379167,0.377904089178301,96.2940502648024,-0.32179269328802
528.96,580,11,11,65142,56144,2024-05-16,2024-06-21,529.78,0,-8998,168672803,-78039132,0.0332857455389533,99.3571761536447,-0.160266457680251
448.68,449,1752,1752,66576,56064,2024-05-16,2024-06-28,529.78,0,-10512,71313964,4291035,0.0786157392681187,97.4362496523121,-0.1875
423.06,425,288,288,55872,55872,2024-05-16,2024-10-18,529.78,0,0,21699053,7078243,0.257485891204561,98.4673432522608,0
476.09,478,277,291,73405,55581,2024-05-16,2024-08-16,529.78,14,-17824,85913959,-15086717,0.0646937944042365,99.1648924012453,-0.320685126212195
503.05,504,757,579,130961,55005,2024-05-16,2024-06-14,529.78,-178,-75956,24055258,-5534803,0.228661027040325,96.5927449208817,-1.38089264612308
434.76,435,2260,2258,67800,54192,2024-05-16,2024-06-28,529.78,-2,-13608,71313964,4291035,0.0759907274261181,97.5122403797383,-0.2511071744907
528.35,534,5,95,6175,53675,2024-05-16,2024-05-24,529.78,90,47500,11385857,-4974638,0.471418181345506,92.7054063651072,0.88495575221239
214.79,215,2438,2539,56074,53319,2024-05-16,2024-12-20,529.78,101,-2755.00000000001,392218823,-61081925,0.0135941971352048,99.9218897763099,-0.051670136349144
528.7,550,10,25,27850,53250,2024-05-16,2024-07-19,529.78,15,25400,106722520,-20817707,0.0498957483387761,99.4883591579359,0.476995305164319
508.98,509,25518,26571,382770,53142,2024-05-16,2024-05-17,529.78,1053,-329628,12246418,-21476147,0.433939132242587,87.7221976254608,-6.20277746415265
394.51,395,1084,1082,61788,53018,2024-05-16,2024-08-16,529.78,-2,-8770.00000000001,85913959,-15086717,0.0617105772066679,99.226602978452,-0.165415519257611
507.97,508,17986,17650,233818,52950,2024-05-16,2024-05-17,529.78,-336,-180868,12246418,-21476147,0.432371326864721,88.1545689523255,-3.41582625118036
483.62,484,1404,1376,84240,52288,2024-05-16,2024-06-14,529.78,-28,-31952,24055258,-5534803,0.217366199107073,96.8101111199888,-0.611077111383109
516.95,517,9214,10424,737120,52120,2024-05-16,2024-05-17,529.78,1210,-685000,12246418,-21476147,0.425593834866653,88.5801627871921,-13.142747505756
511.32,513,277,310,82823,52080,2024-05-16,2024-06-14,529.78,33,-30743,24055258,-5534803,0.216501523284431,97.0266126432733,-0.590303379416283
427.85,428,3455,3456,69100,51840,2024-05-16,2024-06-21,529.78,1,-17260,168672803,-78039132,0.0307340597167879,99.3879102133614,-0.332947530864198
354.99,355,51537,51537,103074,51537,2024-05-16,2024-05-31,529.78,0,-51537,27053797,-21589374,0.190498213614895,95.7144943462095,-1
339.96,340,11291,12689,67746,50756,2024-05-16,2024-06-21,529.78,1398,-16990,168672803,-78039132,0.0300913953507964,99.4180016087122,-0.33473875009851
424.79,425,2413,2412,60325,50652,2024-05-16,2024-06-28,529.78,-1,-9673,71313964,4291035,0.0710267627248992,97.5832671424632,-0.19096975440259
440.82,441,2802,2768,70050,49824,2024-05-16,2024-06-21,529.78,-34,-20226,168672803,-78039132,0.0295388462833573,99.4475404549956,-0.40594894026975
513.96,514,13278,12362,531120,49448,2024-05-16,2024-05-17,529.78,-916,-481672,12246418,-21476147,0.403775210024678,88.9839379972168,-9.74098042387963
428.8,429,2459,2459,49180,49180,2024-05-16,2024-06-21,529.78,0,0,168672803,-78039132,0.0291570419921225,99.4766974969877,0
224.75,225,1963,1964,58890,49100,2024-05-16,2024-12-20,529.78,1,-9790,392218823,-61081925,0.0125185220904097,99.9344082984003,-0.19938900203666
249.9,250,4773,4909,57276,49090,2024-05-16,2024-09-20,529.78,136,-8186,207805543,-46765032,0.0236230464747516,99.7489263315753,-0.166754939906295
503.89,504,4303,4458,137696,49038,2024-05-16,2024-05-24,529.78,155,-88658,11385857,-4974638,0.430692217546734,93.1360985826539,-1.80794485908887
476.38,477,795,787,67575,48794,2024-05-16,2024-06-28,529.78,-8,-18781,71313964,4291035,0.068421382381717,97.6516885248449,-0.38490388162479
488.86,489,3487,3474,76714,48636,2024-05-16,2024-05-31,529.78,-13,-28078,27053797,-21589374,0.1797751347066,95.8942694809161,-0.577308989226087
497.91,498,5380,5388,102220,48492,2024-05-16,2024-05-24,529.78,8,-53728,11385857,-4974638,0.425896794593503,93.5619953772474,-1.10797657345542
447.58,448,1146,1146,48132,48132,2024-05-16,2024-06-28,529.78,0,0,71313964,4291035,0.0674930929375907,97.7191816177825,0
528.03,543,2,32,4418,47904,2024-05-16,2024-06-28,529.78,30,43486,71313964,4291035,0.0671733799568343,97.7863549977393,0.907773881095524
501.62,502.5,551,544,87058,47872,2024-05-16,2024-06-14,529.78,-7,-39186,24055258,-5534803,0.199008466257148,97.2256211095304,-0.818557820855615
464.93,465,6803,6786,61227,47502,2024-05-16,2024-05-31,529.78,-17,-13725,27053797,-21589374,0.175583486488052,96.0698529674042,-0.288935202728306
529.55,550,8,23,21280,47035,2024-05-16,2024-06-28,529.78,15,25755,71313964,4291035,0.0659548247801791,97.8523098225195,0.547570957797385
412.85,413,3135,3135,47025,47025,2024-05-16,2024-06-21,529.78,0,0,168672803,-78039132,0.027879420489621,99.5045769174773,0
429.76,430,1957,1955,54796,46920,2024-05-16,2024-06-28,529.78,-2,-7876,71313964,4291035,0.0657935660398853,97.9181033885594,-0.167860187553282
527.7,550,21,21,58275,46830,2024-05-16,2024-08-16,529.78,0,-11445,85913959,-15086717,0.0545080223808566,99.2811110008328,-0.244394618834081
488.99,489,46757,46763,140271,46763,2024-05-16,2024-05-17,529.78,6,-93508,12246418,-21476147,0.381850431693578,89.3657884289104,-1.99961508029853
478.33,479,691,695,72555,46565,2024-05-16,2024-06-28,529.78,4,-25990,71313964,4291035,0.0652957673198478,97.9833991558792,-0.558144529152797
259.88,260,876,3876,12264,46512,2024-05-16,2024-09-20,529.78,3000,34248,207805543,-46765032,0.0223824635900112,99.7713087951653,0.736326109391125
304.75,305,1855,1857,51940,46425,2024-05-16,2024-09-20,529.78,2,-5515.00000000001,207805543,-46765032,0.0223405975267946,99.7936493926921,-0.118793753365644
249.93,250,6560,6560,45920,45920,2024-05-16,2024-08-16,529.78,0,0,85913959,-15086717,0.0534488231417668,99.3345598239746,0
364.67,365,1347,1370,49839,45210,2024-05-16,2024-08-16,529.78,23,-4629,85913959,-15086717,0.0526224149442351,99.3871822389188,-0.102388852023889
468.49,469,902,885,65846,45135,2024-05-16,2024-06-28,529.78,-17,-20711,71313964,4291035,0.0632905499405418,98.0466897058198,-0.458867840921679
374.89,375,4131,4101,53703,45111,2024-05-16,2024-06-28,529.78,-30,-8592,71313964,4291035,0.0632568959425674,98.1099466017623,-0.190463523309171
472.28,474,263,262,58649,45064,2024-05-16,2024-08-16,529.78,-1,-13585,85913959,-15086717,0.0524524774838976,99.4396347164027,-0.301460145570744
485.6,486,1118,1121,81614,44840,2024-05-16,2024-06-14,529.78,3,-36774,24055258,-5534803,0.18640415330403,97.4120252628344,-0.820115967885816
324.96,325,11185,11185,44740,44740,2024-05-16,2024-06-21,529.78,0,0,168672803,-78039132,0.026524726692305,99.5311016441696,0
498.79,499,2414,2129,101388,44709,2024-05-16,2024-05-31,529.78,-285,-56679,27053797,-21589374,0.165259612171999,96.2351125795762,-1.26773132926256
512.97,513,11456,14890,366592,44670,2024-05-16,2024-05-17,529.78,3434,-321922,12246418,-21476147,0.364759719944232,89.7305481488546,-7.20667114394448
497.33,498,659,665,79080,44555,2024-05-16,2024-06-14,529.78,6,-34525,24055258,-5534803,0.1852193811432,97.5972446439776,-0.7748849736281
224.93,225,6314,6314,56826,44198,2024-05-16,2024-09-20,529.78,0,-12628,207805543,-46765032,0.0212689225522728,99.8149183152444,-0.285714285714286
436.82,437,2450,2445,58800,44010,2024-05-16,2024-06-21,529.78,-5,-14790,168672803,-78039132,0.0260919361137314,99.5571935802834,-0.336059986366735
486.87,487,3424,3370,68480,43810,2024-05-16,2024-05-31,529.78,-54,-24670,27053797,-21589374,0.161936603575461,96.3970491831516,-0.563113444419082
501.88,502,3587,3630,100436,43560,2024-05-16,2024-05-24,529.78,43,-56876,11385857,-4974638,0.382579897147839,93.9445752743953,-1.30569329660239
369.9,370,4041,4342,48492,43420,2024-05-16,2024-06-28,529.78,301,-5071.99999999999,71313964,4291035,0.0608856913352903,98.1708322930976,-0.116812528788576
427.76,428,1626,1786,43902,42864,2024-05-16,2024-06-28,529.78,160,-1038.00000000001,71313964,4291035,0.0601060403822174,98.2309383334798,-0.024216125419933
484.99,485,42273,42260,126819,42260,2024-05-16,2024-05-17,529.78,-13,-84559,12246418,-21476147,0.345080496190805,90.0756286450454,-2.00092285849503
510.77,511,1828,1837,149896,42251,2024-05-16,2024-05-24,529.78,9,-107645,11385857,-4974638,0.371083178016376,94.3156584524116,-2.54775034910416
495.85,496,2811,2804,95574,42060,2024-05-16,2024-05-31,529.78,-7,-53514,27053797,-21589374,0.155468010645604,96.5525171937972,-1.27232524964337
449.96,450,10752,10432,53760,41728,2024-05-16,2024-05-24,529.78,-320,-12032,11385857,-4974638,0.366489760059344,94.682148212471,-0.288343558282209
389.54,390,901,901,46852,41446,2024-05-16,2024-08-16,529.78,0,-5406.00000000001,85913959,-15086717,0.0482412875421094,99.4878760039448,-0.130434782608696
506.39,507.5,283,365,59147,40515,2024-05-16,2024-06-14,529.78,82,-18632,24055258,-5534803,0.168424716126512,97.7656693601041,-0.459879057139331
528.86,560,2,13,7678,40482,2024-05-16,2024-10-18,529.78,11,32804,21699053,7078243,0.186561137022892,98.6539043892837,0.810335457734302
425.74,426,1556,1556,40456,40456,2024-05-16,2024-06-28,529.78,0,0,71313964,4291035,0.0567294225854561,98.2876677560653,0
450.58,451,961,961,40362,40362,2024-05-16,2024-06-28,529.78,0,0,71313964,4291035,0.0565976110933898,98.3442653671587,0
461.59,462,982,980,51064,40180,2024-05-16,2024-06-28,529.78,-2,-10884,71313964,4291035,0.0563424016087508,98.4006077687674,-0.270881035340966
496.91,497,4380,4387,74460,39483,2024-05-16,2024-05-24,529.78,7,-34977,11385857,-4974638,0.3467723158652,95.0289205283362,-0.88587493351569
418.85,419,2626,2626,47268,39390,2024-05-16,2024-06-21,529.78,0,-7878,168672803,-78039132,0.0233529053287862,99.5805464856122,-0.2
529.33,550,1,19,4750,39273,2024-05-16,2024-06-21,529.78,18,34523,168672803,-78039132,0.0232835402634531,99.6038300258756,0.879051765844219
529.39,535,0,70,0,39270,2024-05-16,2024-05-17,529.78,70,39270,12246418,-21476147,0.320665193691739,90.3962938387372,1
493.83,494,2292,2289,66468,38913,2024-05-16,2024-05-31,529.78,-3,-27555,27053797,-21589374,0.143835632388311,96.6963528261856,-0.708118109629172
493.98,494,19609,19375,58827,38750,2024-05-16,2024-05-17,529.78,-234,-20077,12246418,-21476147,0.316419054126684,90.7127128928639,-0.518116129032258
329.9,330,3855,3854,46260,38540,2024-05-16,2024-07-19,529.78,-1,-7720,106722520,-20817707,0.0361123406756137,99.5244714986115,-0.200311364815776
510.81,512.5,169,228,48672,38532,2024-05-16,2024-06-14,529.78,59,-10140,24055258,-5534803,0.160181196144311,97.9258505562485,-0.263157894736842
496.67,497,1251,1165,81315,38445,2024-05-16,2024-06-07,529.78,-86,-42870,14949825,-8379167,0.257160200871917,96.5512104656744,-1.1150994927819
490.52,491,782,799,64124,38352,2024-05-16,2024-06-14,529.78,17,-25772,24055258,-5534803,0.159432918990102,98.0852834752386,-0.671985815602837
528.98,720,2,2,39310,38204,2024-05-16,2024-12-20,529.78,0,-1106,392218823,-61081925,0.00974048101714894,99.9441487794175,-0.0289498481834363
488.94,489,6385,6352,63850,38112,2024-05-16,2024-05-24,529.78,-33,-25738,11385857,-4974638,0.334731061526594,95.3636515898628,-0.675325356842989
459.93,460,5630,5439,45040,38073,2024-05-16,2024-05-31,529.78,-191,-6967,27053797,-21589374,0.14073070778198,96.8370835339675,-0.182990570745673
428.27,430,220,220,45540,38060,2024-05-16,2024-10-18,529.78,0,-7480,21699053,7078243,0.175399359594172,98.8293037488779,-0.196531791907514
432.83,433,2218,2222,48796,37774,2024-05-16,2024-06-21,529.78,4,-11022,168672803,-78039132,0.0223948374178616,99.6262248632935,-0.291788002329645
416.85,417,2516,2516,45288,37740,2024-05-16,2024-06-21,529.78,0,-7548,168672803,-78039132,0.0223746800484486,99.6485995433419,-0.2
504.99,505,41349,37422,330792,37422,2024-05-16,2024-05-17,529.78,-3927,-293370,12246418,-21476147,0.305575066929775,91.0182879597936,-7.83950617283951
405.76,406,1553,1553,37272,37272,2024-05-16,2024-06-28,529.78,0,0,71313964,4291035,0.0522646588541902,98.4528724276216,0
498.3,499,497,532,63616,37240,2024-05-16,2024-06-14,529.78,35,-26376,24055258,-5534803,0.154810229015212,98.2400937042538,-0.708270676691729
515.95,516,8000,7427,520000,37135,2024-05-16,2024-05-17,529.78,-573,-482865,12246418,-21476147,0.303231524515985,91.3215194843096,-13.0029621650734
437.69,438,1196,1196,37076,37076,2024-05-16,2024-06-28,529.78,0,0,71313964,4291035,0.0519898178707329,98.5048622454924,0
529.12,540,35,34,58730,36992,2024-05-16,2024-05-17,529.78,-1,-21738,12246418,-21476147,0.302063836135595,91.6235833204452,-0.587640570934256
349.31,350,530,530,36570,36570,2024-05-16,2024-10-18,529.78,0,0,21699053,7078243,0.168532700482367,98.9978364493603,0
475.39,476,650,599,53300,36539,2024-05-16,2024-06-28,529.78,-51,-16761,71313964,4291035,0.0512368096660564,98.5560990551584,-0.458715345247544
469.99,470,38700,36416,116100,36416,2024-05-16,2024-05-17,529.78,-2284,-79684,12246418,-21476147,0.297360420001996,91.9209437404472,-2.18815905096661
435.82,436,2016,2013,46368,36234,2024-05-16,2024-06-21,529.78,-3,-10134,168672803,-78039132,0.0214818271562132,99.6700813704981,-0.279682066567313
359.84,360,2267,2262,43073,36192,2024-05-16,2024-07-19,529.78,-5,-6881,106722520,-20817707,0.0339122427019152,99.5583837413135,-0.190124889478338
423.85,424,2401,2403,43218,36045,2024-05-16,2024-06-21,529.78,2,-7173,168672803,-78039132,0.0213697758968291,99.691451146395,-0.199001248439451
289.8,290,1796,1796,39512,35920,2024-05-16,2024-09-20,529.78,0,-3591.99999999999,207805543,-46765032,0.0172853906981682,99.8322037059425,-0.0999999999999998
481.89,482,3241,3242,48615,35662,2024-05-16,2024-05-31,529.78,1,-12953,27053797,-21589374,0.131818834894045,96.9689023688616,-0.36321574785486
504.88,505,3072,2961,110592,35532,2024-05-16,2024-05-24,529.78,-111,-75060,11385857,-4974638,0.312071370648692,95.6757229605114,-2.11246200607903
503.98,504,16915,17757,135320,35514,2024-05-16,2024-05-17,529.78,842,-99806,12246418,-21476147,0.289995000987227,92.2109387414344,-2.81032832122543
354.72,355,1268,1268,43112,35504,2024-05-16,2024-08-16,529.78,0,-7608,85913959,-15086717,0.0413250656974148,99.5292010696422,-0.214285714285714
384.73,385,1314,1314,35478,35478,2024-05-16,2024-07-19,529.78,0,0,106722520,-20817707,0.0332432180199643,99.5916269593334,0
472.45,473,668,644,55444,35420,2024-05-16,2024-06-28,529.78,-24,-20024,71313964,4291035,0.0496676920105016,98.6057667471689,-0.56533032185206
496.76,498,240,283,47280,35092,2024-05-16,2024-06-28,529.78,43,-12188,71313964,4291035,0.0492077540381853,98.6549745012071,-0.347315627493446
369.81,370,1814,1845,43536,35055,2024-05-16,2024-07-19,529.78,31,-8480.99999999999,106722520,-20817707,0.0328468630613295,99.6244738223947,-0.241934103551562
494.99,495,36307,34996,145228,34996,2024-05-16,2024-05-17,529.78,-1311,-110232,12246418,-21476147,0.285765192728192,92.4967039341626,-3.14984569665105
486.99,487,34131,34985,102393,34985,2024-05-16,2024-05-17,529.78,854,-67408,12246418,-21476147,0.285675370545085,92.7823793047077,-1.92676861512077
254.97,255,11641,11649,46564,34947,2024-05-16,2024-07-19,529.78,8,-11617,106722520,-20817707,0.0327456660506143,99.6572194884454,-0.332417661029559
505.86,506,2583,2493,111069,34902,2024-05-16,2024-05-24,529.78,-90,-76167,11385857,-4974638,0.306538190318041,95.9822611508295,-2.18231046931408
462.92,463,4329,4329,38961,34632,2024-05-16,2024-05-31,529.78,0,-4329,27053797,-21589374,0.128011605912471,97.0969139747741,-0.125
460.6,461,844,857,47264,34280,2024-05-16,2024-06-28,529.78,13,-12984,71313964,4291035,0.0480691271067192,98.7030436283138,-0.378763127187865
398.85,399,2275,2282,36400,34230,2024-05-16,2024-06-28,529.78,7,-2170,71313964,4291035,0.0479990146109393,98.7510426429247,-0.0633946830265849
495.33,496,506,509,55660,34103,2024-05-16,2024-06-14,529.78,3,-21557,24055258,-5534803,0.141769421055472,98.3818631253092,-0.632114476732252
498.64,499,932,944,68036,33984,2024-05-16,2024-06-07,529.78,12,-34052,14949825,-8379167,0.22732038669349,96.7785308523678,-1.00200094161959
458.62,459,812,892,42224,33896,2024-05-16,2024-06-28,529.78,80,-8328,71313964,4291035,0.0475306631391294,98.7985733060639,-0.245692707104083
502.9,503,3360,3384,97440,33840,2024-05-16,2024-05-24,529.78,24,-63600,11385857,-4974638,0.29721082918923,96.2794719800187,-1.87943262411348
279.83,280,1943,1971,38860,33507,2024-05-16,2024-09-20,529.78,28,-5352.99999999999,207805543,-46765032,0.0161242089678041,99.8483279149103,-0.159757662577969
452.45,455,93,131,27993,33405,2024-05-16,2024-10-18,529.78,38,5411.99999999999,21699053,7078243,0.15394681048984,99.1517832598501,0.162011674898967
500.6,501,905,835,78735,33400,2024-05-16,2024-06-07,529.78,-70,-45335,14949825,-8379167,0.223413986451346,97.0019448388192,-1.35733532934132
439.94,440,5551,5554,33306,33324,2024-05-16,2024-05-31,529.78,3,18,27053797,-21589374,0.123176794739755,97.2200907695138,0.000540151242347857
466.55,467,742,738,51940,33210,2024-05-16,2024-06-28,529.78,-4,-18730,71313964,4291035,0.0465687196970288,98.8451420257609,-0.563986750978621
334.9,335,3197,3297,44758,32970,2024-05-16,2024-07-19,529.78,100,-11788,106722520,-20817707,0.0308931985489098,99.6881126869943,-0.357537154989384
349.92,350,4190,4115,33520,32920,2024-05-16,2024-06-28,529.78,-75,-600,71313964,4291035,0.0461620672215052,98.8913040929824,-0.0182260024301337
423.81,424,1732,1732,45032,32908,2024-05-16,2024-06-28,529.78,0,-12124,71313964,4291035,0.046145240222518,98.9374493332049,-0.368421052631579
492.47,493,606,620,55146,32860,2024-05-16,2024-06-14,529.78,14,-22286,24055258,-5534803,0.136602151596129,98.5184652769054,-0.678210590383445
384.87,385,2512,2512,32656,32656,2024-05-16,2024-06-28,529.78,0,0,71313964,4291035,0.0457918732437872,98.9832412064487,0
269.98,270,16285,16285,32570,32570,2024-05-16,2024-06-21,529.78,0,0,168672803,-78039132,0.0193095741700575,99.710760720565,0
214.94,215,5383,5383,43064,32298,2024-05-16,2024-09-20,529.78,0,-10766,207805543,-46765032,0.0155424150548284,99.8638703299652,-0.333333333333334
481.62,482,845,847,53235,32186,2024-05-16,2024-06-14,529.78,2,-21049,24055258,-5534803,0.133800269363147,98.6522655462685,-0.653979991300566
490.84,491,2042,2011,49008,32176,2024-05-16,2024-05-31,529.78,-31,-16832,27053797,-21589374,0.118933397777768,97.3390241672916,-0.52312282446544
486.57,487,1116,740,78120,31820,2024-05-16,2024-06-14,529.78,-376,-46300,24055258,-5534803,0.132278772482922,98.7845443187515,-1.45505971087366
528.49,555,1,12,5372,31812,2024-05-16,2024-06-28,529.78,11,26440,71313964,4291035,0.0446083743150219,99.0278495807637,0.831132905821703
435.75,436,1268,1268,41844,31700,2024-05-16,2024-06-28,529.78,0,-10144,71313964,4291035,0.0444513223244749,99.0723009030882,-0.32
419.81,420,1670,1668,40080,31692,2024-05-16,2024-06-28,529.78,-2,-8388,71313964,4291035,0.0444401043251501,99.1167410074134,-0.264672472548277
529.1,537,0,40,0,31600,2024-05-16,2024-05-24,529.78,40,31600,11385857,-4974638,0.277537299124695,96.5570092791434,1
493.43,494,552,554,53544,31578,2024-05-16,2024-06-14,529.78,2,-21966,24055258,-5534803,0.131272755420042,98.9158170741715,-0.69561086832605
527.49,545,9,18,20097,31518,2024-05-16,2024-07-19,529.78,9,11421,106722520,-20817707,0.0295326609604046,99.7176453479547,0.362364363221017
500.89,501,2863,2857,71575,31427,2024-05-16,2024-05-24,529.78,-6,-40148,11385857,-4974638,0.276017870240246,96.8330271493837,-1.2775002386483
528.52,537,1,37,1550,31376,2024-05-16,2024-05-31,529.78,36,29826,27053797,-21589374,0.115976326724119,97.4550004940157,0.95059918408975
527.43,541,1,23,1983,31211,2024-05-16,2024-06-28,529.78,22,29228,71313964,4291035,0.0437656221157472,99.1605066295291,0.936464707955528
501.53,502,800,661,73600,31067,2024-05-16,2024-06-07,529.78,-139,-42533,14949825,-8379167,0.207808452607305,97.2097532914265,-1.36907329320501
414.82,415,1722,1721,37884,30978,2024-05-16,2024-06-28,529.78,-1,-6906,71313964,4291035,0.0434388978854127,99.2039455274145,-0.222932403641294
184.84,185,1930,1930,30880,30880,2024-05-16,2024-12-20,529.78,0,0,392218823,-61081925,0.00787315605197255,99.9520219354694,0
354.85,355,1899,2032,36081,30480,2024-05-16,2024-07-19,529.78,133,-5601,106722520,-20817707,0.0285600452463079,99.746205393201,-0.183759842519685
199.95,200,5981,6078,35886,30390,2024-05-16,2024-09-20,529.78,97,-5496,207805543,-46765032,0.0146242489787676,99.8784945789439,-0.180848963474827
299.94,300,5013,5010,40104,30060,2024-05-16,2024-07-19,529.78,-3,-10044,106722520,-20817707,0.0281665013157485,99.7743718945167,-0.334131736526946
413.6,415,212,212,35404,29680,2024-05-16,2024-10-18,529.78,0,-5724,21699053,7078243,0.136780162710327,99.2885634225604,-0.192857142857143
497.66,498,878,869,62338,29546,2024-05-16,2024-06-07,529.78,-9,-32792,14949825,-8379167,0.197634420469805,97.4073877118963,-1.10986258715224
443.71,444,1009,1010,38342,29290,2024-05-16,2024-06-28,529.78,1,-9052,71313964,4291035,0.0410719000278823,99.2450174274424,-0.309047456469785
434.95,435,5852,5852,35112,29260,2024-05-16,2024-05-31,529.78,0,-5852,27053797,-21589374,0.108154873787217,97.5631553678029,-0.2
464.99,465,29191,29222,58382,29222,2024-05-16,2024-05-17,529.78,31,-29160,12246418,-21476147,0.238616712250064,93.0209960169578,-0.99787831086168
394.73,395,1086,1080,32580,29160,2024-05-16,2024-07-19,529.78,-6,-3420,106722520,-20817707,0.0273231928931213,99.8016950874099,-0.117283950617284
491.95,492.5,527,526,57443,28930,2024-05-16,2024-06-14,529.78,-1,-28513,24055258,-5534803,0.120264767062569,99.0360818412341,-0.985585896992741
495.98,496,14468,14392,57872,28784,2024-05-16,2024-05-17,529.78,-76,-29088,12246418,-21476147,0.235040156231806,93.2560361731896,-1.01056142301278
339.87,340,2216,2213,33240,28769,2024-05-16,2024-07-19,529.78,-3,-4471,106722520,-20817707,0.0269568222339577,99.8286519096438,-0.155410337516076
482.79,483,1373,1367,42563,28707,2024-05-16,2024-06-07,529.78,-6,-13856,14949825,-8379167,0.192022314642479,97.5994100265388,-0.482669732121086
493.92,494,2619,3585,39285,28680,2024-05-16,2024-05-24,529.78,966,-10605,11385857,-4974638,0.251891447433426,97.0849185968171,-0.369769874476987
527.57,539,0,25,0,28575,2024-05-16,2024-06-21,529.78,25,28575,168672803,-78039132,0.0169410832640281,99.727701803829,1
487.53,488,588,603,41748,28341,2024-05-16,2024-06-14,529.78,15,-13407,24055258,-5534803,0.117816237930186,99.1538980791642,-0.473060230761088
234.71,235,975,977,32175,28333,2024-05-16,2024-12-20,529.78,2,-3842,392218823,-61081925,0.00722377365351484,99.9592457091229,-0.135601595312886
529.56,600,0,4,0,28176,2024-05-16,2024-08-16,529.78,4,28176,85913959,-15086717,0.0327956019347217,99.561996671577,1
451.5,452,556,556,27800,27800,2024-05-16,2024-06-28,529.78,0,0,71313964,4291035,0.0389825476536405,99.283999975096,0
508.81,509,1631,1460,99491,27740,2024-05-16,2024-05-24,529.78,-171,-71751,11385857,-4974638,0.243635591067058,97.3285541878842,-2.58655371304975
482.6,483,720,692,41040,27680,2024-05-16,2024-06-14,529.78,-28,-13360,24055258,-5534803,0.115068397936119,99.2689664771004,-0.482658959537572
474.99,475,27600,27523,82800,27523,2024-05-16,2024-05-17,529.78,-77,-55277,12246418,-21476147,0.224743267786548,93.4807794409761,-2.00839298041638
497.98,498,14105,13649,70525,27298,2024-05-16,2024-05-17,529.78,-456,-43227,12246418,-21476147,0.222905995859361,93.7036854368355,-1.58352260238845
478.7,479,917,909,50435,27270,2024-05-16,2024-06-14,529.78,-8,-23165,24055258,-5534803,0.113363988862643,99.382330465963,-0.84946828016135
437.83,438,1644,1600,37812,27200,2024-05-16,2024-06-21,529.78,-44,-10612,168672803,-78039132,0.0161258955304134,99.7438276993595,-0.390147058823529
465.92,466,3388,3389,30492,27112,2024-05-16,2024-05-31,529.78,1,-3380,27053797,-21589374,0.100215138008169,97.6633705058111,-0.124668043670699
448.97,449,8981,8981,26943,26943,2024-05-16,2024-05-17,529.78,0,0,12246418,-21476147,0.22000718904091,93.9236926258764,0
289.99,290,26836,26836,26836,26836,2024-05-16,2024-05-17,529.78,0,0,12246418,-21476147,0.21913346416887,94.1428260900453,0
379.87,380,2059,2059,26767,26767,2024-05-16,2024-06-28,529.78,0,0,71313964,4291035,0.0375340234908271,99.3215339985869,0
528.61,536,8,36,11056,26604,2024-05-16,2024-05-24,529.78,28,15548,11385857,-4974638,0.233658300820044,97.5622124887042,0.584423394978199
274.81,275,1398,1398,26562,26562,2024-05-16,2024-09-20,529.78,0,0,207805543,-46765032,0.0127821421972368,99.8912767211412,0
456.92,457,3282,3282,32820,26256,2024-05-16,2024-05-31,529.78,0,-6564.00000000001,27053797,-21589374,0.0970510719807648,97.7604215777918,-0.25
502.78,555,5,5,26110,26110,2024-05-16,2024-09-20,529.78,0,0,207805543,-46765032,0.0125646311561574,99.9038413522973,0
254.58,255,619,619,25998,25998,2024-05-16,2024-12-20,529.78,0,0,392218823,-61081925,0.00662844271499943,99.9658741518379,0
284.81,285,1268,1358,29164,25802,2024-05-16,2024-09-20,529.78,90,-3362,207805543,-46765032,0.0124164156679882,99.9162577679653,-0.130299976745989
529.22,615,3,3,28203,25734,2024-05-16,2024-08-16,529.78,0,-2469,85913959,-15086717,0.0299532233172959,99.5919498948943,-0.095943110282117
219.92,220,3194,3194,25552,25552,2024-05-16,2024-09-20,529.78,0,0,207805543,-46765032,0.0122961108886301,99.928553878854,0
529.61,534,24,58,24600,25462,2024-05-16,2024-05-17,529.78,34,861.999999999996,12246418,-21476147,0.207913856933513,94.3507399469788,0.0338543712198569
411.88,412,2101,2117,42020,25404,2024-05-16,2024-06-21,529.78,16,-16616,168672803,-78039132,0.0150611121343611,99.7588888114938,-0.654070225161392
319.97,320,8406,8406,25218,25218,2024-05-16,2024-05-17,529.78,0,0,12246418,-21476147,0.205921437599141,94.5566613845779,0
159.91,160,2777,2777,24993,24993,2024-05-16,2024-12-20,529.78,0,0,392218823,-61081925,0.00637220819970693,99.9722463600376,0
472.99,473,24990,24974,49980,24974,2024-05-16,2024-05-17,529.78,-16,-25006,12246418,-21476147,0.203929018264769,94.7605904028427,-1.00128133258589
446.94,447,1696,4141,11872,24846,2024-05-16,2024-05-31,529.78,2445,12974,27053797,-21589374,0.0918392342487082,97.8522608120405,0.522176607904693
490.98,491,12022,12359,48088,24718,2024-05-16,2024-05-17,529.78,337,-23370,12246418,-21476147,0.201838611094281,94.962429013937,-0.945464843433935
254.92,255,3072,3072,24576,24576,2024-05-16,2024-08-16,529.78,0,0,85913959,-15086717,0.0286053631866738,99.620555258081,0
452.91,453,2714,2714,24426,24426,2024-05-16,2024-05-31,529.78,0,0,27053797,-21589374,0.0902867719455424,97.9425475839861,0
502.99,503,24819,24421,148914,24421,2024-05-16,2024-05-17,529.78,-398,-124493,12246418,-21476147,0.199413412150394,95.1618424260874,-5.09778469350149
526.27,545,7,13,16849,24349,2024-05-16,2024-08-16,529.78,6,7500,85913959,-15086717,0.0283411453545052,99.6488964034354,0.308020863279806
389.88,390,2013,2022,32208,24264,2024-05-16,2024-06-28,529.78,9,-7944,71313964,4291035,0.0340241919520839,99.355558190539,-0.327398615232443
299.86,300,1728,1728,24192,24192,2024-05-16,2024-08-16,529.78,0,0,85913959,-15086717,0.028158404386882,99.6770548078223,0
274.98,275,12052,12052,24104,24104,2024-05-16,2024-06-21,529.78,0,0,168672803,-78039132,0.0142903891862163,99.77317920068,0
194.81,195,1265,1265,24035,24035,2024-05-16,2024-12-20,529.78,0,0,392218823,-61081925,0.00612795679109975,99.9783743168287,0
412.42,414,152,152,24016,24016,2024-05-16,2024-10-18,529.78,0,0,21699053,7078243,0.110677641093369,99.3992410636538,0
491.92,492,2997,2990,38961,23920,2024-05-16,2024-05-24,529.78,-7,-15041,11385857,-4974638,0.210085196046288,97.7722976847505,-0.628804347826087
496.98,497,11937,11760,47748,23520,2024-05-16,2024-05-17,529.78,-177,-24228,12246418,-21476147,0.192056158788635,95.353898584876,-1.03010204081633
402.61,403,600,600,23400,23400,2024-05-16,2024-06-28,529.78,0,0,71313964,4291035,0.0328126480250067,99.388370838564,0
417.83,418,1369,1369,23273,23273,2024-05-16,2024-06-21,529.78,0,0,168672803,-78039132,0.01379771936321,99.7869769200432,0
374.98,375,11589,11589,23178,23178,2024-05-16,2024-05-17,529.78,0,0,12246418,-21476147,0.189263505459311,95.5431620903353,0
527.04,538,11,21,20955,23016,2024-05-16,2024-06-21,529.78,10,2061,168672803,-78039132,0.0136453533649998,99.8006222734082,0.089546402502607
264.9,265,2279,2279,22790,22790,2024-05-16,2024-08-16,529.78,0,0,85913959,-15086717,0.0265265391855589,99.7035813470079,0
404.79,405,1075,1075,22575,22575,2024-05-16,2024-06-28,529.78,0,0,71313964,4291035,0.0316557918446379,99.4200266304086,0
403.75,404,895,895,22375,22375,2024-05-16,2024-06-28,529.78,0,0,71313964,4291035,0.0313753418615182,99.4514019722701,0
389.75,390,877,891,25433,22275,2024-05-16,2024-07-19,529.78,14,-3158,106722520,-20817707,0.0208718834600232,99.8495237931039,-0.141773288439955
431.83,432,1282,1309,28204,22253,2024-05-16,2024-06-21,529.78,27,-5951,168672803,-78039132,0.0131929982808195,99.8138152716891,-0.267424616905586
475.69,476,705,704,31725,21824,2024-05-16,2024-06-14,529.78,-1,-9901,24055258,-5534803,0.0907244478525235,99.4730549138155,-0.453674853372434
524.93,534,17,24,22440,21768,2024-05-16,2024-06-28,529.78,7,-671.999999999996,71313964,4291035,0.0305241761627498,99.4819261484329,-0.0308710033076073
379.6,380,541,544,24345,21760,2024-05-16,2024-08-16,529.78,3,-2585,85913959,-15086717,0.0253276653215341,99.7289090123294,-0.118795955882353
454.82,455,1186,1191,27278,21438,2024-05-16,2024-06-14,529.78,5,-5840,24055258,-5534803,0.0891198090662757,99.5621747228818,-0.272413471405915
425.85,426,1419,1422,26961,21330,2024-05-16,2024-06-21,529.78,3,-5631,168672803,-78039132,0.0126457849876367,99.8264610566767,-0.263994374120956
406.57,407,488,488,20984,20984,2024-05-16,2024-06-28,529.78,0,0,71313964,4291035,0.0294248122289206,99.5113509606618,0
501.98,502,10444,10477,62664,20954,2024-05-16,2024-05-17,529.78,33,-41710,12246418,-21476147,0.171103093165691,95.714265183501,-1.99055073017085
493.69,494,714,671,38556,20801,2024-05-16,2024-06-07,529.78,-43,-17755,14949825,-8379167,0.139138752460313,97.7385487789991,-0.853564732464785
529.22,550,0,10,0,20780,2024-05-16,2024-06-14,529.78,10,20780,24055258,-5534803,0.0863844403581122,99.6485591632399,1
254.88,255,1711,1711,27376,20532,2024-05-16,2024-09-20,529.78,0,-6844,207805543,-46765032,0.00988039091912,99.9384342697731,-0.333333333333333
475.91,476,2281,2278,31934,20502,2024-05-16,2024-05-31,529.78,-3,-11432,27053797,-21589374,0.0757823384273934,98.0183299224135,-0.557604136181836
404.75,406,163,164,24124,20500,2024-05-16,2024-10-18,529.78,1,-3624,21699053,7078243,0.0944741689879277,99.4937152326417,-0.176780487804878
527.51,533,24,37,24888,20313,2024-05-16,2024-05-31,529.78,13,-4575,27053797,-21589374,0.0750837303909688,98.0934136528045,-0.225225225225225
487.94,488,3397,3382,33970,20292,2024-05-16,2024-05-24,529.78,-15,-13678,11385857,-4974638,0.178221103602478,97.950518788353,-0.674058742361522
469.76,470,847,845,29645,20280,2024-05-16,2024-06-14,529.78,-2,-9365,24055258,-5534803,0.084305892707532,99.7328650559474,-0.461785009861933
426.85,427,1329,1326,26580,19890,2024-05-16,2024-06-21,529.78,-3,-6690,168672803,-78039132,0.0117920611066148,99.8382531177833,-0.336349924585219
498.92,499,2550,2482,53550,19856,2024-05-16,2024-05-24,529.78,-68,-33694,11385857,-4974638,0.174391791500631,98.1249105798536,-1.69691780821918
502.05,502.5,397,439,49228,19755,2024-05-16,2024-06-07,529.78,42,-29473,14949825,-8379167,0.13214201504031,97.8706907940394,-1.49192609465958
439.99,440,19576,19559,19576,19559,2024-05-16,2024-05-17,529.78,-17,-17,12246418,-21476147,0.159712007217131,95.8739771907181,-0.000869165090239787
279.98,280,9555,9555,19110,19110,2024-05-16,2024-06-21,529.78,0,0,168672803,-78039132,0.0113296273377279,99.849582745121,0
179.88,180,1586,1584,22204,19008,2024-05-16,2024-12-20,529.78,-2,-3196,392218823,-61081925,0.00484627429520383,99.983220591124,-0.168139730639731
481.99,482,18920,18909,37840,18909,2024-05-16,2024-05-17,529.78,-11,-18931,12246418,-21476147,0.154404332760812,96.0283815234789,-1.00116346713205
401.81,402,988,988,18772,18772,2024-05-16,2024-06-28,529.78,0,0,71313964,4291035,0.0263230354156165,99.5376739960774,0
344.85,345,1251,1251,20016,18765,2024-05-16,2024-07-19,529.78,0,-1251,106722520,-20817707,0.0175829806117772,99.8671067737156,-0.0666666666666667
259.96,260,4669,4669,18676,18676,2024-05-16,2024-07-19,529.78,0,0,106722520,-20817707,0.0174995867788729,99.8846063604945,0
471.9,472,1856,1856,20416,18560,2024-05-16,2024-05-31,529.78,0,-1856,27053797,-21589374,0.0686040484446601,98.1620177012491,-0.0999999999999998
304.97,305,6178,6175,18534,18525,2024-05-16,2024-06-21,529.78,-3,-9,168672803,-78039132,0.0109828020110628,99.8605655471321,-0.00048582995951417
382.88,384,164,164,18368,18368,2024-05-16,2024-10-18,529.78,0,0,21699053,7078243,0.0846488554131832,99.5783640880549,0
526.83,537,3,18,4893,18306,2024-05-16,2024-06-21,529.78,15,13413,168672803,-78039132,0.0108529648374907,99.8714185119696,0.732710586692888
424.96,425,4480,4479,26880,17916,2024-05-16,2024-05-31,529.78,-1,-8964,27053797,-21589374,0.0662236062464725,98.2282413074956,-0.500334896182184
506.86,507,1307,1276,62736,17864,2024-05-16,2024-05-24,529.78,-31,-44872,11385857,-4974638,0.156896402264669,98.2818069821183,-2.51186744290193
404.95,405,3454,3533,24178,17665,2024-05-16,2024-06-07,529.78,79,-6513,14949825,-8379167,0.118161918283324,97.9888527123227,-0.368695159920748
528.2,538,2,18,5324,17640,2024-05-16,2024-05-31,529.78,16,12316,27053797,-21589374,0.0652034167329636,98.2934447242286,0.698185941043084
294.92,295,2205,2205,17640,17640,2024-05-16,2024-07-19,529.78,0,0,106722520,-20817707,0.0165288450834932,99.901135205578,0
505.99,506,17690,17586,159210,17586,2024-05-16,2024-05-17,529.78,-104,-141624,12246418,-21476147,0.143601173828951,96.1719826973079,-8.0532241555783
518.51,536,10,10,17490,17490,2024-05-16,2024-07-19,529.78,0,0,106722520,-20817707,0.016388293679722,99.9175234992577,0
475.99,476,17241,17240,34482,17240,2024-05-16,2024-05-17,529.78,-1,-17242,12246418,-21476147,0.140775857887588,96.3127585551955,-1.00011600928074
469.87,470,1275,1325,22950,17225,2024-05-16,2024-06-07,529.78,50,-5725,14949825,-8379167,0.115218740018696,98.1040714523414,-0.332365747460087
408.75,409,688,688,17200,17200,2024-05-16,2024-06-28,529.78,0,0,71313964,4291035,0.0241186985482955,99.5617926946257,0
284.9,285,901,1720,11713,17200,2024-05-16,2024-08-16,529.78,819,5487,85913959,-15086717,0.0200200295740067,99.7489290419034,0.319011627906977
455.99,456,17006,17001,34012,17001,2024-05-16,2024-05-17,529.78,-5,-17011,12246418,-21476147,0.138824266818265,96.4515828220138,-1.00058820069408
400.8,401,845,845,16900,16900,2024-05-16,2024-06-28,529.78,0,0,71313964,4291035,0.023698023573616,99.5854907181993,0
432.71,433,579,579,16791,16791,2024-05-16,2024-06-28,529.78,0,0,71313964,4291035,0.0235451783328157,99.6090358965321,0
487.76,488,606,698,23634,16752,2024-05-16,2024-06-07,529.78,92,-6882,14949825,-8379167,0.11205482338422,98.2161262757256,-0.410816618911175
204.79,205,795,795,16695,16695,2024-05-16,2024-12-20,529.78,0,0,392218823,-61081925,0.00425655247045601,99.9874771435944,0
304.86,305,1192,1192,21456,16688,2024-05-16,2024-08-16,529.78,0,-4768,85913959,-15086717,0.0194240845076177,99.7683531264111,-0.285714285714285
497.17,497.5,498,501,33366,16533,2024-05-16,2024-06-07,529.78,3,-16833,14949825,-8379167,0.110589923293416,98.3267161990191,-1.01814552712756
309.97,310,5482,5482,21928,16446,2024-05-16,2024-06-21,529.78,0,-5482,168672803,-78039132,0.00975023815783746,99.8811687501274,-0.333333333333333
434.92,435,2040,2049,20400,16392,2024-05-16,2024-06-07,529.78,9,-4008,14949825,-8379167,0.109646768440433,98.4363629674595,-0.244509516837482
477.9,478,1644,1635,21372,16350,2024-05-16,2024-05-31,529.78,-9,-5022,27053797,-21589374,0.0604351396589544,98.3538798638875,-0.307155963302752
482.99,483,16271,16269,48813,16269,2024-05-16,2024-05-17,529.78,-2,-32544,12246418,-21476147,0.132847008815149,96.5844298308289,-2.00036879955744
495.67,496,488,489,29768,16137,2024-05-16,2024-06-07,529.78,1,-13631,14949825,-8379167,0.107941062855251,98.5443040303147,-0.84470471587036
422.8,423,802,802,21654,16040,2024-05-16,2024-06-28,529.78,0,-5614,71313964,4291035,0.0224920886462012,99.6315279851783,-0.35
239.9,240,1586,1594,15860,15940,2024-05-16,2024-09-20,529.78,8,79.9999999999982,207805543,-46765032,0.00767063273187087,99.9461049025049,0.00501882057716425
400.66,402,117,117,15678,15678,2024-05-16,2024-10-18,529.78,0,0,21699053,7078243,0.0722520010435478,99.6506160890985,0
433.61,434,401,401,15639,15639,2024-05-16,2024-06-28,529.78,0,0,71313964,4291035,0.0219297864300462,99.6534577716084,0
492.2,492.5,483,519,23667,15570,2024-05-16,2024-06-07,529.78,36,-8097,14949825,-8379167,0.104148376318786,98.6484524066335,-0.520038535645472
314.97,315,5135,5135,20540,15405,2024-05-16,2024-06-21,529.78,0,-5135,168672803,-78039132,0.00913306693551538,99.890301817063,-0.333333333333334
529.22,560,5,5,19400,15390,2024-05-16,2024-05-17,529.78,0,-4010,12246418,-21476147,0.125669399819604,96.7100992306485,-0.260558804418454
484.95,485,3081,3057,30810,15285,2024-05-16,2024-05-24,529.78,-24,-15525,11385857,-4974638,0.134245494212689,98.416052476331,-1.01570166830226
492.99,493,15280,15255,45840,15255,2024-05-16,2024-05-17,529.78,-25,-30585,12246418,-21476147,0.124567036663292,96.8346662673118,-2.00491642084562
464.89,465,1434,1371,24378,15081,2024-05-16,2024-06-07,529.78,-63,-9297,14949825,-8379167,0.100877435020142,98.7493298416537,-0.616471056296002
406.95,407,3005,3005,15025,15025,2024-05-16,2024-05-31,529.78,0,0,27053797,-21589374,0.055537490726348,98.4094173546139,0
445.94,446,169,2504,1690,15024,2024-05-16,2024-05-31,529.78,2335,13334,27053797,-21589374,0.0555337943875309,98.4649511490014,0.887513312034079
525.75,600,2,2,18864,14850,2024-05-16,2024-12-20,529.78,0,-4014,392218823,-61081925,0.00378615179312799,99.9912632953875,-0.27030303030303
482.89,483,1410,1343,22560,14773,2024-05-16,2024-05-31,529.78,-67,-7787,27053797,-21589374,0.0546060133444485,98.5195571623458,-0.527110268733501
279.88,280,1228,1228,14736,14736,2024-05-16,2024-08-16,529.78,0,0,85913959,-15086717,0.0171520439420095,99.7855051703531,0
329.8,330,734,736,18350,14720,2024-05-16,2024-08-16,529.78,2,-3630,85913959,-15086717,0.0171334206586848,99.8026385910117,-0.246603260869565
528.77,545,0,9,0,14607,2024-05-16,2024-06-21,529.78,9,14607,168672803,-78039132,0.00865996161811575,99.8989617786811,1
289.98,290,7289,7289,21867,14578,2024-05-16,2024-06-21,529.78,0,-7289,168672803,-78039132,0.00864276856773406,99.9076045472488,-0.5
528.9,538,0,16,0,14560,2024-05-16,2024-05-24,529.78,16,14560,11385857,-4974638,0.12787794541948,98.5439304217504,1
451.94,452,2326,2416,16282,14496,2024-05-16,2024-05-31,529.78,90,-1786,27053797,-21589374,0.0535821274921225,98.573139289838,-0.123206401766005
294.78,295,656,653,15088,14366,2024-05-16,2024-09-20,529.78,-3,-722,207805543,-46765032,0.00691319384103243,99.953018096346,-0.0502575525546429
450.94,451,2328,2388,18624,14328,2024-05-16,2024-05-31,529.78,60,-4296,27053797,-21589374,0.0529611425708561,98.6261004324088,-0.299832495812395
485.88,486,1164,1161,20952,13932,2024-05-16,2024-05-31,529.78,-3,-7020,27053797,-21589374,0.0514973923992998,98.6775978248081,-0.503875968992248
294.84,295,863,863,13808,13808,2024-05-16,2024-08-16,529.78,0,0,85913959,-15086717,0.0160718935091793,99.8187104845209,0
484.8,485,775,681,25575,13620,2024-05-16,2024-06-07,529.78,-94,-11955,14949825,-8379167,0.0911047453732736,98.8404345870269,-0.877753303964757
329.99,330,13598,13598,13598,13598,2024-05-16,2024-05-17,529.78,0,0,12246418,-21476147,0.111036549626185,96.945702816938,0
299.97,300,4413,4522,13239,13566,2024-05-16,2024-06-28,529.78,109,327.000000000002,71313964,4291035,0.0190229223550103,99.6724806939634,0.0241043785935428
459.9,460,1500,1340,21000,13400,2024-05-16,2024-06-07,529.78,-160,-7600,14949825,-8379167,0.0896331562409593,98.9300677432679,-0.567164179104478
450.99,451,13394,13394,13394,13394,2024-05-16,2024-05-17,529.78,0,0,12246418,-21476147,0.109370756412202,97.0550735733502,0
492.74,493,518,513,26418,13338,2024-05-16,2024-06-07,529.78,-5,-13080,14949825,-8379167,0.0892184356673072,99.0192861789352,-0.980656770130454
249.99,250,13297,13297,13297,13297,2024-05-16,2024-05-17,529.78,0,0,12246418,-21476147,0.108578688070259,97.1636522614205,0
199.98,200,6695,6646,20085,13292,2024-05-16,2024-08-16,529.78,-49,-6793,85913959,-15086717,0.0154712926219591,99.8341817771429,-0.511059283779717
473.99,474,13298,13279,26596,13279,2024-05-16,2024-05-17,529.78,-19,-13317,12246418,-21476147,0.108431706316084,97.2720839677365,-1.00286166126967
525.94,537,9,12,15228,13272,2024-05-16,2024-06-28,529.78,3,-1956,71313964,4291035,0.0186106608798243,99.6910913548432,-0.147377938517179
279.95,280,2562,2563,15372,12815,2024-05-16,2024-07-19,529.78,1,-2557,106722520,-20817707,0.0120077749288529,99.9295312741866,-0.19953179867343
324.93,325,1827,1827,12789,12789,2024-05-16,2024-06-28,529.78,0,0,71313964,4291035,0.0179333741705902,99.7090247290138,0
404.99,405,12559,12709,25118,12709,2024-05-16,2024-05-24,529.78,150,-12409,11385857,-4974638,0.111620934638473,98.6555513563889,-0.976394680934771
259.99,260,12443,12444,12443,12444,2024-05-16,2024-06-21,529.78,1,1,168672803,-78039132,0.00737759720516413,99.914982144454,8.03600128576021e-05
441.94,442,2013,2071,12078,12426,2024-05-16,2024-05-31,529.78,58,348,27053797,-21589374,0.0459307061408053,98.7235285309489,0.0280057943022694
453.93,454,1777,1772,15993,12404,2024-05-16,2024-05-31,529.78,-5,-3589,27053797,-21589374,0.04584938668683,98.7693779176357,-0.289342147694292
524.6,540,8,8,15800,12320,2024-05-16,2024-06-28,529.78,0,-3480,71313964,4291035,0.0172757189601745,99.726300447974,-0.282467532467533
486.94,487,2058,2043,18522,12258,2024-05-16,2024-05-24,529.78,-15,-6264,11385857,-4974638,0.107659880147801,98.7632112365367,-0.511013215859031
374.64,375,310,340,13020,12240,2024-05-16,2024-08-16,529.78,30,-779.999999999998,85913959,-15086717,0.0142468117433629,99.8484285888862,-0.0637254901960783
430.96,431,3054,3054,30540,12216,2024-05-16,2024-05-31,529.78,0,-18324,27053797,-21589374,0.0451544749892224,98.814532392625,-1.5
154.98,155,6058,6057,18174,12114,2024-05-16,2024-09-20,529.78,-1,-6060,207805543,-46765032,0.00582948838857489,99.9588475847345,-0.500247647350173
463.92,464,1511,1514,15110,12112,2024-05-16,2024-05-31,529.78,3,-2998,27053797,-21589374,0.044770055752248,98.8593024483772,-0.247523117569353
344.7,345,403,403,12090,12090,2024-05-16,2024-08-16,529.78,0,0,85913959,-15086717,0.0140722184621943,99.8625008073484,0
234.9,235,1207,1207,12070,12070,2024-05-16,2024-09-20,529.78,0,0,207805543,-46765032,0.00580831474740787,99.964655899482,0
369.66,370,352,354,13376,12036,2024-05-16,2024-08-16,529.78,2,-1340,85913959,-15086717,0.0140093648809735,99.8765101722294,-0.111332668660684
149.99,150,11989,12016,23978,12016,2024-05-16,2024-09-20,529.78,27,-11962,207805543,-46765032,0.00578232891506652,99.970438228397,-0.995505992010652
528.53,536,1,16,1288,11952,2024-05-16,2024-05-31,529.78,15,10664,27053797,-21589374,0.0441786415415182,98.9034810899187,0.892235609103079
339.94,340,1960,1957,13720,11742,2024-05-16,2024-06-28,529.78,-3,-1978,71313964,4291035,0.0164652185089585,99.7427656664829,-0.168455118378471
389.93,390,1521,1668,12168,11676,2024-05-16,2024-06-14,529.78,147,-492,24055258,-5534803,0.0485382447363483,99.7814033006838,-0.0421377183967112
491.7,492,393,389,18864,11670,2024-05-16,2024-06-07,529.78,-4,-7194,14949825,-8379167,0.0780611144277608,99.097347293363,-0.616452442159383
526.73,550,5,5,15020,11635,2024-05-16,2024-06-07,529.78,0,-3385,14949825,-8379167,0.0778269979748927,99.1751742913379,-0.290932531155995
229.93,230,1654,1657,16540,11599,2024-05-16,2024-09-20,529.78,3,-4941,207805543,-46765032,0.00558166054309726,99.9760198889401,-0.425984998706785
309.99,310,11522,11522,11522,11522,2024-05-16,2024-05-17,529.78,0,0,12246418,-21476147,0.094084653978004,97.3661686217145,0
477.83,478,683,675,16392,11475,2024-05-16,2024-06-07,529.78,-8,-4917,14949825,-8379167,0.0767567513332096,99.2519310426711,-0.428496732026144
524.87,539,8,8,14792,11304,2024-05-16,2024-06-28,529.78,0,-3488,71313964,4291035,0.0158510330459263,99.7586166995289,-0.308563340410474
464.97,465,3836,3766,19180,11298,2024-05-16,2024-05-24,529.78,-70,-7882,11385857,-4974638,0.099228367263,98.8624396037997,-0.697645600991326
527.19,555,0,4,0,11124,2024-05-16,2024-10-18,529.78,4,11124,21699053,7078243,0.0512649100400833,99.7018809991386,1
453.6,454,278,278,12232,11120,2024-05-16,2024-06-28,529.78,0,-1112,71313964,4291035,0.0155930190614562,99.7742097185903,-0.1
405.96,406,2775,2775,11100,11100,2024-05-16,2024-05-31,529.78,0,0,27053797,-21589374,0.0410293608693819,98.9445104507881,0
421.8,422,422,552,12660,11040,2024-05-16,2024-06-28,529.78,130,-1620,71313964,4291035,0.0154808390682083,99.7896905576585,-0.146739130434783
229.99,230,10966,10965,10966,10965,2024-05-16,2024-06-21,529.78,-1,-1,168672803,-78039132,0.0065007516356979,99.9214828960897,-9.11992704058368e-05
467.91,468,1210,1205,12100,10845,2024-05-16,2024-05-31,529.78,-5,-1255,27053797,-21589374,0.0400867944710312,98.9845972452591,-0.11572153065929
476.99,477,10848,10836,32544,10836,2024-05-16,2024-05-17,529.78,-12,-21708,12246418,-21476147,0.0884830160133355,97.4546516377279,-2.00332225913621
438.91,439,1203,1203,10827,10827,2024-05-16,2024-05-31,529.78,0,0,27053797,-21589374,0.0400202603723241,99.0246175056315,0
274.99,275,10798,10798,10798,10798,2024-05-16,2024-05-17,529.78,0,0,12246418,-21476147,0.0881727211989661,97.5428243589268,0
455.65,456,252,303,12852,10605,2024-05-16,2024-06-28,529.78,51,-2247,71313964,4291035,0.0148708603549229,99.8045614180135,-0.211881188118812
529.16,635,1,1,11751,10584,2024-05-16,2024-07-19,529.78,0,-1167,106722520,-20817707,0.00991730705009589,99.9394485812367,-0.110260770975057
447.94,448,1810,1762,12670,10572,2024-05-16,2024-05-31,529.78,-48,-2098,27053797,-21589374,0.0390776939739734,99.0636951996054,-0.198448732500946
259.99,260,10444,10444,10444,10444,2024-05-16,2024-05-17,529.78,0,0,12246418,-21476147,0.0852820800335249,97.6281064389604,0
354.98,355,5063,5214,15189,10428,2024-05-16,2024-06-07,529.78,151,-4761,14949825,-8379167,0.0697533248716958,99.3216843675428,-0.456559263521289
478.99,479,10506,10380,31518,10380,2024-05-16,2024-05-17,529.78,-126,-21138,12246418,-21476147,0.0847594782409028,97.7128659172013,-2.0364161849711
294.98,295,5178,5177,15534,10354,2024-05-16,2024-06-21,529.78,-1,-5180,168672803,-78039132,0.00613851185006987,99.9276214079397,-0.500289743094456
426.79,427,492,493,12792,10353,2024-05-16,2024-06-28,529.78,1,-2439,71313964,4291035,0.0145174933761921,99.8190789113896,-0.235583888727905
472.92,473,1301,1294,15612,10352,2024-05-16,2024-05-31,529.78,-7,-5260,27053797,-21589374,0.0382644994342199,99.1019596990397,-0.508114374034003
174.97,175,3386,3413,13544,10239,2024-05-16,2024-09-20,529.78,27,-3305,207805543,-46765032,0.00492720254338933,99.9809470914835,-0.322785428264479
498.99,499,10353,10199,51765,10199,2024-05-16,2024-05-17,529.78,-154,-41566,12246418,-21476147,0.0832814950461433,97.7961474122474,-4.07549759780371
529.06,580,2,2,11280,10188,2024-05-16,2024-05-17,529.78,0,-1092,12246418,-21476147,0.0831916728630364,97.8793390851104,-0.10718492343934
467.99,468,10052,10183,20104,10183,2024-05-16,2024-05-17,529.78,131,-9921,12246418,-21476147,0.0831508445979877,97.9624899297084,-0.974270843562801
339.7,340,339,339,10170,10170,2024-05-16,2024-08-16,529.78,0,0,85913959,-15086717,0.0118374244632354,99.8883475966927,0
239.99,240,10119,10119,10119,10119,2024-05-16,2024-05-17,529.78,0,0,12246418,-21476147,0.0826282428053656,98.0451181725138,0
466.92,467,1243,1241,14916,9928,2024-05-16,2024-05-31,529.78,-2,-4988,27053797,-21589374,0.0366972517757859,99.1386569508155,-0.502417405318292
415.87,416,752,762,12032,9906,2024-05-16,2024-06-21,529.78,10,-2126,168672803,-78039132,0.00587290886486306,99.9334943168046,-0.214617403593782
374,375,99,99,9900,9900,2024-05-16,2024-10-18,529.78,0,0,21699053,7078243,0.0456241108770968,99.7475051100156,0
455.93,456,1413,1413,12717,9891,2024-05-16,2024-05-31,529.78,0,-2826,27053797,-21589374,0.0365604872395546,99.175217438055,-0.285714285714286
520.65,570,2,2,9870,9870,2024-05-16,2024-12-20,529.78,0,0,392218823,-61081925,0.00251645240391739,99.9937797477915,0
204.98,205,4921,4921,9842,9842,2024-05-16,2024-06-21,529.78,0,0,168672803,-78039132,0.00583496558126208,99.9393292823859,0
424.99,425,9768,9763,9768,9763,2024-05-16,2024-05-17,529.78,-5,-5,12246418,-21476147,0.079721270333905,98.1248394428477,-0.000512137662603708
481.8,482,501,488,14529,9760,2024-05-16,2024-06-07,529.78,-13,-4769,14949825,-8379167,0.0652850451426689,99.3869694126854,-0.488627049180328
480.65,481,268,278,17152,9730,2024-05-16,2024-06-14,529.78,10,-7422,24055258,-5534803,0.0404485372802902,99.8218518379641,-0.762795477903392
259.92,260,1195,1195,9560,9560,2024-05-16,2024-08-16,529.78,0,0,85913959,-15086717,0.0111274117864828,99.8994750084791,0
525.47,536,2,9,2960,9477,2024-05-16,2024-06-28,529.78,7,6517,71313964,4291035,0.0132891224501277,99.8323680338398,0.687664872850058
454.91,455,1077,1050,16155,9450,2024-05-16,2024-06-07,529.78,-27,-6705,14949825,-8379167,0.0632114422744079,99.4501808549598,-0.709523809523809
319.83,320,554,554,10526,9418,2024-05-16,2024-08-16,529.78,0,-1108,85913959,-15086717,0.0109621301469765,99.9104371386261,-0.117647058823529
284.98,285,4933,4706,14799,9412,2024-05-16,2024-06-21,529.78,-227,-5387,168672803,-78039132,0.00558003414456805,99.9449093165304,-0.572354441138971
249.97,250,3117,3122,9351,9366,2024-05-16,2024-07-19,529.78,5,15,106722520,-20817707,0.00877602965147375,99.9482246108881,0.00160153747597694
407.97,408,3105,3105,15525,9315,2024-05-16,2024-05-31,529.78,0,-6210,27053797,-21589374,0.0344313960809272,99.2096488341359,-0.666666666666667
429.96,430,2326,2322,13956,9288,2024-05-16,2024-05-31,529.78,-4,-4668,27053797,-21589374,0.0343315949328665,99.2439804290688,-0.502583979328165
470.92,471,1160,1158,12760,9264,2024-05-16,2024-05-31,529.78,-2,-3496,27053797,-21589374,0.0342428828012571,99.2782233118701,-0.377374784110535
477.99,478,9175,9159,18350,9159,2024-05-16,2024-05-17,529.78,-16,-9191,12246418,-21476147,0.0747892159160336,98.1996286587637,-1.00349383120428
459.81,460,425,481,10625,9139,2024-05-16,2024-06-14,529.78,56,-1486,24055258,-5534803,0.0379916939573045,99.8598435319214,-0.162599846810373
457.99,458,9129,9129,9129,9129,2024-05-16,2024-05-17,529.78,0,0,12246418,-21476147,0.0745442463257419,98.2741729050895,0
529.17,620,1,1,10253,9083,2024-05-16,2024-12-20,529.78,0,-1170,392218823,-61081925,0.00231579910686744,99.9960955468983,-0.128812066497853
209.79,210,438,432,9636,9072,2024-05-16,2024-12-20,529.78,-6,-564,392218823,-61081925,0.00231299454998365,99.9984085414483,-0.0621693121693122
354.9,355,902,902,9020,9020,2024-05-16,2024-06-28,529.78,0,0,71313964,4291035,0.0126482942386992,99.8450163280785,0
500.98,501,4584,4504,27504,9008,2024-05-16,2024-05-17,529.78,-80,-18496,12246418,-21476147,0.0735562023115657,98.347729107401,-2.05328596802842
468.99,469,8911,8915,17822,8915,2024-05-16,2024-05-17,529.78,4,-8907,12246418,-21476147,0.0727967965816617,98.4205259039827,-0.99910263600673
453.99,454,8844,8844,8844,8844,2024-05-16,2024-05-17,529.78,0,0,12246418,-21476147,0.0722170352179715,98.4927429392007,0
490.95,491,1053,1768,12636,8840,2024-05-16,2024-05-24,529.78,715,-3796,11385857,-4974638,0.0776401811475412,98.9400797849473,-0.429411764705882
428.77,429,372,382,11160,8786,2024-05-16,2024-06-28,529.78,10,-2374,71313964,4291035,0.0123201677584491,99.8573364958369,-0.27020259503756
437.95,440,38,42,8740,8610,2024-05-16,2024-10-18,529.78,4,-130,21699053,7078243,0.0396791509749297,99.7871842609906,-0.0150987224157956
324.8,325,428,430,12412,8600,2024-05-16,2024-08-16,529.78,2,-3812,85913959,-15086717,0.0100100147870034,99.9204471534131,-0.443255813953488
416.91,417,954,954,8586,8586,2024-05-16,2024-05-31,529.78,0,0,27053797,-21589374,0.0317367650832894,99.3099600769533,0
485.77,486,386,367,13510,8441,2024-05-16,2024-06-07,529.78,-19,-5069,14949825,-8379167,0.0564621993902939,99.5066430543501,-0.600521265252932
486.77,487,366,367,13176,8441,2024-05-16,2024-06-07,529.78,1,-4735,14949825,-8379167,0.0564621993902939,99.5631052537404,-0.560952493780358
364.9,365,837,841,8370,8410,2024-05-16,2024-06-28,529.78,4,40,71313964,4291035,0.011792921790184,99.8691294176271,0.00475624256837099
469.96,470,2391,2094,14346,8376,2024-05-16,2024-05-24,529.78,-297,-5970,11385857,-4974638,0.0735649499198875,99.0136447348671,-0.712750716332378
430.77,431,422,363,11816,8349,2024-05-16,2024-06-28,529.78,-59,-3467,71313964,4291035,0.0117073845453325,99.8808368021724,-0.415259312492514
468.92,469,1181,1041,11810,8328,2024-05-16,2024-05-31,529.78,-140,-3482,27053797,-21589374,0.0307831096684876,99.3407431866218,-0.418107588856868
407.75,408,331,331,8275,8275,2024-05-16,2024-06-28,529.78,0,0,71313964,4291035,0.0116036180515782,99.892440420224,0
456.99,457,8271,8271,16542,8271,2024-05-16,2024-05-17,529.78,0,-8271,12246418,-21476147,0.0675381160434014,98.5602810552441,-1
482.96,483,1108,2065,9972,8260,2024-05-16,2024-05-24,529.78,957,-1712,11385857,-4974638,0.072546142112974,99.0861908769801,-0.20726392251816
399.93,400,1073,1177,10730,8239,2024-05-16,2024-06-14,529.78,104,-2491,24055258,-5534803,0.0342503081862602,99.8940938401076,-0.302342517295788
412.93,413,1156,1156,8092,8092,2024-05-16,2024-05-31,529.78,0,0,27053797,-21589374,0.0299107737076611,99.3706539603295,0
184.95,185,1589,1589,7945,7945,2024-05-16,2024-09-20,529.78,0,0,207805543,-46765032,0.00382328588799963,99.9847703773715,0
319.95,320,1587,1586,7935,7930,2024-05-16,2024-06-28,529.78,-1,-5,71313964,4291035,0.0111198418306967,99.9035602620547,-0.000630517023959647
449.9,450,890,764,9790,7640,2024-05-16,2024-06-07,529.78,-126,-2150,14949825,-8379167,0.0511042771403679,99.6142095308808,-0.281413612565445
444.91,445,855,848,9405,7632,2024-05-16,2024-06-07,529.78,-7,-1773,14949825,-8379167,0.0510507648082837,99.6652602956891,-0.232311320754717
289.9,290,729,761,10206,7610,2024-05-16,2024-08-16,529.78,32,-2596,85913959,-15086717,0.00885769913129018,99.9293048525444,-0.341130091984231
480.93,481,1107,1080,8856,7560,2024-05-16,2024-05-24,529.78,-27,-1296,11385857,-4974638,0.0663981639678067,99.1525890409479,-0.171428571428571
409.99,410,7557,7557,7557,7557,2024-05-16,2024-05-17,529.78,0,0,12246418,-21476147,0.0617078397944607,98.6219888950385,0
264.8,265,50,372,1150,7440,2024-05-16,2024-10-18,529.78,322,6290,21699053,7078243,0.0342872105985455,99.8214714715891,0.845430107526882
506.99,507,7818,7420,78180,7420,2024-05-16,2024-05-17,529.78,-398,-70760,12246418,-21476147,0.060589145332129,98.6825780403707,-9.53638814016172
529.48,548,0,4,0,7408,2024-05-16,2024-06-28,529.78,4,7408,71313964,4291035,0.0103878673747543,99.9139481294295,1
234.99,235,7397,7397,7397,7397,2024-05-16,2024-06-21,529.78,0,0,168672803,-78039132,0.00438541357494367,99.9492947301054,0
483.93,484,1065,1055,8520,7385,2024-05-16,2024-05-24,529.78,-10,-1135,11385857,-4974638,0.0648611694315149,99.2174502103794,-0.153689911983751
423.89,424,665,665,7315,7315,2024-05-16,2024-05-31,529.78,0,0,27053797,-21589374,0.0270387184468044,99.3976926787763,0
420.8,421,167,365,5010,7300,2024-05-16,2024-06-28,529.78,198,2290,71313964,4291035,0.0102364243838696,99.9241845538133,0.313698630136986
428.93,429,1035,1035,7245,7245,2024-05-16,2024-05-31,529.78,0,0,27053797,-21589374,0.02677997472961,99.4244726535059,0
274.89,275,656,656,7216,7216,2024-05-16,2024-08-16,529.78,0,0,85913959,-15086717,0.00839910077942049,99.9377039533238,0
483.79,484,352,343,10912,7203,2024-05-16,2024-06-07,529.78,-9,-3709,14949825,-8379167,0.0481811660002709,99.7134414616894,-0.514924337081772
481.94,482,969,1200,6783,7200,2024-05-16,2024-05-24,529.78,231,416.999999999999,11385857,-4974638,0.0632363466360064,99.2806865570154,0.0579166666666665
324.91,325,786,786,10218,7074,2024-05-16,2024-07-19,529.78,0,-3144,106722520,-20817707,0.00662840420184981,99.95485301509,-0.444444444444445
529.34,600,1,1,7980,7066,2024-05-16,2024-06-21,529.78,0,-914,168672803,-78039132,0.00418917565506989,99.9534839057604,-0.129351825643929
419.97,420,2359,2347,11795,7041,2024-05-16,2024-05-31,529.78,-12,-4754,27053797,-21589374,0.0260259216109295,99.4504985751168,-0.675188183496663
529.73,600,9,1,74142,7027,2024-05-16,2024-07-19,529.78,-8,-67115,106722520,-20817707,0.0065843647620015,99.961437379852,-9.55101750391348
179.99,180,6969,6969,6969,6969,2024-05-16,2024-06-21,529.78,0,0,168672803,-78039132,0.00413166786586217,99.9576155736263,0
264.99,265,6889,6889,6889,6889,2024-05-16,2024-05-17,529.78,0,0,12246418,-21476147,0.0562531835839672,98.7388312239546,0
284.99,285,6889,6889,6889,6889,2024-05-16,2024-05-17,529.78,0,0,12246418,-21476147,0.0562531835839672,98.7950844075386,0
463.99,464,6902,6857,20706,6857,2024-05-16,2024-05-17,529.78,-45,-13849,12246418,-21476147,0.0559918826876561,98.8510762902263,-2.0196879101648
219.99,220,6857,6857,6857,6857,2024-05-16,2024-06-21,529.78,0,0,168672803,-78039132,0.00406526711956047,99.9616808407459,0
443.94,444,1139,1139,9112,6834,2024-05-16,2024-05-31,529.78,0,-2278,27053797,-21589374,0.0252607794757978,99.4757593545926,-0.333333333333333
478.84,479,384,423,9984,6768,2024-05-16,2024-06-07,529.78,39,-3216,14949825,-8379167,0.045271432943195,99.7587128946326,-0.475177304964539
409.97,410,2553,2251,10212,6753,2024-05-16,2024-05-31,529.78,-302,-3459,27053797,-21589374,0.0249613760316158,99.5007207306243,-0.51221679253665
384.57,385,154,157,7238,6751,2024-05-16,2024-08-16,529.78,3,-486.999999999999,85913959,-15086717,0.00785786160779763,99.9455618149316,-0.0721374611168714
279.99,280,6723,6723,6723,6723,2024-05-16,2024-05-17,529.78,0,0,12246418,-21476147,0.0548976851843535,98.9059739754106,0
454.97,455,2251,2241,11255,6723,2024-05-16,2024-05-24,529.78,-10,-4532,11385857,-4974638,0.059046938671371,99.3397334956868,-0.6741038226982
264.98,265,3332,3331,3332,6662,2024-05-16,2024-06-21,529.78,-1,3330,168672803,-78039132,0.00394965867733875,99.9656304994232,0.499849894926449
476.91,477,748,737,10472,6633,2024-05-16,2024-05-31,529.78,-11,-3839,27053797,-21589374,0.0245178153735685,99.5252385459978,-0.5787728026534
269.92,270,829,829,7461,6632,2024-05-16,2024-08-16,529.78,0,-828.999999999999,85913959,-15086717,0.0077193509380705,99.9532811658697,-0.125
249.99,250,6698,6593,13396,6593,2024-05-16,2024-06-21,529.78,-105,-6803,168672803,-78039132,0.00390875107470646,99.9695392504979,-1.03185196420446
496.81,497.5,96,95,12960,6555,2024-05-16,2024-06-14,529.78,-1,-6405,24055258,-5534803,0.0272497596991061,99.9213435998067,-0.977116704805492
462.99,463,6550,6548,13100,6548,2024-05-16,2024-05-17,529.78,-2,-6552,12246418,-21476147,0.0534686959076523,98.9594426713183,-1.00061087354918
309.77,310,284,284,6532,6532,2024-05-16,2024-08-16,529.78,0,0,85913959,-15086717,0.00760295541729139,99.960884121287,0
529.06,550,0,3,0,6282,2024-05-16,2024-05-24,529.78,3,6282,11385857,-4974638,0.0551737124399156,99.3949072081267,1
517.58,580,1,1,6242,6242,2024-05-16,2024-12-20,529.78,0,0,392218823,-61081925,0.0015914585516973,100,0
529.33,550,2,3,6058,6201,2024-05-16,2024-05-17,529.78,1,143.000000000001,12246418,-21476147,0.0506352143132792,99.0100778856315,0.0230607966457024
410.81,411,323,324,7752,6156,2024-05-16,2024-06-28,529.78,1,-1596,71313964,4291035,0.00863225048042485,99.9328168042938,-0.259259259259259
473.9,474,607,607,7891,6070,2024-05-16,2024-05-31,529.78,0,-1821,27053797,-21589374,0.0224367766195629,99.5476753226174,-0.3
239.99,240,6001,6001,6001,6001,2024-05-16,2024-06-21,529.78,0,0,168672803,-78039132,0.00355777570139746,99.9730970261993,0
478.9,479,601,600,7813,6000,2024-05-16,2024-05-31,529.78,-1,-1813,27053797,-21589374,0.0221780329023686,99.5698533555198,-0.302166666666667
530.02,540,0,6,0,5988,2024-05-16,2024-05-24,529.78,6,5988,11385857,-4974638,0.0525915616189453,99.4474987697457,1
459.97,460,2095,1964,12570,5892,2024-05-16,2024-05-24,529.78,-131,-6678,11385857,-4974638,0.0517484103304652,99.4992471800761,-1.13340122199593
434.99,435,5866,5865,5866,5865,2024-05-16,2024-05-17,529.78,-1,-1,12246418,-21476147,0.047891554902013,99.0579694405336,-0.000170502983802217
526.99,585,0,1,0,5801,2024-05-16,2024-05-24,529.78,1,5801,11385857,-4974638,0.0509491731715935,99.5501963532477,1
204.95,205,1155,1155,6930,5775,2024-05-16,2024-09-20,529.78,0,-1155,207805543,-46765032,0.00277904040317154,99.9875494177747,-0.2
284.95,285,1444,1148,8664,5740,2024-05-16,2024-07-19,529.78,-296,-2924,106722520,-20817707,0.0053784337176446,99.9668158135696,-0.509407665505226
199.99,200,5728,5728,5728,5728,2024-05-16,2024-06-21,529.78,0,0,168672803,-78039132,0.00339592388228706,99.9764929500816,0
214.99,215,5552,5552,5552,5552,2024-05-16,2024-06-21,529.78,0,0,168672803,-78039132,0.00329157985238438,99.979784529934,0
524.29,538,4,4,7608,5484,2024-05-16,2024-07-19,529.78,0,-2124,106722520,-20817707,0.00513855932187508,99.9719543728915,-0.387308533916849
324.99,325,5470,5470,5470,5470,2024-05-16,2024-05-17,529.78,0,0,12246418,-21476147,0.0446661219631732,99.1026355624967,0
442.94,443,905,905,5430,5430,2024-05-16,2024-05-31,529.78,0,0,27053797,-21589374,0.0200711197766436,99.5899244752964,0
439.92,440,740,677,7400,5416,2024-05-16,2024-06-07,529.78,-63,-1984,14949825,-8379167,0.0362278488209728,99.7949407434535,-0.366322008862629
414.99,415,5320,5315,5320,5315,2024-05-16,2024-05-17,529.78,-5,-5,12246418,-21476147,0.0434004457466665,99.1460360082434,-0.000940733772342427
529.31,547,0,3,0,5307,2024-05-16,2024-05-17,529.78,3,5307,12246418,-21476147,0.0433351205225887,99.189371128766,1
452.99,453,5270,5269,5270,5269,2024-05-16,2024-05-17,529.78,-1,-1,12246418,-21476147,0.0430248257082193,99.2323959544742,-0.000189789333839438
460.99,461,5193,5261,10386,5261,2024-05-16,2024-05-17,529.78,68,-5125,12246418,-21476147,0.0429595004841416,99.2753554549584,-0.974149401254514
445.69,446,158,166,5846,5146,2024-05-16,2024-06-28,529.78,8,-700,71313964,4291035,0.00721597806567028,99.9400327823594,-0.136027982899339
529.39,555,7,2,22148,5122,2024-05-16,2024-08-16,529.78,-5,-17026,85913959,-15086717,0.00596177857430595,99.9668458998613,-3.32409215150332
364.98,365,2558,2558,5116,5116,2024-05-16,2024-05-31,529.78,0,0,27053797,-21589374,0.0189104693880863,99.6088349446845,0
379.99,380,5107,5107,5107,5107,2024-05-16,2024-05-17,529.78,0,0,12246418,-21476147,0.0417019899206445,99.317057444879,0
319.92,320,633,633,6963,5064,2024-05-16,2024-07-19,529.78,0,-1899,106722520,-20817707,0.00474501539131572,99.9766993882828,-0.375
418.8,419,54,252,1620,5040,2024-05-16,2024-06-28,529.78,198,3420,71313964,4291035,0.00706733957461683,99.947100121934,0.678571428571429
457.93,458,721,717,6489,5019,2024-05-16,2024-05-31,529.78,-4,-1470,27053797,-21589374,0.0185519245228313,99.6273868692073,-0.292887029288703
413.79,414,239,239,5019,5019,2024-05-16,2024-06-28,529.78,0,0,71313964,4291035,0.00703789232638926,99.9541380142604,0
330.51,331,0,102,0,4998,2024-05-16,2024-10-18,529.78,102,4998,21699053,7078243,0.0230332632488616,99.844504734838,1
304.91,305,547,547,4923,4923,2024-05-16,2024-07-19,529.78,0,0,106722520,-20817707,0.00461289707177079,99.9813122853546,0
394.99,395,4900,4900,4900,4900,2024-05-16,2024-05-17,529.78,0,0,12246418,-21476147,0.0400116997476323,99.3570691446266,0
467.95,468,1134,965,5670,4825,2024-05-16,2024-05-24,529.78,-169,-845,11385857,-4974638,0.042377135072046,99.5925734883198,-0.175129533678756
394.97,395,1592,1592,4776,4776,2024-05-16,2024-05-31,529.78,0,0,27053797,-21589374,0.0176537141902854,99.6450405833976,0
465.99,466,4397,4754,8794,4754,2024-05-16,2024-05-17,529.78,357,-4040,12246418,-21476147,0.0388195144082131,99.3958886590348,-0.849810685738326
159.97,160,1579,1579,4737,4737,2024-05-16,2024-09-20,529.78,0,0,207805543,-46765032,0.00227953495927681,99.9898289527339,0
471.99,472,4655,4642,9310,4642,2024-05-16,2024-05-17,529.78,-13,-4668,12246418,-21476147,0.0379049612711243,99.433793620306,-1.00560103403705
529.4,541,0,4,0,4640,2024-05-16,2024-05-24,529.78,4,4640,11385857,-4974638,0.0407523122765375,99.6333258005963,1
314.99,315,4573,4573,4573,4573,2024-05-16,2024-05-17,529.78,0,0,12246418,-21476147,0.0373415312134536,99.4711351515194,0
209.93,210,649,649,4543,4543,2024-05-16,2024-09-20,529.78,0,0,207805543,-46765032,0.00218617845049494,99.9920151311844,0
224.96,225,1121,1129,5605,4516,2024-05-16,2024-08-16,529.78,8,-1089,85913959,-15086717,0.00525642171838455,99.9721023215797,-0.241142604074402
339.99,340,4508,4508,4508,4508,2024-05-16,2024-05-17,529.78,0,0,12246418,-21476147,0.0368107637678217,99.5079459152872,0
475.85,476,233,298,5126,4470,2024-05-16,2024-06-07,529.78,65,-656,14949825,-8379167,0.0299000155520215,99.8248407590055,-0.14675615212528
244.9,245,448,446,4928,4460,2024-05-16,2024-09-20,529.78,-2,-468,207805543,-46765032,0.00214623726374806,99.9941613684482,-0.104932735426009
424.98,425,2303,2215,6909,4430,2024-05-16,2024-05-24,529.78,-88,-2479,11385857,-4974638,0.0389079188329873,99.6722337194293,-0.559593679458239
329.52,330,0,92,0,4416,2024-05-16,2024-10-18,529.78,92,4416,21699053,7078243,0.0203511185488141,99.8648558533868,1
219.95,220,883,883,4415,4415,2024-05-16,2024-08-16,529.78,0,0,85913959,-15086717,0.00513886224239765,99.9772411838221,0
447.99,448,4359,4359,8718,4359,2024-05-16,2024-05-17,529.78,0,-4359,12246418,-21476147,0.0355940814693733,99.5435399967566,-1
485.95,486,866,866,7794,4330,2024-05-16,2024-05-24,529.78,0,-3464,11385857,-4974638,0.0380296362408205,99.7102633556701,-0.8
314.84,315,270,270,5400,4320,2024-05-16,2024-08-16,529.78,0,-1080,85913959,-15086717,0.0050282864976575,99.9822694703197,-0.25
418.2,420,24,24,4320,4320,2024-05-16,2024-10-18,529.78,0,0,21699053,7078243,0.0199087029281877,99.884764556315,0
520.75,542,2,2,4250,4250,2024-05-16,2024-06-21,529.78,0,0,168672803,-78039132,0.00251967117662709,99.9823042011106,0
299.99,300,4228,4228,4228,4228,2024-05-16,2024-05-17,529.78,0,0,12246418,-21476147,0.0345243809250999,99.5780643776817,0
414.94,415,699,700,5592,4200,2024-05-16,2024-06-07,529.78,1,-1392,14949825,-8379167,0.0280939743441813,99.8529347333497,-0.331428571428571
374.99,375,3999,4179,3999,4179,2024-05-16,2024-05-31,529.78,180,180,27053797,-21589374,0.0154469999164997,99.6604875833141,0.0430725053840632
429.98,430,1971,2088,5913,4176,2024-05-16,2024-05-24,529.78,117,-1737,11385857,-4974638,0.0366770810488837,99.746940436719,-0.415948275862069
431.75,432,167,167,5010,4175,2024-05-16,2024-06-28,529.78,0,-835,71313964,4291035,0.00585439339762406,99.9599924076581,-0.2
528.58,570,0,1,0,4142,2024-05-16,2024-08-16,529.78,1,4142,85913959,-15086717,0.00482110247067069,99.9870905727904,1
189.99,190,4141,4141,4141,4141,2024-05-16,2024-06-21,529.78,0,0,168672803,-78039132,0.00245504902174419,99.9847592501323,0
334.95,335,830,828,5810,4140,2024-05-16,2024-06-28,529.78,-2,-1670,71313964,4291035,0.00580531465057811,99.9657977223086,-0.403381642512077
309.9,310,408,408,4080,4080,2024-05-16,2024-07-19,529.78,0,0,106722520,-20817707,0.00382299818257665,99.9851352835372,0
466.98,467,2057,2039,4114,4078,2024-05-16,2024-05-17,529.78,-18,-36,12246418,-21476147,0.0332995329736418,99.6113639106554,-0.00882785679254537
314.92,315,505,505,5050,4040,2024-05-16,2024-07-19,529.78,0,-1010,106722520,-20817707,0.00378551780823766,99.9889208013454,-0.25
444.98,445,2009,2006,8036,4012,2024-05-16,2024-05-24,529.78,-3,-4024,11385857,-4974638,0.0352366975977302,99.7821771343167,-1.00299102691924
424.89,425,360,360,4680,3960,2024-05-16,2024-06-14,529.78,0,-720,24055258,-5534803,0.016462097392595,99.9378056971993,-0.181818181818182
299.99,300,3952,3959,3952,3959,2024-05-16,2024-05-31,529.78,7,7,27053797,-21589374,0.0146338053767462,99.6751213886908,0.00176812326345037
289.93,290,564,564,3948,3948,2024-05-16,2024-07-19,529.78,0,0,106722520,-20817707,0.00369931294725799,99.9926201142927,0
525.51,545,2,2,4758,3898,2024-05-16,2024-06-28,529.78,0,-860.000000000001,71313964,4291035,0.00546597017100326,99.9712636924797,-0.220625962031811
438.97,441,15,19,4980,3857,2024-05-16,2024-10-18,529.78,4,-1123,21699053,7078243,0.017774969257875,99.9025395255729,-0.29115893181229
334.78,335,175,175,4900,3850,2024-05-16,2024-08-16,529.78,0,-1050,85913959,-15086717,0.00448122754999569,99.9915718003404,-0.272727272727273
526.67,565,1,1,5072,3833,2024-05-16,2024-09-20,529.78,0,-1239,207805543,-46765032,0.00184451287711801,99.9960058813253,-0.323245499608662
421.96,422,961,954,7688,3816,2024-05-16,2024-05-31,529.78,-7,-3872,27053797,-21589374,0.0141052289259064,99.6892266176167,-1.0146750524109
451.99,452,3742,3742,3742,3742,2024-05-16,2024-05-17,529.78,0,0,12246418,-21476147,0.0305558735623755,99.6419197842177,0
527.85,537,2,4,2766,3660,2024-05-16,2024-05-17,529.78,2,894,12246418,-21476147,0.0298862900155784,99.6718060742333,0.244262295081967
304.99,305,3644,3644,3644,3644,2024-05-16,2024-05-17,529.78,0,0,12246418,-21476147,0.0297556395674229,99.7015617138007,0
528.87,565,0,1,0,3613,2024-05-16,2024-08-16,529.78,1,3613,85913959,-15086717,0.0042053701657492,99.9957771705061,1
184.99,185,3611,3611,3611,3611,2024-05-16,2024-06-21,529.78,0,0,168672803,-78039132,0.00214083120442363,99.9869000813368,0
461.93,462,516,515,5160,3605,2024-05-16,2024-05-31,529.78,-1,-1555,27053797,-21589374,0.0133253014355065,99.7025519190523,-0.431345353675451
364.99,365,3599,3599,3599,3599,2024-05-16,2024-05-17,529.78,0,0,12246418,-21476147,0.0293881851819855,99.7309498989827,0
448.93,449,512,512,3584,3584,2024-05-16,2024-05-31,529.78,0,0,27053797,-21589374,0.0132476783203482,99.7157995973726,0
519.39,537,2,2,3522,3522,2024-05-16,2024-07-19,529.78,0,0,106722520,-20817707,0.00330014696054778,99.9959202612532,0
410.97,411,1217,1169,3651,3507,2024-05-16,2024-05-31,529.78,-48,-144,27053797,-21589374,0.0129630602314344,99.7287626576041,-0.0410607356715141
526.31,538,10,3,19240,3507,2024-05-16,2024-06-28,529.78,-7,-15733,71313964,4291035,0.00491769045400421,99.9761813829337,-4.48617051611063
359.99,360,3497,3497,3497,3497,2024-05-16,2024-05-17,529.78,0,0,12246418,-21476147,0.0285552885749939,99.7595051875577,0
413.95,414,697,697,3485,3485,2024-05-16,2024-05-31,529.78,0,0,27053797,-21589374,0.0128817407774591,99.7416443983815,0
304.97,305,1158,1149,4632,3447,2024-05-16,2024-06-28,529.78,-9,-1185,71313964,4291035,0.0048335554590683,99.9810149383927,-0.343777197563098
528.93,546,0,2,0,3414,2024-05-16,2024-05-31,529.78,2,3414,27053797,-21589374,0.0126193007214477,99.7542636991029,1
379.95,380,678,678,3390,3390,2024-05-16,2024-06-07,529.78,0,0,14949825,-8379167,0.0226758507206606,99.8756105840704,0
389.98,390,1686,1691,5058,3382,2024-05-16,2024-05-31,529.78,5,-1676,27053797,-21589374,0.0125010178793017,99.7667647169822,-0.495564754583087
349.99,350,3283,3379,3283,3379,2024-05-16,2024-05-31,529.78,96,96,27053797,-21589374,0.0124899288628506,99.7792546458451,0.0284107724178751
432.92,433,419,419,3352,3352,2024-05-16,2024-05-31,529.78,0,0,27053797,-21589374,0.0123901277147899,99.7916447735599,0
476.94,477,511,556,3577,3336,2024-05-16,2024-05-24,529.78,45,-241,11385857,-4974638,0.029299507274683,99.8114766415914,-0.0722422062350121
442.84,445,12,15,3060,3240,2024-05-16,2024-10-18,529.78,3,180,21699053,7078243,0.0149315271961408,99.917471052769,0.0555555555555557
169.98,170,1616,1612,6464,3224,2024-05-16,2024-09-20,529.78,-4,-3240,207805543,-46765032,0.00155145043460174,99.9975573317599,-1.00496277915633
344.99,345,3216,3216,3216,3216,2024-05-16,2024-05-17,529.78,0,0,12246418,-21476147,0.0262607400792624,99.785765927637,0
224.99,225,3208,3209,3208,3209,2024-05-16,2024-06-21,529.78,1,1.00000000000045,168672803,-78039132,0.00190249995430502,99.9888025812911,0.000311623558741182
528.11,560,0,1,0,3189,2024-05-16,2024-06-07,529.78,1,3189,14949825,-8379167,0.0213313533770462,99.8969419374474,1
349.99,350,3102,3102,3102,3102,2024-05-16,2024-05-17,529.78,0,0,12246418,-21476147,0.0253298556361542,99.8110957832731,0
529.18,560,0,1,0,3082,2024-05-16,2024-06-21,529.78,1,3082,168672803,-78039132,0.00182720625090934,99.990629787542,1
440.93,441,436,436,3924,3052,2024-05-16,2024-05-31,529.78,0,-872,27053797,-21589374,0.0112812260696715,99.8029259996296,-0.285714285714286
254.99,255,3009,3009,3009,3009,2024-05-16,2024-05-17,529.78,0,0,12246418,-21476147,0.0245704499062501,99.8356662331794,0
314.94,315,501,501,3006,3006,2024-05-16,2024-06-28,529.78,0,0,71313964,4291035,0.00421516324628933,99.985230101639,0
309.96,310,751,751,3004,3004,2024-05-16,2024-06-28,529.78,0,0,71313964,4291035,0.00421235874645813,99.9894424603855,0
379.98,380,1490,1497,2980,2994,2024-05-16,2024-05-31,529.78,7,14,27053797,-21589374,0.0110668384182819,99.8139928380478,0.00467601870407482
431.95,432,493,593,3451,2965,2024-05-16,2024-05-31,529.78,100,-486.000000000001,27053797,-21589374,0.0109596445925871,99.8249524826404,-0.163912310286678
411.74,412,114,114,2964,2964,2024-05-16,2024-06-28,529.78,0,0,71313964,4291035,0.00415626874983418,99.9935987291353,0
461.99,462,3040,2960,3040,2960,2024-05-16,2024-05-17,529.78,-80,-80,12246418,-21476147,0.0241703329087738,99.8598365660881,-0.027027027027027
425.95,426,575,576,3450,2880,2024-05-16,2024-05-31,529.78,1,-570,27053797,-21589374,0.0106454557931369,99.8355979384336,-0.197916666666667
422.96,423,706,706,3530,2824,2024-05-16,2024-05-31,529.78,0,-706.000000000001,27053797,-21589374,0.0104384608193815,99.8460363992529,-0.25
452.96,453,705,705,2820,2820,2024-05-16,2024-05-24,529.78,0,0,11385857,-4974638,0.0247675690991025,99.8362442106905,0
369.99,370,2740,2740,2740,2740,2024-05-16,2024-05-17,529.78,0,0,12246418,-21476147,0.0223738892466352,99.8822104553348,0
480.81,481,139,137,4587,2603,2024-05-16,2024-06-07,529.78,-2,-1984,14949825,-8379167,0.0174115750518819,99.9143535124993,-0.76219746446408
460.93,461,371,370,3710,2590,2024-05-16,2024-05-31,529.78,-1,-1120,27053797,-21589374,0.0095735175361891,99.8556099167891,-0.432432432432432
529.14,555,0,1,0,2586,2024-05-16,2024-05-31,529.78,1,2586,27053797,-21589374,0.00955873218092085,99.8651686489701,1
528.08,541,1,2,2014,2584,2024-05-16,2024-06-21,529.78,1,570,168672803,-78039132,0.00153196007538927,99.9921617476174,0.220588235294118
424.94,425,432,430,3888,2580,2024-05-16,2024-06-07,529.78,-2,-1308,14949825,-8379167,0.0172577270971399,99.9316112395964,-0.506976744186046
529.2,555,1,1,5327,2580,2024-05-16,2024-06-21,529.78,0,-2747,168672803,-78039132,0.00152958862016421,99.9936913362375,-1.06472868217054
294.99,295,2522,2522,2522,2522,2024-05-16,2024-05-17,529.78,0,0,12246418,-21476147,0.0205937768905161,99.9028042322253,0
519.05,544,1,1,2495,2495,2024-05-16,2024-06-28,529.78,0,0,71313964,4291035,0.00349861353941845,99.9970973426747,0
458.93,459,318,352,2862,2464,2024-05-16,2024-05-31,529.78,34,-398,27053797,-21589374,0.00910777884523936,99.8742764278153,-0.161525974025974
476.84,477,157,150,4553,2400,2024-05-16,2024-06-07,529.78,-7,-2153,14949825,-8379167,0.0160536996252465,99.9476649392217,-0.897083333333333
209.99,210,2348,2348,2348,2348,2024-05-16,2024-06-21,529.78,0,0,168672803,-78039132,0.00139204421711069,99.9950833804547,0
450.96,451,581,581,2324,2324,2024-05-16,2024-05-24,529.78,0,0,11385857,-4974638,0.0204112874419554,99.8566554981325,0
244.99,245,2272,2272,2272,2272,2024-05-16,2024-06-21,529.78,0,0,168672803,-78039132,0.00134698656783453,99.9964303670225,0
434.87,435,170,174,3060,2262,2024-05-16,2024-06-14,529.78,4,-798,24055258,-5534803,0.00940334957122472,99.9472090467706,-0.352785145888594
324.53,325,134,47,7102,2209,2024-05-16,2024-10-18,529.78,-87,-4893,21699053,7078243,0.0101801677704552,99.9276512205395,-2.21502942507922
418.95,419,428,428,2140,2140,2024-05-16,2024-05-31,529.78,0,0,27053797,-21589374,0.00791016506851146,99.8821865928838,0
458.99,459,2103,2102,4206,2102,2024-05-16,2024-05-17,529.78,-1,-2104,12246418,-21476147,0.0171642026264333,99.9199684348517,-1.00095147478592
529.02,550,1,1,2914,2098,2024-05-16,2024-05-31,529.78,0,-816,27053797,-21589374,0.00775491883819488,99.889941511722,-0.388941849380362
440.91,443,7,10,1862,2090,2024-05-16,2024-10-18,529.78,3,228,21699053,7078243,0.00963175674072044,99.9372829772802,0.109090909090909
521.23,542,1,1,2077,2077,2024-05-16,2024-05-24,529.78,0,0,11385857,-4974638,0.0182419294393035,99.8748974275718,0
476.69,477,67,67,3015,2077,2024-05-16,2024-06-14,529.78,0,-938,24055258,-5534803,0.00863428694051006,99.9558433337111,-0.451612903225806
329.95,330,414,414,2484,2070,2024-05-16,2024-06-28,529.78,0,-414,71313964,4291035,0.00290265732528906,100,-0.2
477.69,478,65,66,2990,2046,2024-05-16,2024-06-14,529.78,1,-944,24055258,-5534803,0.00850541698617408,99.9643487506973,-0.4613880742913
528.6,549,0,1,0,2040,2024-05-16,2024-06-21,529.78,1,2040,168672803,-78039132,0.001209442164781,99.9976398091873,1
264.96,265,506,506,2024,2024,2024-05-16,2024-07-19,529.78,0,0,106722520,-20817707,0.00189650694155273,99.9978167681948,0
526.9,547,0,1,0,2010,2024-05-16,2024-05-31,529.78,1,2010,27053797,-21589374,0.00742964102229347,99.8973711527443,1
529.03,539,0,2,0,1994,2024-05-16,2024-05-31,529.78,2,1994,27053797,-21589374,0.00737049960122049,99.9047416523455,1
244.99,245,1951,1951,1951,1951,2024-05-16,2024-05-17,529.78,0,0,12246418,-21476147,0.0159311890219654,99.9358996238737,0
269.96,270,485,475,2425,1900,2024-05-16,2024-07-19,529.78,-10,-525,106722520,-20817707,0.00178031778110187,99.9995970859759,-0.276315789473684
384.98,385,847,879,2541,1758,2024-05-16,2024-05-31,529.78,32,-783,27053797,-21589374,0.00649816364039399,99.9112398159859,-0.445392491467577
369.99,370,1709,1709,1709,1709,2024-05-16,2024-05-31,529.78,0,0,27053797,-21589374,0.00631704303835798,99.9175568590243,0
269.99,270,1700,1700,1700,1700,2024-05-16,2024-05-17,529.78,0,0,12246418,-21476147,0.0138816101165255,99.9497812339902,0
436.95,437,194,340,1164,1700,2024-05-16,2024-05-31,529.78,146,536,27053797,-21589374,0.00628377598900443,99.9238406350133,0.315294117647059
528.26,545,0,1,0,1674,2024-05-16,2024-05-24,529.78,1,1674,11385857,-4974638,0.0147024505928715,99.8895998781646,1
411.97,412,599,556,2396,1668,2024-05-16,2024-05-31,529.78,-43,-728,27053797,-21589374,0.00616549314685846,99.9300061281601,-0.436450839328537
189.96,190,401,409,2005,1636,2024-05-16,2024-09-20,529.78,8,-369,207805543,-46765032,0.000787274476119244,99.998344606236,-0.225550122249389
415.95,416,326,326,1630,1630,2024-05-16,2024-05-31,529.78,0,0,27053797,-21589374,0.00602503227181013,99.9360311604319,0
529.05,545,0,1,0,1595,2024-05-16,2024-06-07,529.78,1,1595,14949825,-8379167,0.0106690212092784,99.958333960431,1
304.99,305,1565,1565,1565,1565,2024-05-16,2024-05-31,529.78,0,0,27053797,-21589374,0.00578477024870113,99.9418159306806,0
239.93,240,222,222,1554,1554,2024-05-16,2024-08-16,529.78,0,0,85913959,-15086717,0.00180878639290735,99.997585956899,0
446.99,447,1551,1551,1551,1551,2024-05-16,2024-05-17,529.78,0,0,12246418,-21476147,0.0126649278180771,99.9624461618083,0
419.89,420,139,139,1668,1529,2024-05-16,2024-06-14,529.78,0,-139,24055258,-5534803,0.00635619871547418,99.9707049494127,-0.0909090909090909
417.96,418,381,380,3810,1520,2024-05-16,2024-05-31,529.78,-1,-2290,27053797,-21589374,0.00561843500193337,99.9474343656826,-1.50657894736842
420.96,421,382,379,9932,1516,2024-05-16,2024-05-31,529.78,-3,-8416,27053797,-21589374,0.00560364964666512,99.9530380153293,-5.55145118733509
433.94,434,249,249,1494,1494,2024-05-16,2024-05-31,529.78,0,0,27053797,-21589374,0.00552233019268977,99.9585603455219,0
194.99,195,1488,1488,1488,1488,2024-05-16,2024-06-21,529.78,0,0,168672803,-78039132,0.000882181343722616,99.998521990531,0
528.12,543,0,1,0,1488,2024-05-16,2024-06-21,529.78,1,1488,168672803,-78039132,0.000882181343722616,99.9994041718747,1
194.96,195,355,368,1775,1472,2024-05-16,2024-09-20,529.78,13,-303,207805543,-46765032,0.000708354540860347,99.9990529607769,-0.205842391304348
528.49,543,0,1,0,1451,2024-05-16,2024-05-24,529.78,1,1451,11385857,-4974638,0.0127438804123396,99.902343758577,1
323.49,324,28,28,1428,1428,2024-05-16,2024-10-18,529.78,0,0,21699053,7078243,0.0065809323568176,99.943863909637,0
529.14,543,1,1,1995,1386,2024-05-16,2024-05-17,529.78,0,-609,12246418,-21476147,0.0113175950714731,99.9737637568798,-0.439393939393939
399.99,400,522,1383,522,1383,2024-05-16,2024-05-24,529.78,861,861,11385857,-4974638,0.0121466482496662,99.9144904068267,0.622559652928417
529.2,536,0,2,0,1360,2024-05-16,2024-05-17,529.78,2,1360,12246418,-21476147,0.0111052880932204,99.984869044973,1
349.97,350,339,453,1695,1359,2024-05-16,2024-06-14,529.78,114,-336,24055258,-5534803,0.00564949251427692,99.976354441927,-0.247240618101545
179.97,180,449,451,1796,1353,2024-05-16,2024-09-20,529.78,2,-443,207805543,-46765032,0.000651089465885903,99.9997040502428,-0.327420546932742
389.96,390,283,333,1415,1332,2024-05-16,2024-06-07,529.78,50,-83,14949825,-8379167,0.00890980329201178,99.967243763723,-0.0623123123123123
379.94,380,208,218,1872,1308,2024-05-16,2024-06-14,529.78,10,-564,24055258,-5534803,0.00543748065391774,99.9817919225809,-0.431192660550459
408.4,410,8,8,1280,1280,2024-05-16,2024-10-18,529.78,0,0,21699053,7078243,0.00589887494168524,99.9497627845787,0
529.31,542,0,1,0,1269,2024-05-16,2024-05-31,529.78,1,1269,27053797,-21589374,0.00469065395885095,99.9632509994808,1
439.48,442,5,5,1260,1260,2024-05-16,2024-10-18,529.78,0,0,21699053,7078243,0.00580670502072141,99.9555694895994,0
408.97,409,414,414,1242,1242,2024-05-16,2024-05-31,529.78,0,0,27053797,-21589374,0.00459085281079029,99.9678418522916,0
380.88,382,11,11,1232,1232,2024-05-16,2024-10-18,529.78,0,0,21699053,7078243,0.00567766713137205,99.9612471567308,0
309.99,310,1220,1220,1220,1220,2024-05-16,2024-05-31,529.78,0,0,27053797,-21589374,0.00450953335681494,99.9723513856484,0
354.95,355,243,243,1215,1215,2024-05-16,2024-06-14,529.78,0,0,24055258,-5534803,0.00505087079090983,99.9868427933718,0
414.99,415,1211,1186,2422,1186,2024-05-16,2024-05-24,529.78,-25,-1236,11385857,-4974638,0.0104164315430977,99.9249068383698,-1.04215851602024
349.98,350,452,575,1356,1150,2024-05-16,2024-06-07,529.78,123,-206,14949825,-8379167,0.00769239773709726,99.9749361614601,-0.179130434782609
409.99,410,1134,1134,2268,1134,2024-05-16,2024-05-24,529.78,0,-1134,11385857,-4974638,0.00995972459517101,99.9348665629649,-1
453.97,454,368,368,1104,1104,2024-05-16,2024-05-24,529.78,0,0,11385857,-4974638,0.00969623981752098,99.9445628027824,0
434.99,435,1081,1093,3243,1093,2024-05-16,2024-05-24,529.78,12,-2150,11385857,-4974638,0.00959962873238264,99.9541624315148,-1.96706312900274
314.98,315,530,530,1060,1060,2024-05-16,2024-05-31,529.78,0,0,27053797,-21589374,0.00391811914608511,99.9762695047945,0
254.99,255,1115,1005,2230,1005,2024-05-16,2024-06-21,529.78,-110,-1225,168672803,-78039132,0.000595828125296525,100,-1.21890547263682
439.98,440,498,499,1494,998,2024-05-16,2024-05-24,529.78,1,-496,11385857,-4974638,0.00876526026982422,99.9629276917847,-0.496993987975952
319.57,320,3,23,147,989,2024-05-16,2024-10-18,529.78,20,842,21699053,7078243,0.00455780259166149,99.9658049593224,0.851365015166835
399.93,400,141,141,987,987,2024-05-16,2024-06-07,529.78,0,0,14949825,-8379167,0.0066020839708826,99.981538245431,0
209.97,210,316,317,1264,951,2024-05-16,2024-08-16,529.78,1,-313,85913959,-15086717,0.00110692140260932,99.9986928783017,-0.329127234490011
339.99,340,949,949,949,949,2024-05-16,2024-05-31,529.78,0,0,27053797,-21589374,0.00350782553739129,99.9797773303319,0
409.42,411,6,6,948,948,2024-05-16,2024-10-18,529.78,0,0,21699053,7078243,0.00436885425368563,99.9701738135761,0
384.94,385,79,151,711,906,2024-05-16,2024-06-14,529.78,72,195,24055258,-5534803,0.00376632834285128,99.9906091217147,0.21523178807947
437.85,438,58,58,870,870,2024-05-16,2024-05-31,529.78,0,0,27053797,-21589374,0.00321581477084344,99.9829931451027,0
448.98,449,426,426,1704,852,2024-05-16,2024-05-24,529.78,0,-852,11385857,-4974638,0.00748296768526076,99.9704106594699,-1
441.87,444,4,4,1152,852,2024-05-16,2024-10-18,529.78,0,-300,21699053,7078243,0.00392643863305924,99.9741002522092,-0.352112676056338
435.94,436,139,138,834,828,2024-05-16,2024-05-31,529.78,-1,-6.00000000000011,27053797,-21589374,0.00306056854052686,99.9860537136432,-0.00724637681159434
334.99,335,827,827,827,827,2024-05-16,2024-05-17,529.78,0,0,12246418,-21476147,0.00675299503903917,99.991622040012,0
426.91,427,91,91,819,819,2024-05-16,2024-05-31,529.78,0,0,27053797,-21589374,0.00302730149117331,99.9890810151344,0
384.99,385,795,795,795,795,2024-05-16,2024-05-17,529.78,0,0,12246418,-21476147,0.0064916941427281,99.9981137341548,0
439.87,440,56,58,952,754,2024-05-16,2024-06-14,529.78,2,-198,24055258,-5534803,0.00313444985707491,99.9937435715718,-0.262599469496021
319.99,320,726,726,726,726,2024-05-16,2024-05-31,529.78,0,0,27053797,-21589374,0.0026835419811866,99.9917645571156,0
394.99,395,641,693,1282,693,2024-05-16,2024-05-24,529.78,52,-589,11385857,-4974638,0.00608649836371562,99.9764971578336,-0.84992784992785
229.95,230,151,137,755,685,2024-05-16,2024-08-16,529.78,-14,-70.0000000000001,85913959,-15086717,0.000797309317336895,99.999490187619,-0.102189781021898
429.72,432,3,3,684,684,2024-05-16,2024-10-18,529.78,0,0,21699053,7078243,0.00315221129696305,99.9772524635061,0
329.99,330,650,650,650,650,2024-05-16,2024-05-31,529.78,0,0,27053797,-21589374,0.00240262023108993,99.9941671773467,0
427.95,428,119,129,1428,645,2024-05-16,2024-05-31,529.78,10,-783,27053797,-21589374,0.00238413853700462,99.9965513158837,-1.21395348837209
457.95,458,127,127,635,635,2024-05-16,2024-05-24,529.78,0,0,11385857,-4974638,0.0055770944602589,99.9820742522939,0
379.1,380,5,7,505,630,2024-05-16,2024-10-18,529.78,2,125,21699053,7078243,0.00290335251036071,99.9801558160165,0.198412698412698
164.97,165,205,205,615,615,2024-05-16,2024-09-20,529.78,0,0,207805543,-46765032,0.000295949757220865,100,0
419.99,420,613,613,1226,613,2024-05-16,2024-05-24,529.78,0,-613,11385857,-4974638,0.00538387228998221,99.9874581245839,-1
374.97,375,150,171,600,513,2024-05-16,2024-06-07,529.78,21,-87,14949825,-8379167,0.00343147829489643,99.9849697237259,-0.169590643274854
314.55,315,10,10,450,450,2024-05-16,2024-10-18,529.78,0,0,21699053,7078243,0.00207382322168622,99.9822296392382,0
274.95,275,91,86,637,430,2024-05-16,2024-07-19,529.78,-5,-207,106722520,-20817707,0.000402914024144108,100,-0.48139534883721
409.92,410,52,51,624,408,2024-05-16,2024-06-14,529.78,-1,-216,24055258,-5534803,0.00169609488287342,99.9954396664546,-0.529411764705882
444.82,445,22,22,396,396,2024-05-16,2024-06-14,529.78,0,0,24055258,-5534803,0.0016462097392595,99.9970858761939,0
359.21,360,5,5,395,395,2024-05-16,2024-10-18,529.78,0,0,21699053,7078243,0.00182035593903568,99.9840499951772,0
429.93,430,64,56,640,392,2024-05-16,2024-06-07,529.78,-8,-248,14949825,-8379167,0.00262210427212359,99.987591827998,-0.63265306122449
409.95,410,77,78,539,390,2024-05-16,2024-06-07,529.78,1,-149,14949825,-8379167,0.00260872618910255,99.9902005541871,-0.382051282051282
369.97,370,30,130,120,390,2024-05-16,2024-06-07,529.78,100,270,14949825,-8379167,0.00260872618910255,99.9928092803762,0.692307692307692
364.96,365,93,93,372,372,2024-05-16,2024-06-07,529.78,0,0,14949825,-8379167,0.0024883234419132,99.9952976038181,0
344.99,345,370,370,370,370,2024-05-16,2024-05-31,529.78,0,0,27053797,-21589374,0.00136764536231273,99.997918961246,0
451.97,452,120,120,480,360,2024-05-16,2024-05-24,529.78,0,-120,11385857,-4974638,0.00316181733180032,99.9906199419157,-0.333333333333334
416.27,418,2,2,346,346,2024-05-16,2024-10-18,529.78,0,0,21699053,7078243,0.00159453963267429,99.9856445348099,0
324.99,325,334,334,334,334,2024-05-16,2024-05-31,529.78,0,0,27053797,-21589374,0.00123457716489852,99.9991535384109,0
394.96,395,82,81,492,324,2024-05-16,2024-06-07,529.78,-1,-168,14949825,-8379167,0.00216724944940827,99.9974648532675,-0.518518518518519
338.46,339,0,6,0,324,2024-05-16,2024-10-18,529.78,6,324,21699053,7078243,0.00149315271961408,99.9871376875295,1
433.89,437,1,1,311,311,2024-05-16,2024-10-18,529.78,0,0,21699053,7078243,0.00143324227098759,99.9885709298005,0
406.45,408,2,2,310,310,2024-05-16,2024-10-18,529.78,0,0,21699053,7078243,0.0014286337749394,99.9899995635754,0
458.96,459,0,77,0,308,2024-05-16,2024-05-24,529.78,77,308,11385857,-4974638,0.00270511038387361,99.9933250522995,1
456.97,457,101,101,404,303,2024-05-16,2024-05-24,529.78,0,-101,11385857,-4974638,0.00266119625426527,99.9959862485538,-0.333333333333333
414.9,415,14,24,210,240,2024-05-16,2024-06-14,529.78,10,30,24055258,-5534803,0.000997702872278485,99.9980835790662,0.125
385.8,387,2,2,240,240,2024-05-16,2024-10-18,529.78,0,0,21699053,7078243,0.00110603905156598,99.991105602627,0
334.99,335,229,229,229,229,2024-05-16,2024-05-31,529.78,0,0,27053797,-21589374,0.000846461589107067,100,0
341.44,342,0,4,0,224,2024-05-16,2024-10-18,529.78,4,224,21699053,7078243,0.00103230311479492,99.9921379057418,1
269.78,270,0,10,0,220,2024-05-16,2024-10-18,529.78,10,220,21699053,7078243,0.00101386913060215,99.9931517748724,1
204.98,205,104,104,208,208,2024-05-16,2024-08-16,529.78,0,0,85913959,-15086717,0.000242102683220546,99.9997322903022,0
394.92,395,26,25,234,200,2024-05-16,2024-06-14,529.78,-1,-34,24055258,-5534803,0.000831419060232071,99.9989149981264,-0.17
304.6,305,5,5,200,200,2024-05-16,2024-10-18,529.78,0,0,21699053,7078243,0.000921699209638319,99.994073474082,0
384.96,385,41,49,164,196,2024-05-16,2024-06-07,529.78,8,32,14949825,-8379167,0.00131105213606179,99.9987759054036,0.163265306122449
432.07,434,0,1,0,193,2024-05-16,2024-10-18,529.78,1,193,21699053,7078243,0.000889439737300978,99.9949629138193,1
359.97,360,61,61,183,183,2024-05-16,2024-06-07,529.78,0,0,14949825,-8379167,0.00122409459642504,100,0
403.19,405,1,1,181,181,2024-05-16,2024-10-18,529.78,0,0,21699053,7078243,0.000834137784722679,99.9957970516041,0
294.64,295,5,5,180,180,2024-05-16,2024-10-18,529.78,0,0,21699053,7078243,0.000829529288674487,99.9966265808927,0
443.98,444,86,86,172,172,2024-05-16,2024-05-17,529.78,0,0,12246418,-21476147,0.00140449231767199,99.9995182264724,0
214.95,215,32,32,160,160,2024-05-16,2024-08-16,529.78,0,0,85913959,-15086717,0.000186232833246574,99.9999185231355,0
419.43,421,0,1,0,157,2024-05-16,2024-10-18,529.78,1,157,21699053,7078243,0.000723533879566081,99.9973501147723,1
465.94,466,23,23,138,138,2024-05-16,2024-05-24,529.78,0,0,11385857,-4974638,0.00121202997719012,99.997198278531,0
374.95,375,12,27,96,135,2024-05-16,2024-06-14,529.78,15,39,24055258,-5534803,0.000561207865656648,99.9994762059921,0.288888888888889
393.73,395,1,1,127,127,2024-05-16,2024-10-18,529.78,0,0,21699053,7078243,0.000585278998120333,99.9979353937704,0
377.98,379,1,1,102,102,2024-05-16,2024-10-18,529.78,0,0,21699053,7078243,0.000470066596915543,99.9984054603673,0
380.09,381,0,1,0,91,2024-05-16,2024-10-18,529.78,1,91,21699053,7078243,0.000419373140385435,99.9988248335077,1
455.97,456,37,26,185,78,2024-05-16,2024-05-24,529.78,-11,-107,11385857,-4974638,0.00068506042189007,99.9978833389529,-1.37179487179487
364.96,365,22,19,132,76,2024-05-16,2024-06-14,529.78,-3,-56,24055258,-5534803,0.000315939242888187,99.999792145235,-0.736842105263158
299.63,300,2,2,74,74,2024-05-16,2024-10-18,529.78,0,0,21699053,7078243,0.000341028707566178,99.9991658622153,0
364.26,365,0,1,0,74,2024-05-16,2024-10-18,529.78,1,74,21699053,7078243,0.000341028707566178,99.9995068909229,1
446.97,447,0,24,0,72,2024-05-16,2024-05-24,529.78,24,72,11385857,-4974638,0.000632363466360064,99.9985157024192,1
234.95,235,35,14,245,70,2024-05-16,2024-08-16,529.78,-21,-175,85913959,-15086717,8.14768645453762e-05,100,-2.5
445.99,446,59,59,59,59,2024-05-16,2024-05-17,529.78,0,0,12246418,-21476147,0.000481773527573532,100,0
333.42,334,1,1,58,58,2024-05-16,2024-10-18,529.78,0,0,21699053,7078243,0.000267292770795113,99.9997741836937,0
478.93,479,8,8,56,56,2024-05-16,2024-05-24,529.78,0,0,11385857,-4974638,0.000491838251613383,99.9990075406709,0
447.98,448,0,26,0,52,2024-05-16,2024-05-24,529.78,26,52,11385857,-4974638,0.000456706947926713,99.9994642476188,1
369.95,370,10,10,60,50,2024-05-16,2024-06-14,529.78,0,-10,24055258,-5534803,0.000207854765058018,100,-0.2
328.51,329,0,1,0,49,2024-05-16,2024-10-18,529.78,1,49,21699053,7078243,0.000225816306361388,100,1
477.93,478,2,2,14,14,2024-05-16,2024-05-24,529.78,0,0,11385857,-4974638,0.000122959562903346,99.9995872071817,0
460.96,461,0,3,0,12,2024-05-16,2024-05-24,529.78,3,12,11385857,-4974638,0.000105393911060011,99.9996926010927,1
471.94,472,2,2,12,12,2024-05-16,2024-05-24,529.78,0,0,11385857,-4974638,0.000105393911060011,99.9997979950038,0
462.95,463,1,1,5,5,2024-05-16,2024-05-24,529.78,0,0,11385857,-4974638,4.39141296083378e-05,99.9998419091334,0
468.95,469,1,1,5,5,2024-05-16,2024-05-24,529.78,0,0,11385857,-4974638,4.39141296083378e-05,99.999885823263,0
470.95,471,0,1,0,5,2024-05-16,2024-05-24,529.78,1,5,11385857,-4974638,4.39141296083378e-05,99.9999297373926,1
443.96,444,1,1,4,4,2024-05-16,2024-05-24,529.78,0,0,11385857,-4974638,3.51313036866702e-05,99.9999648686963,0
473.96,474,0,1,0,4,2024-05-16,2024-05-24,529.78,1,4,11385857,-4974638,3.51313036866702e-05,100,1
528.65,538,0,0,0,0,2024-05-16,2024-05-17,529.78,0,0,12246418,-21476147,0,100,
501.64,539,0,0,0,0,2024-05-16,2024-05-17,529.78,0,0,12246418,-21476147,0,100,
541,541,0,0,0,0,2024-05-16,2024-05-17,529.78,0,0,12246418,-21476147,0,100,
542,542,0,0,0,0,2024-05-16,2024-05-17,529.78,0,0,12246418,-21476147,0,100,
529.13,544,0,0,0,0,2024-05-16,2024-05-17,529.78,0,0,12246418,-21476147,0,100,
529.12,545,0,0,0,0,2024-05-16,2024-05-17,529.78,0,0,12246418,-21476147,0,100,
529.6,546,1,0,2410,0,2024-05-16,2024-05-17,529.78,-1,-2410,12246418,-21476147,0,100,-Inf
548,548,0,0,0,0,2024-05-16,2024-05-17,529.78,0,0,12246418,-21476147,0,100,
549,549,0,0,0,0,2024-05-16,2024-05-17,529.78,0,0,12246418,-21476147,0,100,
519.7,555,0,0,0,0,2024-05-16,2024-05-17,529.78,0,0,12246418,-21476147,0,100,
520.78,565,0,0,0,0,2024-05-16,2024-05-17,529.78,0,0,12246418,-21476147,0,100,
520.77,570,0,0,0,0,2024-05-16,2024-05-17,529.78,0,0,12246418,-21476147,0,100,
510.45,575,0,0,0,0,2024-05-16,2024-05-17,529.78,0,0,12246418,-21476147,0,100,
529.05,585,0,0,0,0,2024-05-16,2024-05-17,529.78,0,0,12246418,-21476147,0,100,
529.04,590,0,0,0,0,2024-05-16,2024-05-17,529.78,0,0,12246418,-21476147,0,100,
522.4,595,0,0,0,0,2024-05-16,2024-05-17,529.78,0,0,12246418,-21476147,0,100,
515.4,600,0,0,0,0,2024-05-16,2024-05-17,529.78,0,0,12246418,-21476147,0,100,
605,605,0,0,0,0,2024-05-16,2024-05-17,529.78,0,0,12246418,-21476147,0,100,
529.03,610,1,0,8865,0,2024-05-16,2024-05-17,529.78,-1,-8865,12246418,-21476147,0,100,-Inf
517.39,615,0,0,0,0,2024-05-16,2024-05-17,529.78,0,0,12246418,-21476147,0,100,
446,446,0,0,0,0,2024-05-16,2024-05-24,529.78,0,0,11385857,-4974638,0,100,
462,462,0,0,0,0,2024-05-16,2024-05-24,529.78,0,0,11385857,-4974638,0,100,
464,464,0,0,0,0,2024-05-16,2024-05-24,529.78,0,0,11385857,-4974638,0,100,
467,467,0,0,0,0,2024-05-16,2024-05-24,529.78,0,0,11385857,-4974638,0,100,
473,473,0,0,0,0,2024-05-16,2024-05-24,529.78,0,0,11385857,-4974638,0,100,
476,476,0,0,0,0,2024-05-16,2024-05-24,529.78,0,0,11385857,-4974638,0,100,
544,544,0,0,0,0,2024-05-16,2024-05-24,529.78,0,0,11385857,-4974638,0,100,
520.68,546,0,0,0,0,2024-05-16,2024-05-24,529.78,0,0,11385857,-4974638,0,100,
520.66,547,0,0,0,0,2024-05-16,2024-05-24,529.78,0,0,11385857,-4974638,0,100,
548,548,0,0,0,0,2024-05-16,2024-05-24,529.78,0,0,11385857,-4974638,0,100,
549,549,0,0,0,0,2024-05-16,2024-05-24,529.78,0,0,11385857,-4974638,0,100,
517.58,555,0,0,0,0,2024-05-16,2024-05-24,529.78,0,0,11385857,-4974638,0,100,
560,560,0,0,0,0,2024-05-16,2024-05-24,529.78,0,0,11385857,-4974638,0,100,
518.96,565,0,0,0,0,2024-05-16,2024-05-24,529.78,0,0,11385857,-4974638,0,100,
570,570,0,0,0,0,2024-05-16,2024-05-24,529.78,0,0,11385857,-4974638,0,100,
575,575,0,0,0,0,2024-05-16,2024-05-24,529.78,0,0,11385857,-4974638,0,100,
580,580,0,0,0,0,2024-05-16,2024-05-24,529.78,0,0,11385857,-4974638,0,100,
590,590,0,0,0,0,2024-05-16,2024-05-24,529.78,0,0,11385857,-4974638,0,100,
595,595,0,0,0,0,2024-05-16,2024-05-24,529.78,0,0,11385857,-4974638,0,100,
600,600,0,0,0,0,2024-05-16,2024-05-24,529.78,0,0,11385857,-4974638,0,100,
506.68,541,0,0,0,0,2024-05-16,2024-05-31,529.78,0,0,27053797,-21589374,0,100,
520.72,543,0,0,0,0,2024-05-16,2024-05-31,529.78,0,0,27053797,-21589374,0,100,
520.99,544,0,0,0,0,2024-05-16,2024-05-31,529.78,0,0,27053797,-21589374,0,100,
529.2,545,0,0,0,0,2024-05-16,2024-05-31,529.78,0,0,27053797,-21589374,0,100,
548,548,0,0,0,0,2024-05-16,2024-05-31,529.78,0,0,27053797,-21589374,0,100,
549,549,0,0,0,0,2024-05-16,2024-05-31,529.78,0,0,27053797,-21589374,0,100,
508.93,560,0,0,0,0,2024-05-16,2024-05-31,529.78,0,0,27053797,-21589374,0,100,
508.91,565,0,0,0,0,2024-05-16,2024-05-31,529.78,0,0,27053797,-21589374,0,100,
530,570,0,0,0,0,2024-05-16,2024-05-31,529.78,0,0,27053797,-21589374,0,100,
520.21,575,0,0,0,0,2024-05-16,2024-05-31,529.78,0,0,27053797,-21589374,0,100,
529,580,2,0,11708,0,2024-05-16,2024-05-31,529.78,-2,-11708,27053797,-21589374,0,100,-Inf
520.7,585,0,0,0,0,2024-05-16,2024-05-31,529.78,0,0,27053797,-21589374,0,100,
520.69,590,0,0,0,0,2024-05-16,2024-05-31,529.78,0,0,27053797,-21589374,0,100,
595,595,0,0,0,0,2024-05-16,2024-05-31,529.78,0,0,27053797,-21589374,0,100,
522.23,600,0,0,0,0,2024-05-16,2024-05-31,529.78,0,0,27053797,-21589374,0,100,
528.9,555,10,0,33560,0,2024-05-16,2024-06-07,529.78,-10,-33560,14949825,-8379167,0,100,-Inf
523.33,565,0,0,0,0,2024-05-16,2024-06-07,529.78,0,0,14949825,-8379167,0,100,
570,570,0,0,0,0,2024-05-16,2024-06-07,529.78,0,0,14949825,-8379167,0,100,
575,575,0,0,0,0,2024-05-16,2024-06-07,529.78,0,0,14949825,-8379167,0,100,
528.15,580,0,0,0,0,2024-05-16,2024-06-07,529.78,0,0,14949825,-8379167,0,100,
585,585,0,0,0,0,2024-05-16,2024-06-07,529.78,0,0,14949825,-8379167,0,100,
590,590,0,0,0,0,2024-05-16,2024-06-07,529.78,0,0,14949825,-8379167,0,100,
595,595,0,0,0,0,2024-05-16,2024-06-07,529.78,0,0,14949825,-8379167,0,100,
600,600,0,0,0,0,2024-05-16,2024-06-07,529.78,0,0,14949825,-8379167,0,100,
555,555,0,0,0,0,2024-05-16,2024-06-14,529.78,0,0,24055258,-5534803,0,100,
560,560,0,0,0,0,2024-05-16,2024-06-14,529.78,0,0,24055258,-5534803,0,100,
565,565,0,0,0,0,2024-05-16,2024-06-14,529.78,0,0,24055258,-5534803,0,100,
525.89,570,0,0,0,0,2024-05-16,2024-06-14,529.78,0,0,24055258,-5534803,0,100,
575,575,0,0,0,0,2024-05-16,2024-06-14,529.78,0,0,24055258,-5534803,0,100,
580,580,0,0,0,0,2024-05-16,2024-06-14,529.78,0,0,24055258,-5534803,0,100,
585,585,0,0,0,0,2024-05-16,2024-06-14,529.78,0,0,24055258,-5534803,0,100,
590,590,0,0,0,0,2024-05-16,2024-06-14,529.78,0,0,24055258,-5534803,0,100,
517.37,595,0,0,0,0,2024-05-16,2024-06-14,529.78,0,0,24055258,-5534803,0,100,
517.35,600,0,0,0,0,2024-05-16,2024-06-14,529.78,0,0,24055258,-5534803,0,100,
500.39,544,0,0,0,0,2024-05-16,2024-06-21,529.78,0,0,168672803,-78039132,0,100,
519.6,547,0,0,0,0,2024-05-16,2024-06-21,529.78,0,0,168672803,-78039132,0,100,
513.31,548,0,0,0,0,2024-05-16,2024-06-21,529.78,0,0,168672803,-78039132,0,100,
523.9,551,0,0,0,0,2024-05-16,2024-06-21,529.78,0,0,168672803,-78039132,0,100,
495.8,552,0,0,0,0,2024-05-16,2024-06-21,529.78,0,0,168672803,-78039132,0,100,
513.69,570,0,0,0,0,2024-05-16,2024-06-21,529.78,0,0,168672803,-78039132,0,100,
524.26,575,0,0,0,0,2024-05-16,2024-06-21,529.78,0,0,168672803,-78039132,0,100,
520.76,585,0,0,0,0,2024-05-16,2024-06-21,529.78,0,0,168672803,-78039132,0,100,
503.78,590,0,0,0,0,2024-05-16,2024-06-21,529.78,0,0,168672803,-78039132,0,100,
529.32,595,0,0,0,0,2024-05-16,2024-06-21,529.78,0,0,168672803,-78039132,0,100,
520.19,605,0,0,0,0,2024-05-16,2024-06-21,529.78,0,0,168672803,-78039132,0,100,
505.13,610,0,0,0,0,2024-05-16,2024-06-21,529.78,0,0,168672803,-78039132,0,100,
519.19,615,0,0,0,0,2024-05-16,2024-06-21,529.78,0,0,168672803,-78039132,0,100,
517.45,620,0,0,0,0,2024-05-16,2024-06-21,529.78,0,0,168672803,-78039132,0,100,
434.09,625,0,0,0,0,2024-05-16,2024-06-21,529.78,0,0,168672803,-78039132,0,100,
509.24,630,0,0,0,0,2024-05-16,2024-06-21,529.78,0,0,168672803,-78039132,0,100,
517.47,635,0,0,0,0,2024-05-16,2024-06-21,529.78,0,0,168672803,-78039132,0,100,
499.02,640,0,0,0,0,2024-05-16,2024-06-21,529.78,0,0,168672803,-78039132,0,100,
433.93,645,0,0,0,0,2024-05-16,2024-06-21,529.78,0,0,168672803,-78039132,0,100,
508.54,650,0,0,0,0,2024-05-16,2024-06-21,529.78,0,0,168672803,-78039132,0,100,
434.02,655,0,0,0,0,2024-05-16,2024-06-21,529.78,0,0,168672803,-78039132,0,100,
433.52,660,0,0,0,0,2024-05-16,2024-06-21,529.78,0,0,168672803,-78039132,0,100,
433.78,665,0,0,0,0,2024-05-16,2024-06-21,529.78,0,0,168672803,-78039132,0,100,
433.8,670,0,0,0,0,2024-05-16,2024-06-21,529.78,0,0,168672803,-78039132,0,100,
510.44,675,0,0,0,0,2024-05-16,2024-06-21,529.78,0,0,168672803,-78039132,0,100,
510.07,680,0,0,0,0,2024-05-16,2024-06-21,529.78,0,0,168672803,-78039132,0,100,
515.07,542,0,0,0,0,2024-05-16,2024-06-28,529.78,0,0,71313964,4291035,0,100,
520.14,546,0,0,0,0,2024-05-16,2024-06-28,529.78,0,0,71313964,4291035,0,100,
547,547,0,0,0,0,2024-05-16,2024-06-28,529.78,0,0,71313964,4291035,0,100,
516.7,549,0,0,0,0,2024-05-16,2024-06-28,529.78,0,0,71313964,4291035,0,100,
517.95,551,0,0,0,0,2024-05-16,2024-06-28,529.78,0,0,71313964,4291035,0,100,
552,552,0,0,0,0,2024-05-16,2024-06-28,529.78,0,0,71313964,4291035,0,100,
553,553,0,0,0,0,2024-05-16,2024-06-28,529.78,0,0,71313964,4291035,0,100,
554,554,0,0,0,0,2024-05-16,2024-06-28,529.78,0,0,71313964,4291035,0,100,
501.26,556,0,0,0,0,2024-05-16,2024-06-28,529.78,0,0,71313964,4291035,0,100,
557,557,0,0,0,0,2024-05-16,2024-06-28,529.78,0,0,71313964,4291035,0,100,
558,558,0,0,0,0,2024-05-16,2024-06-28,529.78,0,0,71313964,4291035,0,100,
559,559,0,0,0,0,2024-05-16,2024-06-28,529.78,0,0,71313964,4291035,0,100,
499.23,560,0,0,0,0,2024-05-16,2024-06-28,529.78,0,0,71313964,4291035,0,100,
561,561,0,0,0,0,2024-05-16,2024-06-28,529.78,0,0,71313964,4291035,0,100,
562,562,0,0,0,0,2024-05-16,2024-06-28,529.78,0,0,71313964,4291035,0,100,
563,563,0,0,0,0,2024-05-16,2024-06-28,529.78,0,0,71313964,4291035,0,100,
526.51,564,0,0,0,0,2024-05-16,2024-06-28,529.78,0,0,71313964,4291035,0,100,
565,565,0,0,0,0,2024-05-16,2024-06-28,529.78,0,0,71313964,4291035,0,100,
566,566,0,0,0,0,2024-05-16,2024-06-28,529.78,0,0,71313964,4291035,0,100,
567,567,0,0,0,0,2024-05-16,2024-06-28,529.78,0,0,71313964,4291035,0,100,
568,568,0,0,0,0,2024-05-16,2024-06-28,529.78,0,0,71313964,4291035,0,100,
569,569,0,0,0,0,2024-05-16,2024-06-28,529.78,0,0,71313964,4291035,0,100,
516.8,570,0,0,0,0,2024-05-16,2024-06-28,529.78,0,0,71313964,4291035,0,100,
575,575,0,0,0,0,2024-05-16,2024-06-28,529.78,0,0,71313964,4291035,0,100,
580,580,0,0,0,0,2024-05-16,2024-06-28,529.78,0,0,71313964,4291035,0,100,
585,585,0,0,0,0,2024-05-16,2024-06-28,529.78,0,0,71313964,4291035,0,100,
590,590,0,0,0,0,2024-05-16,2024-06-28,529.78,0,0,71313964,4291035,0,100,
595,595,0,0,0,0,2024-05-16,2024-06-28,529.78,0,0,71313964,4291035,0,100,
499.77,600,0,0,0,0,2024-05-16,2024-06-28,529.78,0,0,71313964,4291035,0,100,
520.1,555,0,0,0,0,2024-05-16,2024-07-19,529.78,0,0,106722520,-20817707,0,100,
512.24,560,0,0,0,0,2024-05-16,2024-07-19,529.78,0,0,106722520,-20817707,0,100,
501.11,565,0,0,0,0,2024-05-16,2024-07-19,529.78,0,0,106722520,-20817707,0,100,
523.43,570,0,0,0,0,2024-05-16,2024-07-19,529.78,0,0,106722520,-20817707,0,100,
495.5,575,0,0,0,0,2024-05-16,2024-07-19,529.78,0,0,106722520,-20817707,0,100,
501.64,580,0,0,0,0,2024-05-16,2024-07-19,529.78,0,0,106722520,-20817707,0,100,
585,585,0,0,0,0,2024-05-16,2024-07-19,529.78,0,0,106722520,-20817707,0,100,
511,590,0,0,0,0,2024-05-16,2024-07-19,529.78,0,0,106722520,-20817707,0,100,
513.9,595,0,0,0,0,2024-05-16,2024-07-19,529.78,0,0,106722520,-20817707,0,100,
529.71,605,0,0,0,0,2024-05-16,2024-07-19,529.78,0,0,106722520,-20817707,0,100,
610,610,0,0,0,0,2024-05-16,2024-07-19,529.78,0,0,106722520,-20817707,0,100,
523.73,615,0,0,0,0,2024-05-16,2024-07-19,529.78,0,0,106722520,-20817707,0,100,
620,620,0,0,0,0,2024-05-16,2024-07-19,529.78,0,0,106722520,-20817707,0,100,
625,625,0,0,0,0,2024-05-16,2024-07-19,529.78,0,0,106722520,-20817707,0,100,
630,630,0,0,0,0,2024-05-16,2024-07-19,529.78,0,0,106722520,-20817707,0,100,
529.14,640,0,0,0,0,2024-05-16,2024-07-19,529.78,0,0,106722520,-20817707,0,100,
645,645,0,0,0,0,2024-05-16,2024-07-19,529.78,0,0,106722520,-20817707,0,100,
650,650,0,0,0,0,2024-05-16,2024-07-19,529.78,0,0,106722520,-20817707,0,100,
515.6,560,0,0,0,0,2024-05-16,2024-08-16,529.78,0,0,85913959,-15086717,0,100,
514.41,575,0,0,0,0,2024-05-16,2024-08-16,529.78,0,0,85913959,-15086717,0,100,
521.05,580,0,0,0,0,2024-05-16,2024-08-16,529.78,0,0,85913959,-15086717,0,100,
585,585,0,0,0,0,2024-05-16,2024-08-16,529.78,0,0,85913959,-15086717,0,100,
590,590,0,0,0,0,2024-05-16,2024-08-16,529.78,0,0,85913959,-15086717,0,100,
516.43,595,0,0,0,0,2024-05-16,2024-08-16,529.78,0,0,85913959,-15086717,0,100,
507.56,605,0,0,0,0,2024-05-16,2024-08-16,529.78,0,0,85913959,-15086717,0,100,
610,610,0,0,0,0,2024-05-16,2024-08-16,529.78,0,0,85913959,-15086717,0,100,
529.2,620,0,0,0,0,2024-05-16,2024-08-16,529.78,0,0,85913959,-15086717,0,100,
519.07,625,0,0,0,0,2024-05-16,2024-08-16,529.78,0,0,85913959,-15086717,0,100,
514.22,630,0,0,0,0,2024-05-16,2024-08-16,529.78,0,0,85913959,-15086717,0,100,
504.99,635,0,0,0,0,2024-05-16,2024-08-16,529.78,0,0,85913959,-15086717,0,100,
512.31,640,0,0,0,0,2024-05-16,2024-08-16,529.78,0,0,85913959,-15086717,0,100,
645,645,0,0,0,0,2024-05-16,2024-08-16,529.78,0,0,85913959,-15086717,0,100,
650,650,0,0,0,0,2024-05-16,2024-08-16,529.78,0,0,85913959,-15086717,0,100,
520.86,570,0,0,0,0,2024-05-16,2024-09-20,529.78,0,0,207805543,-46765032,0,100,
522.01,575,0,0,0,0,2024-05-16,2024-09-20,529.78,0,0,207805543,-46765032,0,100,
580,580,0,0,0,0,2024-05-16,2024-09-20,529.78,0,0,207805543,-46765032,0,100,
518.8,585,0,0,0,0,2024-05-16,2024-09-20,529.78,0,0,207805543,-46765032,0,100,
590,590,0,0,0,0,2024-05-16,2024-09-20,529.78,0,0,207805543,-46765032,0,100,
595,595,0,0,0,0,2024-05-16,2024-09-20,529.78,0,0,207805543,-46765032,0,100,
503.9,600,0,0,0,0,2024-05-16,2024-09-20,529.78,0,0,207805543,-46765032,0,100,
504.79,605,0,0,0,0,2024-05-16,2024-09-20,529.78,0,0,207805543,-46765032,0,100,
610,610,0,0,0,0,2024-05-16,2024-09-20,529.78,0,0,207805543,-46765032,0,100,
615,615,0,0,0,0,2024-05-16,2024-09-20,529.78,0,0,207805543,-46765032,0,100,
620,620,0,0,0,0,2024-05-16,2024-09-20,529.78,0,0,207805543,-46765032,0,100,
498,625,0,0,0,0,2024-05-16,2024-09-20,529.78,0,0,207805543,-46765032,0,100,
630,630,0,0,0,0,2024-05-16,2024-09-20,529.78,0,0,207805543,-46765032,0,100,
635,635,0,0,0,0,2024-05-16,2024-09-20,529.78,0,0,207805543,-46765032,0,100,
435.01,640,0,0,0,0,2024-05-16,2024-09-20,529.78,0,0,207805543,-46765032,0,100,
645,645,0,0,0,0,2024-05-16,2024-09-20,529.78,0,0,207805543,-46765032,0,100,
434.57,650,0,0,0,0,2024-05-16,2024-09-20,529.78,0,0,207805543,-46765032,0,100,
434.75,655,0,0,0,0,2024-05-16,2024-09-20,529.78,0,0,207805543,-46765032,0,100,
660,660,0,0,0,0,2024-05-16,2024-09-20,529.78,0,0,207805543,-46765032,0,100,
435,665,0,0,0,0,2024-05-16,2024-09-20,529.78,0,0,207805543,-46765032,0,100,
434.73,670,0,0,0,0,2024-05-16,2024-09-20,529.78,0,0,207805543,-46765032,0,100,
434.51,675,0,0,0,0,2024-05-16,2024-09-20,529.78,0,0,207805543,-46765032,0,100,
434.79,680,0,0,0,0,2024-05-16,2024-09-20,529.78,0,0,207805543,-46765032,0,100,
450.5,685,0,0,0,0,2024-05-16,2024-09-20,529.78,0,0,207805543,-46765032,0,100,
434.75,690,0,0,0,0,2024-05-16,2024-09-20,529.78,0,0,207805543,-46765032,0,100,
434.68,695,0,0,0,0,2024-05-16,2024-09-20,529.78,0,0,207805543,-46765032,0,100,
509.3,700,0,0,0,0,2024-05-16,2024-09-20,529.78,0,0,207805543,-46765032,0,100,
275,275,0,0,0,0,2024-05-16,2024-10-18,529.78,0,0,21699053,7078243,0,100,
280,280,0,0,0,0,2024-05-16,2024-10-18,529.78,0,0,21699053,7078243,0,100,
285,285,0,0,0,0,2024-05-16,2024-10-18,529.78,0,0,21699053,7078243,0,100,
290,290,0,0,0,0,2024-05-16,2024-10-18,529.78,0,0,21699053,7078243,0,100,
310,310,0,0,0,0,2024-05-16,2024-10-18,529.78,0,0,21699053,7078243,0,100,
326,326,0,0,0,0,2024-05-16,2024-10-18,529.78,0,0,21699053,7078243,0,100,
327,327,0,0,0,0,2024-05-16,2024-10-18,529.78,0,0,21699053,7078243,0,100,
328,328,0,0,0,0,2024-05-16,2024-10-18,529.78,0,0,21699053,7078243,0,100,
332,332,0,0,0,0,2024-05-16,2024-10-18,529.78,0,0,21699053,7078243,0,100,
333,333,0,0,0,0,2024-05-16,2024-10-18,529.78,0,0,21699053,7078243,0,100,
335,335,0,0,0,0,2024-05-16,2024-10-18,529.78,0,0,21699053,7078243,0,100,
336,336,0,0,0,0,2024-05-16,2024-10-18,529.78,0,0,21699053,7078243,0,100,
337,337,0,0,0,0,2024-05-16,2024-10-18,529.78,0,0,21699053,7078243,0,100,
338,338,0,0,0,0,2024-05-16,2024-10-18,529.78,0,0,21699053,7078243,0,100,
340,340,0,0,0,0,2024-05-16,2024-10-18,529.78,0,0,21699053,7078243,0,100,
341,341,0,0,0,0,2024-05-16,2024-10-18,529.78,0,0,21699053,7078243,0,100,
343,343,0,0,0,0,2024-05-16,2024-10-18,529.78,0,0,21699053,7078243,0,100,
344,344,0,0,0,0,2024-05-16,2024-10-18,529.78,0,0,21699053,7078243,0,100,
345,345,0,0,0,0,2024-05-16,2024-10-18,529.78,0,0,21699053,7078243,0,100,
346,346,0,0,0,0,2024-05-16,2024-10-18,529.78,0,0,21699053,7078243,0,100,
347,347,0,0,0,0,2024-05-16,2024-10-18,529.78,0,0,21699053,7078243,0,100,
348,348,0,0,0,0,2024-05-16,2024-10-18,529.78,0,0,21699053,7078243,0,100,
349,349,0,0,0,0,2024-05-16,2024-10-18,529.78,0,0,21699053,7078243,0,100,
351,351,0,0,0,0,2024-05-16,2024-10-18,529.78,0,0,21699053,7078243,0,100,
352,352,0,0,0,0,2024-05-16,2024-10-18,529.78,0,0,21699053,7078243,0,100,
353,353,0,0,0,0,2024-05-16,2024-10-18,529.78,0,0,21699053,7078243,0,100,
354,354,0,0,0,0,2024-05-16,2024-10-18,529.78,0,0,21699053,7078243,0,100,
355,355,0,0,0,0,2024-05-16,2024-10-18,529.78,0,0,21699053,7078243,0,100,
356,356,0,0,0,0,2024-05-16,2024-10-18,529.78,0,0,21699053,7078243,0,100,
357,357,0,0,0,0,2024-05-16,2024-10-18,529.78,0,0,21699053,7078243,0,100,
358,358,0,0,0,0,2024-05-16,2024-10-18,529.78,0,0,21699053,7078243,0,100,
359,359,0,0,0,0,2024-05-16,2024-10-18,529.78,0,0,21699053,7078243,0,100,
361,361,0,0,0,0,2024-05-16,2024-10-18,529.78,0,0,21699053,7078243,0,100,
362,362,0,0,0,0,2024-05-16,2024-10-18,529.78,0,0,21699053,7078243,0,100,
363,363,0,0,0,0,2024-05-16,2024-10-18,529.78,0,0,21699053,7078243,0,100,
364,364,0,0,0,0,2024-05-16,2024-10-18,529.78,0,0,21699053,7078243,0,100,
366,366,0,0,0,0,2024-05-16,2024-10-18,529.78,0,0,21699053,7078243,0,100,
367,367,0,0,0,0,2024-05-16,2024-10-18,529.78,0,0,21699053,7078243,0,100,
368,368,0,0,0,0,2024-05-16,2024-10-18,529.78,0,0,21699053,7078243,0,100,
369,369,0,0,0,0,2024-05-16,2024-10-18,529.78,0,0,21699053,7078243,0,100,
370,370,0,0,0,0,2024-05-16,2024-10-18,529.78,0,0,21699053,7078243,0,100,
371,371,0,0,0,0,2024-05-16,2024-10-18,529.78,0,0,21699053,7078243,0,100,
372,372,0,0,0,0,2024-05-16,2024-10-18,529.78,0,0,21699053,7078243,0,100,
373,373,0,0,0,0,2024-05-16,2024-10-18,529.78,0,0,21699053,7078243,0,100,
374,374,0,0,0,0,2024-05-16,2024-10-18,529.78,0,0,21699053,7078243,0,100,
376,376,0,0,0,0,2024-05-16,2024-10-18,529.78,0,0,21699053,7078243,0,100,
377,377,0,0,0,0,2024-05-16,2024-10-18,529.78,0,0,21699053,7078243,0,100,
378,378,0,0,0,0,2024-05-16,2024-10-18,529.78,0,0,21699053,7078243,0,100,
383,383,0,0,0,0,2024-05-16,2024-10-18,529.78,0,0,21699053,7078243,0,100,
385,385,0,0,0,0,2024-05-16,2024-10-18,529.78,0,0,21699053,7078243,0,100,
386,386,0,0,0,0,2024-05-16,2024-10-18,529.78,0,0,21699053,7078243,0,100,
388,388,0,0,0,0,2024-05-16,2024-10-18,529.78,0,0,21699053,7078243,0,100,
389,389,0,0,0,0,2024-05-16,2024-10-18,529.78,0,0,21699053,7078243,0,100,
391,391,0,0,0,0,2024-05-16,2024-10-18,529.78,0,0,21699053,7078243,0,100,
392,392,0,0,0,0,2024-05-16,2024-10-18,529.78,0,0,21699053,7078243,0,100,
394,394,0,0,0,0,2024-05-16,2024-10-18,529.78,0,0,21699053,7078243,0,100,
396,396,0,0,0,0,2024-05-16,2024-10-18,529.78,0,0,21699053,7078243,0,100,
397,397,0,0,0,0,2024-05-16,2024-10-18,529.78,0,0,21699053,7078243,0,100,
398,398,0,0,0,0,2024-05-16,2024-10-18,529.78,0,0,21699053,7078243,0,100,
403,403,0,0,0,0,2024-05-16,2024-10-18,529.78,0,0,21699053,7078243,0,100,
404,404,0,0,0,0,2024-05-16,2024-10-18,529.78,0,0,21699053,7078243,0,100,
407,407,0,0,0,0,2024-05-16,2024-10-18,529.78,0,0,21699053,7078243,0,100,
409,409,0,0,0,0,2024-05-16,2024-10-18,529.78,0,0,21699053,7078243,0,100,
412,412,0,0,0,0,2024-05-16,2024-10-18,529.78,0,0,21699053,7078243,0,100,
413,413,0,0,0,0,2024-05-16,2024-10-18,529.78,0,0,21699053,7078243,0,100,
416,416,0,0,0,0,2024-05-16,2024-10-18,529.78,0,0,21699053,7078243,0,100,
417,417,0,0,0,0,2024-05-16,2024-10-18,529.78,0,0,21699053,7078243,0,100,
419,419,0,0,0,0,2024-05-16,2024-10-18,529.78,0,0,21699053,7078243,0,100,
422,422,0,0,0,0,2024-05-16,2024-10-18,529.78,0,0,21699053,7078243,0,100,
423,423,0,0,0,0,2024-05-16,2024-10-18,529.78,0,0,21699053,7078243,0,100,
424,424,0,0,0,0,2024-05-16,2024-10-18,529.78,0,0,21699053,7078243,0,100,
426,426,0,0,0,0,2024-05-16,2024-10-18,529.78,0,0,21699053,7078243,0,100,
427,427,0,0,0,0,2024-05-16,2024-10-18,529.78,0,0,21699053,7078243,0,100,
429,429,0,0,0,0,2024-05-16,2024-10-18,529.78,0,0,21699053,7078243,0,100,
431,431,0,0,0,0,2024-05-16,2024-10-18,529.78,0,0,21699053,7078243,0,100,
433,433,0,0,0,0,2024-05-16,2024-10-18,529.78,0,0,21699053,7078243,0,100,
436,436,0,0,0,0,2024-05-16,2024-10-18,529.78,0,0,21699053,7078243,0,100,
438,438,0,0,0,0,2024-05-16,2024-10-18,529.78,0,0,21699053,7078243,0,100,
439,439,0,0,0,0,2024-05-16,2024-10-18,529.78,0,0,21699053,7078243,0,100,
565,565,0,0,0,0,2024-05-16,2024-10-18,529.78,0,0,21699053,7078243,0,100,
530.39,570,1,0,4792,0,2024-05-16,2024-10-18,529.78,-1,-4792,21699053,7078243,0,100,-Inf
522.08,575,0,0,0,0,2024-05-16,2024-10-18,529.78,0,0,21699053,7078243,0,100,
580,580,0,0,0,0,2024-05-16,2024-10-18,529.78,0,0,21699053,7078243,0,100,
521.88,585,0,0,0,0,2024-05-16,2024-10-18,529.78,0,0,21699053,7078243,0,100,
590,590,0,0,0,0,2024-05-16,2024-10-18,529.78,0,0,21699053,7078243,0,100,
595,595,0,0,0,0,2024-05-16,2024-10-18,529.78,0,0,21699053,7078243,0,100,
600,600,0,0,0,0,2024-05-16,2024-10-18,529.78,0,0,21699053,7078243,0,100,
605,605,0,0,0,0,2024-05-16,2024-10-18,529.78,0,0,21699053,7078243,0,100,
610,610,0,0,0,0,2024-05-16,2024-10-18,529.78,0,0,21699053,7078243,0,100,
615,615,0,0,0,0,2024-05-16,2024-10-18,529.78,0,0,21699053,7078243,0,100,
620,620,0,0,0,0,2024-05-16,2024-10-18,529.78,0,0,21699053,7078243,0,100,
625,625,0,0,0,0,2024-05-16,2024-10-18,529.78,0,0,21699053,7078243,0,100,
630,630,0,0,0,0,2024-05-16,2024-10-18,529.78,0,0,21699053,7078243,0,100,
635,635,0,0,0,0,2024-05-16,2024-10-18,529.78,0,0,21699053,7078243,0,100,
640,640,0,0,0,0,2024-05-16,2024-10-18,529.78,0,0,21699053,7078243,0,100,
645,645,0,0,0,0,2024-05-16,2024-10-18,529.78,0,0,21699053,7078243,0,100,
521.61,650,0,0,0,0,2024-05-16,2024-10-18,529.78,0,0,21699053,7078243,0,100,
655,655,0,0,0,0,2024-05-16,2024-10-18,529.78,0,0,21699053,7078243,0,100,
500.7,565,0,0,0,0,2024-05-16,2024-12-20,529.78,0,0,392218823,-61081925,0,100,
500.86,575,0,0,0,0,2024-05-16,2024-12-20,529.78,0,0,392218823,-61081925,0,100,
505.75,585,0,0,0,0,2024-05-16,2024-12-20,529.78,0,0,392218823,-61081925,0,100,
528.62,590,0,0,0,0,2024-05-16,2024-12-20,529.78,0,0,392218823,-61081925,0,100,
595,595,0,0,0,0,2024-05-16,2024-12-20,529.78,0,0,392218823,-61081925,0,100,
505.66,605,0,0,0,0,2024-05-16,2024-12-20,529.78,0,0,392218823,-61081925,0,100,
513.01,610,0,0,0,0,2024-05-16,2024-12-20,529.78,0,0,392218823,-61081925,0,100,
519.93,615,0,0,0,0,2024-05-16,2024-12-20,529.78,0,0,392218823,-61081925,0,100,
529.15,625,0,0,0,0,2024-05-16,2024-12-20,529.78,0,0,392218823,-61081925,0,100,
501.25,630,0,0,0,0,2024-05-16,2024-12-20,529.78,0,0,392218823,-61081925,0,100,
514.35,635,0,0,0,0,2024-05-16,2024-12-20,529.78,0,0,392218823,-61081925,0,100,
484.92,640,0,0,0,0,2024-05-16,2024-12-20,529.78,0,0,392218823,-61081925,0,100,
493.79,645,0,0,0,0,2024-05-16,2024-12-20,529.78,0,0,392218823,-61081925,0,100,
497.5,650,0,0,0,0,2024-05-16,2024-12-20,529.78,0,0,392218823,-61081925,0,100,
453.98,655,0,0,0,0,2024-05-16,2024-12-20,529.78,0,0,392218823,-61081925,0,100,
418.16,660,0,0,0,0,2024-05-16,2024-12-20,529.78,0,0,392218823,-61081925,0,100,
665,665,0,0,0,0,2024-05-16,2024-12-20,529.78,0,0,392218823,-61081925,0,100,
670,670,0,0,0,0,2024-05-16,2024-12-20,529.78,0,0,392218823,-61081925,0,100,
675,675,0,0,0,0,2024-05-16,2024-12-20,529.78,0,0,392218823,-61081925,0,100,
680,680,0,0,0,0,2024-05-16,2024-12-20,529.78,0,0,392218823,-61081925,0,100,
685,685,0,0,0,0,2024-05-16,2024-12-20,529.78,0,0,392218823,-61081925,0,100,
690,690,0,0,0,0,2024-05-16,2024-12-20,529.78,0,0,392218823,-61081925,0,100,
493.35,695,0,0,0,0,2024-05-16,2024-12-20,529.78,0,0,392218823,-61081925,0,100,
498.41,700,0,0,0,0,2024-05-16,2024-12-20,529.78,0,0,392218823,-61081925,0,100,
705,705,0,0,0,0,2024-05-16,2024-12-20,529.78,0,0,392218823,-61081925,0,100,
418.57,710,0,0,0,0,2024-05-16,2024-12-20,529.78,0,0,392218823,-61081925,0,100,
494.27,715,0,0,0,0,2024-05-16,2024-12-20,529.78,0,0,392218823,-61081925,0,100,
528.95,725,0,0,0,0,2024-05-16,2024-12-20,529.78,0,0,392218823,-61081925,0,100,
730,730,0,0,0,0,2024-05-16,2024-12-20,529.78,0,0,392218823,-61081925,0,100,
735,735,0,0,0,0,2024-05-16,2024-12-20,529.78,0,0,392218823,-61081925,0,100,
740,740,0,0,0,0,2024-05-16,2024-12-20,529.78,0,0,392218823,-61081925,0,100,
512.87,745,0,0,0,0,2024-05-16,2024-12-20,529.78,0,0,392218823,-61081925,0,100,
750,750,0,0,0,0,2024-05-16,2024-12-20,529.78,0,0,392218823,-61081925,0,100,
755,755,0,0,0,0,2024-05-16,2024-12-20,529.78,0,0,392218823,-61081925,0,100,
760,760,0,0,0,0,2024-05-16,2024-12-20,529.78,0,0,392218823,-61081925,0,100,
765,765,0,0,0,0,2024-05-16,2024-12-20,529.78,0,0,392218823,-61081925,0,100,
770,770,0,0,0,0,2024-05-16,2024-12-20,529.78,0,0,392218823,-61081925,0,100,
